"","Team","Opponent","game_id","game_date","season","is_home","TOI","GF","GA","G_diff","xGF","xGA","xG_diff","SF","SA","S_diff","FF","FA","F_diff","CF","CA","C_diff","PEND2","PENT2","PEND5","PENT5"
"1","ANA","S.J",2008020008,14161,20082009,0,60,1,4,-3,0,0,0,29,41,-12,30,48,-18,40,63,-23,2,7,0,0
"2","ANA","ARI",2008020030,14164,20082009,1,60,2,4,-2,0,0,0,35,24,11,50,32,18,58,39,19,7,9,0,0
"3","ANA","L.A",2008020042,14166,20082009,0,60,3,6,-3,0,0,0,26,23,3,36,37,-1,46,45,1,7,11,0,0
"4","ANA","EDM",2008020048,14167,20082009,1,60,2,3,-1,0,0,0,35,28,7,49,41,8,61,47,14,2,4,0,0
"5","ANA","S.J",2008020061,14169,20082009,1,60,4,0,4,0,0,0,20,38,-18,36,52,-16,43,59,-16,7,8,0,0
"6","ANA","CAR",2008020077,14171,20082009,1,60,1,3,-2,0,0,0,33,24,9,55,32,23,70,38,32,4,4,0,0
"7","ANA","TOR",2008020083,14173,20082009,0,65,2,2,0,0,0,0,21,38,-17,32,63,-31,52,83,-31,1,4,0,0
"8","ANA","OTT",2008020099,14176,20082009,0,60,4,3,1,0,0,0,32,30,2,44,46,-2,52,59,-7,3,7,0,0
"9","ANA","MTL",2008020107,14177,20082009,0,60,6,4,2,0,0,0,25,51,-26,37,64,-27,53,78,-25,6,8,0,0
"10","ANA","CBJ",2008020122,14179,20082009,0,60,3,2,1,0,0,0,24,32,-8,34,46,-12,39,57,-18,6,7,0,0
"11","ANA","DET",2008020135,14181,20082009,1,61.65,5,4,1,0,0,0,34,38,-4,45,50,-5,57,60,-3,9,8,0,0
"12","ANA","VAN",2008020149,14183,20082009,1,65,6,6,0,0,0,0,37,29,8,48,37,11,57,45,12,11,8,0,0
"13","ANA","CGY",2008020166,14185,20082009,1,60,3,2,1,0,0,0,37,36,1,53,49,4,59,55,4,1,6,0,0
"14","ANA","L.A",2008020176,14187,20082009,0,60.6666666666667,1,0,1,0,0,0,27,35,-8,35,55,-20,42,66,-24,6,7,0,0
"15","ANA","STL",2008020180,14188,20082009,1,60,5,2,3,0,0,0,27,32,-5,37,41,-4,49,50,-1,1,5,0,0
"16","ANA","DAL",2008020195,14190,20082009,1,60,2,5,-3,0,0,0,30,26,4,46,35,11,53,39,14,7,7,0,0
"17","ANA","FLA",2008020212,14192,20082009,1,60,1,3,-2,0,0,0,45,26,19,55,34,21,64,41,23,5,5,0,0
"18","ANA","NSH",2008020241,14197,20082009,1,62.2833333333333,3,4,-1,0,0,0,35,35,0,54,48,6,63,56,7,4,5,0,0
"19","ANA","L.A",2008020256,14199,20082009,1,60,2,0,2,0,0,0,26,29,-3,38,43,-5,42,51,-9,3,4,0,0
"20","ANA","WSH",2008020270,14202,20082009,1,60,4,6,-2,0,0,0,32,33,-1,44,36,8,50,41,9,8,10,0,0
"21","ANA","STL",2008020284,14204,20082009,0,62.65,2,3,-1,0,0,0,28,28,0,33,40,-7,53,51,2,6,6,0,0
"22","ANA","DAL",2008020293,14205,20082009,0,65,1,1,0,0,0,0,24,32,-8,36,55,-19,45,64,-19,7,9,0,0
"23","ANA","COL",2008020305,14207,20082009,1,60,4,1,3,0,0,0,24,30,-6,37,44,-7,41,51,-10,3,4,0,0
"24","ANA","CHI",2008020327,14211,20082009,1,60,1,0,1,0,0,0,21,26,-5,28,39,-11,34,42,-8,1,2,0,0
"25","ANA","CAR",2008020349,14213,20082009,0,60,4,1,3,0,0,0,27,37,-10,35,55,-20,49,79,-30,4,4,0,0
"26","ANA","DET",2008020352,14214,20082009,0,60,1,2,-1,0,0,0,16,47,-31,26,67,-41,41,73,-32,2,4,0,0
"27","ANA","CHI",2008020364,14216,20082009,0,60,2,4,-2,0,0,0,32,41,-9,38,48,-10,43,60,-17,3,5,0,0
"28","ANA","CBJ",2008020396,14220,20082009,1,60,5,3,2,0,0,0,34,32,2,41,47,-6,49,52,-3,4,6,0,0
"29","ANA","STL",2008020413,14223,20082009,1,60,4,2,2,0,0,0,36,28,8,46,39,7,53,47,6,5,6,0,0
"30","ANA","S.J",2008020421,14224,20082009,0,60,0,2,-2,0,0,0,31,27,4,46,40,6,63,55,8,5,6,0,0
"31","ANA","MIN",2008020442,14227,20082009,1,60,4,2,2,0,0,0,34,28,6,45,37,8,52,42,10,4,4,0,0
"32","ANA","NYR",2008020454,14229,20082009,1,60,1,3,-2,0,0,0,20,30,-10,29,41,-12,38,48,-10,4,5,0,0
"33","ANA","EDM",2008020473,14232,20082009,0,65,2,2,0,0,0,0,36,53,-17,48,63,-15,59,75,-16,10,11,0,0
"34","ANA","VAN",2008020493,14235,20082009,0,60,3,4,-1,0,0,0,27,26,1,45,40,5,61,50,11,8,10,0,0
"35","ANA","CGY",2008020505,14236,20082009,0,60,3,4,-1,0,0,0,33,32,1,45,49,-4,53,67,-14,1,4,0,0
"36","ANA","DAL",2008020522,14240,20082009,0,63.5666666666667,3,4,-1,0,0,0,22,38,-16,34,57,-23,44,68,-24,3,6,0,0
"37","ANA","STL",2008020528,14241,20082009,0,60,4,3,1,0,0,0,29,30,-1,38,43,-5,47,54,-7,6,8,0,0
"38","ANA","CBJ",2008020552,14244,20082009,1,60,0,2,-2,0,0,0,27,29,-2,36,38,-2,46,46,0,6,5,0,0
"39","ANA","PHI",2008020564,14246,20082009,1,65,4,4,0,0,0,0,27,32,-5,42,46,-4,47,55,-8,5,6,0,0
"40","ANA","ARI",2008020581,14248,20082009,1,60,2,0,2,0,0,0,34,29,5,55,37,18,60,44,16,4,3,0,0
"41","ANA","L.A",2008020595,14250,20082009,1,60,3,1,2,0,0,0,26,18,8,33,28,5,44,40,4,5,4,0,0
"42","ANA","L.A",2008020608,14252,20082009,0,60,3,4,-1,0,0,0,27,26,1,48,36,12,60,46,14,7,4,0,0
"43","ANA","T.B",2008020613,14253,20082009,1,60,3,4,-1,0,0,0,32,19,13,45,29,16,57,38,19,4,3,0,0
"44","ANA","N.J",2008020628,14255,20082009,1,60,4,3,1,0,0,0,34,21,13,44,27,17,51,33,18,4,2,0,0
"45","ANA","DET",2008020645,14258,20082009,1,60,3,4,-1,0,0,0,28,33,-5,40,54,-14,52,63,-11,4,4,0,0
"46","ANA","PIT",2008020657,14260,20082009,0,60,1,3,-2,0,0,0,22,24,-2,35,32,3,49,42,7,5,4,0,0
"47","ANA","MIN",2008020670,14261,20082009,0,60,3,0,3,0,0,0,34,30,4,43,48,-5,52,59,-7,1,4,0,0
"48","ANA","NYR",2008020684,14264,20082009,0,60,2,4,-2,0,0,0,34,30,4,51,48,3,60,55,5,5,7,0,0
"49","ANA","NYI",2008020693,14265,20082009,0,60,1,2,-1,0,0,0,40,14,26,54,21,33,82,30,52,5,1,0,0
"50","ANA","ARI",2008020711,14271,20082009,0,60,7,3,4,0,0,0,37,26,11,44,35,9,54,49,5,1,5,0,0
"51","ANA","CHI",2008020714,14272,20082009,1,60,2,3,-1,0,0,0,38,27,11,58,37,21,66,43,23,3,4,0,0
"52","ANA","COL",2008020733,14275,20082009,0,60,4,3,1,0,0,0,31,37,-6,45,52,-7,66,67,-1,5,4,0,0
"53","ANA","BUF",2008020747,14277,20082009,1,60,3,2,1,0,0,0,37,23,14,51,30,21,58,36,22,4,3,0,0
"54","ANA","MIN",2008020763,14279,20082009,0,60,0,3,-3,0,0,0,34,25,9,46,40,6,62,48,14,5,3,0,0
"55","ANA","NSH",2008020767,14280,20082009,0,60,2,4,-2,0,0,0,30,34,-4,35,42,-7,51,56,-5,2,2,0,0
"56","ANA","CGY",2008020779,14282,20082009,0,60,2,1,1,0,0,0,25,27,-2,38,34,4,50,44,6,2,4,0,0
"57","ANA","CGY",2008020810,14286,20082009,1,60.9166666666667,3,2,1,0,0,0,40,23,17,52,36,16,65,41,24,6,5,0,0
"58","ANA","ATL",2008020839,14290,20082009,1,60,4,8,-4,0,0,0,35,43,-8,51,52,-1,64,62,2,3,6,0,0
"59","ANA","L.A",2008020858,14293,20082009,1,60,3,4,-1,0,0,0,31,26,5,41,42,-1,50,54,-4,8,8,0,0
"60","ANA","DET",2008020873,14295,20082009,0,60,2,5,-3,0,0,0,26,34,-8,39,49,-10,50,62,-12,4,5,0,0
"61","ANA","CBJ",2008020883,14296,20082009,0,60,5,2,3,0,0,0,13,28,-15,20,39,-19,27,54,-27,4,9,0,0
"62","ANA","BUF",2008020894,14299,20082009,0,60,3,2,1,0,0,0,22,36,-14,27,45,-18,40,52,-12,5,6,0,0
"63","ANA","BOS",2008020908,14301,20082009,0,60,0,6,-6,0,0,0,35,27,8,43,32,11,54,47,7,4,5,0,0
"64","ANA","DAL",2008020925,14303,20082009,0,60,4,3,1,0,0,0,18,33,-15,29,44,-15,41,54,-13,3,5,0,0
"65","ANA","CHI",2008020949,14306,20082009,0,61.6666666666667,2,3,-1,0,0,0,28,37,-9,41,46,-5,51,54,-3,3,2,0,0
"66","ANA","DAL",2008020968,14309,20082009,1,60,2,3,-1,0,0,0,38,16,22,51,22,29,63,27,36,4,5,0,0
"67","ANA","MIN",2008020985,14311,20082009,1,60,2,3,-1,0,0,0,38,25,13,54,32,22,63,39,24,3,4,0,0
"68","ANA","VAN",2008021002,14314,20082009,1,63.6166666666667,4,3,1,0,0,0,41,35,6,57,52,5,65,61,4,7,7,0,0
"69","ANA","S.J",2008021036,14318,20082009,1,60,0,1,-1,0,0,0,34,30,4,46,42,4,59,54,5,4,4,0,0
"70","ANA","NSH",2008021054,14321,20082009,1,60.5666666666667,4,3,1,0,0,0,31,24,7,44,26,18,54,31,23,5,3,0,0
"71","ANA","ARI",2008021061,14322,20082009,0,65,2,2,0,0,0,0,27,28,-1,37,44,-7,48,55,-7,3,6,0,0
"72","ANA","ARI",2008021083,14325,20082009,1,60,6,2,4,0,0,0,30,28,2,49,40,9,65,52,13,4,4,0,0
"73","ANA","NSH",2008021092,14327,20082009,0,65,1,1,0,0,0,0,19,32,-13,28,44,-16,42,61,-19,1,3,0,0
"74","ANA","COL",2008021101,14328,20082009,0,60,7,2,5,0,0,0,29,36,-7,33,50,-17,50,58,-8,8,6,0,0
"75","ANA","EDM",2008021115,14330,20082009,1,60,3,5,-2,0,0,0,54,20,34,78,27,51,93,30,63,12,8,0,0
"76","ANA","COL",2008021133,14332,20082009,1,60,4,1,3,0,0,0,31,27,4,43,43,0,53,54,-1,4,3,0,0
"77","ANA","EDM",2008021142,14334,20082009,0,60,5,3,2,0,0,0,25,31,-6,39,49,-10,50,67,-17,5,7,0,0
"78","ANA","VAN",2008021156,14336,20082009,0,65,5,5,0,0,0,0,32,30,2,43,41,2,48,58,-10,1,4,0,0
"79","ANA","S.J",2008021173,14338,20082009,0,60,5,2,3,0,0,0,28,30,-2,38,38,0,45,45,0,2,4,0,0
"80","ANA","S.J",2008021179,14339,20082009,1,60,2,3,-1,0,0,0,21,26,-5,30,35,-5,34,44,-10,5,11,0,0
"81","ANA","DAL",2008021213,14344,20082009,1,65,3,3,0,0,0,0,39,45,-6,53,59,-6,65,68,-3,4,4,0,0
"82","ANA","ARI",2008021225,14345,20082009,0,65,4,4,0,0,0,0,35,33,2,48,42,6,55,51,4,6,6,0,0
"83","ANA","S.J",2008030151,14350,20082009,0,60,2,0,2,0,0,0,17,35,-18,27,43,-16,38,61,-23,4,6,0,0
"84","ANA","S.J",2008030152,14353,20082009,0,60,3,2,1,0,0,0,26,44,-18,40,62,-22,51,83,-32,2,6,0,0
"85","ANA","S.J",2008030153,14355,20082009,1,60,3,4,-1,0,0,0,30,35,-5,40,45,-5,52,54,-2,4,5,0,0
"86","ANA","S.J",2008030154,14357,20082009,1,60,4,0,4,0,0,0,26,31,-5,42,40,2,55,46,9,6,3,0,0
"87","ANA","S.J",2008030155,14359,20082009,0,66.0333333333333,2,3,-1,0,0,0,25,48,-23,40,61,-21,61,86,-25,3,3,0,0
"88","ANA","S.J",2008030156,14361,20082009,1,60,4,1,3,0,0,0,32,37,-5,52,57,-5,62,71,-9,10,10,0,0
"89","ANA","DET",2008030231,14365,20082009,0,60,2,3,-1,0,0,0,24,37,-13,36,52,-16,43,67,-24,5,5,0,0
"90","ANA","DET",2008030232,14367,20082009,0,80,3,3,0,0,0,0,35,47,-12,47,72,-25,61,86,-25,4,3,0,0
"91","ANA","DET",2008030233,14369,20082009,1,60,2,1,1,0,0,0,23,46,-23,30,61,-31,38,77,-39,6,7,0,0
"92","ANA","DET",2008030234,14371,20082009,1,60,3,6,-3,0,0,0,28,40,-12,41,57,-16,46,71,-25,3,5,0,0
"93","ANA","DET",2008030235,14374,20082009,0,60,1,4,-3,0,0,0,17,38,-21,25,57,-32,39,65,-26,3,4,0,0
"94","ANA","DET",2008030236,14376,20082009,1,60,2,1,1,0,0,0,28,39,-11,36,52,-16,40,65,-25,5,8,0,0
"95","ANA","DET",2008030237,14378,20082009,0,60,3,4,-1,0,0,0,27,40,-13,35,58,-23,52,74,-22,5,5,0,0
"96","ANA","S.J",2009020022,14520,20092010,1,60,1,4,-3,0,0,0,25,37,-12,37,52,-15,50,61,-11,8,7,0,0
"97","ANA","MIN",2009020029,14523,20092010,0,63.1333333333333,3,4,-1,0,0,0,19,32,-13,27,48,-21,35,65,-30,4,7,0,0
"98","ANA","BOS",2009020035,14525,20092010,0,60,6,1,5,0,0,0,30,34,-4,40,44,-4,49,59,-10,2,6,0,0
"99","ANA","PHI",2009020052,14527,20092010,0,65,2,2,0,0,0,0,33,35,-2,43,52,-9,61,71,-10,5,8,0,0
"100","ANA","NYR",2009020062,14528,20092010,0,60,0,3,-3,0,0,0,18,38,-20,28,56,-28,42,67,-25,3,4,0,0
"101","ANA","MIN",2009020079,14531,20092010,1,60,3,2,1,0,0,0,35,34,1,47,50,-3,57,60,-3,4,4,0,0
"102","ANA","STL",2009020105,14534,20092010,1,60,0,5,-5,0,0,0,26,32,-6,34,56,-22,42,64,-22,5,7,0,0
"103","ANA","DAL",2009020117,14538,20092010,1,60,2,4,-2,0,0,0,26,38,-12,45,43,2,53,51,2,1,3,0,0
"104","ANA","CBJ",2009020144,14541,20092010,1,60,4,6,-2,0,0,0,36,37,-1,49,47,2,58,53,5,3,3,0,0
"105","ANA","TOR",2009020151,14543,20092010,1,60,3,6,-3,0,0,0,28,39,-11,42,52,-10,49,68,-19,8,15,0,0
"106","ANA","VAN",2009020178,14547,20092010,1,60,7,2,5,0,0,0,34,38,-4,47,55,-8,53,62,-9,2,4,0,0
"107","ANA","ARI",2009020189,14548,20092010,0,65,2,2,0,0,0,0,34,32,2,47,41,6,59,63,-4,7,2,0,0
"108","ANA","PIT",2009020202,14551,20092010,1,60,3,4,-1,0,0,0,29,27,2,47,40,7,67,58,9,3,7,0,0
"109","ANA","NSH",2009020217,14553,20092010,1,60,4,0,4,0,0,0,31,40,-9,36,58,-22,42,69,-27,6,6,0,0
"110","ANA","ARI",2009020236,14555,20092010,1,60,4,3,1,0,0,0,26,30,-4,37,43,-6,45,58,-13,7,3,0,0
"111","ANA","N.J",2009020248,14559,20092010,0,60,1,3,-2,0,0,0,32,25,7,37,31,6,44,34,10,6,3,0,0
"112","ANA","CBJ",2009020264,14561,20092010,0,65,2,2,0,0,0,0,34,29,5,45,42,3,60,56,4,6,5,0,0
"113","ANA","DET",2009020273,14562,20092010,0,60,4,7,-3,0,0,0,23,37,-14,33,56,-23,46,72,-26,5,7,0,0
"114","ANA","PIT",2009020286,14564,20092010,0,60,2,5,-3,0,0,0,25,26,-1,35,41,-6,50,51,-1,3,7,0,0
"115","ANA","T.B",2009020306,14567,20092010,1,60.8666666666667,4,3,1,0,0,0,27,24,3,37,31,6,49,41,8,6,4,0,0
"116","ANA","S.J",2009020325,14569,20092010,1,60,2,3,-1,0,0,0,30,36,-6,42,46,-4,55,54,1,5,4,0,0
"117","ANA","CGY",2009020337,14571,20092010,1,65,2,2,0,0,0,0,31,43,-12,47,55,-8,51,66,-15,4,5,0,0
"118","ANA","CAR",2009020351,14573,20092010,1,60,3,2,1,0,0,0,33,30,3,47,44,3,58,53,5,2,3,0,0
"119","ANA","CHI",2009020359,14575,20092010,1,60,3,0,3,0,0,0,34,28,6,40,41,-1,48,52,-4,5,4,0,0
"120","ANA","ARI",2009020380,14577,20092010,1,61.3,2,3,-1,0,0,0,28,26,2,39,39,0,46,54,-8,4,5,0,0
"121","ANA","L.A",2009020392,14579,20092010,1,60,3,4,-1,0,0,0,30,42,-12,37,55,-18,43,64,-21,4,5,0,0
"122","ANA","DAL",2009020405,14581,20092010,0,60,1,3,-2,0,0,0,27,37,-10,39,50,-11,53,63,-10,1,4,0,0
"123","ANA","MIN",2009020411,14582,20092010,0,65,4,4,0,0,0,0,22,29,-7,28,44,-16,40,61,-21,3,3,0,0
"124","ANA","OTT",2009020428,14584,20092010,1,65,3,3,0,0,0,0,36,29,7,46,40,6,56,51,5,3,5,0,0
"125","ANA","DAL",2009020441,14586,20092010,1,64.2166666666667,4,3,1,0,0,0,42,22,20,54,31,23,70,47,23,1,4,0,0
"126","ANA","DET",2009020461,14589,20092010,0,61.1166666666667,2,3,-1,0,0,0,27,31,-4,31,51,-20,40,66,-26,4,10,0,0
"127","ANA","CBJ",2009020472,14590,20092010,0,60,3,1,2,0,0,0,25,36,-11,29,43,-14,40,58,-18,3,5,0,0
"128","ANA","VAN",2009020501,14594,20092010,0,60,3,2,1,0,0,0,34,30,4,41,45,-4,50,56,-6,5,6,0,0
"129","ANA","S.J",2009020510,14595,20092010,0,60,1,4,-3,0,0,0,21,37,-16,33,51,-18,48,67,-19,5,6,0,0
"130","ANA","ARI",2009020519,14597,20092010,1,60,4,2,2,0,0,0,34,41,-7,50,51,-1,54,64,-10,8,4,0,0
"131","ANA","COL",2009020543,14600,20092010,0,60,4,2,2,0,0,0,43,17,26,57,29,28,73,35,38,3,3,0,0
"132","ANA","ARI",2009020555,14601,20092010,0,60,0,4,-4,0,0,0,21,32,-11,30,39,-9,40,53,-13,4,2,0,0
"133","ANA","S.J",2009020569,14604,20092010,0,60,2,5,-3,0,0,0,32,25,7,52,36,16,63,51,12,5,3,0,0
"134","ANA","MIN",2009020589,14607,20092010,1,60,4,2,2,0,0,0,32,31,1,40,44,-4,50,53,-3,4,5,0,0
"135","ANA","DAL",2009020606,14609,20092010,0,60,3,5,-2,0,0,0,34,42,-8,44,65,-21,56,71,-15,2,4,0,0
"136","ANA","NSH",2009020619,14611,20092010,0,60,1,3,-2,0,0,0,26,36,-10,33,49,-16,43,64,-21,2,2,0,0
"137","ANA","CHI",2009020626,14612,20092010,0,60,2,5,-3,0,0,0,24,28,-4,31,50,-19,43,63,-20,3,4,0,0
"138","ANA","DET",2009020638,14614,20092010,1,60,4,1,3,0,0,0,35,39,-4,47,52,-5,57,57,0,8,8,0,0
"139","ANA","STL",2009020653,14616,20092010,1,60,4,2,2,0,0,0,29,22,7,46,28,18,61,35,26,5,3,0,0
"140","ANA","NSH",2009020667,14618,20092010,0,60,3,2,1,0,0,0,21,27,-6,32,37,-5,44,55,-11,1,1,0,0
"141","ANA","CHI",2009020675,14619,20092010,0,60,3,1,2,0,0,0,12,43,-31,14,57,-43,25,73,-48,3,4,0,0
"142","ANA","BOS",2009020692,14622,20092010,1,60,4,3,1,0,0,0,32,30,2,41,44,-3,48,53,-5,7,5,0,0
"143","ANA","L.A",2009020703,14623,20092010,0,60,0,4,-4,0,0,0,22,27,-5,42,32,10,58,42,16,8,8,0,0
"144","ANA","CGY",2009020722,14626,20092010,1,60,5,4,1,0,0,0,26,37,-11,41,49,-8,55,61,-6,4,4,0,0
"145","ANA","BUF",2009020739,14628,20092010,1,60,5,4,1,0,0,0,30,45,-15,38,52,-14,42,61,-19,4,5,0,0
"146","ANA","S.J",2009020756,14630,20092010,0,60,1,3,-2,0,0,0,27,25,2,37,43,-6,52,62,-10,5,5,0,0
"147","ANA","STL",2009020768,14632,20092010,0,65,3,3,0,0,0,0,37,21,16,56,33,23,73,46,27,3,1,0,0
"148","ANA","ATL",2009020780,14635,20092010,0,60,1,2,-1,0,0,0,35,34,1,45,44,1,64,51,13,4,4,0,0
"149","ANA","WSH",2009020788,14636,20092010,0,60,1,5,-4,0,0,0,31,49,-18,42,69,-27,59,81,-22,7,10,0,0
"150","ANA","T.B",2009020804,14638,20092010,0,65,1,1,0,0,0,0,32,31,1,47,43,4,69,52,17,5,5,0,0
"151","ANA","FLA",2009020824,14641,20092010,0,60,3,0,3,0,0,0,25,33,-8,37,49,-12,51,63,-12,3,4,0,0
"152","ANA","DET",2009020840,14643,20092010,1,60,3,1,2,0,0,0,30,47,-17,36,64,-28,41,78,-37,3,3,0,0
"153","ANA","L.A",2009020849,14644,20092010,0,60,4,6,-2,0,0,0,22,31,-9,33,45,-12,41,56,-15,1,2,0,0
"154","ANA","L.A",2009020875,14648,20092010,1,60,4,2,2,0,0,0,33,37,-4,47,47,0,59,55,4,5,5,0,0
"155","ANA","EDM",2009020890,14650,20092010,1,60,3,2,1,0,0,0,30,39,-9,44,53,-9,66,63,3,8,4,0,0
"156","ANA","CGY",2009020914,14653,20092010,0,60,1,3,-2,0,0,0,27,38,-11,35,57,-22,47,69,-22,2,2,0,0
"157","ANA","EDM",2009020921,14654,20092010,0,60,7,3,4,0,0,0,46,29,17,58,38,20,78,50,28,12,6,0,0
"158","ANA","COL",2009020940,14671,20092010,1,60,3,4,-1,0,0,0,34,25,9,48,33,15,51,34,17,7,8,0,0
"159","ANA","ARI",2009020961,14674,20092010,0,60,0,4,-4,0,0,0,32,30,2,46,46,0,57,52,5,8,5,0,0
"160","ANA","MTL",2009020973,14675,20092010,1,65,3,3,0,0,0,0,32,43,-11,43,56,-13,52,67,-15,4,5,0,0
"161","ANA","CBJ",2009020984,14677,20092010,1,60,2,5,-3,0,0,0,38,29,9,52,44,8,64,53,11,9,9,0,0
"162","ANA","NSH",2009021005,14680,20092010,1,60,0,1,-1,0,0,0,31,28,3,43,36,7,50,41,9,4,6,0,0
"163","ANA","S.J",2009021023,14682,20092010,1,60,4,2,2,0,0,0,33,33,0,43,51,-8,48,67,-19,7,5,0,0
"164","ANA","CHI",2009021041,14685,20092010,1,60,4,2,2,0,0,0,36,41,-5,45,63,-18,58,76,-18,4,5,0,0
"165","ANA","NYI",2009021056,14687,20092010,1,60.2333333333333,5,4,1,0,0,0,39,31,8,55,39,16,71,44,27,4,5,0,0
"166","ANA","COL",2009021076,14689,20092010,1,60,5,2,3,0,0,0,33,28,5,47,42,5,61,46,15,6,3,0,0
"167","ANA","CGY",2009021088,14691,20092010,0,60,1,3,-2,0,0,0,23,28,-5,39,41,-2,54,58,-4,0,2,0,0
"168","ANA","VAN",2009021095,14692,20092010,0,60,1,4,-3,0,0,0,31,30,1,44,43,1,59,50,9,4,2,0,0
"169","ANA","EDM",2009021109,14694,20092010,0,60,3,2,1,0,0,0,40,36,4,54,50,4,72,63,9,5,8,0,0
"170","ANA","DAL",2009021132,14697,20092010,1,60,3,1,2,0,0,0,46,31,15,55,43,12,66,50,16,5,2,0,0
"171","ANA","COL",2009021147,14699,20092010,0,60,5,2,3,0,0,0,27,29,-2,34,45,-11,41,61,-20,1,3,0,0
"172","ANA","VAN",2009021163,14701,20092010,1,65,4,4,0,0,0,0,34,40,-6,52,51,1,65,61,4,7,5,0,0
"173","ANA","L.A",2009021174,14702,20092010,0,65,1,1,0,0,0,0,33,29,4,55,49,6,72,54,18,3,5,0,0
"174","ANA","L.A",2009021192,14705,20092010,1,65,4,4,0,0,0,0,21,40,-19,35,48,-13,41,66,-25,3,3,0,0
"175","ANA","DAL",2009021203,14707,20092010,0,65,2,2,0,0,0,0,19,51,-32,36,68,-32,49,90,-41,3,3,0,0
"176","ANA","STL",2009021210,14708,20092010,0,60,3,6,-3,0,0,0,26,48,-22,39,66,-27,45,79,-34,5,7,0,0
"177","ANA","EDM",2009021230,14710,20092010,1,60,7,2,5,0,0,0,45,31,14,56,42,14,66,47,19,4,3,0,0
"178","ANA","DET",2010020009,14890,20102011,0,60,0,4,-4,4.88431488923379,7.94009270339302,-3.05577781415923,21,43,-22,35,54,-19,43,74,-31,3,8,0,0
"179","ANA","NSH",2010020020,14891,20102011,0,60,1,4,-3,6.07015120323922,3.81164818812977,2.25850301510945,37,49,-12,43,63,-20,57,74,-17,4,8,0,0
"180","ANA","STL",2010020029,14893,20102011,0,60,1,5,-4,1.32255647098646,4.38913146152117,-3.06657499053472,14,53,-39,19,67,-48,25,82,-57,10,14,0,0
"181","ANA","VAN",2010020041,14895,20102011,1,60,4,3,1,5.99063842993928,5.3660032831076,0.624635146831679,32,39,-7,43,58,-15,55,68,-13,5,3,0,0
"182","ANA","ATL",2010020053,14897,20102011,1,65,4,4,0,7.29435317792377,3.88185887584992,3.41249430207385,41,33,8,66,46,20,79,58,21,7,4,0,0
"183","ANA","ARI",2010020067,14899,20102011,1,60,3,2,1,0,0,0,35,38,-3,47,54,-7,52,62,-10,4,3,0,0
"184","ANA","CBJ",2010020079,14902,20102011,0,60,1,3,-2,2.79928801419737,5.15826043288689,-2.35897241868952,32,22,10,42,28,14,62,35,27,5,3,0,0
"185","ANA","PHI",2010020084,14903,20102011,0,60,3,2,1,2.47169672137147,7.90505528939181,-5.43335856802034,22,42,-20,32,61,-29,40,89,-49,4,5,0,0
"186","ANA","DET",2010020104,14905,20102011,0,60,4,5,-1,3.83147233142518,4.46366027486511,-0.632187943439931,25,41,-16,34,56,-22,45,73,-28,1,3,0,0
"187","ANA","DAL",2010020121,14908,20102011,0,60,5,2,3,2.96547862432931,2.71518343509524,0.250295189234066,26,37,-11,37,48,-11,44,62,-18,2,5,0,0
"188","ANA","N.J",2010020142,14911,20102011,1,60,1,2,-1,5.62776492883131,1.98575816247467,3.64200676635664,28,27,1,39,35,4,44,49,-5,4,4,0,0
"189","ANA","S.J",2010020156,14912,20102011,0,60,2,5,-3,3.53791767262737,4.78060169877426,-1.24268402614689,24,41,-17,35,55,-20,54,70,-16,3,6,0,0
"190","ANA","T.B",2010020172,14916,20102011,1,62.8833333333333,3,2,1,5.17246664711274,5.29149787833376,-0.119031231221015,30,34,-4,43,44,-1,57,55,2,5,3,0,0
"191","ANA","PIT",2010020186,14918,20102011,1,60,3,2,1,2.04152068579079,4.67782922743629,-2.6363085416455,19,32,-13,34,44,-10,46,60,-14,2,4,0,0
"192","ANA","NSH",2010020202,14920,20102011,1,60,5,4,1,7.68575879279012,3.80431104976089,3.88144774302924,37,24,13,53,43,10,60,53,7,4,4,0,0
"193","ANA","S.J",2010020210,14922,20102011,0,64.45,3,2,1,4.26625956452335,7.64891236388939,-3.38265279936604,20,41,-21,31,59,-28,38,76,-38,2,4,0,0
"194","ANA","NYI",2010020216,14923,20102011,1,60,1,0,1,1.82015108832456,1.91275481761841,-0.0926037292938418,14,27,-13,21,48,-27,34,63,-29,2,6,0,0
"195","ANA","DAL",2010020232,14925,20102011,1,60,4,2,2,5.38815115419129,3.58511625826941,1.80303489592188,37,29,8,47,37,10,54,47,7,3,3,0,0
"196","ANA","CHI",2010020247,14927,20102011,0,64.5333333333333,2,3,-1,2.89608684681298,5.80264683569334,-2.90655998888036,26,43,-17,37,66,-29,49,84,-35,2,4,0,0
"197","ANA","DAL",2010020256,14929,20102011,0,60,1,2,-1,3.4054432362798,3.85397127052853,-0.448528034248724,27,26,1,38,40,-2,50,55,-5,7,6,0,0
"198","ANA","MIN",2010020264,14930,20102011,0,63.6,1,2,-1,3.62461755925324,3.50786319135022,0.116754367903013,28,27,1,41,43,-2,51,53,-2,1,1,0,0
"199","ANA","CBJ",2010020282,14932,20102011,1,60,3,4,-1,4.91539114297484,7.28810842998791,-2.37271728701307,50,29,21,59,42,17,71,52,19,5,4,0,0
"200","ANA","EDM",2010020296,14934,20102011,1,60,2,4,-2,6.57712593022734,4.87069877330214,1.7064271569252,40,26,14,54,35,19,60,54,6,5,3,0,0
"201","ANA","CHI",2010020326,14939,20102011,1,60,1,4,-3,4.24845415994059,4.35370045991221,-0.105246299971622,27,34,-7,38,50,-12,46,62,-16,6,3,0,0
"202","ANA","ARI",2010020341,14940,20102011,0,60,6,4,2,3.58670675169014,7.40006768808234,-3.8133609363922,25,34,-9,33,49,-16,40,70,-30,3,5,0,0
"203","ANA","L.A",2010020352,14942,20102011,1,60,2,0,2,1.52193253926089,4.84034302910732,-3.31841048984643,19,27,-8,32,46,-14,36,62,-26,2,3,0,0
"204","ANA","FLA",2010020364,14944,20102011,1,60,5,3,2,4.66528614901472,3.72064524958842,0.944640899426304,29,32,-3,36,48,-12,50,59,-9,1,2,0,0
"205","ANA","DET",2010020378,14946,20102011,1,60,0,4,-4,3.98639661056222,4.24915156312636,-0.262754952564137,41,29,12,48,41,7,57,48,9,3,1,0,0
"206","ANA","ARI",2010020394,14948,20102011,1,60,0,3,-3,2.87776320141716,5.38280559552368,-2.50504239410652,26,39,-13,39,53,-14,52,69,-17,5,8,0,0
"207","ANA","EDM",2010020405,14950,20102011,0,65,2,2,0,4.02641061985469,4.62028097234906,-0.593870352494378,32,36,-4,44,52,-8,56,71,-15,4,4,0,0
"208","ANA","VAN",2010020410,14951,20102011,0,65,4,4,0,2.17158387880772,4.34551899222424,-2.17393511341652,20,40,-20,22,59,-37,28,80,-52,4,7,0,0
"209","ANA","CGY",2010020424,14953,20102011,1,65,2,2,0,5.323861280858,7.00384960963856,-1.67998832878056,25,39,-14,39,57,-18,51,67,-16,5,6,0,0
"210","ANA","MIN",2010020440,14955,20102011,1,60,6,2,4,4.8947295766236,2.75512894289568,2.13960063372792,36,22,14,46,31,15,57,48,9,6,4,0,0
"211","ANA","WSH",2010020452,14958,20102011,0,64.05,2,1,1,4.96243245078949,3.13672023902473,1.82571221176477,24,32,-8,40,45,-5,55,65,-10,2,2,0,0
"212","ANA","NYI",2010020460,14959,20102011,0,60,2,3,-1,5.33183614133263,4.27598263289524,1.05585350843738,32,29,3,48,39,9,68,52,16,6,4,0,0
"213","ANA","CAR",2010020476,14961,20102011,0,60,2,4,-2,8.37380899320124,6.13257894593698,2.24123004726425,45,32,13,62,47,15,80,65,15,8,5,0,0
"214","ANA","BOS",2010020488,14963,20102011,0,60,3,0,3,2.44039137467952,5.89303284735104,-3.45264147267152,25,45,-20,34,65,-31,44,88,-44,1,2,0,0
"215","ANA","BUF",2010020495,14964,20102011,0,60,2,5,-3,2.11972532335382,5.79102194200095,-3.67129661864713,23,42,-19,28,52,-24,42,68,-26,4,3,0,0
"216","ANA","L.A",2010020529,14969,20102011,0,60,1,4,-3,2.78677322188742,2.76257774644182,0.0241954754455946,19,30,-11,31,45,-14,42,69,-27,2,4,0,0
"217","ANA","ARI",2010020543,14971,20102011,0,60,3,1,2,4.44476458086638,3.27400544568172,1.17075913518465,24,32,-8,36,49,-13,41,66,-25,3,6,0,0
"218","ANA","PHI",2010020563,14974,20102011,1,60,5,2,3,4.14008002754417,3.39151696083718,0.748563066706993,27,37,-10,36,51,-15,48,65,-17,2,2,0,0
"219","ANA","CHI",2010020580,14976,20102011,1,60,2,1,1,2.92662307916908,5.26026361749155,-2.33364053832247,18,40,-22,29,58,-29,39,71,-32,4,2,0,0
"220","ANA","NSH",2010020596,14979,20102011,1,60,1,4,-3,5.60861095158566,7.00636979844421,-1.39775884685855,41,24,17,50,33,17,64,41,23,4,2,0,0
"221","ANA","CBJ",2010020611,14981,20102011,1,60,6,0,6,5.31442892478663,4.29464727305458,1.01978165173205,29,27,2,35,39,-4,41,46,-5,8,7,0,0
"222","ANA","S.J",2010020627,14983,20102011,1,60,1,0,1,2.5197651378403,4.99488334724447,-2.47511820940417,28,37,-9,47,53,-6,58,74,-16,2,3,0,0
"223","ANA","STL",2010020645,14986,20102011,1,60,7,4,3,3.14482423651498,5.61828904363054,-2.47346480711556,24,34,-10,33,58,-25,43,74,-31,4,5,0,0
"224","ANA","ARI",2010020669,14989,20102011,0,60,2,6,-4,4.57174259158106,4.5048006113348,0.0669419802462556,28,34,-6,37,53,-16,47,64,-17,3,4,0,0
"225","ANA","EDM",2010020676,14990,20102011,1,60,3,2,1,2.98810211194729,3.70178928523968,-0.713687173292397,28,28,0,39,42,-3,47,64,-17,4,5,0,0
"226","ANA","OTT",2010020687,14992,20102011,0,65,1,1,0,5.62729487246725,4.83294605305127,0.794348819415973,27,40,-13,40,57,-17,49,76,-27,0,2,0,0
"227","ANA","TOR",2010020697,14994,20102011,0,60,2,5,-3,5.8171618974884,3.44795432611014,2.36920757137826,28,37,-9,44,46,-2,59,66,-7,2,2,0,0
"228","ANA","MTL",2010020716,14996,20102011,0,65,3,3,0,3.10978168699103,4.74725097029339,-1.63746928330236,26,40,-14,34,51,-17,43,77,-34,4,6,0,0
"229","ANA","CBJ",2010020737,14999,20102011,0,60,3,2,1,1.49686539033428,3.90514315496346,-2.40827776462919,22,37,-15,27,48,-21,33,67,-34,0,5,0,0
"230","ANA","S.J",2010020769,15007,20102011,1,60,3,4,-1,2.71681406906646,7.17674025371525,-4.45992618464879,30,28,2,44,38,6,60,43,17,5,2,0,0
"231","ANA","COL",2010020784,15010,20102011,0,60,3,0,3,5.15642644341278,3.38392354125972,1.77250290215306,29,25,4,45,41,4,57,61,-4,6,3,0,0
"232","ANA","VAN",2010020815,15014,20102011,0,60,4,3,1,3.65669543396507,8.18468836904458,-4.52799293507951,24,38,-14,31,55,-24,40,73,-33,2,1,0,0
"233","ANA","CGY",2010020828,15016,20102011,0,64.6833333333333,5,4,1,0,0,0,30,25,5,37,44,-7,52,70,-18,1,4,0,0
"234","ANA","EDM",2010020844,15018,20102011,0,60,4,0,4,3.76317264983663,1.36877794043677,2.39439470939986,22,12,10,39,22,17,49,38,11,5,3,0,0
"235","ANA","WSH",2010020862,15021,20102011,1,60,6,7,-1,2.57246627868153,5.96108093171428,-3.38861465303275,21,31,-10,30,41,-11,42,57,-15,4,4,0,0
"236","ANA","MIN",2010020875,15023,20102011,0,60,1,5,-4,4.30091736104805,2.72948323446653,1.57143412658152,30,26,4,44,35,9,56,44,12,5,4,0,0
"237","ANA","STL",2010020882,15024,20102011,0,60,3,9,-6,3.94455614977596,2.61232569254935,1.33223045722661,25,23,2,32,31,1,47,43,4,4,5,0,0
"238","ANA","L.A",2010020908,15028,20102011,1,60,2,3,-1,4.32366248133621,5.12551623990294,-0.801853758566722,27,18,9,34,36,-2,43,50,-7,2,1,0,0
"239","ANA","MIN",2010020923,15030,20102011,1,64.8833333333333,2,3,-1,6.9431634944483,5.81261472975259,1.13054876469571,48,31,17,65,39,26,83,46,37,5,4,0,0
"240","ANA","COL",2010020939,15032,20102011,1,60,3,2,1,6.07372750552349,2.53891554194241,3.53481196358109,32,24,8,47,33,14,51,47,4,5,2,0,0
"241","ANA","DET",2010020956,15035,20102011,1,62.8333333333333,2,1,1,3.10652473385593,5.02776797511615,-1.92124324126021,28,29,-1,38,47,-9,46,60,-14,5,9,0,0
"242","ANA","DAL",2010020972,15037,20102011,1,64.9333333333333,4,3,1,5.42915648929193,4.8863967579673,0.542759731324622,29,26,3,39,37,2,49,47,2,5,5,0,0
"243","ANA","VAN",2010020988,15039,20102011,1,60,0,3,-3,5.25911469039846,3.08346021189936,2.1756544784991,26,16,10,35,27,8,45,37,8,7,6,0,0
"244","ANA","NYR",2010021007,15042,20102011,1,60,5,2,3,5.76949225956605,2.83948418619025,2.9300080733758,33,32,1,46,45,1,59,55,4,3,3,0,0
"245","ANA","COL",2010021022,15044,20102011,0,60,6,2,4,5.19716061163695,3.34702952780574,1.85013108383121,33,26,7,41,31,10,49,44,5,6,6,0,0
"246","ANA","ARI",2010021037,15046,20102011,1,60,2,5,-3,0,0,0,38,31,7,50,40,10,64,54,10,6,3,0,0
"247","ANA","STL",2010021054,15049,20102011,1,60,2,1,1,4.99001214469899,5.79987534497832,-0.809863200279324,24,31,-7,34,48,-14,46,64,-18,3,2,0,0
"248","ANA","L.A",2010021078,15052,20102011,0,61.5333333333333,2,1,1,2.90195601840969,6.84246855892707,-3.94051254051737,25,32,-7,34,54,-20,43,73,-30,3,6,0,0
"249","ANA","CGY",2010021085,15053,20102011,1,62.6333333333333,5,4,1,4.24327261147499,5.03186944723711,-0.788596835762121,33,41,-8,44,56,-12,51,76,-25,4,4,0,0
"250","ANA","DAL",2010021100,15056,20102011,0,61.7,4,3,1,4.47306597593706,7.75909998309133,-3.28603400715427,26,26,0,38,42,-4,50,54,-4,4,3,0,0
"251","ANA","NSH",2010021107,15057,20102011,0,60,4,5,-1,3.89665169198997,3.48781727151263,0.408834420477348,38,28,10,43,36,7,59,45,14,6,3,0,0
"252","ANA","CHI",2010021125,15059,20102011,0,60,2,1,1,0,0,0,25,28,-3,32,38,-6,37,54,-17,2,2,0,0
"253","ANA","COL",2010021133,15061,20102011,1,60,5,4,1,6.15950318481555,4.87531677202617,1.28418641278938,42,35,7,52,50,2,62,58,4,7,4,0,0
"254","ANA","CGY",2010021149,15063,20102011,0,60,4,2,2,4.19425838180847,2.79274338964622,1.40151499216225,22,25,-3,26,42,-16,35,71,-36,6,7,0,0
"255","ANA","S.J",2010021174,15066,20102011,0,60,2,4,-2,4.4779668780975,5.53938327317472,-1.06141639507722,22,33,-11,32,48,-16,47,67,-20,4,1,0,0
"256","ANA","DAL",2010021181,15067,20102011,1,60,3,4,-1,4.3435199605301,3.05535308574326,1.28816687478684,27,31,-4,38,40,-2,49,57,-8,3,6,0,0
"257","ANA","S.J",2010021199,15070,20102011,1,60,6,2,4,3.98797213310635,7.82569995347876,-3.83772782037241,34,38,-4,50,54,-4,55,66,-11,7,5,0,0
"258","ANA","L.A",2010021214,15072,20102011,1,60,2,1,1,2.01018604403362,5.02150406822057,-3.01131802418695,28,24,4,35,30,5,50,53,-3,3,4,0,0
"259","ANA","L.A",2010021224,15073,20102011,0,60,3,1,2,2.82982295351667,7.17161857849239,-4.34179562497572,20,44,-24,27,71,-44,31,93,-62,6,8,0,0
"260","ANA","NSH",2010030181,15077,20102011,1,60,1,4,-3,3.01756259548711,2.67266835339507,0.344894242092039,28,30,-2,41,38,3,61,55,6,7,8,0,0
"261","ANA","NSH",2010030182,15079,20102011,1,60,5,3,2,5.90319080688641,4.62409308832139,1.27909771856503,28,34,-6,33,51,-18,40,65,-25,6,7,0,0
"262","ANA","NSH",2010030183,15081,20102011,0,60,3,4,-1,2.65011751980444,6.16143932813429,-3.51132180832985,16,37,-21,28,52,-24,42,70,-28,3,6,0,0
"263","ANA","NSH",2010030184,15084,20102011,0,60,6,3,3,4.7670366717648,2.86837577201711,1.89866089974769,38,22,16,46,32,14,57,52,5,5,5,0,0
"264","ANA","NSH",2010030185,15086,20102011,1,61.95,3,4,-1,4.94728716765083,4.95800620387308,-0.0107190362222482,26,37,-11,35,51,-16,42,70,-28,2,2,0,0
"265","ANA","NSH",2010030186,15088,20102011,0,60,2,4,-2,4.74630186179638,5.23959432651645,-0.493292464720071,27,30,-3,42,41,1,59,56,3,2,4,0,0
"266","ANA","BUF",2011020007,15254,20112012,0,60,1,4,-3,4.15024344591438,2.62404053902719,1.52620290688719,30,25,5,45,37,8,62,48,14,7,6,0,0
"267","ANA","NYR",2011020020,15255,20112012,1,65,1,1,0,3.28976860914565,2.4794803540757,0.810288255069949,28,15,13,42,28,14,60,45,15,8,9,0,0
"268","ANA","S.J",2011020048,15261,20112012,1,60,1,0,1,2.81368613158836,3.71603323426098,-0.902347102672617,23,31,-8,35,45,-10,45,64,-19,3,5,0,0
"269","ANA","STL",2011020063,15263,20112012,1,60,4,2,2,3.55345157370175,6.3990846028193,-2.84563302911755,23,30,-7,37,47,-10,52,58,-6,5,5,0,0
"270","ANA","S.J",2011020068,15264,20112012,0,60,3,2,1,2.80818806363443,6.79439337978511,-3.98620531615068,22,43,-21,31,63,-32,43,93,-50,3,6,0,0
"271","ANA","DAL",2011020094,15268,20112012,1,60,1,3,-2,5.21388661941091,3.81696816440672,1.3969184550042,36,19,17,52,28,24,69,37,32,5,2,0,0
"272","ANA","ARI",2011020109,15270,20112012,1,60,4,5,-1,3.4264641625341,4.4155274588702,-0.989063296336095,33,35,-2,46,49,-3,54,58,-4,4,3,0,0
"273","ANA","CHI",2011020118,15272,20112012,0,65,2,2,0,3.47896805102937,5.53059821252828,-2.05163016149891,31,35,-4,38,48,-10,53,62,-9,6,3,0,0
"274","ANA","MIN",2011020132,15274,20112012,0,60,3,2,1,0.959551529926102,2.15318012704984,-1.19362859712373,16,25,-9,26,32,-6,41,49,-8,6,5,0,0
"275","ANA","NSH",2011020147,15276,20112012,0,60,0,3,-3,3.50483819062356,4.48165696975775,-0.976818779134192,20,29,-9,31,39,-8,45,55,-10,3,6,0,0
"276","ANA","CBJ",2011020153,15277,20112012,0,60,1,3,-2,1.52170726103941,3.48267431397107,-1.96096705293166,20,21,-1,25,31,-6,43,38,5,4,4,0,0
"277","ANA","WSH",2011020161,15279,20112012,0,62.3,4,5,-1,1.4138926205769,7.1510538820803,-5.7371612615034,15,40,-25,22,53,-31,37,70,-33,1,3,0,0
"278","ANA","NYR",2011020169,15281,20112012,0,65,1,1,0,2.93917730352095,2.9692346372467,-0.0300573337257504,28,25,3,38,42,-4,53,59,-6,3,5,0,0
"279","ANA","DET",2011020190,15283,20112012,0,60,0,5,-5,4.06353201959064,5.73423298946,-1.67070096986936,22,50,-28,29,63,-34,33,77,-44,5,4,0,0
"280","ANA","NSH",2011020213,15287,20112012,1,60,2,4,-2,3.08527661378935,1.25474548559083,1.83053112819852,33,32,1,51,40,11,71,46,25,5,4,0,0
"281","ANA","VAN",2011020228,15289,20112012,1,60,4,3,1,3.25119658786571,5.16084281195109,-1.90964622408538,21,41,-20,26,52,-26,30,59,-29,2,5,0,0
"282","ANA","MIN",2011020242,15291,20112012,1,60,2,3,-1,4.4281985171578,5.79502773861168,-1.36682922145388,34,26,8,56,45,11,73,57,16,4,5,0,0
"283","ANA","L.A",2011020259,15294,20112012,0,65,1,1,0,4.92269112844951,7.0300446606562,-2.10735353220669,24,37,-13,42,59,-17,47,74,-27,4,6,0,0
"284","ANA","L.A",2011020269,15295,20112012,1,60,3,5,-2,6.13112709043216,4.35579038050491,1.77533670992725,38,36,2,56,49,7,67,67,0,4,5,0,0
"285","ANA","DET",2011020288,15298,20112012,1,60,2,4,-2,4.14975207718089,4.08152324176626,0.0682288354146294,34,30,4,46,44,2,55,60,-5,5,6,0,0
"286","ANA","ARI",2011020311,15301,20112012,0,60,2,4,-2,2.56268975290982,5.2482745019556,-2.68558474904578,21,29,-8,31,52,-21,39,62,-23,3,9,0,0
"287","ANA","CHI",2011020318,15303,20112012,1,60,5,6,-1,2.88142649247227,7.26356976193301,-4.38214326946075,28,42,-14,38,56,-18,49,73,-24,3,7,0,0
"288","ANA","TOR",2011020340,15305,20112012,1,60,2,5,-3,3.26585360460012,5.88077600424731,-2.61492239964718,28,28,0,41,44,-3,52,55,-3,2,4,0,0
"289","ANA","MTL",2011020357,15308,20112012,1,60,4,1,3,4.22036699938485,2.11164184089284,2.10872515849201,27,20,7,40,34,6,61,47,14,6,7,0,0
"290","ANA","PHI",2011020371,15310,20112012,1,63.4833333333333,3,4,-1,2.00114233664817,5.56369895195887,-3.5625566153107,22,47,-25,33,57,-24,42,76,-34,5,11,0,0
"291","ANA","MIN",2011020385,15312,20112012,1,60,3,5,-2,3.27110692195129,6.26925586999528,-2.99814894804399,27,36,-9,46,47,-1,65,58,7,3,3,0,0
"292","ANA","L.A",2011020400,15314,20112012,1,60,3,2,1,3.48419768805616,5.82053224134143,-2.33633455328527,27,39,-12,40,56,-16,51,70,-19,2,2,0,0
"293","ANA","STL",2011020413,15316,20112012,0,60,2,4,-2,2.97202580480371,3.1093436479714,-0.137317843167693,23,24,-1,33,38,-5,45,49,-4,5,4,0,0
"294","ANA","NSH",2011020429,15318,20112012,0,60,2,3,-1,2.73318934446434,3.29300756014709,-0.559818215682753,17,28,-11,23,42,-19,35,54,-19,2,4,0,0
"295","ANA","ARI",2011020450,15322,20112012,1,60,4,1,3,5.72947186203504,3.12830117133554,2.6011706906995,28,20,8,41,36,5,54,55,-1,4,3,0,0
"296","ANA","CHI",2011020465,15324,20112012,0,60,1,4,-3,4.07324438390788,1.60032832893194,2.47291605497594,25,24,1,42,32,10,59,44,15,3,3,0,0
"297","ANA","WPG",2011020470,15325,20112012,0,60,3,5,-2,4.81235740611706,4.87698364954154,-0.0646262434244846,36,31,5,57,47,10,69,53,16,5,3,0,0
"298","ANA","DAL",2011020483,15327,20112012,0,60,3,5,-2,5.45044460120574,3.06355649209114,2.38688810911459,28,33,-5,39,45,-6,52,59,-7,3,5,0,0
"299","ANA","L.A",2011020507,15330,20112012,0,65,2,2,0,2.75317328388337,5.65754417513381,-2.90437089125044,22,34,-12,34,50,-16,41,67,-26,4,5,0,0
"300","ANA","S.J",2011020528,15334,20112012,0,60,3,2,1,2.18663534650113,5.32882874918869,-3.14219340268755,23,38,-15,31,51,-20,48,66,-18,2,2,0,0
"301","ANA","VAN",2011020550,15337,20112012,1,60,2,5,-3,3.80923717561419,4.15147943818124,-0.342242262567055,32,31,1,47,41,6,63,46,17,6,1,0,0
"302","ANA","COL",2011020566,15339,20112012,1,60,2,4,-2,1.89622708647863,2.65506734568044,-0.758840259201804,20,26,-6,30,38,-8,45,47,-2,2,2,0,0
"303","ANA","S.J",2011020583,15343,20112012,1,60,1,3,-2,5.62072512402665,6.34457740554353,-0.723852281516884,27,36,-9,48,51,-3,66,62,4,3,4,0,0
"304","ANA","NYI",2011020597,15345,20112012,1,60,4,2,2,4.04027037404012,2.75107915655462,1.2891912174855,20,21,-1,34,37,-3,52,56,-4,2,3,0,0
"305","ANA","CBJ",2011020613,15347,20112012,1,60,7,4,3,5.51086734381603,2.49707384440331,3.01379349941272,27,18,9,39,32,7,56,46,10,5,2,0,0
"306","ANA","DAL",2011020628,15349,20112012,1,60,5,2,3,6.16940413287375,4.11204170068959,2.05736243218416,26,28,-2,39,46,-7,52,63,-11,3,3,0,0
"307","ANA","CGY",2011020640,15351,20112012,0,61.85,0,1,-1,3.77333326026564,1.38733415160095,2.38599910866469,23,19,4,33,31,2,45,39,6,1,2,0,0
"308","ANA","EDM",2011020646,15352,20112012,0,60,5,0,5,5.90682621424396,4.12292761708886,1.7838985971551,28,33,-5,37,48,-11,43,58,-15,3,2,0,0
"309","ANA","VAN",2011020663,15354,20112012,0,60,4,2,2,4.92927510775876,4.16249776212499,0.766777345633777,34,23,11,42,32,10,51,50,1,3,3,0,0
"310","ANA","ARI",2011020684,15357,20112012,1,60,6,2,4,3.71570601014537,4.25179445871441,-0.536088448569046,21,27,-6,33,49,-16,42,64,-22,1,4,0,0
"311","ANA","OTT",2011020705,15360,20112012,1,60,2,1,1,4.25857930403436,3.81126500247046,0.447314301563893,29,32,-3,44,41,3,54,63,-9,3,2,0,0
"312","ANA","COL",2011020715,15361,20112012,1,60,3,2,1,3.28689822849628,4.65787360306767,-1.37097537457139,18,45,-27,35,61,-26,49,88,-39,3,4,0,0
"313","ANA","DAL",2011020730,15363,20112012,0,60,0,1,-1,5.23696796153672,1.43247320971932,3.8044947518174,27,16,11,42,20,22,69,33,36,3,1,0,0
"314","ANA","ARI",2011020745,15370,20112012,0,60,4,1,3,3.54382507462287,2.83642481990557,0.7074002547173,30,26,4,39,45,-6,49,59,-10,3,3,0,0
"315","ANA","DAL",2011020752,15371,20112012,1,60,2,6,-4,5.23611041231197,2.70091531437958,2.53519509793239,35,26,9,45,35,10,56,46,10,4,3,0,0
"316","ANA","CBJ",2011020766,15373,20112012,1,63.9166666666667,2,3,-1,3.87071868491572,4.23077838906693,-0.360059704151205,35,21,14,49,36,13,70,53,17,5,4,0,0
"317","ANA","CGY",2011020785,15376,20112012,1,65,2,2,0,3.96425988259448,4.30921659697538,-0.344956714380892,33,26,7,48,38,10,71,52,19,6,3,0,0
"318","ANA","CAR",2011020799,15378,20112012,1,62.2333333333333,3,2,1,4.49497524476828,6.50763943366474,-2.01266418889645,34,33,1,46,46,0,63,63,0,1,2,0,0
"319","ANA","DET",2011020813,15380,20112012,0,65,1,1,0,4.70431445079157,4.05770690480464,0.646607545986932,30,24,6,39,35,4,47,45,2,7,6,0,0
"320","ANA","CBJ",2011020830,15382,20112012,0,60,5,3,2,6.02043695357861,2.99213697842788,3.02829997515073,35,27,8,40,34,6,50,50,0,4,5,0,0
"321","ANA","MIN",2011020843,15384,20112012,0,60,2,1,1,2.5445226326168,1.79017441772157,0.754348214895227,25,18,7,36,25,11,53,43,10,3,4,0,0
"322","ANA","N.J",2011020858,15387,20112012,0,65,2,2,0,4.26654770728783,2.40906348601584,1.85748422127199,38,27,11,44,35,9,50,42,8,3,1,0,0
"323","ANA","FLA",2011020878,15389,20112012,0,60,2,0,2,2.4478982704544,6.62394354300341,-4.176045272549,27,31,-4,40,42,-2,54,58,-4,2,3,0,0
"324","ANA","T.B",2011020890,15391,20112012,0,60,2,3,-1,3.18724064569853,2.92294576723361,0.264294878464912,30,16,14,43,23,20,59,33,26,2,2,0,0
"325","ANA","CAR",2011020900,15393,20112012,0,65,2,2,0,9.14048341258922,4.11082726356835,5.02965614902086,37,32,5,65,47,18,82,58,24,5,2,0,0
"326","ANA","CHI",2011020931,15396,20112012,1,60,3,1,2,3.39280528135328,2.2189130015322,1.17389227982108,38,19,19,49,30,19,62,50,12,4,4,0,0
"327","ANA","COL",2011020935,15397,20112012,0,60,1,4,-3,2.92879880015971,2.91572510477272,0.0130736953869928,28,23,5,39,35,4,55,53,2,3,1,0,0
"328","ANA","BUF",2011020949,15399,20112012,1,60,0,2,-2,9.45141773551888,2.99999298457988,6.451424750939,43,24,19,73,33,40,82,42,40,5,8,0,0
"329","ANA","CGY",2011020964,15401,20112012,1,60,3,2,1,6.61715389971505,5.46817335218657,1.14898054752848,38,29,9,52,36,16,65,51,14,4,5,0,0
"330","ANA","L.A",2011020972,15402,20112012,0,60,2,4,-2,0,0,0,31,20,11,41,40,1,50,50,0,4,4,0,0
"331","ANA","EDM",2011020983,15404,20112012,1,60,4,2,2,7.64654709220486,3.9368015524924,3.70974553971246,30,36,-6,44,44,0,54,59,-5,4,1,0,0
"332","ANA","STL",2011021004,15407,20112012,0,60,1,3,-2,3.01723822479835,5.72279628837714,-2.70555806357879,25,27,-2,34,44,-10,43,58,-15,3,4,0,0
"333","ANA","DAL",2011021022,15409,20112012,0,60,0,2,-2,1.96270447748248,3.42402558158938,-1.4613211041069,21,23,-2,35,28,7,53,53,0,5,6,0,0
"334","ANA","COL",2011021034,15411,20112012,0,61.8666666666667,2,3,-1,7.18924087042251,4.18927751434967,2.99996335607284,40,33,7,57,43,14,66,67,-1,1,1,0,0
"335","ANA","DET",2011021051,15413,20112012,1,60,4,0,4,2.26970961775098,2.80717346878822,-0.537463851037245,24,23,1,41,37,4,53,54,-1,2,3,0,0
"336","ANA","L.A",2011021064,15415,20112012,1,60,2,4,-2,4.51096554280031,6.64393295256082,-2.13296740976051,20,43,-23,36,59,-23,48,77,-29,4,4,0,0
"337","ANA","NSH",2011021080,15417,20112012,1,60,1,3,-2,4.55615864241181,3.89045366036589,0.665704982045921,31,27,4,42,41,1,54,50,4,1,4,0,0
"338","ANA","S.J",2011021087,15418,20112012,0,60,5,3,2,5.04058957973029,5.31823078383481,-0.277641204104512,40,30,10,46,46,0,65,63,2,2,3,0,0
"339","ANA","STL",2011021101,15420,20112012,1,60,4,3,1,3.5631298890803,2.9981110376782,0.565018851402101,22,38,-16,28,50,-22,39,68,-29,5,3,0,0
"340","ANA","BOS",2011021132,15424,20112012,1,60,2,3,-1,3.07530528814823,3.26801184207579,-0.192706553927565,27,25,2,35,32,3,50,45,5,3,2,0,0
"341","ANA","S.J",2011021153,15427,20112012,1,60,3,1,2,5.10092373621592,4.41001857157244,0.690905164643482,28,29,-1,36,40,-4,48,51,-3,0,1,0,0
"342","ANA","ARI",2011021178,15430,20112012,0,60,0,4,-4,4.87034765151839,5.37391516729258,-0.503567515774193,44,29,15,57,41,16,77,45,32,7,5,0,0
"343","ANA","EDM",2011021186,15431,20112012,1,60,1,2,-1,6.48976037360262,2.70449664414627,3.78526372945635,33,15,18,47,23,24,68,37,31,7,4,0,0
"344","ANA","VAN",2011021197,15433,20112012,0,65,4,4,0,1.688460659665,7.84581781522138,-6.15735715555638,24,39,-15,30,54,-24,41,78,-37,3,6,0,0
"345","ANA","EDM",2011021213,15435,20112012,0,61.2,3,2,1,4.23655563034117,4.74756459489436,-0.511008964553184,17,26,-9,25,37,-12,47,54,-7,1,1,0,0
"346","ANA","CGY",2011021221,15437,20112012,0,60,2,5,-3,5.45092812849907,2.93269842089808,2.51822970760099,25,23,2,40,33,7,49,47,2,5,3,0,0
"347","ANA","VAN",2012020013,15724,20122013,0,60,7,3,4,4.11687346478811,6.87721530362956,-2.76034183884145,26,29,-3,34,47,-13,41,62,-21,3,4,0,0
"348","ANA","CGY",2012020026,15726,20122013,0,60,5,4,1,5.25751840826706,3.38918119031587,1.86833721795119,24,25,-1,33,41,-8,44,58,-14,2,3,0,0
"349","ANA","VAN",2012020056,15730,20122013,1,60,0,5,-5,2.74353520281287,4.62673478064244,-1.88319957782956,30,34,-4,38,48,-10,48,58,-10,3,9,0,0
"350","ANA","NSH",2012020064,15731,20122013,1,65,2,2,0,3.12746730668005,3.9927824519109,-0.865315145230852,22,21,1,37,35,2,54,47,7,4,3,0,0
"351","ANA","S.J",2012020087,15734,20122013,0,65,2,2,0,4.95222194495125,3.87247712530615,1.0797448196451,30,18,12,45,37,8,67,52,15,4,2,0,0
"352","ANA","MIN",2012020107,15737,20122013,1,60,3,1,2,3.46558316622395,3.16065315780151,0.30493000842244,31,27,4,43,34,9,65,46,19,2,1,0,0
"353","ANA","L.A",2012020117,15738,20122013,1,60,7,4,3,3.47406458173646,6.4814087592531,-3.00734417751664,25,34,-9,33,56,-23,40,74,-34,4,4,0,0
"354","ANA","S.J",2012020127,15740,20122013,1,60,2,1,1,3.3716163687139,3.64765123543118,-0.276034866717286,32,26,6,43,44,-1,58,68,-10,6,6,0,0
"355","ANA","COL",2012020139,15742,20122013,0,60,3,0,3,3.4172246279777,5.38829925212485,-1.97107462414715,20,31,-11,32,44,-12,48,66,-18,5,2,0,0
"356","ANA","DAL",2012020153,15744,20122013,0,60,1,3,-2,3.71669490746444,3.76549233679509,-0.0487974293306479,21,28,-7,36,40,-4,48,55,-7,5,5,0,0
"357","ANA","STL",2012020163,15745,20122013,0,65,5,5,0,1.44363456498832,3.7053591597105,-2.26172459472218,23,31,-8,29,45,-16,44,62,-18,1,2,0,0
"358","ANA","CHI",2012020185,15748,20122013,0,65,2,2,0,2.45895380859292,3.9883309045108,-1.52937709591788,31,30,1,38,35,3,52,50,2,5,6,0,0
"359","ANA","DET",2012020200,15751,20122013,0,60,5,2,3,5.88118503743148,5.61982579945834,0.26135923797314,37,28,9,45,47,-2,59,59,0,3,4,0,0
"360","ANA","NSH",2012020209,15752,20122013,0,65,2,2,0,2.36854840986324,4.17786876825267,-1.80932035838942,22,34,-12,34,46,-12,51,62,-11,2,5,0,0
"361","ANA","CBJ",2012020225,15754,20122013,1,60,3,2,1,2.7512662060908,2.42572282705805,0.325543379032752,29,27,2,39,41,-2,49,70,-21,3,3,0,0
"362","ANA","COL",2012020269,15760,20122013,1,64.2333333333333,4,3,1,7.6685065216152,4.58825626224244,3.08025025937276,39,23,16,56,38,18,69,57,12,5,4,0,0
"363","ANA","L.A",2012020274,15761,20122013,0,60,2,5,-3,4.00156805824372,6.8746272646822,-2.87305920643848,26,25,1,38,43,-5,48,62,-14,3,2,0,0
"364","ANA","NSH",2012020286,15763,20122013,1,60,5,1,4,4.19831164773859,5.08455081015767,-0.886239162419077,28,21,7,44,27,17,57,38,19,4,3,0,0
"365","ANA","MIN",2012020301,15765,20122013,1,60,3,2,1,3.84081346521498,4.24379069466834,-0.402977229453363,29,33,-4,41,42,-1,48,60,-12,1,3,0,0
"366","ANA","ARI",2012020308,15766,20122013,0,65,4,4,0,5.39773333165795,8.95312103143528,-3.55538769977733,35,37,-2,45,54,-9,58,81,-23,4,1,0,0
"367","ANA","ARI",2012020322,15768,20122013,0,65,4,4,0,3.800853575421,6.60436370804382,-2.80351013262282,31,40,-9,44,55,-11,49,71,-22,2,4,0,0
"368","ANA","ARI",2012020338,15770,20122013,1,60,2,0,2,4.33057446426946,1.82855586889491,2.50201859537455,24,18,6,31,34,-3,43,51,-8,2,3,0,0
"369","ANA","CGY",2012020354,15772,20122013,1,60,4,0,4,2.39068875687939,2.9764484486077,-0.585759691728304,24,29,-5,33,46,-13,44,65,-21,0,2,0,0
"370","ANA","STL",2012020374,15774,20122013,1,60,4,2,2,3.37005072643115,3.90748956839785,-0.537438841966705,22,31,-9,31,44,-13,48,51,-3,7,3,0,0
"371","ANA","MIN",2012020384,15776,20122013,0,60,2,1,1,3.10835667197594,7.88032875279896,-4.77197208082302,21,31,-10,30,41,-11,41,67,-26,4,5,0,0
"372","ANA","DAL",2012020399,15778,20122013,0,65,1,1,0,4.18395224034767,2.1705403077649,2.01341193258278,30,34,-4,50,50,0,70,70,0,3,5,0,0
"373","ANA","STL",2012020414,15780,20122013,0,60.75,1,2,-1,2.25519449132095,2.778113990149,-0.522919498828049,28,21,7,41,37,4,59,47,12,2,3,0,0
"374","ANA","S.J",2012020427,15782,20122013,1,60,5,3,2,3.77324885711577,4.2105567646795,-0.437307907563723,28,35,-7,36,51,-15,44,67,-23,1,3,0,0
"375","ANA","CHI",2012020442,15784,20122013,1,60,4,2,2,4.89678675539708,3.66155875342567,1.23522800197141,26,24,2,40,34,6,51,50,1,1,2,0,0
"376","ANA","DET",2012020455,15786,20122013,1,60,1,5,-4,5.83979581121821,4.34320487704827,1.49659093416994,34,23,11,40,37,3,56,52,4,3,2,0,0
"377","ANA","DET",2012020471,15788,20122013,1,60,1,2,-1,3.54194721992826,2.45701681388164,1.08493040604662,34,21,13,49,28,21,63,41,22,3,6,0,0
"378","ANA","S.J",2012020478,15789,20122013,1,60,3,5,-2,3.33630558223172,5.11492557642869,-1.77861999419697,27,39,-12,39,47,-8,59,59,0,2,5,0,0
"379","ANA","S.J",2012020491,15791,20122013,0,60,0,4,-4,3.20336605434409,5.57013526239461,-2.36676920805053,22,29,-7,36,39,-3,66,52,14,3,4,0,0
"380","ANA","CHI",2012020503,15793,20122013,0,60,2,1,1,2.94805381589486,3.84375288550655,-0.895699069611689,24,26,-2,31,34,-3,41,46,-5,1,4,0,0
"381","ANA","CBJ",2012020518,15795,20122013,0,64,1,2,-1,5.25798873527674,4.1134211360029,1.14456759927384,30,18,12,40,27,13,54,34,20,2,1,0,0
"382","ANA","DAL",2012020528,15796,20122013,0,60,4,0,4,4.62133524964156,4.41570923372637,0.205626015915186,30,26,4,41,39,2,55,53,2,2,4,0,0
"383","ANA","DAL",2012020541,15798,20122013,1,60,5,2,3,5.04465768090449,2.93520970281679,2.1094479780877,27,25,2,34,35,-1,40,50,-10,1,0,0,0
"384","ANA","DAL",2012020557,15800,20122013,1,60,1,3,-2,2.69518270141742,4.10207885492127,-1.40689615350385,28,25,3,44,37,7,59,50,9,4,6,0,0
"385","ANA","L.A",2012020576,15802,20122013,1,65,3,3,0,3.51256701267266,9.15224517813141,-5.63967816545875,22,38,-16,30,51,-21,36,74,-38,5,3,0,0
"386","ANA","EDM",2012020581,15803,20122013,1,60,2,1,1,5.69132806066074,2.95779702283834,2.7335310378224,38,28,10,49,41,8,69,51,18,5,3,0,0
"387","ANA","COL",2012020595,15805,20122013,1,60,1,4,-3,3.03400639657048,3.49056910528452,-0.456562708714046,22,28,-6,27,39,-12,42,55,-13,3,2,0,0
"388","ANA","L.A",2012020620,15808,20122013,0,60,1,2,-1,4.60509611835715,3.54450886457926,1.06058725377789,20,18,2,32,40,-8,38,57,-19,1,5,0,0
"389","ANA","CBJ",2012020643,15812,20122013,1,62.3166666666667,2,3,-1,2.58343699836489,2.09790930460986,0.485527693755031,28,28,0,36,41,-5,43,59,-16,5,5,0,0
"390","ANA","CGY",2012020659,15814,20122013,0,60,1,3,-2,5.25144417727722,6.2780302550982,-1.02658607782098,33,31,2,47,38,9,69,53,16,3,4,0,0
"391","ANA","EDM",2012020673,15816,20122013,0,60,3,1,2,3.40535751929565,3.43876603525132,-0.0334085159556707,30,28,2,48,37,11,63,53,10,5,4,0,0
"392","ANA","EDM",2012020679,15817,20122013,0,60,3,0,3,5.0828099699126,5.22115764213959,-0.138347672226985,28,24,4,41,35,6,56,60,-4,3,3,0,0
"393","ANA","VAN",2012020703,15820,20122013,0,60,3,1,2,5.65224950769698,7.73353862011572,-2.08128911241874,30,29,1,31,43,-12,45,59,-14,3,3,0,0
"394","ANA","ARI",2012020719,15822,20122013,1,60,3,5,-2,5.28415717958705,5.12171862754334,0.16243855204371,46,31,15,57,43,14,72,59,13,4,2,0,0
"395","ANA","DET",2012030161,15825,20122013,1,60,3,1,2,4.759534285462,5.70427612750791,-0.944741842045914,27,22,5,35,38,-3,50,55,-5,4,4,0,0
"396","ANA","DET",2012030162,15827,20122013,1,61.35,4,5,-1,2.23305498624168,3.9287441061897,-1.69568911994801,32,32,0,45,45,0,69,61,8,5,6,0,0
"397","ANA","DET",2012030163,15829,20122013,0,60,4,0,4,2.98755920362782,4.72071801790526,-1.73315881427743,29,23,6,35,34,1,43,48,-5,5,7,0,0
"398","ANA","DET",2012030164,15831,20122013,0,75.1666666666667,2,3,-1,5.63087334874103,8.56960647179085,-2.93873312304981,33,49,-16,45,68,-23,52,89,-37,3,1,0,0
"399","ANA","DET",2012030165,15833,20122013,1,61.9,3,2,1,3.08064194420513,5.09936373005621,-2.01872178585108,34,31,3,49,51,-2,63,68,-5,4,3,0,0
"400","ANA","DET",2012030166,15835,20122013,0,61.0666666666667,3,4,-1,2.87271865098587,5.99660810796195,-3.12388945697608,37,29,8,48,49,-1,61,63,-2,0,3,0,0
"401","ANA","DET",2012030167,15837,20122013,1,60,2,3,-1,7.08295054471034,4.33401981188217,2.74893073282817,33,32,1,46,47,-1,59,58,1,5,3,0,0
"402","ANA","COL",2013020006,15980,20132014,0,60,1,6,-5,4.25097800948237,5.09957707044668,-0.848599060964318,36,29,7,46,41,5,59,50,9,6,7,0,0
"403","ANA","MIN",2013020029,15983,20132014,0,64.9166666666667,4,3,1,5.08165706627692,4.44733005864256,0.634327007634354,30,33,-3,36,47,-11,43,66,-23,3,4,0,0
"404","ANA","WPG",2013020033,15984,20132014,0,60,3,2,1,3.35228158191603,2.19215163098971,1.16012995092632,34,17,17,48,27,21,61,44,17,4,3,0,0
"405","ANA","NYR",2013020057,15988,20132014,1,60,6,0,6,3.64507458292064,3.04817859998002,0.596895982940623,37,34,3,46,40,6,57,53,4,7,3,0,0
"406","ANA","OTT",2013020078,15991,20132014,1,60,4,1,3,5.86293110250699,5.14711912854995,0.715811973957038,56,31,25,77,47,30,88,65,23,6,1,0,0
"407","ANA","CGY",2013020095,15994,20132014,1,60,3,2,1,2.0715149525435,4.62712859884778,-2.55561364630428,22,35,-13,31,45,-14,47,57,-10,1,4,0,0
"408","ANA","ARI",2013020109,15996,20132014,1,65,2,2,0,7.42498815535589,3.04260432437192,4.38238383098397,39,32,7,47,44,3,67,59,8,4,7,0,0
"409","ANA","DAL",2013020125,15998,20132014,1,60,6,3,3,7.37077442044968,4.18351696077152,3.18725745967816,47,36,11,60,49,11,71,62,9,8,7,0,0
"410","ANA","TOR",2013020129,16000,20132014,0,60,2,4,-2,5.69825519657024,3.85406220989535,1.8441929866749,25,23,2,47,30,17,68,44,24,5,5,0,0
"411","ANA","MTL",2013020142,16002,20132014,0,60,1,4,-3,4.56814452569506,6.009107146936,-1.44096262124094,32,25,7,41,40,1,58,61,-3,3,6,0,0
"412","ANA","OTT",2013020151,16003,20132014,0,60,2,1,1,3.84974342577902,3.67070850327424,0.179034922504784,28,27,1,42,40,2,54,58,-4,5,4,0,0
"413","ANA","CBJ",2013020168,16005,20132014,0,60,4,3,1,8.40486858785152,3.30477449197861,5.10009409587292,32,21,11,42,30,12,58,42,16,3,1,0,0
"414","ANA","PHI",2013020177,16007,20132014,0,60,3,2,1,8.91369771934114,5.02712136925395,3.8865763500872,37,28,9,49,39,10,64,50,14,2,3,0,0
"415","ANA","BOS",2013020188,16009,20132014,0,65,2,2,0,6.78469111584127,3.49931755744243,3.28537355839884,23,23,0,34,35,-1,44,51,-7,4,2,0,0
"416","ANA","BUF",2013020201,16011,20132014,0,60,6,3,3,5.20190386576724,3.95861676428467,1.24328710148257,29,17,12,40,25,15,52,40,12,3,2,0,0
"417","ANA","NYR",2013020215,16013,20132014,0,60,2,1,1,4.11419327871408,5.38095927232644,-1.26676599361235,25,33,-8,32,46,-14,42,66,-24,2,3,0,0
"418","ANA","ARI",2013020229,16015,20132014,1,60,5,2,3,4.3508553004905,4.74237647192786,-0.391521171437357,29,26,3,40,37,3,52,49,3,4,4,0,0
"419","ANA","BUF",2013020244,16017,20132014,1,60,6,2,4,5.93171204619284,3.09195100639408,2.83976103979876,46,27,19,64,40,24,70,55,15,2,2,0,0
"420","ANA","VAN",2013020261,16019,20132014,1,60,3,1,2,0,0,0,23,36,-13,30,49,-19,47,65,-18,2,2,0,0
"421","ANA","FLA",2013020271,16021,20132014,0,60,2,3,-1,2.94104809954297,2.83953484362766,0.101513255915307,34,25,9,38,34,4,48,51,-3,3,4,0,0
"422","ANA","T.B",2013020279,16023,20132014,0,60,1,5,-4,2.40310336556286,4.38934199555661,-1.98623862999375,25,20,5,32,37,-5,43,47,-4,5,5,0,0
"423","ANA","CAR",2013020287,16024,20132014,0,65,2,2,0,4.47032377233728,3.09745630226098,1.3728674700763,30,23,7,47,37,10,53,54,-1,3,3,0,0
"424","ANA","N.J",2013020325,16029,20132014,1,61.9666666666667,3,4,-1,3.50226538078949,4.95682049139396,-1.45455511060447,25,26,-1,33,39,-6,47,53,-6,5,3,0,0
"425","ANA","T.B",2013020340,16031,20132014,1,64.9,1,0,1,6.5659231674297,5.26583201100584,1.30009115642386,42,31,11,53,46,7,63,56,7,5,8,0,0
"426","ANA","ARI",2013020349,16032,20132014,0,60,4,2,2,4.92375550890574,4.77529002954189,0.148465479363856,27,44,-17,41,59,-18,51,83,-32,5,5,0,0
"427","ANA","DAL",2013020364,16035,20132014,0,60,3,6,-3,6.01077946704231,5.73286999232726,0.277909474715053,31,33,-2,48,48,0,66,58,8,2,3,0,0
"428","ANA","CGY",2013020384,16038,20132014,1,60,5,2,3,6.70360074924247,4.71889878285151,1.98470196639096,42,21,21,60,36,24,73,46,27,4,0,0,0
"429","ANA","S.J",2013020402,16039,20132014,0,65,3,3,0,4.19513614846528,6.11796558220109,-1.92282943373581,31,35,-4,43,52,-9,59,79,-20,5,7,0,0
"430","ANA","L.A",2013020418,16042,20132014,1,65,2,2,0,4.58717456675367,6.3306289728207,-1.74345440606703,28,51,-23,40,75,-35,53,103,-50,7,6,0,0
"431","ANA","CHI",2013020435,16045,20132014,0,65,2,2,0,1.45763447756565,3.04712322307751,-1.58948874551186,26,25,1,38,40,-2,49,61,-12,1,3,0,0
"432","ANA","STL",2013020445,16046,20132014,0,60,5,2,3,4.43044531748092,4.3592550791509,0.0711902383300185,23,28,-5,29,42,-13,33,57,-24,3,4,0,0
"433","ANA","NYI",2013020457,16048,20132014,1,60,5,2,3,2.95195869221061,5.07367651726236,-2.12171782505175,31,37,-6,41,50,-9,57,71,-14,3,5,0,0
"434","ANA","MIN",2013020472,16050,20132014,1,60,2,1,1,4.23051733339707,3.92942114117159,0.301096192225486,31,24,7,40,34,6,46,43,3,3,2,0,0
"435","ANA","EDM",2013020504,16054,20132014,1,60,3,2,1,6.35429641831433,2.7069842206256,3.64731219768873,34,25,9,50,32,18,67,39,28,1,2,0,0
"436","ANA","DET",2013020514,16056,20132014,0,60,5,2,3,3.25488045944076,2.09242012619507,1.16246033324569,30,18,12,39,25,14,52,32,20,2,2,0,0
"437","ANA","N.J",2013020534,16059,20132014,0,62.6166666666667,3,2,1,4.45700123105325,4.07356372767583,0.383437503377422,24,21,3,28,29,-1,35,36,-1,4,3,0,0
"438","ANA","NYI",2013020544,16060,20132014,0,60,5,3,2,6.39546115451958,1.65372731236093,4.74173384215865,31,21,10,39,31,8,62,44,18,3,2,0,0
"439","ANA","WSH",2013020555,16062,20132014,0,60,3,2,1,2.36045872998511,1.88999419368338,0.470464536301733,29,19,10,43,32,11,56,53,3,4,5,0,0
"440","ANA","ARI",2013020583,16067,20132014,1,60.85,3,2,1,4.90113983867923,3.37256583630551,1.52857400237372,41,25,16,50,36,14,61,51,10,3,2,0,0
"441","ANA","S.J",2013020594,16068,20132014,0,60,1,3,-2,3.77789425978699,3.34711198313744,0.430782276649552,31,23,8,40,36,4,70,51,19,1,2,0,0
"442","ANA","S.J",2013020607,16070,20132014,1,60,6,3,3,1.5135169284747,4.44014314166679,-2.92662621319209,38,36,2,42,50,-8,53,65,-12,4,6,0,0
"443","ANA","EDM",2013020625,16073,20132014,1,60,5,2,3,7.05171491517831,2.72574448884025,4.32597042633806,37,18,19,54,24,30,68,33,35,7,3,0,0
"444","ANA","VAN",2013020642,16075,20132014,1,64.9666666666667,4,3,1,7.11074197887501,3.94598742727612,3.16475455159889,49,20,29,68,38,30,90,44,46,3,3,0,0
"445","ANA","BOS",2013020655,16077,20132014,1,60,5,2,3,3.07756871770835,5.15602783422219,-2.07845911651384,20,32,-12,31,55,-24,42,73,-31,3,3,0,0
"446","ANA","NSH",2013020664,16079,20132014,0,60,4,3,1,3.45481389865745,5.41785501892446,-1.96304112026701,28,26,2,41,36,5,57,47,10,4,3,0,0
"447","ANA","ARI",2013020681,16081,20132014,0,60,5,3,2,3.40554172528209,6.53452487731741,-3.12898315203532,30,31,-1,39,50,-11,43,78,-35,3,6,0,0
"448","ANA","DET",2013020691,16082,20132014,1,60,1,0,1,2.64352148983485,4.87922193759005,-2.23570044775519,23,22,1,32,42,-10,44,63,-19,4,5,0,0
"449","ANA","VAN",2013020709,16085,20132014,1,60,9,1,8,10.0498586573478,4.65750156448212,5.39235709286572,44,32,12,64,48,16,80,62,18,9,3,0,0
"450","ANA","CHI",2013020722,16087,20132014,0,60,2,4,-2,2.22122120534755,4.62781252071727,-2.40659131536972,21,35,-14,28,51,-23,38,74,-36,2,5,0,0
"451","ANA","STL",2013020731,16088,20132014,0,60,3,2,1,4.98552010778803,5.31641722359927,-0.33089711581124,21,36,-15,35,50,-15,49,73,-24,4,3,0,0
"452","ANA","WPG",2013020755,16091,20132014,1,60,2,3,-1,4.99203327924261,2.50903533547535,2.48299794376726,42,21,21,58,36,22,94,40,54,4,2,0,0
"453","ANA","L.A",2013020767,16093,20132014,1,60,2,1,1,2.75608278151743,5.94468212073434,-3.18859933921691,21,31,-10,31,49,-18,38,61,-23,5,4,0,0
"454","ANA","L.A",2013020782,16095,20132014,0,60,3,0,3,4.00181182186692,5.44808945532714,-1.44627763346022,21,36,-15,32,53,-21,34,70,-36,4,5,0,0
"455","ANA","MIN",2013020805,16098,20132014,1,60,2,4,-2,5.41658449272109,5.55376996828784,-0.137185475566753,33,33,0,45,48,-3,58,58,0,4,6,0,0
"456","ANA","PHI",2013020817,16100,20132014,1,60,5,3,2,5.89190435639466,4.95147126813086,0.940433088263799,28,30,-2,44,45,-1,53,66,-13,1,4,0,0
"457","ANA","DAL",2013020833,16102,20132014,1,60,0,2,-2,2.94730910323767,4.78762142314631,-1.84031231990864,26,27,-1,40,46,-6,53,56,-3,4,4,0,0
"458","ANA","CBJ",2013020841,16104,20132014,1,60,2,4,-2,4.03483550406963,5.05924427893478,-1.02440877486515,36,33,3,49,40,9,68,56,12,2,5,0,0
"459","ANA","CHI",2013020854,16106,20132014,1,60,0,2,-2,3.78221757761639,3.44603905253462,0.336178525081777,29,25,4,47,33,14,69,44,25,4,2,0,0
"460","ANA","NSH",2013020880,16109,20132014,0,60,5,2,3,5.97329544593231,6.50857805714176,-0.535282611209453,24,38,-14,33,49,-16,52,63,-11,4,4,0,0
"461","ANA","STL",2013020901,16129,20132014,1,60,1,0,1,1.46763917146018,3.01702250784973,-1.54938333638955,19,18,1,30,48,-18,38,75,-37,4,4,0,0
"462","ANA","CAR",2013020919,16131,20132014,1,60,5,3,2,5.26331714571596,4.76212726515712,0.501189880558844,34,52,-18,46,71,-25,61,85,-24,4,7,0,0
"463","ANA","MTL",2013020937,16134,20132014,1,65,3,3,0,5.70451214819809,4.56635609191036,1.13815605628773,42,31,11,60,53,7,76,68,8,6,5,0,0
"464","ANA","TOR",2013020975,16139,20132014,1,60,1,3,-2,5.68038529138721,3.03381336125813,2.64657193012908,44,23,21,67,29,38,91,41,50,6,4,0,0
"465","ANA","CGY",2013020988,16141,20132014,0,60,2,7,-5,3.7472374765224,3.49481953496553,0.25241794155687,22,25,-3,30,33,-3,45,48,-3,2,4,0,0
"466","ANA","COL",2013021003,16143,20132014,0,60,6,4,2,5.2400377846534,6.22846202820074,-0.988424243547342,33,38,-5,47,50,-3,63,67,-4,2,7,0,0
"467","ANA","L.A",2013021012,16144,20132014,0,60,2,1,1,4.13871665577608,4.67747243574559,-0.538755779969506,20,38,-18,34,51,-17,40,68,-28,4,4,0,0
"468","ANA","WSH",2013021036,16147,20132014,1,60,2,3,-1,5.06623652428971,3.37466673874591,1.6915697855438,45,30,15,66,41,25,79,54,25,6,4,0,0
"469","ANA","S.J",2013021050,16149,20132014,0,60,2,3,-1,3.28023959991697,5.37429565793354,-2.09405605801658,18,28,-10,31,47,-16,48,65,-17,2,3,0,0
"470","ANA","FLA",2013021072,16152,20132014,1,60,6,2,4,5.37907605993314,5.59062576493307,-0.211549704999925,40,30,10,64,43,21,73,52,21,3,1,0,0
"471","ANA","CGY",2013021091,16155,20132014,0,60,3,2,1,5.2112444738159,6.54096590216795,-1.32972142835206,34,34,0,45,47,-2,65,66,-1,3,2,0,0
"472","ANA","EDM",2013021107,16157,20132014,0,63.85,3,4,-1,6.88297309612972,2.9440101597429,3.93896293638682,51,23,28,67,29,38,82,37,45,6,4,0,0
"473","ANA","VAN",2013021117,16158,20132014,0,60,5,1,4,3.18833794588136,6.41220188247723,-3.22386393659588,21,32,-11,32,46,-14,44,60,-16,6,4,0,0
"474","ANA","WPG",2013021127,16160,20132014,1,60.2666666666667,5,4,1,5.52169966435758,4.4398296629588,1.08187000139878,36,37,-1,50,47,3,67,66,1,2,4,0,0
"475","ANA","EDM",2013021142,16162,20132014,1,60,3,2,1,2.53059435257182,4.77351076620107,-2.24291641362925,26,32,-6,35,39,-4,47,47,0,5,5,0,0
"476","ANA","NSH",2013021159,16164,20132014,1,60,2,5,-3,4.18296642618043,2.26033725269372,1.92262917348671,29,24,5,38,32,6,52,43,9,3,4,0,0
"477","ANA","EDM",2013021176,16166,20132014,0,60,2,4,-2,6.86604911529867,4.40307690707724,2.46297220822143,36,28,8,50,34,16,75,47,28,5,3,0,0
"478","ANA","VAN",2013021179,16167,20132014,0,60,3,0,3,2.44180733773283,3.9942226348212,-1.55241529708837,23,18,5,29,39,-10,40,61,-21,3,5,0,0
"479","ANA","S.J",2013021193,16169,20132014,1,60,5,2,3,3.70342041537113,5.46262489142828,-1.75920447605714,30,38,-8,47,57,-10,62,70,-8,4,6,0,0
"480","ANA","L.A",2013021220,16172,20132014,0,65,3,3,0,3.13083633860333,3.4821781280466,-0.351341789443266,24,30,-6,37,43,-6,49,63,-14,4,4,0,0
"481","ANA","COL",2013021229,16173,20132014,1,61.55,3,2,1,5.68552116744011,4.02726468428256,1.65825648315756,36,31,5,62,41,21,69,57,12,2,1,0,0
"482","ANA","DAL",2013030171,16176,20132014,1,60,4,3,1,6.55409727622464,6.07412949000025,0.479967786224393,35,35,0,49,48,1,61,69,-8,5,5,0,0
"483","ANA","DAL",2013030172,16178,20132014,1,60,3,2,1,1.5497389050401,7.5565144567357,-6.0067755516956,19,36,-17,29,61,-32,45,73,-28,3,6,0,0
"484","ANA","DAL",2013030173,16181,20132014,0,60,0,3,-3,7.1695301180313,4.26792577572633,2.90160434230497,37,22,15,51,35,16,70,51,19,8,6,0,0
"485","ANA","DAL",2013030174,16183,20132014,0,60,2,4,-2,7.8139082192406,4.51515323737112,3.29875498186948,23,26,-3,41,39,2,58,61,-3,5,6,0,0
"486","ANA","DAL",2013030175,16185,20132014,1,60,6,2,4,3.68873664429884,4.89931043332763,-1.21057378902879,23,36,-13,30,53,-23,36,68,-32,7,10,0,0
"487","ANA","DAL",2013030176,16187,20132014,0,62.7833333333333,5,4,1,3.72247613751097,3.6173326585031,0.105143479007864,30,24,6,39,48,-9,64,66,-2,6,8,0,0
"488","ANA","L.A",2013030241,16193,20132014,1,72.1166666666667,2,3,-1,7.8597584915172,8.20873073910774,-0.348972247590545,35,36,-1,54,58,-4,74,87,-13,4,4,0,0
"489","ANA","L.A",2013030242,16195,20132014,1,60,1,3,-2,5.60180037839382,3.98378294906286,1.61801742933096,37,17,20,54,30,24,62,38,24,5,4,0,0
"490","ANA","L.A",2013030243,16198,20132014,0,60,3,2,1,3.11845107085537,3.4313412415795,-0.312890170724131,22,31,-9,33,49,-16,48,60,-12,4,3,0,0
"491","ANA","L.A",2013030244,16200,20132014,0,60,2,0,2,2.0489485092173,4.03831689710205,-1.98936838788475,14,28,-14,27,46,-19,36,71,-35,2,4,0,0
"492","ANA","L.A",2013030245,16202,20132014,1,60,4,3,1,3.2494982201606,6.61921929569668,-3.36972107553608,24,42,-18,37,58,-21,47,80,-33,5,4,0,0
"493","ANA","L.A",2013030246,16204,20132014,0,60,1,2,-1,3.27396663615946,5.45951543468982,-2.18554879853036,22,23,-1,41,43,-2,55,59,-4,5,4,0,0
"494","ANA","L.A",2013030247,16206,20132014,1,60,2,6,-4,4.03401806134556,1.90603217217756,2.127985889168,27,30,-3,44,42,2,61,53,8,5,7,0,0
"495","ANA","DET",2014020020,16354,20142015,0,60,3,2,1,2.78969704220071,3.11801785428088,-0.328320812080165,26,29,-3,30,35,-5,43,51,-8,4,3,0,0
"496","ANA","BUF",2014020036,16356,20142015,0,60,5,1,4,5.85291427859198,2.67224962945329,3.18066464913869,44,12,32,60,18,42,75,35,40,8,4,0,0
"497","ANA","PHI",2014020039,16357,20142015,0,65,3,3,0,2.5686707507266,6.42724051725531,-3.85856976652872,28,42,-14,34,56,-22,46,79,-33,2,4,0,0
"498","ANA","MIN",2014020062,16360,20142015,1,60,2,1,1,5.2187305959695,3.38227990107407,1.83645069489543,26,28,-2,41,41,0,51,53,-2,5,4,0,0
"499","ANA","STL",2014020077,16362,20142015,1,60,3,0,3,2.90025366761428,5.9136113496895,-3.01335768207522,25,28,-3,37,42,-5,48,56,-8,3,2,0,0
"500","ANA","BUF",2014020092,16365,20142015,1,60,4,1,3,5.46279366865281,3.30753348831331,2.1552601803395,34,23,11,52,38,14,69,53,16,4,2,0,0
"501","ANA","CBJ",2014020105,16367,20142015,1,60,4,1,3,4.92830374869973,1.99225873920022,2.93604500949951,34,17,17,49,32,17,58,39,19,4,4,0,0
"502","ANA","S.J",2014020120,16369,20142015,1,60,1,4,-3,3.5446449474218,6.57377010014534,-3.02912515272354,34,37,-3,51,54,-3,66,69,-3,10,10,0,0
"503","ANA","CHI",2014020131,16371,20142015,0,60,1,0,1,3.17798053324248,4.46166182355955,-1.28368129031708,25,38,-13,35,48,-13,44,66,-22,2,4,0,0
"504","ANA","STL",2014020144,16373,20142015,0,60,0,2,-2,3.35879754680013,3.27721726620803,0.0815802805921066,24,29,-5,35,45,-10,48,59,-11,4,3,0,0
"505","ANA","DAL",2014020150,16374,20142015,0,62.5,2,1,1,2.96625017177541,2.08755393097557,0.87869624079984,24,22,2,34,34,0,47,50,-3,5,7,0,0
"506","ANA","COL",2014020168,16376,20142015,0,60,3,2,1,3.68143892102353,3.22255995980231,0.458878961221217,33,18,15,40,23,17,50,36,14,5,3,0,0
"507","ANA","NYI",2014020186,16379,20142015,1,62.3,2,3,-1,4.80417453035566,5.33591831941158,-0.531743789055913,34,36,-2,51,51,0,67,68,-1,2,3,0,0
"508","ANA","ARI",2014020201,16381,20142015,1,65,2,2,0,4.82121938364071,3.74441687046783,1.07680251317288,39,25,14,60,35,25,81,52,29,4,3,0,0
"509","ANA","VAN",2014020217,16383,20142015,1,65,1,1,0,6.08052604817249,5.98410209384747,0.0964239543250187,29,35,-6,46,53,-7,65,66,-1,2,4,0,0
"510","ANA","L.A",2014020232,16386,20142015,1,65,5,5,0,5.5407504292597,3.76959760555474,1.77115282370497,49,26,23,68,39,29,88,49,39,2,3,0,0
"511","ANA","L.A",2014020250,16389,20142015,0,62.3166666666667,2,3,-1,3.93383097003061,4.43442139693616,-0.500590426905546,29,37,-8,41,51,-10,54,66,-12,3,3,0,0
"512","ANA","FLA",2014020264,16390,20142015,1,60,2,6,-4,0,0,0,35,29,6,54,44,10,75,51,24,2,1,0,0
"513","ANA","CGY",2014020275,16392,20142015,0,65,3,3,0,2.87979341451239,2.34975225524977,0.530041159262623,27,19,8,40,31,9,62,48,14,3,5,0,0
"514","ANA","VAN",2014020288,16394,20142015,0,65,3,3,0,3.96162577631185,2.97314068524986,0.988485091061989,26,28,-2,31,38,-7,49,62,-13,3,1,0,0
"515","ANA","ARI",2014020310,16397,20142015,1,60,2,1,1,4.05711564789817,5.17458637163509,-1.11747072373691,30,27,3,47,40,7,61,51,10,2,3,0,0
"516","ANA","CGY",2014020322,16399,20142015,1,60,3,2,1,2.81572670893308,5.9886053133705,-3.17287860443741,29,34,-5,41,45,-4,49,60,-11,2,6,0,0
"517","ANA","CHI",2014020334,16402,20142015,1,60,1,4,-3,1.60414145690942,6.11565071617997,-4.51150925927055,24,38,-14,31,53,-22,35,64,-29,3,4,0,0
"518","ANA","S.J",2014020355,16403,20142015,0,60,4,6,-2,2.95698177308943,2.61294929896603,0.344032474123397,34,35,-1,43,47,-4,54,62,-8,8,8,0,0
"519","ANA","BOS",2014020361,16405,20142015,1,60,3,2,1,4.15586316748522,5.1519352751712,-0.99607210768598,28,34,-6,41,57,-16,56,85,-29,3,3,0,0
"520","ANA","PHI",2014020375,16407,20142015,1,65,4,4,0,4.04746183138482,5.61953318450833,-1.5720713531235,33,35,-2,56,49,7,76,56,20,6,3,0,0
"521","ANA","MIN",2014020387,16409,20142015,0,60,5,4,1,2.88307288105716,4.84649359062314,-1.96342070956598,21,25,-4,35,36,-1,47,52,-5,4,4,0,0
"522","ANA","WPG",2014020402,16411,20142015,0,60.8833333333333,4,3,1,4.3181919229296,3.40351394601646,0.91467797691314,25,30,-5,32,48,-16,44,68,-24,5,7,0,0
"523","ANA","EDM",2014020420,16414,20142015,1,60,2,1,1,5.8416161597298,3.73845433695533,2.10316182277447,34,22,12,42,32,10,51,43,8,4,2,0,0
"524","ANA","EDM",2014020434,16416,20142015,0,60,4,2,2,2.1697168252515,3.37512627892511,-1.20540945367361,20,23,-3,30,31,-1,38,47,-9,2,4,0,0
"525","ANA","WPG",2014020442,16417,20142015,0,60,4,1,3,6.50561297261386,3.30461233987845,3.20100063273541,31,28,3,41,41,0,56,59,-3,5,4,0,0
"526","ANA","TOR",2014020454,16420,20142015,0,60,2,6,-4,6.57023245397886,2.82706443923234,3.74316801474652,42,27,15,72,43,29,89,59,30,5,6,0,0
"527","ANA","MTL",2014020471,16422,20142015,0,60,2,1,1,3.6494841014287,3.07096410386293,0.578519997565763,23,24,-1,35,35,0,58,53,5,4,4,0,0
"528","ANA","OTT",2014020475,16423,20142015,0,60,2,6,-4,5.39230450652394,3.29534355996293,2.09696094656101,34,31,3,45,39,6,66,51,15,3,2,0,0
"529","ANA","S.J",2014020501,16426,20142015,1,60.9666666666667,3,2,1,5.00867624033303,5.87945387669049,-0.87077763635746,32,32,0,47,43,4,59,56,3,3,2,0,0
"530","ANA","ARI",2014020523,16431,20142015,0,65,1,1,0,7.16044798607751,5.11792262308882,2.0425253629887,36,29,7,52,36,16,67,58,9,1,1,0,0
"531","ANA","VAN",2014020528,16432,20142015,1,62.7,2,1,1,6.53343975052849,3.1818279508152,3.35161179971328,31,14,17,56,36,20,77,48,29,4,1,0,0
"532","ANA","S.J",2014020552,16435,20142015,1,60,0,3,-3,5.40966177842461,4.74292862147558,0.666733156949022,28,27,1,47,43,4,59,60,-1,4,9,0,0
"533","ANA","STL",2014020565,16437,20142015,1,60,4,3,1,4.46397400591971,6.12359618702143,-1.65962218110172,33,42,-9,43,56,-13,60,69,-9,5,5,0,0
"534","ANA","NSH",2014020581,16439,20142015,1,65,3,3,0,7.31957516931288,4.44220011046855,2.87737505884434,33,30,3,50,41,9,67,55,12,3,4,0,0
"535","ANA","NYR",2014020597,16442,20142015,1,60,1,4,-3,2.06148425170977,5.39343262996408,-3.33194837825431,25,30,-5,49,46,3,68,60,8,3,1,0,0
"536","ANA","WPG",2014020626,16446,20142015,1,65,4,4,0,6.61850902368315,3.58377972266828,3.03472930101486,43,32,11,54,45,9,66,59,7,6,7,0,0
"537","ANA","TOR",2014020642,16449,20142015,1,60,4,0,4,5.38741817688742,3.47539456165396,1.91202361523347,25,28,-3,41,34,7,49,45,4,2,3,0,0
"538","ANA","N.J",2014020659,16451,20142015,1,60,5,1,4,4.30870026252876,4.25686055156302,0.0518397109657371,40,15,25,51,23,28,69,38,31,3,2,0,0
"539","ANA","L.A",2014020670,16452,20142015,0,65,2,2,0,5.15996908874115,6.75435762716279,-1.59438853842164,31,28,3,46,47,-1,58,62,-4,2,2,0,0
"540","ANA","CGY",2014020695,16456,20142015,1,60,6,3,3,5.14725849184299,5.18504192610271,-0.0377834342597225,27,33,-6,37,44,-7,52,62,-10,2,3,0,0
"541","ANA","VAN",2014020707,16462,20142015,0,60,4,0,4,5.43907784977591,2.49728830056983,2.94178954920608,24,17,7,40,28,12,50,42,8,3,3,0,0
"542","ANA","S.J",2014020721,16464,20142015,0,60,3,6,-3,2.86830638881474,4.3527924203157,-1.48448603150096,28,33,-5,39,44,-5,60,64,-4,2,5,0,0
"543","ANA","CHI",2014020726,16465,20142015,1,60,1,4,-3,3.942317279279,4.54355758053134,-0.601240301252346,22,33,-11,35,45,-10,45,60,-15,3,3,0,0
"544","ANA","CAR",2014020755,16469,20142015,1,60.75,5,4,1,3.8181095818145,4.1742737951041,-0.356164213289599,31,32,-1,42,42,0,51,47,4,4,5,0,0
"545","ANA","NSH",2014020763,16471,20142015,0,60,5,2,3,4.16770037978495,7.27203252400795,-3.10433214422301,26,46,-20,32,57,-25,41,72,-31,4,4,0,0
"546","ANA","WSH",2014020769,16472,20142015,0,65,2,2,0,4.99059349015442,7.25446869543521,-2.26387520528078,25,34,-9,33,49,-16,51,64,-13,2,1,0,0
"547","ANA","T.B",2014020788,16474,20142015,0,60,3,5,-2,0,0,0,28,23,5,45,31,14,66,40,26,6,6,0,0
"548","ANA","FLA",2014020802,16476,20142015,0,60,2,6,-4,6.70870879778886,3.55558503780048,3.15312375998838,33,26,7,45,38,7,62,43,19,3,7,0,0
"549","ANA","CAR",2014020810,16478,20142015,0,60,2,1,1,1.33914399062087,6.00842379909591,-4.66927980847504,17,36,-19,26,52,-26,37,71,-34,1,3,0,0
"550","ANA","WSH",2014020836,16481,20142015,1,60,3,5,-2,5.99901817913595,5.03030061884783,0.968717560288121,33,28,5,51,44,7,69,55,14,4,5,0,0
"551","ANA","T.B",2014020858,16484,20142015,1,60,1,4,-3,3.74925231776433,4.82207185380685,-1.07281953604252,25,32,-7,45,41,4,62,52,10,2,3,0,0
"552","ANA","CGY",2014020871,16486,20142015,0,60,6,3,3,6.62783815804869,3.83746000698011,2.79037815106858,38,28,10,46,39,7,64,63,1,1,5,0,0
"553","ANA","EDM",2014020879,16487,20142015,0,60,2,1,1,3.4178287037536,3.08406450576149,0.333764197992111,21,27,-6,32,37,-5,45,57,-12,1,2,0,0
"554","ANA","DET",2014020893,16489,20142015,1,65,3,3,0,2.84385289833881,4.74924097567323,-1.90538807733443,25,38,-13,41,54,-13,59,68,-9,4,5,0,0
"555","ANA","OTT",2014020907,16491,20142015,1,60,0,3,-3,3.18122334681729,5.16803955830624,-1.98681621148895,25,34,-9,40,45,-5,56,57,-1,2,4,0,0
"556","ANA","L.A",2014020922,16493,20142015,1,60,4,2,2,4.81503723527567,5.93577529691356,-1.12073806163789,32,22,10,45,39,6,53,57,-4,1,1,0,0
"557","ANA","DAL",2014020937,16495,20142015,0,60,3,1,2,4.8430641352731,4.69595472237691,0.147109412896185,22,40,-18,32,53,-21,42,80,-38,1,3,0,0
"558","ANA","ARI",2014020949,16497,20142015,0,60,4,1,3,8.03777722816449,2.92313924337031,5.11463798479417,35,30,5,54,41,13,65,52,13,1,3,0,0
"559","ANA","MTL",2014020955,16498,20142015,1,60,3,1,2,4.66141410035809,4.89326207149406,-0.231847971135977,33,38,-5,45,47,-2,57,61,-4,1,3,0,0
"560","ANA","VAN",2014020988,16503,20142015,0,60,1,2,-1,6.50318355827767,4.39039034830057,2.1127932099771,30,16,14,49,23,26,71,32,39,5,3,0,0
"561","ANA","CGY",2014021001,16505,20142015,0,60,3,6,-3,5.55650963743417,3.91491316742531,1.64159647000886,32,23,9,43,30,13,62,37,25,3,6,0,0
"562","ANA","MIN",2014021016,16507,20142015,0,60,2,1,1,7.7288876228491,10.5152326272382,-2.78634500438912,24,33,-9,31,48,-17,41,57,-16,4,6,0,0
"563","ANA","NSH",2014021036,16509,20142015,1,60,4,2,2,4.43648555169057,4.2821246040985,0.154360947592068,28,27,1,43,34,9,58,48,10,3,3,0,0
"564","ANA","L.A",2014021052,16512,20142015,1,60.75,3,2,1,3.7466692777507,4.84274065773934,-1.09607137998864,26,31,-5,37,36,1,49,52,-3,4,4,0,0
"565","ANA","COL",2014021065,16514,20142015,1,61.4166666666667,3,2,1,4.05241489107721,2.89903095648719,1.15338393459001,40,24,16,54,31,23,68,38,30,3,1,0,0
"566","ANA","NYR",2014021081,16516,20142015,0,60,2,7,-5,6.68521064336528,5.0673554094974,1.61785523386789,38,29,9,59,41,18,72,54,18,2,3,0,0
"567","ANA","CBJ",2014021093,16518,20142015,0,60,3,5,-2,6.11306327092461,3.44809000650962,2.66497326441499,40,27,13,61,29,32,73,34,39,6,4,0,0
"568","ANA","BOS",2014021101,16520,20142015,0,63.15,3,2,1,3.30881682558103,3.49321072528547,-0.184393899704434,32,29,3,44,38,6,55,50,5,4,6,0,0
"569","ANA","NYI",2014021117,16522,20142015,0,60,3,2,1,3.25881684850901,6.90300210512942,-3.6441852566204,24,31,-7,35,47,-12,49,69,-20,0,4,0,0
"570","ANA","N.J",2014021133,16523,20142015,0,60,2,1,1,2.17892178761824,3.85085366779822,-1.67193188017998,25,27,-2,31,37,-6,41,44,-3,1,2,0,0
"571","ANA","EDM",2014021151,16526,20142015,1,60,5,1,4,4.94850861811221,1.38425843117147,3.56425018694074,27,23,4,43,34,9,49,50,-1,3,4,0,0
"572","ANA","COL",2014021165,16528,20142015,1,60,2,4,-2,5.53670521235178,3.72212221752852,1.81458299482326,37,23,14,55,37,18,65,44,21,4,5,0,0
"573","ANA","DAL",2014021202,16533,20142015,1,60,0,4,-4,3.08470300811936,6.03092341148295,-2.94622040336359,19,32,-13,34,50,-16,43,61,-18,1,3,0,0
"574","ANA","ARI",2014021229,16536,20142015,0,60,2,1,1,7.11732734019046,4.99930474307621,2.11802259711425,38,24,14,60,36,24,69,50,19,4,4,0,0
"575","ANA","WPG",2014030171,16541,20142015,1,60,4,2,2,6.80320470915467,4.02692625755662,2.77627845159805,33,27,6,53,36,17,67,42,25,4,3,0,0
"576","ANA","WPG",2014030172,16543,20142015,1,60,2,1,1,4.76325965361876,4.05280029172491,0.710459361893854,39,29,10,54,41,13,62,56,6,5,4,0,0
"577","ANA","WPG",2014030173,16545,20142015,0,65.2,5,4,1,8.24051217441081,3.79118595148248,4.44932622292833,31,35,-4,40,47,-7,57,62,-5,4,4,0,0
"578","ANA","WPG",2014030174,16547,20142015,0,60,5,2,3,4.91072175198497,4.07093569636345,0.839786055621516,35,27,8,45,39,6,54,54,0,1,3,0,0
"579","ANA","CGY",2014030241,16555,20142015,1,60,6,1,5,4.57596478992504,2.79167979097174,1.7842849989533,35,24,11,50,38,12,63,57,6,5,4,0,0
"580","ANA","CGY",2014030242,16558,20142015,1,60,3,0,3,5.93322362157051,6.31537148784264,-0.382147866272135,34,30,4,45,40,5,63,60,3,5,4,0,0
"581","ANA","CGY",2014030243,16560,20142015,0,64.4,3,4,-1,6.43882663217482,3.6912657241337,2.74756090804112,21,21,0,36,39,-3,45,57,-12,3,7,0,0
"582","ANA","CGY",2014030244,16563,20142015,0,60,4,2,2,6.64906510990872,3.7552258642163,2.89383924569242,29,27,2,44,38,6,67,52,15,4,3,0,0
"583","ANA","CGY",2014030245,16565,20142015,1,62.4333333333333,3,2,1,6.55385564771726,3.003434406734,3.55042124098327,47,19,28,63,31,32,90,40,50,6,5,0,0
"584","ANA","CHI",2014030321,16572,20142015,1,60,4,1,3,4.93917166675521,6.04807026666448,-1.10889859990927,27,33,-6,44,48,-4,53,70,-17,1,3,0,0
"585","ANA","CHI",2014030322,16574,20142015,1,80,2,2,0,9.3823990537785,7.12892624622964,2.25347280754886,43,36,7,65,51,14,87,76,11,5,4,0,0
"586","ANA","CHI",2014030323,16576,20142015,0,60,2,1,1,2.92728177348545,6.64058906352147,-3.71330729003603,27,28,-1,37,40,-3,46,67,-21,2,5,0,0
"587","ANA","CHI",2014030324,16578,20142015,0,80,4,4,0,8.18230053581647,6.4982492380077,1.68405129780876,47,38,9,54,54,0,72,86,-14,3,5,0,0
"588","ANA","CHI",2014030325,16580,20142015,1,60.75,5,4,1,5.34992354374845,3.26355722071712,2.08636632303133,28,28,0,43,45,-2,54,66,-12,2,2,0,0
"589","ANA","CHI",2014030326,16582,20142015,0,60,2,5,-3,4.88779689737385,5.7910103816539,-0.903213484280059,32,23,9,38,31,7,57,54,3,3,3,0,0
"590","ANA","CHI",2014030327,16585,20142015,1,60,3,5,-2,7.37644325086148,4.11951864325601,3.25692460760547,38,26,12,53,37,16,68,51,17,2,4,0,0
"591","ANA","S.J",2015020030,16718,20152016,0,60,0,2,-2,5.21512354961305,8.11229625553892,-2.89717270592587,27,44,-17,40,56,-16,57,76,-19,1,1,0,0
"592","ANA","VAN",2015020036,16720,20152016,1,65,1,1,0,2.85410014670977,5.80812043727042,-2.95402029056065,29,25,4,48,35,13,66,51,15,2,2,0,0
"593","ANA","ARI",2015020049,16722,20152016,1,60,0,4,-4,5.50556258607151,3.79587261064444,1.70968997542707,37,29,8,46,38,8,54,53,1,3,6,0,0
"594","ANA","COL",2015020063,16724,20152016,1,60,0,3,-3,4.30124175977835,4.24530533165671,0.0559364281216403,35,25,10,51,32,19,92,44,48,7,4,0,0
"595","ANA","MIN",2015020077,16726,20152016,1,60,4,1,3,3.88222497305833,5.39720959561441,-1.51498462255609,22,35,-13,37,56,-19,47,76,-29,2,1,0,0
"596","ANA","NSH",2015020095,16730,20152016,0,60,1,5,-4,2.49175687167477,5.20121214776009,-2.70945527608532,28,29,-1,38,34,4,55,46,9,5,5,0,0
"597","ANA","MIN",2015020106,16732,20152016,0,60,0,3,-3,2.02699250928407,6.39421297915396,-4.3672204698699,15,30,-15,24,43,-19,42,64,-22,1,5,0,0
"598","ANA","CHI",2015020123,16734,20152016,0,60.85,0,1,-1,4.58733290765667,2.36055826614756,2.22677464150911,39,24,15,46,31,15,60,47,13,5,5,0,0
"599","ANA","DAL",2015020132,16735,20152016,0,60,3,4,-1,2.00050547223509,3.26518028086971,-1.26467480863462,20,34,-14,29,49,-20,47,59,-12,4,3,0,0
"600","ANA","STL",2015020141,16737,20152016,0,60,1,2,-1,3.06729942795567,3.85329132596962,-0.785991898013947,23,34,-11,37,41,-4,46,54,-8,5,6,0,0
"601","ANA","NSH",2015020168,16740,20152016,1,60,4,2,2,1.49809057501754,5.27410781418439,-3.77601723916685,28,42,-14,35,62,-27,49,79,-30,4,7,0,0
"602","ANA","FLA",2015020184,16743,20152016,1,65,2,2,0,5.23525143932784,2.40386818652041,2.83138325280743,39,25,14,54,36,18,73,52,21,5,3,0,0
"603","ANA","CBJ",2015020199,16745,20152016,1,60,4,2,2,6.05139306512198,5.29393769038143,0.757455374740555,34,36,-2,49,44,5,61,50,11,5,4,0,0
"604","ANA","S.J",2015020210,16746,20152016,0,60,1,0,1,2.91408261854667,5.26527882512892,-2.35119620658224,17,31,-14,29,43,-14,43,53,-10,2,4,0,0
"605","ANA","ARI",2015020215,16748,20152016,1,61.3,3,4,-1,4.87429117841607,1.97280170024952,2.90148947816655,36,28,8,49,41,8,61,53,8,4,5,0,0
"606","ANA","EDM",2015020229,16750,20152016,1,61.2666666666667,3,4,-1,4.80857700777415,4.67765544845497,0.130921559319177,37,27,10,49,44,5,59,58,1,2,2,0,0
"607","ANA","NYI",2015020245,16752,20152016,1,60,1,4,-3,6.1979682465687,5.77357600672985,0.424392239838847,25,29,-4,43,49,-6,63,70,-7,4,6,0,0
"608","ANA","CAR",2015020262,16755,20152016,0,60,4,1,3,5.65499315538909,5.55283787322696,0.10215528216213,20,25,-5,28,35,-7,41,54,-13,0,3,0,0
"609","ANA","NSH",2015020273,16756,20152016,0,60,2,3,-1,3.58019052393219,2.93203503487473,0.64815548905746,40,21,19,55,26,29,78,34,44,6,7,0,0
"610","ANA","FLA",2015020285,16758,20152016,0,60,3,1,2,4.5322578885025,2.93109703995287,1.60116084854963,41,25,16,49,35,14,57,44,13,3,3,0,0
"611","ANA","T.B",2015020295,16760,20152016,0,60,0,5,-5,5.44671169448611,4.95962755015353,0.487084144332578,30,24,6,44,41,3,53,56,-3,4,7,0,0
"612","ANA","CGY",2015020316,16763,20152016,1,60,5,3,2,6.24489185033235,3.44748795448686,2.79740389584549,32,25,7,53,30,23,73,36,37,2,2,0,0
"613","ANA","ARI",2015020327,16764,20152016,0,60,2,4,-2,3.9081387877708,5.47350434761029,-1.56536555983949,31,34,-3,44,42,2,52,62,-10,4,4,0,0
"614","ANA","CHI",2015020333,16766,20152016,1,61.8833333333333,2,3,-1,5.72556137460197,4.93094182209143,0.79461955251054,25,32,-7,40,49,-9,57,70,-13,4,5,0,0
"615","ANA","VAN",2015020358,16769,20152016,1,60,4,0,4,5.01180089265108,3.08471246593399,1.92708842671709,30,25,5,44,43,1,59,59,0,4,3,0,0
"616","ANA","T.B",2015020372,16771,20152016,1,60,1,2,-1,4.11322472883569,3.17060209214105,0.942622636694637,33,22,11,46,36,10,64,48,16,4,4,0,0
"617","ANA","S.J",2015020387,16773,20152016,1,60,1,0,1,5.28516521483165,4.94574408818153,0.339421126650123,26,23,3,44,36,8,59,49,10,4,4,0,0
"618","ANA","PIT",2015020403,16775,20152016,1,60,2,1,1,4.1134412989195,4.55510320301983,-0.441661904100329,25,24,1,35,45,-10,57,59,-2,2,3,0,0
"619","ANA","CAR",2015020434,16780,20152016,1,60,1,5,-4,7.90750888888579,4.51903411376406,3.38847477512172,32,24,8,56,32,24,73,44,29,2,1,0,0
"620","ANA","BUF",2015020466,16786,20152016,0,60,0,3,-3,6.41037939190574,2.22208101255819,4.18829837934754,44,22,22,52,29,23,66,41,25,4,4,0,0
"621","ANA","N.J",2015020486,16788,20152016,0,60,2,1,1,3.53816022493993,2.72547176165972,0.81268846328021,18,22,-4,28,31,-3,35,40,-5,0,2,0,0
"622","ANA","NYI",2015020499,16790,20152016,0,60,2,5,-3,3.24025992152747,4.8343731565401,-1.59411323501263,29,31,-2,35,43,-8,54,59,-5,2,4,0,0
"623","ANA","NYR",2015020508,16791,20152016,0,62.6166666666667,2,3,-1,1.90563064934031,4.22787709694735,-2.32224644760704,19,22,-3,27,35,-8,41,44,-3,4,5,0,0
"624","ANA","PHI",2015020533,16796,20152016,1,60,4,2,2,5.70073806977598,4.04262132925214,1.65811674052384,37,26,11,49,31,18,59,40,19,4,6,0,0
"625","ANA","CGY",2015020548,16798,20152016,0,60,1,0,1,4.80273158662021,3.36435945681296,1.43837212980725,21,14,7,31,17,14,45,31,14,3,5,0,0
"626","ANA","EDM",2015020563,16800,20152016,0,60,1,0,1,4.20200215619116,1.61204953741981,2.58995261877135,35,21,14,42,25,17,61,41,20,3,4,0,0
"627","ANA","VAN",2015020566,16801,20152016,0,65,1,1,0,6.02802171189069,2.3965767287882,3.63144498310248,28,25,3,42,33,9,55,38,17,2,3,0,0
"628","ANA","WPG",2015020582,16803,20152016,1,60,4,1,3,5.35880408994946,2.61985485555488,2.73894923439458,35,20,15,53,31,22,64,40,24,4,6,0,0
"629","ANA","TOR",2015020600,16806,20152016,1,60,0,4,-4,0,0,0,39,38,1,53,55,-2,63,78,-15,4,8,0,0
"630","ANA","STL",2015020613,16808,20152016,1,65,3,3,0,9.1666810104507,1.80626337842921,7.36041763202149,39,28,11,57,38,19,71,51,20,5,4,0,0
"631","ANA","DET",2015020628,16810,20152016,1,60,1,2,-1,4.22652787432953,4.57311509832056,-0.346587223991028,31,25,6,52,44,8,66,60,6,2,3,0,0
"632","ANA","OTT",2015020645,16813,20152016,1,60,4,1,3,6.95614190001652,2.86485626172825,4.09128563828827,38,25,13,52,31,21,65,45,20,3,2,0,0
"633","ANA","DAL",2015020659,16815,20152016,1,60,4,2,2,2.5537935810392,4.96852819311607,-2.41473461207687,35,24,11,51,39,12,64,61,3,3,4,0,0
"634","ANA","L.A",2015020676,16817,20152016,1,60,2,3,-1,6.65295026297099,5.30787178018363,1.34507848278736,32,26,6,51,42,9,66,56,10,3,2,0,0
"635","ANA","MIN",2015020692,16820,20152016,1,60,3,1,2,4.1641684573298,4.29326779846451,-0.129099341134708,27,26,1,37,41,-4,51,57,-6,1,3,0,0
"636","ANA","WSH",2015020704,16901,20152016,0,60,2,0,2,3.3293538877333,4.19829239005958,-0.868938502326273,21,24,-3,35,42,-7,45,56,-11,4,4,0,0
"637","ANA","DET",2015020713,16823,20152016,0,60,4,3,1,5.5741639699263,3.6330675688223,1.94109640110401,35,27,8,41,32,9,52,44,8,4,4,0,0
"638","ANA","BOS",2015020731,16826,20152016,0,60,6,2,4,5.22286873288575,4.9106781389093,0.312190593976448,39,34,5,51,53,-2,62,66,-4,5,5,0,0
"639","ANA","S.J",2015020755,16833,20152016,1,60,3,2,1,5.18132780163432,3.12635982249049,2.05496797914384,25,32,-7,42,46,-4,55,69,-14,4,3,0,0
"640","ANA","L.A",2015020770,16835,20152016,0,60,4,2,2,3.36264897172714,2.1831994097447,1.17944956198244,24,25,-1,44,37,7,58,47,11,6,3,0,0
"641","ANA","ARI",2015020774,16836,20152016,1,60,5,2,3,7.21219701378996,4.1336421337428,3.07855488004716,41,25,16,55,37,18,74,51,23,7,5,0,0
"642","ANA","PIT",2015020791,16839,20152016,0,60,2,6,-4,5.65680524503114,6.41504764948331,-0.758242404452176,38,35,3,49,45,4,63,59,4,2,1,0,0
"643","ANA","PHI",2015020797,16840,20152016,0,60,4,1,3,3.00468299362363,4.97130287189556,-1.96661987827193,26,29,-3,41,38,3,52,63,-11,8,8,0,0
"644","ANA","CBJ",2015020811,16842,20152016,0,65,3,3,0,4.73485210079891,5.16626064202865,-0.431408541229736,27,34,-7,36,42,-6,48,66,-18,2,4,0,0
"645","ANA","CHI",2015020832,16844,20152016,0,62.2666666666667,3,2,1,6.79591330334006,2.43082114127174,4.36509216206832,44,23,21,59,29,30,74,38,36,4,3,0,0
"646","ANA","CGY",2015020841,16846,20152016,0,60,6,4,2,3.19053654669551,4.77837316791556,-1.58783662122005,28,37,-9,39,44,-5,51,57,-6,4,6,0,0
"647","ANA","EDM",2015020854,16847,20152016,0,60,5,3,2,5.76389815600561,3.52044312388171,2.2434550321239,31,27,4,41,40,1,56,53,3,4,4,0,0
"648","ANA","VAN",2015020868,16849,20152016,0,60,5,2,3,3.42084650450852,2.81031051876198,0.610535985746537,33,21,12,42,27,15,49,41,8,4,5,0,0
"649","ANA","CGY",2015020887,16852,20152016,1,60,5,2,3,3.8585333719102,2.76260212226771,1.09593124964249,33,24,9,53,38,15,70,51,19,6,7,0,0
"650","ANA","BUF",2015020905,16855,20152016,1,60,1,0,1,3.0690013884072,3.41671622431022,-0.34771483590302,29,26,3,47,39,8,64,53,11,3,4,0,0
"651","ANA","EDM",2015020919,16857,20152016,1,61.4,2,1,1,5.52656340278918,3.63255007148109,1.89401333130809,34,18,16,48,30,18,72,42,30,3,3,0,0
"652","ANA","L.A",2015020935,16859,20152016,1,60,4,2,2,4.23965430602948,5.70759437709057,-1.46794007106109,29,29,0,51,42,9,68,60,8,7,6,0,0
"653","ANA","MTL",2015020953,16862,20152016,1,65,2,2,0,5.6264988279072,3.98843123514962,1.63806759275758,35,27,8,50,41,9,62,64,-2,6,4,0,0
"654","ANA","ARI",2015020963,16863,20152016,0,60,5,1,4,3.18169731068886,2.69289832384486,0.488798986844003,21,28,-7,27,44,-17,43,55,-12,12,9,0,0
"655","ANA","L.A",2015020972,16865,20152016,0,60,3,2,1,3.11080101855623,6.35267120029312,-3.24187018173689,22,34,-12,31,57,-26,39,72,-33,3,7,0,0
"656","ANA","WSH",2015020991,16867,20152016,1,65,1,1,0,5.20540112328399,5.69604897632962,-0.49064785304563,28,32,-4,44,40,4,62,52,10,4,4,0,0
"657","ANA","COL",2015021004,16869,20152016,0,60,0,3,-3,4.86149366666041,1.55537841037,3.30611525629041,37,26,11,55,30,25,75,42,33,5,4,0,0
"658","ANA","STL",2015021015,16871,20152016,0,60,2,5,-3,3.82717873898946,2.92509701212839,0.90208172686107,29,23,6,38,30,8,49,42,7,4,4,0,0
"659","ANA","N.J",2015021038,16874,20152016,1,60,7,1,6,3.54269932972966,3.17776622076781,0.36493310896185,27,25,2,39,36,3,48,47,1,3,4,0,0
"660","ANA","NYR",2015021052,16876,20152016,1,60,1,2,-1,3.87813005068165,4.40567721000116,-0.527547159319511,23,23,0,37,31,6,55,44,11,0,3,0,0
"661","ANA","BOS",2015021066,16878,20152016,1,60,4,0,4,3.75760513343466,3.54818440424424,0.209420729190416,26,38,-12,45,54,-9,57,70,-13,3,3,0,0
"662","ANA","WPG",2015021078,16880,20152016,0,64.0166666666667,3,2,1,7.36325460307853,3.41285884240642,3.95039576067211,33,29,4,39,36,3,48,47,1,2,3,0,0
"663","ANA","MTL",2015021091,16882,20152016,0,60,3,4,-1,7.06134486303141,6.41149457718711,0.649850285844295,35,23,12,45,27,18,69,44,25,2,1,0,0
"664","ANA","TOR",2015021104,16884,20152016,0,60.6833333333333,5,6,-1,4.30165274171596,6.42578173283255,-2.12412899111659,38,26,12,53,42,11,63,52,11,4,5,0,0
"665","ANA","OTT",2015021121,16886,20152016,0,62.6333333333333,4,3,1,6.43258046312258,1.90565913696548,4.52692132615709,39,33,6,53,40,13,65,48,17,3,5,0,0
"666","ANA","EDM",2015021137,16888,20152016,0,60,2,1,1,3.74110401963117,4.45208728354191,-0.710983263910748,25,28,-3,33,39,-6,42,61,-19,4,3,0,0
"667","ANA","CGY",2015021151,16890,20152016,1,60,8,3,5,6.27606950202608,6.55952105462086,-0.283451552594784,27,26,1,41,44,-3,54,62,-8,4,4,0,0
"668","ANA","VAN",2015021166,16892,20152016,1,60,2,3,-1,6.30914518896975,4.05198229035796,2.2571628986118,36,28,8,53,39,14,61,52,9,2,3,0,0
"669","ANA","DAL",2015021182,16894,20152016,1,60,3,1,2,6.10198070988727,4.79264739849168,1.30933331139559,25,25,0,45,40,5,53,62,-9,3,5,0,0
"670","ANA","WPG",2015021198,16896,20152016,1,63.1166666666667,1,2,-1,6.71579816934593,4.60351812345033,2.1122800458956,28,26,2,42,39,3,60,47,13,4,3,0,0
"671","ANA","L.A",2015021213,16898,20152016,0,60,1,2,-1,4.15023837164154,3.58985890400822,0.560379467633311,20,31,-11,30,49,-19,44,66,-22,6,6,0,0
"672","ANA","COL",2015021219,16900,20152016,0,60,5,3,2,4.842890217969,2.25026729602459,2.59262292194441,31,32,-1,40,38,2,52,57,-5,2,7,0,0
"673","ANA","NSH",2015030171,16906,20152016,1,60,2,3,-1,5.12030318669463,5.15541181533536,-0.0351086286407281,29,33,-4,46,45,1,66,62,4,4,3,0,0
"674","ANA","NSH",2015030172,16908,20152016,1,60,2,3,-1,3.29471140638918,6.35549554777161,-3.06078414138243,29,27,2,45,37,8,56,49,7,2,6,0,0
"675","ANA","NSH",2015030173,16910,20152016,0,60,3,0,3,3.54151780175744,3.90837075874265,-0.366852956985213,21,27,-6,28,42,-14,39,57,-18,2,5,0,0
"676","ANA","NSH",2015030174,16912,20152016,0,60,4,1,3,4.00438212323934,5.53653247854078,-1.53215035530144,25,31,-6,33,38,-5,45,63,-18,7,7,0,0
"677","ANA","NSH",2015030175,16914,20152016,1,60,5,2,3,5.56129133046488,5.67630203199566,-0.115010701530775,32,29,3,46,49,-3,57,63,-6,7,3,0,0
"678","ANA","NSH",2015030176,16916,20152016,0,60,1,3,-2,7.8713589629042,5.57874715520302,2.29261180770118,27,26,1,41,38,3,62,49,13,2,1,0,0
"679","ANA","NSH",2015030177,16918,20152016,1,60,1,2,-1,4.60527730698232,3.72497765988101,0.88029964710131,37,20,17,53,35,18,77,45,32,5,4,0,0
"680","ANA","DAL",2016020013,17087,20162017,0,60,2,4,-2,5.89775325608798,6.36983854882419,-0.47208529273621,35,20,15,54,36,18,64,49,15,5,4,0,0
"681","ANA","PIT",2016020021,17089,20162017,0,60,2,3,-1,3.95490463105671,4.61189074785216,-0.656986116795451,36,45,-9,47,52,-5,60,62,-2,3,3,0,0
"682","ANA","NYI",2016020030,17090,20162017,0,60.9,2,3,-1,3.81444489769638,4.08005954948021,-0.265614651783835,26,30,-4,32,42,-10,52,55,-3,5,5,0,0
"683","ANA","N.J",2016020037,17092,20162017,0,60,1,2,-1,4.55783759528504,3.65516817284515,0.902669422439885,24,28,-4,33,35,-2,45,45,0,5,7,0,0
"684","ANA","PHI",2016020052,17094,20162017,0,60,3,2,1,5.30187857785495,4.64319329103455,0.658685286820401,26,22,4,30,30,0,46,48,-2,3,8,0,0
"685","ANA","VAN",2016020080,17097,20162017,1,60,4,2,2,5.45707050474675,4.58105431772128,0.876016187025471,37,19,18,56,31,25,77,40,37,2,2,0,0
"686","ANA","S.J",2016020093,17099,20162017,0,61.4,1,2,-1,1.77157717519367,4.44748646535108,-2.67590929015741,20,36,-16,28,43,-15,46,66,-20,3,5,0,0
"687","ANA","NSH",2016020097,17100,20162017,1,60,6,1,5,3.92602685819234,3.78849518782079,0.137531670371555,26,29,-3,44,50,-6,53,66,-13,4,5,0,0
"688","ANA","CBJ",2016020112,17102,20162017,1,60,0,4,-4,4.10168669409867,5.16118272827917,-1.0594960341805,35,37,-2,53,52,1,61,62,-1,5,6,0,0
"689","ANA","L.A",2016020142,17106,20162017,0,60,4,0,4,2.70797012631374,4.46850090531007,-1.76053077899633,21,30,-9,29,42,-13,37,54,-17,6,4,0,0
"690","ANA","PIT",2016020145,17107,20162017,1,60,1,5,-4,4.48962706770919,5.42641036148416,-0.936783293774972,33,34,-1,43,46,-3,57,56,1,4,5,0,0
"691","ANA","ARI",2016020160,17109,20162017,1,60,5,1,4,3.0634919875738,3.13084852152558,-0.0673565339517777,33,22,11,43,31,12,53,40,13,3,2,0,0
"692","ANA","CGY",2016020179,17111,20162017,1,60,4,1,3,2.84985096776644,6.25963014924491,-3.40977918147848,21,26,-5,30,37,-7,39,52,-13,6,5,0,0
"693","ANA","CBJ",2016020193,17114,20162017,0,61.35,2,3,-1,3.34608964294603,2.46297101924439,0.883118623701634,32,18,14,41,25,16,56,40,16,3,3,0,0
"694","ANA","CAR",2016020198,17115,20162017,0,60,4,2,2,4.76681620317686,4.00529493531212,0.761521267864737,27,30,-3,35,39,-4,44,59,-15,3,2,0,0
"695","ANA","NSH",2016020220,17117,20162017,0,60,0,5,-5,3.18043202126864,6.19106550123729,-3.01063347996865,27,27,0,40,39,1,55,44,11,5,4,0,0
"696","ANA","EDM",2016020242,17120,20162017,1,60,4,1,3,4.78100537669354,4.61625026899327,0.164755107700273,27,35,-8,38,53,-15,46,70,-24,4,5,0,0
"697","ANA","N.J",2016020253,17122,20162017,1,60,3,2,1,3.92859784015806,3.82035918813199,0.108238652026074,23,29,-6,35,49,-14,49,66,-17,2,3,0,0
"698","ANA","L.A",2016020275,17125,20162017,1,60,2,3,-1,2.75362688052701,4.48534890045312,-1.73172201992611,30,29,1,42,39,3,60,48,12,7,3,0,0
"699","ANA","NYI",2016020287,17127,20162017,1,65,2,2,0,4.55445481150628,4.33560812508222,0.218846686424058,41,35,6,57,47,10,71,58,13,2,5,0,0
"700","ANA","CHI",2016020304,17130,20162017,1,60,2,3,-1,5.1936767862644,3.5777591674705,1.6159176187939,36,25,11,52,31,21,67,41,26,2,2,0,0
"701","ANA","S.J",2016020321,17131,20162017,0,60,3,2,1,4.78281668975251,4.29333698796108,0.489479701791424,26,23,3,38,35,3,53,61,-8,1,3,0,0
"702","ANA","MTL",2016020340,17134,20162017,1,60,2,1,1,5.83272846776526,8.10809633155441,-2.27536786378914,38,40,-2,52,56,-4,62,74,-12,4,4,0,0
"703","ANA","VAN",2016020356,17136,20162017,0,60,3,1,2,4.01108566725543,4.48103665420786,-0.469950986952426,24,28,-4,32,33,-1,50,52,-2,1,3,0,0
"704","ANA","EDM",2016020370,17138,20162017,0,63.2666666666667,2,3,-1,2.89947227275979,3.41804964636322,-0.518577373603421,33,32,1,40,43,-3,60,60,0,2,2,0,0
"705","ANA","CGY",2016020375,17139,20162017,0,60,3,8,-5,4.83510553302025,3.47925294277229,1.35585259024796,33,25,8,39,33,6,49,44,5,4,3,0,0
"706","ANA","CAR",2016020393,17142,20162017,1,65,5,5,0,6.06006486492697,5.96473338315263,0.0953314817743376,38,34,4,49,53,-4,69,61,8,3,5,0,0
"707","ANA","S.J",2016020410,17144,20162017,1,60,3,2,1,4.47807883929068,2.83864190449822,1.63943693479246,32,24,8,42,42,0,61,63,-2,3,1,0,0
"708","ANA","OTT",2016020421,17146,20162017,1,60,5,1,4,3.30285385402931,2.51461071010999,0.788243143919317,32,22,10,50,34,16,58,49,9,5,5,0,0
"709","ANA","DAL",2016020439,17148,20162017,0,60,2,6,-4,6.70673548520491,4.86127615666373,1.84545932854117,36,27,9,56,45,11,74,56,18,6,5,0,0
"710","ANA","BOS",2016020445,17150,20162017,0,60,4,3,1,5.46800294576678,6.97841706953477,-1.51041412376799,28,34,-6,40,56,-16,53,82,-29,3,4,0,0
"711","ANA","DET",2016020464,17152,20162017,0,60,4,6,-2,4.74846281868219,4.60556535977794,0.142897458904244,25,32,-7,34,50,-16,43,56,-13,2,3,0,0
"712","ANA","TOR",2016020478,17154,20162017,0,60,3,2,1,3.85060487472219,7.03473160295025,-3.18412672822805,28,35,-7,39,44,-5,54,60,-6,5,3,0,0
"713","ANA","MTL",2016020485,17155,20162017,0,60,1,5,-4,2.52167664974695,3.17034961471787,-0.648672964970917,13,34,-21,16,46,-30,19,58,-39,3,6,0,0
"714","ANA","OTT",2016020499,17157,20162017,0,64.05,1,2,-1,2.53482001536759,4.21061508895491,-1.67579507358732,25,18,7,38,25,13,55,37,18,4,3,0,0
"715","ANA","S.J",2016020526,17162,20162017,1,62.7666666666667,2,3,-1,4.58119011976186,4.15843747742474,0.422752642337116,36,25,11,59,34,25,71,48,23,1,4,0,0
"716","ANA","CGY",2016020541,17164,20162017,0,60,3,1,2,5.23395529307891,4.8122010667942,0.421754226284703,25,32,-7,35,39,-4,48,48,0,7,5,0,0
"717","ANA","VAN",2016020546,17165,20162017,0,64.0166666666667,2,3,-1,2.46120237724842,3.66268672497245,-1.20148434772402,26,26,0,31,36,-5,43,47,-4,1,7,0,0
"718","ANA","PHI",2016020561,17167,20162017,1,65,3,3,0,5.21734032427111,6.73814451362705,-1.52080418935594,25,55,-30,40,68,-28,54,85,-31,4,6,0,0
"719","ANA","DET",2016020577,17170,20162017,1,60,2,0,2,4.0086608332583,5.28669772331341,-1.27803689005511,24,23,1,41,37,4,56,47,9,5,4,0,0
"720","ANA","ARI",2016020590,17172,20162017,1,64.4,3,2,1,6.30463153327582,3.55499078414822,2.7496407491276,35,23,12,52,29,23,70,40,30,3,2,0,0
"721","ANA","MIN",2016020608,17174,20162017,1,60,1,2,-1,3.73842473997854,3.90052316981019,-0.162098429831644,24,36,-12,42,47,-5,52,68,-16,4,5,0,0
"722","ANA","DAL",2016020619,17176,20162017,1,60,2,0,2,5.19107350074762,5.70650887674037,-0.515435375992752,38,34,4,58,51,7,71,59,12,4,3,0,0
"723","ANA","COL",2016020630,17178,20162017,0,60,4,1,3,5.24936778992909,4.05187119019683,1.19749659973225,32,34,-2,42,40,2,55,56,-1,1,3,0,0
"724","ANA","ARI",2016020647,17180,20162017,0,60,3,0,3,3.40200123949035,3.74331013100891,-0.341308891518565,23,26,-3,31,53,-22,44,66,-22,2,3,0,0
"725","ANA","STL",2016020655,17181,20162017,1,60.85,1,2,-1,2.85628882768651,4.08785271726083,-1.23156388957432,23,25,-2,36,38,-2,42,53,-11,3,3,0,0
"726","ANA","T.B",2016020671,17183,20162017,1,60.9,2,1,1,2.88658740739981,3.45535122937508,-0.568763821975275,21,28,-7,31,42,-11,49,64,-15,5,3,0,0
"727","ANA","COL",2016020683,17185,20162017,1,60,2,1,1,6.2822840064764,3.75089762583644,2.53138638063996,36,22,14,60,35,25,81,45,36,5,1,0,0
"728","ANA","MIN",2016020699,17187,20162017,0,60,3,5,-2,4.26644905516878,5.36735175378271,-1.10090269861394,29,25,4,39,38,1,46,45,1,2,2,0,0
"729","ANA","WPG",2016020711,17189,20162017,0,60,3,2,1,2.83197147206504,3.88335839168576,-1.05138691962072,27,33,-6,32,43,-11,40,55,-15,4,7,0,0
"730","ANA","EDM",2016020727,17191,20162017,1,60,0,4,-4,5.65151244427112,3.10792044722744,2.54359199704368,26,23,3,43,32,11,54,40,14,2,2,0,0
"731","ANA","COL",2016020753,17197,20162017,1,60,5,1,4,3.71102863752662,4.49696126341587,-0.785932625889245,31,29,2,41,47,-6,50,59,-9,1,4,0,0
"732","ANA","FLA",2016020768,17200,20162017,0,60,1,2,-1,3.93249955949281,4.86842098260759,-0.935921423114779,23,37,-14,30,50,-20,43,58,-15,4,6,0,0
"733","ANA","T.B",2016020776,17201,20162017,0,65,2,2,0,2.41246599180158,7.67079092935747,-5.25832493755589,16,37,-21,27,61,-34,39,82,-43,7,8,0,0
"734","ANA","NYR",2016020791,17204,20162017,0,60,1,4,-3,6.91830223154102,4.84003776675553,2.07826446478549,44,20,24,60,31,29,83,40,43,4,2,0,0
"735","ANA","BUF",2016020803,17206,20162017,0,60,5,2,3,5.23008980672603,5.5633724633808,-0.333282656654774,44,26,18,51,33,18,67,40,27,3,2,0,0
"736","ANA","WSH",2016020824,17208,20162017,0,60,4,6,-2,3.50748754439337,4.3811002788416,-0.87361273444823,22,39,-17,31,49,-18,45,61,-16,4,5,0,0
"737","ANA","MIN",2016020840,17211,20162017,0,60,1,0,1,4.51839543665842,8.06912496421137,-3.55072952755295,23,37,-14,27,58,-31,43,76,-33,0,5,0,0
"738","ANA","FLA",2016020857,17214,20162017,1,60,1,4,-3,4.65756242492353,6.55270427677897,-1.89514185185544,36,31,5,53,45,8,62,57,5,4,4,0,0
"739","ANA","L.A",2016020878,17216,20162017,1,60,1,0,1,3.70838699158776,5.7894618842405,-2.08107489265274,29,24,5,46,36,10,60,53,7,2,2,0,0
"740","ANA","ARI",2016020881,17217,20162017,0,60,2,3,-1,4.07511217899628,2.88186643758672,1.19324574140956,36,20,16,53,33,20,71,41,30,2,3,0,0
"741","ANA","BOS",2016020893,17219,20162017,1,60,5,3,2,5.11152953598173,5.5228887452017,-0.411359209219967,25,29,-4,37,46,-9,47,66,-19,3,5,0,0
"742","ANA","L.A",2016020904,17222,20162017,0,60,1,4,-3,5.32272553775692,7.52983675266124,-2.20711121490432,33,33,0,50,46,4,59,63,-4,5,5,0,0
"743","ANA","TOR",2016020951,17228,20162017,1,60,5,2,3,8.12575241900049,5.15245190676069,2.9733005122398,36,39,-3,48,60,-12,62,78,-16,1,4,0,0
"744","ANA","VAN",2016020967,17230,20162017,1,60,1,2,-1,4.60517715862614,2.0416505245812,2.56352663404494,44,27,17,64,37,27,81,47,34,2,2,0,0
"745","ANA","NSH",2016020981,17232,20162017,1,65,3,3,0,6.72314954659061,4.87203055879218,1.85111898779843,42,27,15,65,42,23,90,50,40,3,5,0,0
"746","ANA","CHI",2016020988,17234,20162017,0,60,1,0,1,2.56712299807987,6.17608102076338,-3.60895802268351,26,43,-17,32,58,-26,56,79,-23,3,3,0,0
"747","ANA","STL",2016020998,17235,20162017,0,60,3,4,-1,4.52937561564613,7.7567808789463,-3.22740526330017,26,35,-9,39,43,-4,52,57,-5,2,3,0,0
"748","ANA","WSH",2016021014,17237,20162017,1,60,5,2,3,5.58881885599112,5.86123787862842,-0.272419022637303,32,27,5,46,51,-5,58,71,-13,6,5,0,0
"749","ANA","STL",2016021036,17240,20162017,1,60,2,1,1,5.13154451271443,4.52917667128949,0.602367841424938,22,27,-5,27,47,-20,44,63,-19,5,3,0,0
"750","ANA","BUF",2016021052,17242,20162017,1,65,1,1,0,8.10894809136516,2.65322474029381,5.45572335107136,40,31,9,62,43,19,76,65,11,0,1,0,0
"751","ANA","S.J",2016021062,17243,20162017,0,60,2,1,1,3.00989549278893,8.23057037306717,-5.22067488027824,27,34,-7,35,53,-18,53,76,-23,4,5,0,0
"752","ANA","EDM",2016021088,17247,20162017,1,60,4,3,1,5.49709022825118,3.33357641466279,2.16351381358839,34,32,2,51,46,5,66,58,8,6,6,0,0
"753","ANA","WPG",2016021104,17249,20162017,1,60,3,1,2,5.5272265493295,2.35255454134312,3.17467200798637,35,18,17,55,30,25,78,39,39,3,3,0,0
"754","ANA","NYR",2016021121,17251,20162017,1,60,6,3,3,5.03219368845243,4.6997235461828,0.332470142269631,34,28,6,43,46,-3,56,62,-6,3,2,0,0
"755","ANA","VAN",2016021135,17253,20162017,0,60,4,1,3,7.40889544069069,5.87181397576754,1.53708146492314,39,35,4,48,44,4,63,50,13,4,2,0,0
"756","ANA","WPG",2016021148,17255,20162017,0,63.5666666666667,3,4,-1,3.32991703590218,8.14677142749946,-4.81685439159727,28,41,-13,35,61,-26,44,74,-30,4,5,0,0
"757","ANA","EDM",2016021164,17257,20162017,0,61.4333333333333,2,3,-1,3.20956139510963,5.2360844539362,-2.02652305882657,18,37,-19,26,47,-21,40,77,-37,2,4,0,0
"758","ANA","CGY",2016021174,17258,20162017,0,60,4,3,1,3.49134803753986,3.41003541916143,0.0813126183784334,34,21,13,43,34,9,51,46,5,3,4,0,0
"759","ANA","CGY",2016021189,17260,20162017,1,60,3,1,2,4.78546000189489,4.50933994250224,0.276120059392653,20,27,-7,47,42,5,54,59,-5,8,8,0,0
"760","ANA","CHI",2016021203,17262,20162017,1,60,4,0,4,3.38666761964964,4.3430979409446,-0.95643032129496,26,37,-11,41,51,-10,52,62,-10,5,3,0,0
"761","ANA","L.A",2016021229,17265,20162017,1,60.8833333333333,4,3,1,5.05842936669509,3.08894855012255,1.96948081657254,24,18,6,45,35,10,60,50,10,5,5,0,0
"762","ANA","CGY",2016030171,17269,20162017,1,60,3,2,1,5.63063866746097,7.2515363726925,-1.62089770523153,41,32,9,53,50,3,70,70,0,7,5,0,0
"763","ANA","CGY",2016030172,17271,20162017,1,60,3,2,1,7.66156815670911,5.1230225131585,2.53854564355061,29,37,-8,48,51,-3,69,63,6,5,5,0,0
"764","ANA","CGY",2016030173,17273,20162017,0,61.5,5,4,1,7.27538240764359,4.92765855565085,2.34772385199274,27,32,-5,45,45,0,56,62,-6,1,6,0,0
"765","ANA","CGY",2016030174,17275,20162017,0,60,3,1,2,6.15749431756558,5.52010487119446,0.637389446371117,25,37,-12,36,50,-14,47,59,-12,2,3,0,0
"766","ANA","EDM",2016030241,17282,20162017,1,60,3,5,-2,7.91582431347342,6.54389237659052,1.3719319368829,36,32,4,57,43,14,72,59,13,6,8,0,0
"767","ANA","EDM",2016030242,17284,20162017,1,60,1,2,-1,6.30625832055659,5.5768712123986,0.729387108157994,40,23,17,67,39,28,85,48,37,4,4,0,0
"768","ANA","EDM",2016030243,17286,20162017,0,60,6,3,3,4.29521783774453,3.68329525074664,0.611922586997892,28,27,1,39,37,2,50,61,-11,5,4,0,0
"769","ANA","EDM",2016030244,17289,20162017,0,60.75,4,3,1,4.0439324158663,4.9096853487008,-0.865752932834503,39,32,7,49,41,8,69,61,8,4,3,0,0
"770","ANA","EDM",2016030245,17291,20162017,1,80,3,3,0,10.7211622959876,9.34084686449158,1.38031543149601,58,38,20,75,59,16,94,70,24,6,4,0,0
"771","ANA","EDM",2016030246,17293,20162017,0,60,1,7,-6,4.12417825812098,4.69231704279082,-0.568138784669834,35,35,0,55,57,-2,66,76,-10,4,8,0,0
"772","ANA","EDM",2016030247,17296,20162017,1,60,2,1,1,3.31851319590351,2.22582717769546,1.09268601820804,30,24,6,45,34,11,65,50,15,1,1,0,0
"773","ANA","NSH",2016030321,17298,20162017,1,69.4,2,3,-1,6.83642260847008,6.49366051506857,0.342762093401511,29,46,-17,47,58,-11,61,77,-16,4,5,0,0
"774","ANA","NSH",2016030322,17300,20162017,1,60,5,3,2,7.86047394030174,3.83212680165889,4.02834713864286,27,33,-6,38,49,-11,50,59,-9,2,3,0,0
"775","ANA","NSH",2016030323,17302,20162017,0,60,1,2,-1,0,0,0,20,40,-20,31,53,-22,38,75,-37,2,4,0,0
"776","ANA","NSH",2016030324,17304,20162017,0,70.4166666666667,3,2,1,7.27126919227885,7.86260119569488,-0.591332003416028,37,34,3,43,54,-11,62,74,-12,2,5,0,0
"777","ANA","NSH",2016030325,17306,20162017,1,60,1,3,-2,6.83837141378899,7.0372133447868,-0.198841930997809,33,29,4,51,48,3,66,66,0,7,6,0,0
"778","ANA","NSH",2016030326,17308,20162017,0,60,3,6,-3,3.8711289208386,4.98730422125664,-1.11617530041804,41,18,23,51,26,25,73,35,38,4,2,0,0
"779","ANA","ARI",2017020011,17444,20172018,1,60,5,4,1,9.07709806528874,4.31102361768113,4.7660744476076,41,30,11,57,43,14,68,61,7,3,4,0,0
"780","ANA","PHI",2017020029,17446,20172018,1,60.7333333333333,2,3,-1,3.61995590757635,3.35122015124025,0.268735756336105,23,37,-14,37,43,-6,49,58,-9,3,6,0,0
"781","ANA","CGY",2017020038,17448,20172018,1,60,0,2,-2,6.16790207877055,5.83697999505966,0.330922083710885,43,29,14,62,47,15,78,64,14,5,4,0,0
"782","ANA","NYI",2017020049,17450,20172018,1,60,3,2,1,4.83484777531885,3.24987807660364,1.58496969871521,30,41,-11,47,53,-6,59,75,-16,4,5,0,0
"783","ANA","COL",2017020060,17452,20172018,0,60,1,3,-2,2.71053161011867,5.75287237949669,-3.04234076937802,18,39,-21,29,57,-28,39,83,-44,2,8,0,0
"784","ANA","BUF",2017020078,17454,20172018,1,60,1,3,-2,6.80355623536668,3.45755168330719,3.34600455205949,26,31,-5,42,41,1,57,56,1,4,3,0,0
"785","ANA","MTL",2017020109,17459,20172018,1,60,6,2,4,7.37175874113644,6.89516234452799,0.476596396608452,45,51,-6,54,68,-14,63,80,-17,6,8,0,0
"786","ANA","PHI",2017020127,17463,20172018,0,60,6,2,4,2.6338721079519,3.21726626620898,-0.583394158257079,25,33,-8,32,46,-14,51,57,-6,6,8,0,0
"787","ANA","FLA",2017020145,17465,20172018,0,60,3,8,-5,3.63169843071019,3.25924119655974,0.372457234150446,34,22,12,47,30,17,58,33,25,3,3,0,0
"788","ANA","T.B",2017020159,17467,20172018,0,60,4,1,3,3.27612755304278,5.86304940213449,-2.58692184909171,21,32,-11,27,47,-20,43,62,-19,2,4,0,0
"789","ANA","CAR",2017020167,17468,20172018,0,65,3,3,0,3.75886036861472,7.47489720255544,-3.71603683394072,25,37,-12,38,61,-23,47,82,-35,0,3,0,0
"790","ANA","TOR",2017020184,17471,20172018,1,60,1,3,-2,4.50904288571981,4.93984201943385,-0.430799133714048,29,29,0,42,39,3,56,54,2,4,2,0,0
"791","ANA","NSH",2017020199,17473,20172018,1,60,3,5,-2,0,0,0,38,30,8,53,50,3,74,63,11,4,4,0,0
"792","ANA","S.J",2017020212,17474,20172018,0,65,1,1,0,4.00210554629808,5.24599606270203,-1.24389051640395,26,45,-19,37,60,-23,56,77,-21,1,3,0,0
"793","ANA","L.A",2017020231,17477,20172018,1,63.85,3,4,-1,5.1551356309473,4.70704214950779,0.448093481439507,36,43,-7,52,56,-4,65,68,-3,4,8,0,0
"794","ANA","VAN",2017020240,17479,20172018,1,60,4,1,3,6.15817283639376,1.74189020693973,4.41628262945403,35,20,15,57,28,29,72,40,32,6,5,0,0
"795","ANA","T.B",2017020263,17482,20172018,1,60,1,2,-1,5.59155368874781,5.29447088806774,0.297082800680073,29,37,-8,43,57,-14,65,76,-11,1,2,0,0
"796","ANA","BOS",2017020277,17485,20172018,1,60,4,2,2,4.83536451851251,5.61548165942077,-0.78011714090826,27,42,-15,38,59,-21,49,71,-22,0,2,0,0
"797","ANA","FLA",2017020309,17489,20172018,1,60,3,2,1,0,0,0,28,52,-24,40,70,-30,52,88,-36,5,7,0,0
"798","ANA","S.J",2017020315,17490,20172018,0,65,2,2,0,4.08277118721287,9.9235711825313,-5.84079999531843,30,42,-12,37,61,-24,44,80,-36,2,3,0,0
"799","ANA","VGK",2017020332,17492,20172018,1,60,2,4,-2,2.9161974280978,6.11641109480115,-3.20021366670335,19,49,-30,30,61,-31,39,76,-37,4,3,0,0
"800","ANA","WPG",2017020337,17494,20172018,1,60,1,4,-3,5.96877193453111,7.45808653265703,-1.48931459812593,31,36,-5,51,49,2,70,61,9,3,4,0,0
"801","ANA","L.A",2017020358,17495,20172018,0,65,1,1,0,4.34053007930283,3.73893372182647,0.601596357476359,26,34,-8,41,53,-12,46,72,-26,2,4,0,0
"802","ANA","CHI",2017020366,17497,20172018,0,60,3,7,-4,4.13314875052311,6.45009455565742,-2.31694580513431,29,35,-6,38,48,-10,51,68,-17,4,5,0,0
"803","ANA","STL",2017020379,17499,20172018,0,60,3,2,1,4.1887215432841,2.26134487706067,1.92737666622344,30,39,-9,34,50,-16,46,71,-25,5,4,0,0
"804","ANA","CBJ",2017020391,17501,20172018,0,60,2,4,-2,2.75147285890969,4.36940742757177,-1.61793456866208,27,31,-4,33,44,-11,46,53,-7,4,9,0,0
"805","ANA","NSH",2017020404,17502,20172018,0,65,2,2,0,4.34034874043886,5.16902928368654,-0.828680543247685,35,35,0,43,44,-1,50,56,-6,4,6,0,0
"806","ANA","VGK",2017020424,17505,20172018,0,65,3,3,0,2.44620615440862,4.96365007042186,-2.51744391601324,29,43,-14,36,57,-21,53,75,-22,2,4,0,0
"807","ANA","OTT",2017020429,17506,20172018,1,60,3,0,3,3.10433148597986,6.88282524392707,-3.77849375794722,22,29,-7,28,44,-16,39,55,-16,2,3,0,0
"808","ANA","MIN",2017020443,17508,20172018,1,63.7166666666667,2,3,-1,3.64870537376555,5.55471119425783,-1.90600582049228,28,31,-3,44,49,-5,62,61,1,4,3,0,0
"809","ANA","CAR",2017020465,17511,20172018,1,60,3,2,1,3.70476572180633,3.41109679787769,0.293668923928635,23,30,-7,39,48,-9,52,67,-15,2,3,0,0
"810","ANA","STL",2017020483,17514,20172018,0,60,3,1,2,2.60335179065213,3.87700792377291,-1.27365613312078,18,30,-12,29,38,-9,45,57,-12,1,4,0,0
"811","ANA","WSH",2017020502,17516,20172018,0,61.9666666666667,2,3,-1,4.2391541058314,5.78570140151714,-1.54654729568574,30,27,3,45,45,0,61,68,-7,1,0,0,0
"812","ANA","N.J",2017020512,17518,20172018,0,60,3,5,-2,2.26846962704846,6.59735318234876,-4.3288835553003,24,34,-10,35,46,-11,50,51,-1,2,2,0,0
"813","ANA","NYR",2017020519,17519,20172018,0,60,1,4,-3,4.53154313145933,4.2226068144555,0.308936317003827,40,32,8,48,43,5,64,49,15,2,2,0,0
"814","ANA","NYI",2017020531,17521,20172018,0,64.05,5,4,1,7.41037568348838,4.94239998588455,2.46797569760383,40,26,14,54,36,18,71,53,18,3,4,0,0
"815","ANA","PIT",2017020549,17523,20172018,0,60,4,0,4,3.34826862756745,3.70902999356063,-0.360761365993181,23,29,-6,32,43,-11,42,56,-14,3,3,0,0
"816","ANA","VGK",2017020568,17527,20172018,1,60,1,4,-3,3.69769398551625,5.89813366252929,-2.20043967701304,28,28,0,46,43,3,64,56,8,2,2,0,0
"817","ANA","CGY",2017020586,17529,20172018,1,60,2,1,1,6.09031208360102,3.89132727725441,2.19898480634661,41,23,18,57,37,20,64,58,6,7,4,0,0
"818","ANA","ARI",2017020598,17531,20172018,1,60,5,2,3,6.5457771901747,3.00243721477455,3.54333997540016,26,25,1,43,38,5,52,60,-8,1,4,0,0
"819","ANA","VAN",2017020612,17533,20172018,0,60,5,0,5,3.27147474844242,4.30665084676809,-1.03517609832568,27,31,-4,33,47,-14,43,61,-18,2,4,0,0
"820","ANA","EDM",2017020626,17535,20172018,0,65,1,1,0,4.18283824123941,5.78716018411797,-1.60432194287856,34,34,0,38,51,-13,55,68,-13,2,5,0,0
"821","ANA","CGY",2017020640,17537,20172018,0,60,2,3,-1,2.44485978033663,5.23611640599484,-2.79125662565821,29,31,-2,36,47,-11,43,65,-22,6,6,0,0
"822","ANA","L.A",2017020677,17544,20172018,0,60,4,2,2,8.34673245582962,7.4422433794747,0.90448907635492,22,25,-3,38,37,1,50,56,-6,2,2,0,0
"823","ANA","COL",2017020684,17546,20172018,0,60,1,3,-2,3.93365126837132,3.01548781522433,0.918163453146983,34,29,5,45,38,7,55,54,1,2,6,0,0
"824","ANA","PIT",2017020694,17548,20172018,1,60,5,3,2,6.0240075968199,4.75454442942282,1.26946316739708,33,33,0,44,46,-2,53,63,-10,5,7,0,0
"825","ANA","L.A",2017020707,17550,20172018,1,60,2,1,1,6.13535338320288,5.89663028577343,0.238723097429452,31,24,7,51,41,10,63,65,-2,2,1,0,0
"826","ANA","S.J",2017020724,17552,20172018,1,60,2,6,-4,6.28983418188961,5.61064826487564,0.679185917013978,35,26,9,55,38,17,73,53,20,3,5,0,0
"827","ANA","NYR",2017020742,17554,20172018,1,60,6,3,3,6.37711475940887,7.30841764171811,-0.931302882309238,31,44,-13,47,52,-5,56,56,0,6,3,0,0
"828","ANA","WPG",2017020759,17556,20172018,1,65,3,3,0,5.70237328259827,4.52234338126559,1.18002990133269,39,27,12,59,46,13,76,55,21,4,2,0,0
"829","ANA","BOS",2017020761,17561,20172018,0,60,3,1,2,3.16385919291928,3.2160736402584,-0.052214447339118,27,31,-4,34,42,-8,43,58,-15,3,5,0,0
"830","ANA","OTT",2017020781,17563,20172018,0,60.5333333333333,1,2,-1,0,0,0,31,32,-1,49,39,10,68,47,21,3,5,0,0
"831","ANA","MTL",2017020792,17565,20172018,0,60,2,5,-3,0,0,0,45,29,16,63,38,25,90,54,36,4,7,0,0
"832","ANA","TOR",2017020808,17567,20172018,0,60,4,7,-3,6.37361660513852,6.9767719448763,-0.603155339737782,44,40,4,61,52,9,84,64,20,3,3,0,0
"833","ANA","BUF",2017020812,17568,20172018,0,61.6,4,3,1,5.80064705490913,2.48988111050545,3.31076594440368,34,33,1,48,41,7,62,55,7,4,3,0,0
"834","ANA","EDM",2017020842,17571,20172018,1,60,3,2,1,3.17725681068424,5.51440250879023,-2.33714569810598,34,32,2,48,49,-1,57,63,-6,2,3,0,0
"835","ANA","S.J",2017020860,17573,20172018,1,65,2,2,0,3.50699675797659,11.134201066161,-7.62720430818445,27,39,-12,41,56,-15,59,65,-6,2,1,0,0
"836","ANA","DET",2017020870,17575,20172018,0,60,1,2,-1,5.61687539855484,3.56412225995825,2.05275313859659,33,16,17,46,28,18,66,42,24,4,2,0,0
"837","ANA","CHI",2017020886,17577,20172018,0,60,3,2,1,4.43761923270358,4.03311245824443,0.404506774459151,32,44,-12,36,53,-17,43,82,-39,3,6,0,0
"838","ANA","MIN",2017020896,17579,20172018,0,65,2,2,0,6.68997970050953,3.66592516576929,3.02405453474023,31,38,-7,43,52,-9,65,66,-1,3,3,0,0
"839","ANA","VGK",2017020917,17581,20172018,0,60,2,0,2,2.23831579416805,5.55025305750314,-3.3119372633351,20,33,-13,33,48,-15,41,73,-32,1,3,0,0
"840","ANA","DAL",2017020928,17583,20172018,1,60,2,0,2,4.1624930288354,9.26687198445597,-5.10437895562058,17,41,-24,27,60,-33,39,73,-34,3,5,0,0
"841","ANA","ARI",2017020956,17586,20172018,0,60,0,2,-2,5.68105702560842,4.79448328620467,0.886573739403756,26,38,-12,39,52,-13,56,66,-10,2,4,0,0
"842","ANA","EDM",2017020962,17587,20172018,1,65,5,5,0,5.58556243825624,7.08927718004225,-1.50371474178601,46,42,4,54,55,-1,62,67,-5,3,2,0,0
"843","ANA","CBJ",2017020999,17592,20172018,1,60,4,2,2,3.95091921499443,2.76022005259531,1.19069916239912,35,36,-1,51,54,-3,62,63,-1,4,6,0,0
"844","ANA","CHI",2017021010,17594,20172018,1,60,6,3,3,7.37484071494691,8.37197312620265,-0.997132411255734,31,40,-9,47,64,-17,57,81,-24,2,2,0,0
"845","ANA","WSH",2017021028,17596,20172018,1,60,4,0,4,5.81517459530005,5.783259860822,0.0319147344780504,18,36,-18,37,56,-19,50,79,-29,2,4,0,0
"846","ANA","NSH",2017021039,17598,20172018,0,60,2,4,-2,3.60026292238018,8.99996482848655,-5.39970190610637,33,28,5,43,42,1,61,49,12,2,1,0,0
"847","ANA","DAL",2017021046,17599,20172018,0,60,1,2,-1,2.85273946486996,3.60800133745382,-0.755261872583865,27,37,-10,34,47,-13,55,70,-15,3,2,0,0
"848","ANA","STL",2017021068,17602,20172018,1,60,2,4,-2,4.9701755185888,3.78803956123893,1.18213595734987,22,23,-1,34,34,0,54,45,9,1,1,0,0
"849","ANA","VAN",2017021082,17604,20172018,1,60,3,0,3,6.81677996035341,6.04236066605036,0.774419294303052,37,32,5,48,43,5,58,54,4,5,2,0,0
"850","ANA","DET",2017021096,17606,20172018,1,60,4,2,2,2.73500492605831,3.27166929020314,-0.536664364144826,36,30,6,49,49,0,60,62,-2,2,5,0,0
"851","ANA","N.J",2017021115,17608,20172018,1,60,4,2,2,6.56280494141902,2.79268907897495,3.77011586244407,36,17,19,53,26,27,67,39,28,3,5,0,0
"852","ANA","CGY",2017021135,17611,20172018,0,60,4,0,4,2.8545879428857,6.19839725984548,-3.34380931695978,16,29,-13,26,48,-22,37,61,-24,3,4,0,0
"853","ANA","WPG",2017021149,17613,20172018,0,63.2666666666667,2,3,-1,3.33616994111799,6.11226524271478,-2.7760953015968,18,42,-24,29,59,-30,35,83,-48,2,2,0,0
"854","ANA","EDM",2017021167,17615,20172018,0,61.35,5,4,1,5.88123638355728,3.36783517133699,2.51340121222029,38,32,6,52,47,5,71,55,16,2,4,0,0
"855","ANA","VAN",2017021185,17617,20172018,0,60,1,4,-3,0.973218411005064,4.63037956065091,-3.65716114964584,24,30,-6,29,44,-15,46,52,-6,2,1,0,0
"856","ANA","L.A",2017021204,17620,20172018,1,64.6833333333333,2,1,1,4.43217523803469,4.77922753986786,-0.347052301833173,33,29,4,53,39,14,71,51,20,1,0,0,0
"857","ANA","COL",2017021222,17622,20172018,1,61.5666666666667,4,3,1,5.38048940523371,4.16751844843384,1.21297095679988,42,32,10,58,42,16,79,57,22,4,6,0,0
"858","ANA","MIN",2017021240,17625,20172018,1,60,3,1,2,8.01386117865331,2.3167486647726,5.69711251388071,30,27,3,49,33,16,63,47,16,3,3,0,0
"859","ANA","DAL",2017021256,17627,20172018,1,60,5,3,2,5.20904720155522,3.17505499494638,2.03399220660884,33,26,7,44,38,6,57,51,6,4,1,0,0
"860","ANA","ARI",2017021267,17628,20172018,0,60,3,0,3,5.19575137935743,3.62591435922241,1.56983702013503,27,31,-4,41,48,-7,51,65,-14,3,5,0,0
"861","ANA","S.J",2017030181,17633,20172018,1,60,0,3,-3,5.02373527900091,7.88006364073681,-2.8563283617359,25,34,-9,45,57,-12,65,70,-5,4,7,0,0
"862","ANA","S.J",2017030182,17635,20172018,1,60,2,3,-1,6.46476118613411,6.49441191972255,-0.0296507335884435,30,35,-5,45,53,-8,61,68,-7,3,4,0,0
"863","ANA","S.J",2017030183,17637,20172018,0,60,1,8,-7,6.47991975256735,6.5577391431143,-0.0778193905469564,46,36,10,57,50,7,75,66,9,4,9,0,0
"864","ANA","S.J",2017030184,17639,20172018,0,60,1,2,-1,3.25019096920082,2.76728203145699,0.482908937743828,31,24,7,42,35,7,61,54,7,4,3,0,0
"865","ANA","S.J",2018020004,17807,20182019,0,60,5,2,3,3.33973804855486,5.78302199899917,-2.44328395044431,15,33,-18,21,55,-34,34,71,-37,3,3,0,0
"866","ANA","ARI",2018020027,17810,20182019,0,60,1,0,1,3.5830016860009,6.72933613384787,-3.14633444784697,20,41,-21,31,58,-27,36,79,-43,2,4,0,0
"867","ANA","DET",2018020035,17812,20182019,1,65,2,2,0,5.73738946665484,4.53555473725817,1.20183472939667,27,21,6,47,44,3,59,58,1,3,2,0,0
"868","ANA","ARI",2018020044,17814,20182019,1,65,2,2,0,2.54626932135375,4.51748146634054,-1.97121214498679,25,39,-14,35,56,-21,48,75,-27,3,3,0,0
"869","ANA","DAL",2018020067,17817,20182019,0,60,3,5,-2,4.39860393399031,9.00487838382833,-4.60627444983802,25,51,-26,30,60,-30,45,84,-39,2,3,0,0
"870","ANA","STL",2018020072,17818,20182019,0,60,3,2,1,2.93435214736655,3.20149871567264,-0.267146568306089,31,31,0,39,45,-6,51,63,-12,2,3,0,0
"871","ANA","NYI",2018020089,17821,20182019,1,60,4,1,3,4.94460262044288,4.86140273917408,0.0831998812687971,25,35,-10,37,57,-20,48,69,-21,4,5,0,0
"872","ANA","VGK",2018020113,17824,20182019,0,60,1,3,-2,3.28807528780507,6.51842180769017,-3.2303465198851,18,45,-27,28,53,-25,49,75,-26,2,5,0,0
"873","ANA","BUF",2018020117,17825,20182019,1,60,2,4,-2,3.81036177220847,6.8371633839585,-3.02680161175003,28,45,-17,36,60,-24,43,71,-28,2,4,0,0
"874","ANA","CHI",2018020127,17827,20182019,0,60,1,3,-2,4.12180532311322,6.18968335188674,-2.06787802877352,25,38,-13,32,51,-19,52,68,-16,5,5,0,0
"875","ANA","DAL",2018020140,17829,20182019,0,60,2,5,-3,3.48071834315314,2.92099032807164,0.559728015081504,25,41,-16,35,47,-12,52,67,-15,6,6,0,0
"876","ANA","S.J",2018020164,17832,20182019,1,62.2,3,4,-1,3.86750003485404,5.66445991471612,-1.79695987986208,30,49,-19,41,67,-26,51,83,-32,2,3,0,0
"877","ANA","PHI",2018020176,17834,20182019,1,60,2,3,-1,2.8714183802878,4.42774148590979,-1.55632310562199,25,36,-11,42,46,-4,67,62,5,3,4,0,0
"878","ANA","NYR",2018020189,17836,20182019,1,65,2,2,0,3.87079465188628,4.85010488196531,-0.979310230079027,30,24,6,40,39,1,53,55,-2,3,3,0,0
"879","ANA","CBJ",2018020209,17839,20182019,1,60.6,3,2,1,2.74528634597285,4.86286734979866,-2.11758100382582,30,26,4,44,43,1,58,53,5,5,6,0,0
"880","ANA","L.A",2018020222,17841,20182019,0,60,1,4,-3,3.34744321578182,5.78017620521132,-2.4327329894295,31,27,4,43,40,3,66,49,17,4,1,0,0
"881","ANA","CGY",2018020226,17842,20182019,1,60,3,2,1,0,0,0,24,39,-15,40,57,-17,45,68,-23,3,3,0,0
"882","ANA","MIN",2018020241,17844,20182019,1,60,1,5,-4,4.90036368254437,3.95075194470701,0.949611737837358,21,43,-22,33,52,-19,44,67,-23,2,3,0,0
"883","ANA","NSH",2018020263,17847,20182019,1,65,1,1,0,3.45965653070084,5.38071186514155,-1.92105533444071,30,35,-5,46,45,1,56,63,-7,2,7,0,0
"884","ANA","VGK",2018020276,17849,20182019,0,60,0,5,-5,3.85484132590139,3.37402182676669,0.480819499134697,29,26,3,44,38,6,77,55,22,4,6,0,0
"885","ANA","TOR",2018020291,17851,20182019,1,63.2833333333333,1,2,-1,5.34133598546237,5.42602401453769,-0.0846880290753154,39,35,4,51,53,-2,69,72,-3,1,2,0,0
"886","ANA","COL",2018020307,17853,20182019,1,64.9666666666667,3,4,-1,4.47840606426689,4.51730438580853,-0.0388983215416374,33,42,-9,44,54,-10,55,78,-23,3,2,0,0
"887","ANA","VAN",2018020330,17856,20182019,1,60,4,3,1,3.28688412743622,4.76763653209252,-1.4807524046563,37,28,9,51,48,3,63,60,3,4,2,0,0
"888","ANA","EDM",2018020337,17858,20182019,1,60.2333333333333,2,1,1,4.30931125365896,3.67010439097066,0.639206862688297,25,28,-3,36,34,2,46,53,-7,2,2,0,0
"889","ANA","NSH",2018020360,17860,20182019,0,60,2,5,-3,2.57408133830722,7.09863264416401,-4.52455130585679,19,33,-14,24,48,-24,34,51,-17,8,8,0,0
"890","ANA","T.B",2018020370,17862,20182019,0,60,3,1,2,2.145896552267,1.95621142833625,0.189685123930758,22,35,-13,34,49,-15,42,62,-20,3,4,0,0
"891","ANA","FLA",2018020378,17863,20182019,0,60,3,2,1,3.27035933846491,7.21270818364428,-3.94234884517937,25,44,-19,36,50,-14,42,60,-18,2,3,0,0
"892","ANA","CAR",2018020392,17865,20182019,0,61.25,2,1,1,2.46491011240741,4.37101507525949,-1.90610496285208,29,34,-5,42,47,-5,46,64,-18,3,6,0,0
"893","ANA","WSH",2018020407,17867,20182019,0,60,6,5,1,3.66930108178713,6.55437352441368,-2.88507244262655,25,32,-7,37,41,-4,49,55,-6,3,5,0,0
"894","ANA","CHI",2018020427,17870,20182019,1,60,4,2,2,7.47565978931615,3.82154477105034,3.65411501826581,32,27,5,47,41,6,62,57,5,1,3,0,0
"895","ANA","CAR",2018020443,17872,20182019,1,60,1,4,-3,3.26167694522451,4.72009867689943,-1.45842173167492,19,36,-17,33,55,-22,45,67,-22,7,6,0,0
"896","ANA","N.J",2018020458,17874,20182019,1,65,5,5,0,7.82906370552519,3.71440460802832,4.11465909749687,38,35,3,52,50,2,67,63,4,1,3,0,0
"897","ANA","DAL",2018020478,17877,20182019,1,60,6,3,3,5.65878647757927,3.7177682663314,1.94101821124787,36,29,7,56,41,15,70,52,18,1,3,0,0
"898","ANA","CBJ",2018020501,17880,20182019,0,61.3166666666667,2,1,1,3.52859085996897,6.14366417957353,-2.61507331960456,22,37,-15,29,57,-28,42,69,-27,2,4,0,0
"899","ANA","PIT",2018020512,17882,20182019,0,60,4,2,2,4.94516863692243,5.16961290658219,-0.224444269659753,36,30,6,46,40,6,59,57,2,2,4,0,0
"900","ANA","NYR",2018020519,17883,20182019,0,60,1,3,-2,2.50330065766189,3.60871031496916,-1.10540965730727,15,24,-9,30,35,-5,44,48,-4,7,5,0,0
"901","ANA","BOS",2018020530,17885,20182019,0,60,1,3,-2,3.43126598396339,4.21251663397031,-0.781250650006927,25,31,-6,35,48,-13,45,58,-13,4,4,0,0
"902","ANA","BUF",2018020551,17887,20182019,0,60,0,3,-3,5.24799924105749,3.02062267637666,2.22737656468082,40,33,7,50,38,12,65,49,16,3,4,0,0
"903","ANA","S.J",2018020579,17892,20182019,0,60,2,4,-2,3.24285702388881,7.53998587793514,-4.29712885404633,27,39,-12,41,51,-10,64,62,2,5,4,0,0
"904","ANA","ARI",2018020597,17894,20182019,1,60.55,4,5,-1,5.99235885765947,7.45971265820827,-1.4673538005488,41,30,11,57,43,14,66,54,12,5,3,0,0
"905","ANA","T.B",2018020611,17896,20182019,1,60.5833333333333,1,2,-1,6.27834625512041,4.97952365890956,1.29882259621085,36,35,1,50,43,7,60,55,5,2,4,0,0
"906","ANA","VGK",2018020635,17900,20182019,1,60,2,3,-1,4.01754941174295,5.46021540724338,-1.44266599550044,27,42,-15,37,64,-27,50,77,-27,3,2,0,0
"907","ANA","EDM",2018020651,17902,20182019,1,60,0,4,-4,6.43728501256555,3.74331527757749,2.69396973498806,39,24,15,60,32,28,84,42,42,6,4,0,0
"908","ANA","OTT",2018020670,17905,20182019,1,61.5666666666667,1,2,-1,4.45729095411662,3.94852733916923,0.508763614947384,33,30,3,54,48,6,72,57,15,3,0,0,0
"909","ANA","PIT",2018020686,17907,20182019,1,60,4,7,-3,5.20748473587446,6.55231849700548,-1.34483376113102,25,36,-11,36,56,-20,48,72,-24,2,3,0,0
"910","ANA","WPG",2018020701,17909,20182019,0,64.8166666666667,3,4,-1,5.56340054253997,2.90528786162412,2.65811268091585,31,34,-3,44,45,-1,57,56,1,3,4,0,0
"911","ANA","DET",2018020715,17911,20182019,0,60,1,3,-2,1.67094489890223,3.60373329254799,-1.93278839364575,24,25,-1,32,39,-7,40,52,-12,2,0,0,0
"912","ANA","MIN",2018020731,17913,20182019,0,60,3,0,3,2.75855534616858,4.33559152466478,-1.5770361784962,23,37,-14,34,50,-16,45,67,-22,4,4,0,0
"913","ANA","N.J",2018020740,17915,20182019,0,60,3,2,1,2.21473797831716,3.46817985998618,-1.25344188166902,14,31,-17,21,43,-22,30,54,-24,2,4,0,0
"914","ANA","NYI",2018020752,17916,20182019,0,60,0,3,-3,1.54867090251355,3.28890426389989,-1.74023336138634,19,28,-9,27,39,-12,39,50,-11,1,3,0,0
"915","ANA","STL",2018020769,17919,20182019,1,60,1,5,-4,2.8631992493174,4.65482253041682,-1.79162328109942,13,32,-19,30,56,-26,46,68,-22,1,0,0,0
"916","ANA","WPG",2018020797,17929,20182019,0,60,3,9,-6,7.08533610144514,5.14526409241989,1.94007200902524,29,31,-2,43,45,-2,57,54,3,1,4,0,0
"917","ANA","TOR",2018020805,17931,20182019,0,60,1,6,-5,3.71667464706115,4.79394322137523,-1.07726857431408,25,44,-19,33,61,-28,44,81,-37,1,3,0,0
"918","ANA","MTL",2018020815,17932,20182019,0,60,1,4,-3,2.20939037998832,3.81935157408589,-1.60996119409756,25,32,-7,29,46,-17,48,65,-17,1,3,0,0
"919","ANA","OTT",2018020829,17934,20182019,0,60,0,4,-4,7.32352514611557,6.41061911486577,0.912906031249804,45,35,10,60,45,15,86,59,27,3,1,0,0
"920","ANA","PHI",2018020842,17936,20182019,0,60,2,6,-4,3.91947446321137,5.69724808373576,-1.77777362052439,32,40,-8,43,53,-10,62,68,-6,5,6,0,0
"921","ANA","VAN",2018020876,17940,20182019,1,60,1,0,1,1.55384993824931,5.48328406535813,-3.92943412710882,22,35,-13,31,50,-19,43,73,-30,4,5,0,0
"922","ANA","BOS",2018020891,17942,20182019,1,60,0,3,-3,3.80485299455904,4.05840309877021,-0.253550104211172,30,29,1,45,41,4,58,57,1,3,4,0,0
"923","ANA","WSH",2018020909,17944,20182019,1,60,5,2,3,7.35473679951974,3.89396699670383,3.46076980281592,39,25,14,61,35,26,78,55,23,4,3,0,0
"924","ANA","MIN",2018020922,17946,20182019,0,60,4,0,4,5.56478078121472,5.19681403351024,0.367966747704486,24,31,-7,32,50,-18,48,69,-21,4,3,0,0
"925","ANA","CGY",2018020943,17949,20182019,0,60,1,2,-1,4.52230211217829,4.31646815946943,0.205833952708865,26,28,-2,38,50,-12,52,67,-15,2,1,0,0
"926","ANA","EDM",2018020954,17950,20182019,0,60,1,2,-1,4.48128553738934,1.99961594387423,2.48166959351511,34,21,13,50,26,24,67,38,29,1,1,0,0
"927","ANA","VAN",2018020967,17952,20182019,0,60,0,4,-4,5.33966260755551,5.4175357419299,-0.0778731343743857,29,29,0,42,51,-9,56,69,-13,2,2,0,0
"928","ANA","CHI",2018020983,17954,20182019,1,60,3,4,-1,2.99500139628924,4.33242269753828,-1.33742130124903,32,35,-3,46,42,4,59,59,0,1,2,0,0
"929","ANA","VGK",2018020997,17956,20182019,1,60,0,3,-3,6.0064794352802,5.78974935050792,0.21673008477228,34,34,0,47,48,-1,60,56,4,2,2,0,0
"930","ANA","COL",2018021012,17958,20182019,1,60,2,1,1,4.62979084750987,3.46029791771434,1.16949292979552,23,26,-3,44,39,5,64,54,10,3,6,0,0
"931","ANA","ARI",2018021027,17960,20182019,0,60,3,1,2,4.121782759903,2.5611158022584,1.5606669576446,31,23,8,38,31,7,56,45,11,5,5,0,0
"932","ANA","STL",2018021031,17961,20182019,1,60,4,5,-1,4.56815818172288,4.67429139227286,-0.106133210549981,27,33,-6,41,49,-8,58,60,-2,4,5,0,0
"933","ANA","MTL",2018021047,17963,20182019,1,60,8,2,6,6.13225885114018,3.05131424343563,3.08094460770455,29,37,-8,43,53,-10,53,69,-16,3,6,0,0
"934","ANA","L.A",2018021064,17965,20182019,1,60,2,3,-1,1.79619883414125,3.63076572376303,-1.83456688962178,20,25,-5,35,38,-3,46,55,-9,2,4,0,0
"935","ANA","NSH",2018021079,17967,20182019,1,60,3,2,1,4.92435498091808,8.0483025585516,-3.12394757763352,18,34,-16,33,53,-20,45,71,-26,4,7,0,0
"936","ANA","ARI",2018021090,17969,20182019,0,60,1,6,-5,3.83650600237888,3.44105910498183,0.395446897397051,37,24,13,53,35,18,69,51,18,5,6,0,0
"937","ANA","COL",2018021096,17970,20182019,0,60,5,3,2,6.80824298944208,5.44875695380324,1.35948603563884,37,44,-7,45,50,-5,57,65,-8,3,4,0,0
"938","ANA","FLA",2018021116,17972,20182019,1,60,3,2,1,3.45090732036624,5.75089736689552,-2.29999004652927,22,39,-17,34,61,-27,44,71,-27,3,2,0,0
"939","ANA","WPG",2018021135,17975,20182019,1,60,0,3,-3,4.24769375417378,4.07224571937695,0.17544803479683,29,23,6,43,33,10,59,47,12,6,6,0,0
"940","ANA","S.J",2018021149,17977,20182019,1,60.6333333333333,4,3,1,2.96566824982287,2.54995232302596,0.415715926796912,21,26,-5,39,43,-4,47,65,-18,3,5,0,0
"941","ANA","L.A",2018021163,17978,20182019,0,65,3,3,0,3.30775199589425,5.05335501288937,-1.74560301699512,20,30,-10,35,45,-10,48,55,-7,4,5,0,0
"942","ANA","VAN",2018021183,17981,20182019,0,60,5,4,1,1.6871180182352,6.44405807165276,-4.75694005341757,24,32,-8,31,43,-12,42,55,-13,3,1,0,0
"943","ANA","CGY",2018021201,17984,20182019,0,60,1,6,-5,3.71806872684829,5.40246919487254,-1.68440046802425,22,37,-15,30,48,-18,42,66,-24,1,3,0,0
"944","ANA","EDM",2018021212,17985,20182019,0,60,5,1,4,2.75494865930523,3.83213288085312,-1.0771842215479,38,31,7,44,40,4,55,56,-1,2,2,0,0
"945","ANA","CGY",2018021241,17989,20182019,1,60,3,1,2,4.03339105590843,3.16660082977251,0.866790226135922,32,26,6,47,36,11,57,45,12,2,5,0,0
"946","ANA","L.A",2018021256,17991,20182019,1,60,5,2,3,3.37290810218983,6.49229038860883,-3.119382286419,33,47,-14,43,64,-21,54,75,-21,1,5,0,0
"947","ARI","CBJ",2008020027,14163,20082009,1,60,3,1,2,0,0,0,30,29,1,36,45,-9,51,69,-18,9,6,0,0
"948","ARI","ANA",2008020030,14164,20082009,0,60,4,2,2,0,0,0,24,35,-11,32,50,-18,39,58,-19,9,7,0,0
"949","ARI","CHI",2008020046,14167,20082009,0,60,1,4,-3,0,0,0,30,30,0,36,37,-1,49,53,-4,10,9,0,0
"950","ARI","OTT",2008020056,14169,20082009,0,60,3,6,-3,0,0,0,37,26,11,44,34,10,61,43,18,0,3,0,0
"951","ARI","MTL",2008020064,14170,20082009,0,60,1,4,-3,0,0,0,29,33,-4,39,47,-8,62,55,7,4,5,0,0
"952","ARI","WSH",2008020098,14175,20082009,1,60,2,1,1,0,0,0,34,32,2,50,46,4,61,61,0,4,4,0,0
"953","ARI","CGY",2008020119,14177,20082009,1,60,1,4,-3,0,0,0,24,36,-12,32,48,-16,40,64,-24,4,4,0,0
"954","ARI","PIT",2008020145,14182,20082009,1,60,4,1,3,0,0,0,30,28,2,41,41,0,56,56,0,4,5,0,0
"955","ARI","MIN",2008020160,14184,20082009,1,60,2,3,-1,0,0,0,27,33,-6,33,44,-11,44,51,-7,4,2,0,0
"956","ARI","CGY",2008020174,14187,20082009,0,60,4,2,2,0,0,0,22,29,-7,28,42,-14,36,65,-29,3,3,0,0
"957","ARI","VAN",2008020189,14189,20082009,0,60,0,1,-1,0,0,0,28,32,-4,35,53,-18,55,70,-15,4,8,0,0
"958","ARI","FLA",2008020204,14191,20082009,1,60,4,1,3,0,0,0,39,27,12,54,41,13,73,67,6,7,1,0,0
"959","ARI","S.J",2008020211,14192,20082009,1,60,4,2,2,0,0,0,30,32,-2,41,45,-4,47,64,-17,7,5,0,0
"960","ARI","CBJ",2008020224,14195,20082009,0,60,5,2,3,0,0,0,30,33,-3,45,47,-2,58,66,-8,5,5,0,0
"961","ARI","MIN",2008020232,14196,20082009,0,60,0,4,-4,0,0,0,24,32,-8,33,46,-13,49,60,-11,6,7,0,0
"962","ARI","DAL",2008020249,14198,20082009,1,60,2,3,-1,0,0,0,27,19,8,32,31,1,47,45,2,4,4,0,0
"963","ARI","CHI",2008020266,14201,20082009,1,65,2,2,0,0,0,0,38,40,-2,51,49,2,70,71,-1,7,5,0,0
"964","ARI","CAR",2008020281,14204,20082009,0,60,2,5,-3,0,0,0,28,33,-5,49,53,-4,68,65,3,3,3,0,0
"965","ARI","PHI",2008020290,14205,20082009,0,61.5833333333333,3,4,-1,0,0,0,28,34,-6,41,46,-5,62,59,3,8,3,0,0
"966","ARI","NYR",2008020299,14207,20082009,0,60,1,4,-3,0,0,0,36,36,0,49,54,-5,65,66,-1,1,2,0,0
"967","ARI","CBJ",2008020313,14209,20082009,0,60,3,2,1,0,0,0,25,40,-15,30,52,-22,33,73,-40,6,8,0,0
"968","ARI","COL",2008020326,14211,20082009,1,60,2,1,1,0,0,0,20,38,-18,30,49,-19,49,64,-15,4,4,0,0
"969","ARI","S.J",2008020344,14212,20082009,1,60,2,3,-1,0,0,0,20,23,-3,31,38,-7,46,48,-2,6,4,0,0
"970","ARI","L.A",2008020359,14215,20082009,1,60,4,2,2,0,0,0,26,34,-8,40,47,-7,64,62,2,5,1,0,0
"971","ARI","TOR",2008020374,14217,20082009,1,60,6,3,3,0,0,0,26,18,8,43,30,13,62,48,14,5,5,0,0
"972","ARI","STL",2008020389,14219,20082009,0,60,3,4,-1,0,0,0,26,30,-4,36,46,-10,47,56,-9,6,4,0,0
"973","ARI","CHI",2008020394,14220,20082009,0,60,1,7,-6,0,0,0,21,28,-7,25,39,-14,32,58,-26,3,5,0,0
"974","ARI","DAL",2008020411,14223,20082009,0,60,5,3,2,0,0,0,34,32,2,45,49,-4,60,54,6,6,7,0,0
"975","ARI","MIN",2008020419,14224,20082009,1,60,3,1,2,0,0,0,32,31,1,39,46,-7,55,62,-7,5,5,0,0
"976","ARI","DET",2008020438,14226,20082009,1,65,4,4,0,0,0,0,28,38,-10,42,59,-17,53,74,-21,6,4,0,0
"977","ARI","DAL",2008020452,14229,20082009,0,63.65,1,2,-1,0,0,0,23,30,-7,33,44,-11,49,63,-14,4,3,0,0
"978","ARI","NSH",2008020468,14231,20082009,1,60,2,1,1,0,0,0,27,31,-4,39,42,-3,48,53,-5,2,3,0,0
"979","ARI","CBJ",2008020483,14233,20082009,1,60,2,0,2,0,0,0,24,33,-9,32,44,-12,44,62,-18,3,2,0,0
"980","ARI","EDM",2008020492,14235,20082009,0,60,2,4,-2,0,0,0,29,27,2,39,44,-5,45,52,-7,7,9,0,0
"981","ARI","COL",2008020504,14236,20082009,0,61.8,4,5,-1,0,0,0,23,48,-25,38,56,-18,44,68,-24,4,4,0,0
"982","ARI","L.A",2008020515,14239,20082009,0,60,2,1,1,0,0,0,26,25,1,41,46,-5,52,58,-6,4,3,0,0
"983","ARI","L.A",2008020525,14240,20082009,1,60,0,4,-4,0,0,0,26,30,-4,42,50,-8,57,60,-3,9,6,0,0
"984","ARI","COL",2008020550,14244,20082009,1,60,3,1,2,0,0,0,29,29,0,46,35,11,54,52,2,2,3,0,0
"985","ARI","NYI",2008020563,14246,20082009,1,60,5,4,1,0,0,0,33,33,0,49,41,8,64,50,14,3,1,0,0
"986","ARI","ANA",2008020581,14248,20082009,0,60,0,2,-2,0,0,0,29,34,-5,37,55,-18,44,60,-16,3,4,0,0
"987","ARI","CHI",2008020594,14250,20082009,1,60,0,6,-6,0,0,0,22,41,-19,31,58,-27,41,71,-30,8,4,0,0
"988","ARI","T.B",2008020607,14252,20082009,1,60,3,2,1,0,0,0,27,24,3,46,36,10,60,53,7,3,2,0,0
"989","ARI","DAL",2008020623,14254,20082009,1,65,0,0,0,0,0,0,28,38,-10,37,48,-11,51,65,-14,4,3,0,0
"990","ARI","MIN",2008020638,14257,20082009,0,60,3,6,-3,0,0,0,24,34,-10,37,44,-7,43,60,-17,3,6,0,0
"991","ARI","VAN",2008020653,14259,20082009,0,60,4,1,3,0,0,0,32,32,0,44,46,-2,57,71,-14,3,2,0,0
"992","ARI","CGY",2008020671,14261,20082009,0,60,4,3,1,0,0,0,26,32,-6,38,49,-11,45,70,-25,2,2,0,0
"993","ARI","EDM",2008020675,14262,20082009,0,60,3,6,-3,0,0,0,28,29,-1,39,43,-4,48,58,-10,1,3,0,0
"994","ARI","DET",2008020690,14264,20082009,1,60,6,3,3,0,0,0,27,37,-10,35,50,-15,44,75,-31,6,6,0,0
"995","ARI","ANA",2008020711,14271,20082009,1,60,3,7,-4,0,0,0,26,37,-11,35,44,-9,49,54,-5,5,1,0,0
"996","ARI","S.J",2008020724,14273,20082009,0,60,0,2,-2,0,0,0,24,29,-5,32,46,-14,42,59,-17,7,6,0,0
"997","ARI","BUF",2008020739,14275,20082009,1,60,0,2,-2,0,0,0,28,21,7,45,30,15,63,42,21,9,6,0,0
"998","ARI","NSH",2008020755,14278,20082009,0,60,1,2,-1,0,0,0,30,24,6,42,40,2,63,51,12,7,6,0,0
"999","ARI","DET",2008020762,14279,20082009,0,60,4,5,-1,0,0,0,27,33,-6,31,49,-18,38,62,-24,4,6,0,0
"1000","ARI","CAR",2008020787,14282,20082009,1,60,2,7,-5,0,0,0,32,41,-9,43,52,-9,63,61,2,4,5,0,0
"1001","ARI","DAL",2008020808,14286,20082009,0,60,1,0,1,0,0,0,29,33,-4,36,44,-8,41,68,-27,4,4,0,0
"1002","ARI","VAN",2008020816,14287,20082009,1,60,3,4,-1,0,0,0,28,32,-4,38,48,-10,47,75,-28,4,7,0,0
"1003","ARI","CGY",2008020833,14289,20082009,1,60,5,7,-2,0,0,0,37,45,-8,54,57,-3,62,68,-6,6,2,0,0
"1004","ARI","EDM",2008020845,14291,20082009,1,60,1,3,-2,0,0,0,29,29,0,44,42,2,59,51,8,6,4,0,0
"1005","ARI","ATL",2008020869,14294,20082009,1,65,3,3,0,0,0,0,40,22,18,53,39,14,72,52,20,5,2,0,0
"1006","ARI","L.A",2008020877,14296,20082009,0,60,6,3,3,0,0,0,29,33,-4,41,55,-14,49,63,-14,2,4,0,0
"1007","ARI","STL",2008020901,14299,20082009,0,60,1,2,-1,0,0,0,25,24,1,40,30,10,49,40,9,3,0,0,0
"1008","ARI","NSH",2008020915,14301,20082009,0,60,1,4,-3,0,0,0,26,47,-21,37,60,-23,47,75,-28,3,4,0,0
"1009","ARI","STL",2008020932,14303,20082009,1,60,1,3,-2,0,0,0,27,30,-3,38,46,-8,57,54,3,5,4,0,0
"1010","ARI","BOS",2008020955,14308,20082009,0,60,2,1,1,0,0,0,18,26,-8,27,37,-10,39,59,-20,2,3,0,0
"1011","ARI","BUF",2008020965,14309,20082009,0,60,1,5,-4,0,0,0,30,31,-1,44,50,-6,57,56,1,7,7,0,0
"1012","ARI","NYI",2008020979,14311,20082009,0,60,2,3,-1,0,0,0,42,26,16,55,35,20,66,54,12,6,2,0,0
"1013","ARI","DET",2008020995,14313,20082009,0,63.5833333333333,2,3,-1,0,0,0,25,43,-18,38,54,-16,47,70,-23,3,1,0,0
"1014","ARI","N.J",2008021005,14315,20082009,0,60,2,5,-3,0,0,0,28,36,-8,37,42,-5,48,56,-8,4,3,0,0
"1015","ARI","NSH",2008021029,14317,20082009,1,60,0,2,-2,0,0,0,18,33,-15,25,42,-17,38,53,-15,3,3,0,0
"1016","ARI","ANA",2008021061,14322,20082009,1,65,2,2,0,0,0,0,28,27,1,44,37,7,55,48,7,6,3,0,0
"1017","ARI","ANA",2008021083,14325,20082009,0,60,2,6,-4,0,0,0,28,30,-2,40,49,-9,52,65,-13,4,4,0,0
"1018","ARI","EDM",2008021109,14329,20082009,1,60,3,2,1,0,0,0,23,28,-5,27,38,-11,33,54,-21,4,5,0,0
"1019","ARI","DAL",2008021136,14333,20082009,1,60.8833333333333,6,5,1,0,0,0,33,23,10,45,33,12,55,48,7,6,4,0,0
"1020","ARI","COL",2008021149,14335,20082009,0,60,3,0,3,0,0,0,35,23,12,41,35,6,55,48,7,7,4,0,0
"1021","ARI","STL",2008021195,14341,20082009,1,60,1,5,-4,0,0,0,29,24,5,40,27,13,60,40,20,2,2,0,0
"1022","ARI","ANA",2008021225,14345,20082009,1,65,4,4,0,0,0,0,33,35,-2,42,48,-6,51,55,-4,6,6,0,0
"1023","ARI","PIT",2009020033,14524,20092010,0,60,3,0,3,0,0,0,25,24,1,37,30,7,54,39,15,10,7,0,0
"1024","ARI","STL",2009020086,14532,20092010,1,63.6166666666667,3,2,1,0,0,0,34,24,10,54,33,21,64,44,20,4,2,0,0
"1025","ARI","NYR",2009020148,14543,20092010,0,60,2,5,-3,0,0,0,32,24,8,47,43,4,77,52,25,6,5,0,0
"1026","ARI","STL",2009020168,14546,20092010,0,60,2,0,2,0,0,0,29,32,-3,46,45,1,56,59,-3,2,3,0,0
"1027","ARI","ANA",2009020189,14548,20092010,1,65,2,2,0,0,0,0,32,34,-2,41,47,-6,63,59,4,2,7,0,0
"1028","ARI","COL",2009020208,14552,20092010,0,60,1,4,-3,0,0,0,29,29,0,37,39,-2,62,55,7,4,6,0,0
"1029","ARI","ANA",2009020236,14555,20092010,0,60,3,4,-1,0,0,0,30,26,4,43,37,6,58,45,13,3,7,0,0
"1030","ARI","MTL",2009020260,14560,20092010,1,60,2,4,-2,0,0,0,20,20,0,30,32,-2,51,41,10,4,2,0,0
"1031","ARI","DAL",2009020278,14562,20092010,1,60,3,2,1,0,0,0,31,28,3,42,36,6,61,47,14,3,6,0,0
"1032","ARI","T.B",2009020288,14564,20092010,1,60,1,4,-3,0,0,0,31,19,12,38,27,11,51,38,13,3,4,0,0
"1033","ARI","MIN",2009020296,14566,20092010,0,60,3,2,1,0,0,0,32,26,6,45,39,6,59,52,7,2,3,0,0
"1034","ARI","STL",2009020302,14567,20092010,0,60.2833333333333,2,3,-1,0,0,0,36,30,6,46,48,-2,54,57,-3,4,4,0,0
"1035","ARI","PHI",2009020323,14569,20092010,1,60,3,1,2,0,0,0,21,24,-3,31,31,0,48,47,1,5,5,0,0
"1036","ARI","EDM",2009020336,14571,20092010,0,60,0,4,-4,0,0,0,36,25,11,56,31,25,76,45,31,3,6,0,0
"1037","ARI","DAL",2009020366,14575,20092010,1,60,5,2,3,0,0,0,29,32,-3,38,42,-4,49,51,-2,2,5,0,0
"1038","ARI","ANA",2009020380,14577,20092010,0,61.3,3,2,1,0,0,0,26,28,-2,39,39,0,54,46,8,5,4,0,0
"1039","ARI","MIN",2009020436,14585,20092010,1,60,2,0,2,0,0,0,31,28,3,43,34,9,51,40,11,5,6,0,0
"1040","ARI","TOR",2009020497,14594,20092010,0,60,6,3,3,0,0,0,29,30,-1,42,49,-7,54,75,-21,2,5,0,0
"1041","ARI","ANA",2009020519,14597,20092010,0,60,2,4,-2,0,0,0,41,34,7,51,50,1,64,54,10,4,8,0,0
"1042","ARI","ANA",2009020555,14601,20092010,1,60,4,0,4,0,0,0,32,21,11,39,30,9,53,40,13,2,4,0,0
"1043","ARI","EDM",2009020636,14614,20092010,0,61.6166666666667,5,4,1,0,0,0,30,42,-12,42,51,-9,55,63,-8,5,3,0,0
"1044","ARI","NYI",2009020669,14618,20092010,1,65,4,4,0,0,0,0,29,30,-1,41,43,-2,61,48,13,5,4,0,0
"1045","ARI","N.J",2009020701,14623,20092010,1,60,4,3,1,0,0,0,19,34,-15,31,53,-22,41,64,-23,4,3,0,0
"1046","ARI","MIN",2009020717,14625,20092010,1,60,6,4,2,0,0,0,33,22,11,42,38,4,64,48,16,6,4,0,0
"1047","ARI","NYR",2009020814,14639,20092010,1,60,3,2,1,0,0,0,24,26,-2,33,39,-6,45,57,-12,7,3,0,0
"1048","ARI","DAL",2009020821,14640,20092010,0,60,4,2,2,0,0,0,31,40,-9,41,57,-16,52,73,-21,1,2,0,0
"1049","ARI","DAL",2009020858,14646,20092010,0,60,0,4,-4,0,0,0,34,35,-1,52,49,3,68,58,10,6,3,0,0
"1050","ARI","EDM",2009020874,14648,20092010,1,60,6,1,5,0,0,0,33,34,-1,39,46,-7,48,57,-9,2,4,0,0
"1051","ARI","MIN",2009020888,14650,20092010,0,60,3,2,1,0,0,0,31,31,0,41,43,-2,50,56,-6,2,2,0,0
"1052","ARI","COL",2009020904,14652,20092010,0,60,1,2,-1,0,0,0,34,25,9,45,36,9,62,44,18,6,7,0,0
"1053","ARI","DAL",2009020912,14653,20092010,1,60,0,3,-3,0,0,0,40,22,18,55,26,29,73,39,34,4,3,0,0
"1054","ARI","STL",2009020933,14670,20092010,1,60,2,5,-3,0,0,0,39,35,4,53,48,5,63,53,10,6,6,0,0
"1055","ARI","COL",2009020948,14672,20092010,1,60,3,1,2,0,0,0,30,24,6,39,33,6,54,45,9,3,4,0,0
"1056","ARI","ANA",2009020961,14674,20092010,1,60,4,0,4,0,0,0,30,32,-2,46,46,0,52,57,-5,5,8,0,0
"1057","ARI","T.B",2009021032,14684,20092010,0,60,2,1,1,0,0,0,28,28,0,35,41,-6,46,51,-5,3,4,0,0
"1058","ARI","FLA",2009021048,14686,20092010,0,65,3,3,0,0,0,0,46,24,22,58,33,25,83,42,41,3,2,0,0
"1059","ARI","DAL",2009021074,14689,20092010,0,65,2,2,0,0,0,0,35,32,3,54,44,10,70,57,13,6,3,0,0
"1060","ARI","COL",2009021119,14695,20092010,1,60,6,2,4,0,0,0,32,29,3,41,42,-1,51,52,-1,2,3,0,0
"1061","ARI","EDM",2009021173,14702,20092010,1,65,2,2,0,0,0,0,44,27,17,59,37,22,73,47,26,9,3,0,0
"1062","ARI","DET",2009030181,14713,20092010,1,60,3,2,1,0,0,0,35,40,-5,47,57,-10,55,72,-17,5,7,0,0
"1063","ARI","DET",2009030182,14715,20092010,1,60,4,7,-3,0,0,0,31,39,-8,39,55,-16,53,69,-16,4,3,0,0
"1064","ARI","DET",2009030183,14717,20092010,0,60,4,2,2,0,0,0,33,31,2,43,40,3,51,51,0,3,5,0,0
"1065","ARI","DET",2009030184,14719,20092010,0,60,0,3,-3,0,0,0,29,35,-6,41,43,-2,49,57,-8,7,4,0,0
"1066","ARI","DET",2009030185,14722,20092010,1,60,1,4,-3,0,0,0,31,29,2,40,36,4,56,46,10,5,6,0,0
"1067","ARI","DET",2009030186,14724,20092010,0,60,5,2,3,0,0,0,29,33,-4,35,53,-18,49,69,-20,7,6,0,0
"1068","ARI","DET",2009030187,14726,20092010,1,60,1,6,-5,0,0,0,33,50,-17,42,63,-21,53,70,-17,6,7,0,0
"1069","ARI","ANA",2010020067,14899,20102011,0,60,2,3,-1,0,0,0,38,35,3,54,47,7,62,52,10,3,4,0,0
"1070","ARI","MTL",2010020115,14907,20102011,0,61.4166666666667,2,3,-1,3.15663784614298,3.22279717602337,-0.0661593298803851,29,29,0,38,39,-1,59,51,8,5,5,0,0
"1071","ARI","T.B",2010020153,14912,20102011,1,60,0,3,-3,1.73018371651415,3.69725853273667,-1.96707481622252,23,23,0,34,35,-1,53,44,9,5,4,0,0
"1072","ARI","DAL",2010020184,14918,20102011,0,60,3,6,-3,2.49100234242894,3.89170982053474,-1.4007074781058,28,31,-3,35,41,-6,48,56,-8,5,6,0,0
"1073","ARI","PIT",2010020196,14919,20102011,1,65,3,3,0,4.82467271885093,4.6260573786858,0.198615340165126,28,36,-8,48,51,-3,62,67,-5,4,5,0,0
"1074","ARI","STL",2010020241,14926,20102011,1,60,5,3,2,4.2916041102726,5.33095593929839,-1.03935182902579,27,38,-11,35,56,-21,38,72,-34,6,2,0,0
"1075","ARI","EDM",2010020281,14932,20102011,0,65,3,3,0,4.61151702320382,5.90563140351151,-1.29411438030769,42,30,12,49,44,5,58,55,3,4,6,0,0
"1076","ARI","EDM",2010020306,14936,20102011,1,60,5,0,5,3.28100876732537,1.9643729053787,1.31663586194668,34,23,11,43,31,12,49,42,7,2,2,0,0
"1077","ARI","ANA",2010020341,14940,20102011,1,60,4,6,-2,7.40006768808234,3.58670675169014,3.8133609363922,34,25,9,49,33,16,70,40,30,5,3,0,0
"1078","ARI","MIN",2010020362,14944,20102011,0,60,4,2,2,5.47510294303208,4.71127752622678,0.763825416805305,36,35,1,45,53,-8,61,60,1,3,4,0,0
"1079","ARI","FLA",2010020388,14947,20102011,1,65,1,1,0,2.42576403941156,5.775413806492,-3.34964976708043,41,37,4,60,48,12,72,57,15,3,4,0,0
"1080","ARI","ANA",2010020394,14948,20102011,0,60,3,0,3,5.38280559552368,2.87776320141716,2.50504239410652,39,26,13,53,39,14,69,52,17,8,5,0,0
"1081","ARI","MIN",2010020417,14952,20102011,1,60,2,3,-1,0,0,0,35,33,2,51,44,7,67,53,14,2,3,0,0
"1082","ARI","DAL",2010020434,14954,20102011,1,60,5,2,3,3.9176586490132,3.96319141855929,-0.0455327695460896,34,35,-1,45,51,-6,60,61,-1,4,7,0,0
"1083","ARI","N.J",2010020450,14958,20102011,0,60,0,3,-3,4.24705397054071,3.1103251646054,1.13672880593531,29,29,0,35,41,-6,41,49,-8,3,4,0,0
"1084","ARI","NYR",2010020461,14959,20102011,0,65,3,3,0,5.60223926187609,4.7572710745153,0.844968187360791,33,36,-3,42,48,-6,59,57,2,4,5,0,0
"1085","ARI","NYI",2010020475,14961,20102011,0,65,3,3,0,8.00837245949043,6.38485249763471,1.62351996185572,35,44,-9,56,51,5,85,66,19,7,8,0,0
"1086","ARI","PIT",2010020491,14963,20102011,0,60,1,6,-5,4.7460206632968,4.65563383872212,0.0903868245746793,27,38,-11,45,50,-5,58,65,-7,10,7,0,0
"1087","ARI","DAL",2010020527,14969,20102011,0,60,1,0,1,3.5170628015585,4.91042793601719,-1.39336513445869,25,30,-5,35,45,-10,52,61,-9,3,2,0,0
"1088","ARI","ANA",2010020543,14971,20102011,1,60,1,3,-2,3.27400544568172,4.44476458086638,-1.17075913518465,32,24,8,49,36,13,66,41,25,6,3,0,0
"1089","ARI","STL",2010020562,14974,20102011,0,60,3,4,-1,6.68682084095781,3.83432567795535,2.85249516300246,33,22,11,50,37,13,72,51,21,3,2,0,0
"1090","ARI","MIN",2010020578,14976,20102011,0,60.7666666666667,5,6,-1,4.91615546483081,3.50485254930894,1.41130291552187,44,29,15,58,43,15,70,55,15,3,2,0,0
"1091","ARI","COL",2010020601,14980,20102011,0,60,2,0,2,5.44325676838343,3.01039739505359,2.43285937332985,33,34,-1,46,46,0,59,65,-6,1,1,0,0
"1092","ARI","STL",2010020629,14984,20102011,0,60,4,3,1,5.24290316832048,6.60075590887573,-1.35785274055524,33,36,-3,48,50,-2,61,63,-2,3,3,0,0
"1093","ARI","TOR",2010020651,14987,20102011,1,60,5,1,4,3.66691169163096,2.5943727218023,1.07253896982866,21,29,-8,33,43,-10,41,54,-13,8,8,0,0
"1094","ARI","ANA",2010020669,14989,20102011,1,60,6,2,4,4.5048006113348,4.57174259158106,-0.0669419802462556,34,28,6,53,37,16,64,47,17,4,3,0,0
"1095","ARI","EDM",2010020741,14999,20102011,1,60,3,4,-1,4.63966354743752,4.06194215195916,0.577721395478363,27,35,-8,43,51,-8,60,67,-7,3,3,0,0
"1096","ARI","COL",2010020747,15000,20102011,0,60,5,2,3,4.24866032692807,5.4612832351923,-1.21262290826422,37,31,6,50,38,12,60,44,16,9,5,0,0
"1097","ARI","MIN",2010020791,15010,20102011,1,60,1,0,1,5.48624022297736,3.27800175134189,2.20823847163547,41,25,16,57,36,21,72,46,26,3,4,0,0
"1098","ARI","COL",2010020800,15012,20102011,1,60,3,0,3,3.52988442598144,2.0799880635459,1.44989636243554,26,26,0,35,43,-8,48,54,-6,5,6,0,0
"1099","ARI","DAL",2010020812,15014,20102011,0,61.2166666666667,3,2,1,4.36188108000351,5.39153983221331,-1.0296587522098,35,18,17,45,33,12,61,51,10,6,4,0,0
"1100","ARI","PHI",2010020895,15027,20102011,0,62.6833333333333,3,2,1,6.02354697627015,5.22210494747446,0.801442028795691,29,39,-10,44,55,-11,57,71,-14,4,5,0,0
"1101","ARI","T.B",2010020905,15028,20102011,0,60,3,8,-5,3.54860789026134,4.54958662416902,-1.00097873390769,28,39,-11,43,55,-12,59,66,-7,3,5,0,0
"1102","ARI","DAL",2010020949,15034,20102011,1,60,2,3,-1,4.98524737416301,5.42059099929202,-0.435343625129008,27,30,-3,43,46,-3,57,58,-1,2,5,0,0
"1103","ARI","ANA",2010021037,15046,20102011,0,60,5,2,3,0,0,0,31,38,-7,40,50,-10,54,64,-10,3,6,0,0
"1104","ARI","EDM",2010021063,15050,20102011,0,60,3,1,2,2.18792549222963,4.45256843193249,-2.26464293970286,17,36,-19,27,48,-21,39,65,-26,5,11,0,0
"1105","ARI","STL",2010021097,15055,20102011,1,60,2,1,1,5.24643166554597,4.31279967715091,0.933631988395064,23,30,-7,41,43,-2,55,61,-6,4,1,0,0
"1106","ARI","DAL",2010021144,15062,20102011,1,65,1,1,0,3.38707448495552,6.85934242479561,-3.47226793984009,27,45,-18,41,59,-18,55,72,-17,1,2,0,0
"1107","ARI","COL",2010021163,15065,20102011,1,65,3,3,0,6.73466739642001,2.94115415340639,3.79351324301363,38,20,18,62,32,30,76,40,36,6,4,0,0
"1108","ARI","DET",2010030171,15077,20102011,0,60,2,4,-2,3.04709400044521,4.22890687606027,-1.18181287561506,28,36,-8,43,51,-8,61,59,2,6,3,0,0
"1109","ARI","DET",2010030172,15080,20102011,0,60,3,4,-1,6.35565772780683,4.02356416701514,2.33209356079169,33,31,2,38,48,-10,51,59,-8,9,7,0,0
"1110","ARI","DET",2010030173,15082,20102011,1,60,2,4,-2,4.96655167106015,3.84138815443099,1.12516351662915,30,34,-4,50,53,-3,65,66,-1,4,5,0,0
"1111","ARI","DET",2010030174,15084,20102011,1,60,3,6,-3,3.28178080404177,8.75317635035481,-5.47139554631303,27,40,-13,43,58,-15,56,71,-15,2,3,0,0
"1112","ARI","DAL",2011020031,15257,20112012,0,65,1,1,0,7.90985790431932,4.08770621968128,3.82215168463804,41,25,16,65,39,26,85,56,29,7,7,0,0
"1113","ARI","WPG",2011020055,15262,20112012,1,60,4,1,3,4.88610802148503,1.96014383530746,2.92596418617757,34,19,15,50,33,17,65,49,16,4,4,0,0
"1114","ARI","ANA",2011020109,15270,20112012,0,60,5,4,1,4.4155274588702,3.4264641625341,0.989063296336095,35,33,2,49,46,3,58,54,4,3,4,0,0
"1115","ARI","DAL",2011020120,15272,20112012,1,65,2,2,0,4.15508437722472,4.66454806004185,-0.509463682817135,35,36,-1,48,44,4,69,57,12,3,4,0,0
"1116","ARI","N.J",2011020135,15274,20112012,1,60,5,3,2,3.40582561833435,2.45033345914005,0.955492159194293,42,34,8,54,45,9,68,57,11,4,1,0,0
"1117","ARI","COL",2011020167,15280,20112012,0,60,4,1,3,4.5837483034702,4.89511728519574,-0.311368981725536,28,40,-12,33,55,-22,47,75,-28,1,4,0,0
"1118","ARI","EDM",2011020192,15283,20112012,1,60,4,2,2,4.19713286706778,3.12552899424918,1.0716038728186,30,26,4,36,37,-1,50,54,-4,2,2,0,0
"1119","ARI","MTL",2011020219,15288,20112012,1,61.75,2,3,-1,4.15478929472738,6.09840103526949,-1.94361174054211,34,36,-2,47,58,-11,64,79,-15,2,1,0,0
"1120","ARI","TOR",2011020248,15293,20112012,0,65,2,2,0,3.47389269282576,8.69648071079834,-5.22258801797259,35,37,-2,50,54,-4,62,74,-12,2,2,0,0
"1121","ARI","PHI",2011020262,15295,20112012,0,60,1,2,-1,5.36234169559225,8.77471323473401,-3.41237153914176,31,42,-11,44,55,-11,54,72,-18,3,3,0,0
"1122","ARI","ANA",2011020311,15301,20112012,1,60,4,2,2,5.2482745019556,2.56268975290982,2.68558474904578,29,21,8,52,31,21,62,39,23,9,3,0,0
"1123","ARI","DAL",2011020334,15304,20112012,1,60,3,0,3,4.22215202844914,3.35401543949308,0.86813658895606,39,26,13,54,39,15,68,49,19,2,2,0,0
"1124","ARI","WPG",2011020360,15309,20112012,0,60,0,1,-1,5.59976272247752,3.81454000260675,1.78522271987077,33,31,2,46,45,1,59,54,5,2,3,0,0
"1125","ARI","PHI",2011020380,15311,20112012,1,60,2,4,-2,5.53241994931599,4.71945477007699,0.812965179239001,38,30,8,60,44,16,82,51,31,8,7,0,0
"1126","ARI","MIN",2011020430,15318,20112012,1,60,1,4,-3,6.92697094031246,4.07173832098488,2.85523261932758,36,20,16,59,25,34,80,36,44,4,4,0,0
"1127","ARI","ANA",2011020450,15322,20112012,0,60,1,4,-3,3.12830117133554,5.72947186203504,-2.6011706906995,20,28,-8,36,41,-5,55,54,1,3,4,0,0
"1128","ARI","EDM",2011020459,15323,20112012,1,60,4,2,2,6.99394321922846,3.03668930556159,3.95725391366686,42,20,22,57,33,24,67,47,20,3,4,0,0
"1129","ARI","NYR",2011020475,15325,20112012,1,60,2,3,-1,3.55143944731345,5.42211814441544,-1.87067869710199,23,30,-7,32,41,-9,45,48,-3,3,7,0,0
"1130","ARI","FLA",2011020491,15328,20112012,0,60,2,1,1,1.79193147825299,3.27670679623827,-1.48477531798528,22,28,-6,25,42,-17,35,52,-17,7,5,0,0
"1131","ARI","STL",2011020516,15331,20112012,1,60,2,3,-1,4.51915097000892,5.34736317989882,-0.828212209889898,26,18,8,32,31,1,47,43,4,4,3,0,0
"1132","ARI","COL",2011020549,15337,20112012,0,60,2,3,-1,1.52269102400169,5.45514471644854,-3.93245369244686,27,35,-8,32,51,-19,42,63,-21,6,5,0,0
"1133","ARI","MIN",2011020560,15339,20112012,0,60,4,2,2,4.15035154018551,3.28331962667835,0.867031913507162,30,30,0,43,40,3,56,50,6,3,1,0,0
"1134","ARI","STL",2011020578,15342,20112012,0,60,1,4,-3,5.41495018767637,5.27285782666877,0.142092361007599,35,31,4,45,43,2,64,51,13,4,2,0,0
"1135","ARI","NYI",2011020608,15346,20112012,1,60,5,1,4,3.53462306369329,3.8506484462996,-0.316025382606313,25,32,-7,39,42,-3,52,57,-5,3,2,0,0
"1136","ARI","NYR",2011020619,15349,20112012,0,65,1,1,0,3.19845607446041,6.0524353277724,-2.85397925331199,19,32,-13,29,45,-16,45,60,-15,1,3,0,0
"1137","ARI","COL",2011020665,15355,20112012,1,60,6,1,5,5.56450743487221,3.25754323431124,2.30696420056097,33,39,-6,46,48,-2,57,56,1,3,0,0,0
"1138","ARI","ANA",2011020684,15357,20112012,0,60,2,6,-4,4.25179445871441,3.71570601014537,0.536088448569046,27,21,6,49,33,16,64,42,22,4,1,0,0
"1139","ARI","T.B",2011020709,15360,20112012,1,60,3,4,-1,3.56809595888444,1.2123599170518,2.35573604183264,36,21,15,54,26,28,74,36,38,4,2,0,0
"1140","ARI","ANA",2011020745,15370,20112012,1,60,1,4,-3,2.83642481990557,3.54382507462287,-0.7074002547173,26,30,-4,45,39,6,59,49,10,3,3,0,0
"1141","ARI","DAL",2011020795,15377,20112012,0,60,4,1,3,2.92632413458882,1.64464891779062,1.2816752167982,24,29,-5,40,42,-2,56,59,-3,1,3,0,0
"1142","ARI","VAN",2011020836,15398,20112012,1,65,1,1,0,4.99722126445744,5.37927698151179,-0.382055717054349,35,40,-5,43,50,-7,55,61,-6,5,4,0,0
"1143","ARI","L.A",2011020857,15386,20112012,0,60,1,0,1,1.86458136324654,5.74410589687735,-3.87952453363081,21,28,-7,35,53,-18,42,63,-21,7,4,0,0
"1144","ARI","DAL",2011020871,15388,20112012,1,61.25,2,1,1,4.86449308245892,4.64667285509523,0.217820227363688,33,31,2,41,45,-4,53,65,-12,5,5,0,0
"1145","ARI","L.A",2011020895,15391,20112012,1,65,4,4,0,4.21389848412582,4.73214377806289,-0.518245293937071,29,29,0,40,44,-4,46,58,-12,5,4,0,0
"1146","ARI","CGY",2011020906,15393,20112012,0,65,3,3,0,5.98143526652393,4.48402412490395,1.49741114161998,29,24,5,44,34,10,58,42,16,2,3,0,0
"1147","ARI","EDM",2011020916,15395,20112012,0,60,3,1,2,4.88411470665596,3.71085293558876,1.1732617710672,20,22,-2,30,36,-6,46,46,0,1,1,0,0
"1148","ARI","VAN",2011020944,15383,20112012,0,65,1,1,0,2.72686618051506,4.24582113634159,-1.51895495582653,24,22,2,34,29,5,47,43,4,3,4,0,0
"1149","ARI","CGY",2011020956,15400,20112012,1,60,2,4,-2,4.82978417408003,4.53086004382021,0.298924130259818,31,31,0,41,41,0,63,57,6,6,3,0,0
"1150","ARI","CBJ",2011020969,15402,20112012,1,60,2,5,-3,3.00068919364526,5.17267677140899,-2.17198757776373,32,26,6,38,36,2,54,47,7,4,3,0,0
"1151","ARI","CBJ",2011020988,15405,20112012,0,60,2,3,-1,4.39533670702711,5.16641704438027,-0.771080337353162,40,32,8,45,39,6,61,45,16,6,4,0,0
"1152","ARI","MIN",2011021007,15407,20112012,1,65,2,2,0,6.10432567937096,3.0833482836606,3.02097739571036,41,24,17,56,35,21,86,44,42,4,1,0,0
"1153","ARI","S.J",2011021023,15409,20112012,1,60,3,0,3,4.45280412138212,6.39714408584405,-1.94433996446193,29,42,-13,42,55,-13,54,82,-28,1,3,0,0
"1154","ARI","NSH",2011021036,15411,20112012,1,65,4,4,0,5.09785981148087,4.12464363785693,0.973216173623939,35,35,0,52,45,7,66,58,8,1,3,0,0
"1155","ARI","VAN",2011021050,15413,20112012,0,60,5,4,1,3.03292957996018,6.0485738205798,-3.01564424061962,33,43,-10,38,60,-22,47,79,-32,2,3,0,0
"1156","ARI","CGY",2011021058,15414,20112012,0,60,1,4,-3,2.96020826915628,2.72676371062516,0.233444558531119,28,19,9,35,27,8,54,35,19,3,2,0,0
"1157","ARI","EDM",2011021079,15417,20112012,0,65,2,2,0,5.96596735851926,3.70817601494491,2.25779134357435,42,38,4,57,50,7,74,63,11,3,2,0,0
"1158","ARI","DAL",2011021094,15419,20112012,0,65,3,3,0,7.01261196687119,7.50013082940131,-0.487518862530123,30,33,-3,47,45,2,64,55,9,7,7,0,0
"1159","ARI","COL",2011021107,15421,20112012,1,60,3,2,1,2.89310465107701,4.8381420654332,-1.94503741435619,25,41,-16,36,55,-19,43,65,-22,6,3,0,0
"1160","ARI","S.J",2011021126,15423,20112012,0,65,3,3,0,3.23967743352841,5.05469607101986,-1.81501863749145,27,32,-5,30,57,-27,40,85,-45,1,5,0,0
"1161","ARI","STL",2011021133,15424,20112012,1,60,0,4,-4,3.17673681646087,2.56566986916175,0.611066947299119,20,29,-9,33,42,-9,50,54,-4,5,4,0,0
"1162","ARI","S.J",2011021160,15428,20112012,1,60,2,0,2,4.78357252200658,5.08285508624334,-0.299282564236762,33,38,-5,43,56,-13,58,70,-12,1,1,0,0
"1163","ARI","ANA",2011021178,15430,20112012,1,60,4,0,4,5.37391516729258,4.87034765151839,0.503567515774193,29,44,-15,41,57,-16,45,77,-32,5,7,0,0
"1164","ARI","CBJ",2011021198,15433,20112012,1,60,2,0,2,3.07740356405627,7.18618035520194,-4.10877679114567,22,54,-32,35,69,-34,51,82,-31,1,7,0,0
"1165","ARI","STL",2011021215,15436,20112012,0,60,4,1,3,5.80853486718843,4.36688566020761,1.44164920698081,32,32,0,44,46,-2,57,56,1,8,8,0,0
"1166","ARI","MIN",2011021226,15437,20112012,0,60,4,1,3,4.88154861588919,3.55192197830112,1.32962663758806,28,24,4,42,34,8,59,46,13,6,6,0,0
"1167","ARI","CHI",2011030171,15442,20112012,1,69.4833333333333,3,2,1,5.53734776546662,6.31117989599738,-0.773832130530764,34,45,-11,57,59,-2,69,86,-17,3,5,0,0
"1168","ARI","CHI",2011030172,15444,20112012,1,70.6,3,4,-1,5.57962977365241,6.19477643826394,-0.61514666461153,33,50,-17,54,59,-5,64,76,-12,2,3,0,0
"1169","ARI","CHI",2011030173,15447,20112012,0,73.25,3,2,1,4.83005901897559,4.97847085213289,-0.148411833157297,34,37,-3,42,48,-6,58,63,-5,4,4,0,0
"1170","ARI","CHI",2011030174,15449,20112012,0,62.25,3,2,1,2.09281558933435,2.78822599496925,-0.695410405634902,19,32,-13,25,38,-13,31,59,-28,2,3,0,0
"1171","ARI","CHI",2011030175,15451,20112012,1,62.7333333333333,1,2,-1,1.48262787509884,3.85033302930788,-2.36770515420903,19,38,-19,23,55,-32,32,84,-52,4,4,0,0
"1172","ARI","CHI",2011030176,15453,20112012,0,60,4,0,4,3.77953745075041,7.07978016432004,-3.30024271356963,20,39,-19,28,61,-33,42,80,-38,2,2,0,0
"1173","ARI","NSH",2011030241,15457,20112012,1,74.0666666666667,4,3,1,4.76569171634037,6.7151508947054,-1.94945917836503,24,42,-18,37,67,-30,52,82,-30,3,5,0,0
"1174","ARI","NSH",2011030242,15459,20112012,1,60,5,3,2,5.81006407178938,4.61826420575993,1.19179986602946,39,33,6,50,50,0,70,57,13,4,4,0,0
"1175","ARI","NSH",2011030243,15462,20112012,0,60,0,2,-2,7.96947080827393,4.3273730649337,3.64209774334023,32,26,6,45,36,9,60,45,15,4,5,0,0
"1176","ARI","NSH",2011030244,15464,20112012,0,60,1,0,1,4.31654245965819,5.51426213033847,-1.19771967068027,24,25,-1,37,39,-2,52,55,-3,2,3,0,0
"1177","ARI","NSH",2011030245,15467,20112012,1,60,2,1,1,2.61618655550064,4.85061804112047,-2.23443148561983,17,33,-16,26,56,-30,40,73,-33,1,4,0,0
"1178","ARI","L.A",2011030321,15473,20112012,1,60,2,4,-2,3.18503939418588,6.26631209135399,-3.08127269716811,27,48,-21,35,65,-30,46,90,-44,5,4,0,0
"1179","ARI","L.A",2011030322,15475,20112012,1,60,0,4,-4,1.42602100387504,4.69257735111751,-3.26655634724246,24,40,-16,35,51,-16,48,60,-12,7,8,0,0
"1180","ARI","L.A",2011030323,15477,20112012,0,60,1,2,-1,2.71333549248356,6.19256101786101,-3.47922552537745,19,28,-9,32,45,-13,43,57,-14,2,6,0,0
"1181","ARI","L.A",2011030324,15480,20112012,0,60,2,0,2,3.81159986900457,6.89019644989489,-3.07859658089032,21,36,-15,34,64,-30,44,76,-32,5,8,0,0
"1182","ARI","L.A",2011030325,15482,20112012,1,77.7,3,4,-1,5.1548660616827,9.76159840727333,-4.60673234559063,41,51,-10,52,66,-14,70,91,-21,6,4,0,0
"1183","ARI","DAL",2012020011,15724,20122013,0,60,3,4,-1,5.73507484054063,4.41580240573485,1.31927243480578,40,26,14,50,49,1,67,64,3,5,4,0,0
"1184","ARI","CHI",2012020019,15725,20122013,1,60,4,6,-2,4.47936926343959,5.75393997249193,-1.27457070905234,29,31,-2,40,43,-3,52,60,-8,3,5,0,0
"1185","ARI","CBJ",2012020039,15728,20122013,1,60,5,1,4,8.38383057212923,3.67326235375367,4.71056821837556,42,26,16,55,39,16,68,57,11,6,4,0,0
"1186","ARI","S.J",2012020049,15729,20122013,0,60,3,5,-2,3.88136639428558,5.66429197995376,-1.78292558566818,35,35,0,52,50,2,77,68,9,5,7,0,0
"1187","ARI","L.A",2012020062,15731,20122013,1,60,2,4,-2,5.27327135899395,4.61555601150576,0.657715347488192,33,31,2,47,42,5,59,57,2,6,4,0,0
"1188","ARI","NSH",2012020075,15733,20122013,1,60,4,0,4,4.38366244017379,4.66880574979587,-0.285143309622072,25,21,4,39,37,2,52,47,5,5,3,0,0
"1189","ARI","EDM",2012020090,15735,20122013,1,63.8666666666667,1,2,-1,2.42417462562075,4.89682994113011,-2.47265531550935,28,21,7,44,38,6,61,50,11,3,5,0,0
"1190","ARI","DAL",2012020105,15737,20122013,0,65,3,3,0,4.99384017434204,2.58835599808026,2.40548417626178,34,24,10,44,35,9,61,53,8,4,3,0,0
"1191","ARI","DAL",2012020115,15738,20122013,1,60,2,0,2,4.41204115097935,3.05603080645432,1.35601034452503,34,17,17,47,28,19,66,44,22,8,2,0,0
"1192","ARI","MIN",2012020125,15740,20122013,1,60,2,1,1,4.4691812324636,4.21870496188058,0.250476270583022,34,22,12,45,35,10,60,52,8,1,2,0,0
"1193","ARI","CHI",2012020152,15743,20122013,1,60,2,6,-4,2.19197484654272,5.91965609355248,-3.72768124700976,24,33,-9,32,44,-12,50,59,-9,3,10,0,0
"1194","ARI","S.J",2012020159,15745,20122013,0,65,0,0,0,3.69578711752024,2.67136483077047,1.02442228674977,21,33,-12,34,51,-17,45,73,-28,3,4,0,0
"1195","ARI","COL",2012020176,15747,20122013,0,64.0166666666667,3,2,1,7.5557069497554,6.95358822316757,0.602118726587832,30,43,-13,43,56,-13,60,67,-7,6,5,0,0
"1196","ARI","NSH",2012020195,15750,20122013,0,60,0,3,-3,4.85764259626512,6.01197579348809,-1.15433319722298,19,29,-10,29,36,-7,48,52,-4,4,2,0,0
"1197","ARI","CBJ",2012020210,15752,20122013,1,60,5,3,2,5.83057943744042,2.18199276455562,3.6485866728848,35,20,15,43,27,16,58,50,8,7,3,0,0
"1198","ARI","CGY",2012020224,15754,20122013,1,60,4,0,4,8.64871226490504,4.03654322322109,4.61216904168396,37,30,7,55,43,12,73,54,19,1,1,0,0
"1199","ARI","EDM",2012020252,15759,20122013,0,65,2,2,0,6.12704510231015,6.38002496526883,-0.252979862958682,36,43,-7,52,53,-1,66,68,-2,6,4,0,0
"1200","ARI","CGY",2012020268,15760,20122013,0,60,4,5,-1,4.99986833252478,4.32803009507984,0.671838237444945,28,31,-3,34,41,-7,44,55,-11,6,3,0,0
"1201","ARI","VAN",2012020282,15762,20122013,0,60,4,2,2,3.81063174241094,3.09499809617409,0.715633646236846,22,31,-9,24,40,-16,30,54,-24,2,3,0,0
"1202","ARI","MIN",2012020297,15764,20122013,1,60,3,4,-1,2.99577594801806,5.54529182049424,-2.54951587247618,28,23,5,49,33,16,67,48,19,5,6,0,0
"1203","ARI","ANA",2012020308,15766,20122013,1,65,4,4,0,8.95312103143528,5.39773333165795,3.55538769977733,37,35,2,54,45,9,81,58,23,1,4,0,0
"1204","ARI","ANA",2012020322,15768,20122013,1,65,4,4,0,6.60436370804382,3.800853575421,2.80351013262282,40,31,9,55,44,11,71,49,22,4,2,0,0
"1205","ARI","ANA",2012020338,15770,20122013,0,60,0,2,-2,1.82855586889491,4.33057446426946,-2.50201859537455,18,24,-6,34,31,3,51,43,8,3,2,0,0
"1206","ARI","STL",2012020348,15771,20122013,1,60,3,6,-3,3.2897768697585,3.5920141430106,-0.302237273252103,26,30,-4,39,41,-2,57,47,10,6,4,0,0
"1207","ARI","DAL",2012020363,15773,20122013,1,60,2,1,1,3.22021542847506,3.37663567693186,-0.156420248456802,21,21,0,34,31,3,46,61,-15,2,5,0,0
"1208","ARI","L.A",2012020387,15776,20122013,1,60,5,2,3,1.55308952549967,4.09118982482509,-2.53810029932542,29,33,-4,35,41,-6,44,66,-22,3,5,0,0
"1209","ARI","STL",2012020397,15778,20122013,0,60,0,3,-3,3.49274056334991,4.70219462252953,-1.20945405917962,28,30,-2,37,41,-4,55,54,1,3,5,0,0
"1210","ARI","CBJ",2012020412,15780,20122013,0,65,0,0,0,7.96628871536374,5.20427372069389,2.76201499466985,39,23,16,51,37,14,74,50,24,2,2,0,0
"1211","ARI","L.A",2012020428,15782,20122013,0,60,0,4,-4,4.06459803692285,5.0541051073385,-0.989507070415653,27,29,-2,44,44,0,57,56,1,5,7,0,0
"1212","ARI","L.A",2012020437,15783,20122013,0,60,2,3,-1,5.97555511214091,2.08525267655205,3.89030243558886,42,29,13,55,42,13,70,52,18,5,6,0,0
"1213","ARI","VAN",2012020450,15785,20122013,1,60,1,2,-1,3.80225461538794,2.80545897816774,0.996795637220202,34,32,2,48,42,6,65,48,17,3,5,0,0
"1214","ARI","DET",2012020477,15789,20122013,1,60,2,3,-1,3.24373344847415,4.65658487109613,-1.41285142262198,30,35,-5,48,52,-4,58,62,-4,3,5,0,0
"1215","ARI","MIN",2012020489,15791,20122013,0,62.7166666666667,3,4,-1,2.62549630605599,4.82849985055509,-2.2030035444991,27,37,-10,33,54,-21,44,67,-23,2,4,0,0
"1216","ARI","NSH",2012020498,15792,20122013,0,60,7,4,3,7.93772204092238,5.67112850252306,2.26659353839932,29,38,-9,37,51,-14,43,59,-16,3,5,0,0
"1217","ARI","S.J",2012020516,15794,20122013,0,65,2,2,0,3.0331945149228,2.70169781544973,0.331496699473064,29,34,-5,39,59,-20,55,86,-31,1,1,0,0
"1218","ARI","L.A",2012020537,15797,20122013,1,60,3,1,2,6.5167544175772,7.31727131869957,-0.800516901122364,31,40,-9,45,52,-7,54,65,-11,3,3,0,0
"1219","ARI","DET",2012020551,15799,20122013,1,60,4,2,2,4.35824181798239,4.77814297773466,-0.419901159752277,38,36,2,44,47,-3,50,67,-17,5,7,0,0
"1220","ARI","COL",2012020567,15801,20122013,1,60,4,0,4,4.48077592770278,4.16928498481637,0.311490942886408,28,24,4,48,40,8,58,52,6,4,4,0,0
"1221","ARI","VAN",2012020580,15803,20122013,0,60,0,2,-2,2.10853104721676,4.36163975624368,-2.25310870902692,19,42,-23,34,53,-19,42,63,-21,4,3,0,0
"1222","ARI","EDM",2012020594,15805,20122013,0,60,3,1,2,5.19516987993848,3.84236044785939,1.35280943207908,32,30,2,47,45,2,63,53,10,6,4,0,0
"1223","ARI","CGY",2012020609,15807,20122013,0,64.6,2,3,-1,5.83373529804851,4.4765714103064,1.35716388774211,31,25,6,50,36,14,63,46,17,2,1,0,0
"1224","ARI","S.J",2012020631,15810,20122013,1,60,0,4,-4,4.63220966243431,6.19911147645325,-1.56690181401895,35,41,-6,55,53,2,68,65,3,4,3,0,0
"1225","ARI","STL",2012020650,15813,20122013,0,65,1,1,0,5.97136531465003,4.94966048403876,1.02170483061127,34,30,4,47,38,9,64,50,14,6,3,0,0
"1226","ARI","CHI",2012020666,15815,20122013,0,65,2,2,0,4.67814962562989,5.3201966299149,-0.642047004285018,31,38,-7,37,46,-9,54,65,-11,5,4,0,0
"1227","ARI","DET",2012020678,15817,20122013,0,60,0,4,-4,4.97364403191023,3.80341376781871,1.17023026409151,34,23,11,44,39,5,55,48,7,5,6,0,0
"1228","ARI","S.J",2012020693,15819,20122013,1,60,2,1,1,5.1429819230581,2.89487888658186,2.24810303647624,32,34,-2,44,46,-2,58,66,-8,4,2,0,0
"1229","ARI","COL",2012020707,15821,20122013,1,65,4,4,0,3.19502969644964,3.25289990642017,-0.0578702099705311,37,28,9,46,37,9,57,51,6,7,5,0,0
"1230","ARI","ANA",2012020719,15822,20122013,0,60,5,3,2,5.12171862754334,5.28415717958705,-0.16243855204371,31,46,-15,43,57,-14,59,72,-13,2,4,0,0
"1231","ARI","NYR",2013020013,15981,20132014,1,60,4,1,3,2.98950892082667,2.87938042532551,0.110128495501158,32,24,8,42,34,8,60,51,9,4,5,0,0
"1232","ARI","S.J",2013020031,15983,20132014,0,60,1,4,-3,3.12113351261564,8.40338949716534,-5.28225598454969,23,51,-28,30,66,-36,44,79,-35,1,4,0,0
"1233","ARI","NYI",2013020038,15986,20132014,0,60,1,6,-5,3.9989836666291,2.77780941528636,1.22117425134275,34,28,6,49,37,12,56,46,10,5,8,0,0
"1234","ARI","DET",2013020051,15988,20132014,0,60,4,2,2,6.02772565809579,3.7676377442549,2.26008791384089,38,30,8,50,38,12,56,51,5,3,3,0,0
"1235","ARI","PHI",2013020058,15989,20132014,0,60,2,1,1,3.3077720367063,5.18468659476028,-1.87691455805398,31,37,-6,46,59,-13,63,70,-7,7,5,0,0
"1236","ARI","CAR",2013020075,15991,20132014,0,60,5,3,2,6.68506408361037,4.97525880285411,1.70980528075626,32,34,-2,50,54,-4,60,70,-10,7,11,0,0
"1237","ARI","OTT",2013020093,15993,20132014,1,62.8,3,4,-1,5.02266899405222,4.5857654241466,0.436903569905629,37,32,5,50,48,2,60,60,0,4,3,0,0
"1238","ARI","ANA",2013020109,15996,20132014,0,65,2,2,0,3.04260432437192,7.42498815535589,-4.38238383098397,32,39,-7,44,47,-3,59,67,-8,7,4,0,0
"1239","ARI","DET",2013020120,15997,20132014,1,60,5,2,3,4.35107192202122,3.01483187076519,1.33624005125603,33,33,0,46,45,1,63,53,10,3,3,0,0
"1240","ARI","CGY",2013020136,16000,20132014,1,60,4,2,2,7.95324803457015,3.98503680247018,3.96821123209997,33,24,9,45,39,6,59,54,5,3,3,0,0
"1241","ARI","L.A",2013020148,16002,20132014,0,60,4,7,-3,5.19427668239179,6.73471189922566,-1.54043521683387,28,38,-10,38,50,-12,51,59,-8,4,5,0,0
"1242","ARI","EDM",2013020164,16004,20132014,1,60,5,4,1,3.10616868454963,4.02737173468631,-0.921203050136683,28,30,-2,40,37,3,54,46,8,6,2,0,0
"1243","ARI","L.A",2013020183,16007,20132014,1,60,3,1,2,5.29801593393495,7.72812818579315,-2.4301122518582,33,42,-9,42,58,-16,56,76,-20,7,5,0,0
"1244","ARI","NSH",2013020190,16009,20132014,1,65,4,4,0,5.29848069203078,6.54866675671656,-1.25018606468578,25,40,-15,40,57,-17,58,70,-12,2,2,0,0
"1245","ARI","S.J",2013020211,16011,20132014,0,65,2,2,0,7.0072659640573,4.33162391663063,2.67564204742666,30,50,-20,38,61,-23,58,87,-29,4,5,0,0
"1246","ARI","VAN",2013020224,16014,20132014,1,65,2,2,0,8.73349277760099,4.47299935139017,4.26049342621081,32,33,-1,48,48,0,64,66,-2,3,3,0,0
"1247","ARI","ANA",2013020229,16015,20132014,0,60,2,5,-3,4.74237647192786,4.3508553004905,0.391521171437357,26,29,-3,37,40,-3,49,52,-3,4,4,0,0
"1248","ARI","WSH",2013020253,16018,20132014,1,65,3,3,0,6.09749093612712,3.97846980467875,2.11902113144836,35,32,3,44,41,3,60,55,5,7,8,0,0
"1249","ARI","STL",2013020272,16021,20132014,0,60.9333333333333,3,2,1,1.86800910125021,3.59853428823408,-1.73052518698387,19,39,-20,22,51,-29,33,68,-35,1,1,0,0
"1250","ARI","CHI",2013020280,16023,20132014,0,65,4,4,0,3.51893047490012,6.35068130702712,-2.831750832127,30,52,-22,42,60,-18,55,79,-24,4,4,0,0
"1251","ARI","T.B",2013020300,16025,20132014,1,60,6,3,3,6.05054237491277,5.44397098838817,0.606571386524593,30,30,0,37,45,-8,46,56,-10,3,2,0,0
"1252","ARI","COL",2013020332,16030,20132014,1,64.3,3,4,-1,12.4078228652361,3.81032766151998,8.59749520371611,44,30,14,64,36,28,78,51,27,3,5,0,0
"1253","ARI","ANA",2013020349,16032,20132014,1,60,2,4,-2,4.77529002954189,4.92375550890574,-0.148465479363856,44,27,17,59,41,18,83,51,32,5,5,0,0
"1254","ARI","NSH",2013020361,16034,20132014,0,60,2,4,-2,6.51199737389106,4.98885575972963,1.52314161416143,31,29,2,42,36,6,56,45,11,1,0,0,0
"1255","ARI","MIN",2013020374,16036,20132014,0,60,3,1,2,2.47889398681582,3.08731965353945,-0.608425666723633,26,29,-3,30,36,-6,36,50,-14,3,3,0,0
"1256","ARI","CHI",2013020399,16039,20132014,1,60,2,5,-3,3.93886464106617,7.11839828127995,-3.17953364021378,34,36,-2,49,47,2,60,63,-3,5,5,0,0
"1257","ARI","EDM",2013020417,16042,20132014,0,60,6,2,4,5.00528959004441,3.0587504087016,1.94653918134281,33,33,0,40,44,-4,50,65,-15,5,8,0,0
"1258","ARI","CGY",2013020421,16043,20132014,0,60,1,4,-3,2.39776017295662,4.01327876687398,-1.61551859391736,30,18,12,42,29,13,63,42,21,5,3,0,0
"1259","ARI","VAN",2013020437,16045,20132014,0,63.6833333333333,2,3,-1,4.52730936267471,3.56397099720198,0.963338365472737,39,32,7,47,41,6,65,51,14,2,2,0,0
"1260","ARI","COL",2013020466,16049,20132014,0,60,3,1,2,3.68522445409326,2.68965428786954,0.995570166223715,25,30,-5,37,41,-4,51,48,3,2,2,0,0
"1261","ARI","NYI",2013020481,16051,20132014,1,60,6,3,3,5.67492081967066,5.39571345727063,0.27920736240003,37,24,13,45,40,5,66,56,10,6,5,0,0
"1262","ARI","CAR",2013020496,16053,20132014,1,60,1,3,-2,4.59029014628158,5.65441321583057,-1.06412306954899,38,33,5,46,41,5,60,62,-2,5,7,0,0
"1263","ARI","MTL",2013020513,16056,20132014,0,60,1,3,-2,3.43587684934027,6.43547352426685,-2.99959667492658,27,28,-1,43,44,-1,70,58,12,4,4,0,0
"1264","ARI","TOR",2013020524,16058,20132014,0,65,1,1,0,6.53877303799479,5.33034640022322,1.20842663777157,35,27,8,57,36,21,77,47,30,2,3,0,0
"1265","ARI","OTT",2013020539,16060,20132014,0,62.3833333333333,4,3,1,4.61443632826707,5.42988327901347,-0.815446950746398,38,40,-2,49,53,-4,63,66,-3,10,11,0,0
"1266","ARI","S.J",2013020576,16066,20132014,1,65,3,3,0,5.18767417757772,3.89745044007347,1.29022373750425,37,32,5,48,53,-5,64,72,-8,2,3,0,0
"1267","ARI","ANA",2013020583,16067,20132014,0,60.85,2,3,-1,3.37256583630551,4.90113983867923,-1.52857400237372,25,41,-16,36,50,-14,51,61,-10,2,3,0,0
"1268","ARI","EDM",2013020609,16070,20132014,1,64.8833333333333,4,3,1,8.14838420570595,2.90489032230107,5.24349388340488,45,25,20,61,30,31,75,44,31,2,1,0,0
"1269","ARI","CBJ",2013020620,16072,20132014,1,60,0,2,-2,6.23645536723465,4.34736590887121,1.88908945836344,34,31,3,43,45,-2,56,55,1,5,4,0,0
"1270","ARI","PHI",2013020636,16074,20132014,1,60,3,5,-2,6.1735765778576,5.30872111869514,0.864855459162466,29,28,1,41,43,-2,56,54,2,4,3,0,0
"1271","ARI","CGY",2013020652,16077,20132014,1,60,6,0,6,5.28560060053132,4.12427658309753,1.1613240174338,30,27,3,41,46,-5,60,61,-1,3,2,0,0
"1272","ARI","MIN",2013020666,16079,20132014,1,60,1,4,-3,4.56754428518204,6.67128833333845,-2.10374404815641,40,29,11,56,36,20,76,50,26,3,3,0,0
"1273","ARI","ANA",2013020681,16081,20132014,1,60,3,5,-2,6.53452487731741,3.40554172528209,3.12898315203532,31,30,1,50,39,11,78,43,35,6,3,0,0
"1274","ARI","WPG",2013020694,16083,20132014,0,60,1,5,-4,4.43305098527344,8.58799720907155,-4.15494622379811,19,38,-19,30,59,-29,47,73,-26,4,10,0,0
"1275","ARI","STL",2013020703,16084,20132014,0,60,1,2,-1,3.47936962448875,1.63665614195634,1.84271348253242,21,18,3,32,26,6,49,34,15,3,3,0,0
"1276","ARI","VAN",2013020720,16086,20132014,1,60,1,0,1,3.2012685439043,3.74447473630816,-0.543206192403865,23,29,-6,42,45,-3,55,55,0,10,10,0,0
"1277","ARI","N.J",2013020733,16088,20132014,1,60,3,2,1,2.958262385946,4.54621071006113,-1.58794832411513,27,35,-8,41,47,-6,51,73,-22,3,2,0,0
"1278","ARI","TOR",2013020744,16090,20132014,1,60,2,4,-2,3.46112421275562,6.49268682788534,-3.03156261512972,41,29,12,62,36,26,78,50,28,4,6,0,0
"1279","ARI","CGY",2013020758,16092,20132014,0,60,2,3,-1,6.97480152657954,2.14780578552745,4.82699574105209,32,26,6,42,32,10,66,40,26,2,2,0,0
"1280","ARI","EDM",2013020774,16094,20132014,0,60,4,3,1,6.89116996550001,4.87107287393883,2.02009709156118,29,39,-10,42,51,-9,61,63,-2,3,6,0,0
"1281","ARI","VAN",2013020788,16096,20132014,0,62.25,4,5,-1,3.89189183708771,5.38100047603257,-1.48910863894486,33,25,8,39,37,2,51,61,-10,6,5,0,0
"1282","ARI","L.A",2013020804,16098,20132014,1,60,3,0,3,5.81522667572744,8.39431022340432,-2.57908354767687,29,30,-1,42,47,-5,58,56,2,4,3,0,0
"1283","ARI","DAL",2013020852,16105,20132014,1,60,1,3,-2,5.9983546713629,6.57053928777987,-0.572184616416962,28,40,-12,46,49,-3,66,61,5,2,4,0,0
"1284","ARI","CHI",2013020870,16108,20132014,1,60,2,0,2,3.82467546335829,3.43150712747592,0.393168335882365,26,30,-4,37,37,0,49,51,-2,6,3,0,0
"1285","ARI","DAL",2013020881,16109,20132014,0,60,1,2,-1,3.73985901040191,3.79710874567536,-0.0572497352734445,27,33,-6,43,56,-13,55,74,-19,4,5,0,0
"1286","ARI","WPG",2013020894,16128,20132014,0,65,2,2,0,9.78213797626086,7.00343237161815,2.77870560464271,36,29,7,47,43,4,60,55,5,7,6,0,0
"1287","ARI","COL",2013020899,16129,20132014,0,60,2,4,-2,5.40570398150157,2.15291666941524,3.25278731208633,42,33,9,56,43,13,68,60,8,5,4,0,0
"1288","ARI","STL",2013020918,16131,20132014,1,60,2,4,-2,3.01946786840563,4.95064403070137,-1.93117616229574,25,30,-5,34,47,-13,49,57,-8,3,3,0,0
"1289","ARI","VAN",2013020931,16133,20132014,1,60,1,0,1,3.81292136394768,4.23474209337604,-0.421820729428358,32,23,9,45,38,7,60,59,1,3,0,0,0
"1290","ARI","MTL",2013020945,16135,20132014,1,60,5,2,3,4.66305997993913,4.10291342146229,0.560146558476845,23,26,-3,32,35,-3,43,52,-9,3,5,0,0
"1291","ARI","WSH",2013020958,16137,20132014,0,60,2,3,-1,5.0722961940337,8.72044557081244,-3.64814937677875,33,33,0,46,42,4,54,53,1,3,2,0,0
"1292","ARI","T.B",2013020970,16139,20132014,0,65,3,3,0,3.36141423604568,4.74826382826945,-1.38684959222378,20,31,-11,36,46,-10,52,66,-14,3,4,0,0
"1293","ARI","FLA",2013020980,16140,20132014,0,60,3,1,2,3.8793246809073,4.40248016394344,-0.523155483036135,26,32,-6,35,49,-14,40,60,-20,3,5,0,0
"1294","ARI","BOS",2013020989,16142,20132014,0,60,1,2,-1,2.47974408394657,4.91817280004034,-2.43842871609377,22,20,2,28,30,-2,43,41,2,4,1,0,0
"1295","ARI","CGY",2013021011,16144,20132014,1,60,3,2,1,6.02628548099892,4.01352057591694,2.01276490508198,26,31,-5,45,37,8,62,55,7,10,6,0,0
"1296","ARI","L.A",2013021025,16146,20132014,0,60,4,3,1,3.5897908732295,6.65101091703752,-3.06122004380802,27,39,-12,35,52,-17,43,65,-22,4,4,0,0
"1297","ARI","FLA",2013021048,16149,20132014,1,60,2,1,1,3.16118532605469,2.50196389679331,0.659221429261379,22,23,-1,29,35,-6,43,47,-4,1,3,0,0
"1298","ARI","BOS",2013021063,16151,20132014,1,60,2,4,-2,4.64573538050172,6.7607676795742,-2.11503229907248,33,28,5,47,44,3,59,63,-4,5,5,0,0
"1299","ARI","NYR",2013021073,16153,20132014,0,61.9333333333333,3,4,-1,1.52191789188828,5.6056782626365,-4.08376037074822,21,36,-15,30,48,-18,45,63,-18,5,3,0,0
"1300","ARI","N.J",2013021093,16156,20132014,0,65,2,2,0,2.87300710362615,4.29565939900931,-1.42265229538316,27,28,-1,34,41,-7,40,50,-10,3,4,0,0
"1301","ARI","MIN",2013021116,16158,20132014,1,60,1,3,-2,3.65683172013087,4.85502602733068,-1.19819430719981,24,30,-6,35,38,-3,57,48,9,5,2,0,0
"1302","ARI","WPG",2013021138,16161,20132014,1,65,1,1,0,2.88246713398257,5.04194632379949,-2.15947918981692,29,22,7,46,32,14,60,44,16,2,1,0,0
"1303","ARI","L.A",2013021143,16162,20132014,0,60,0,4,-4,1.25282425130354,3.96175229988876,-2.70892804858522,17,32,-15,30,39,-9,43,53,-10,2,4,0,0
"1304","ARI","EDM",2013021158,16164,20132014,1,65,2,2,0,3.40341539006377,2.61737773969071,0.786037650373064,26,26,0,40,38,2,52,55,-3,2,1,0,0
"1305","ARI","CBJ",2013021183,16168,20132014,0,63.55,3,4,-1,7.036957084405,7.19880208914401,-0.161845004739007,32,30,2,42,39,3,57,59,-2,2,1,0,0
"1306","ARI","NSH",2013021200,16170,20132014,0,60,0,2,-2,6.0626636591478,3.19145925345947,2.87120440568833,29,23,6,45,34,11,61,38,23,2,2,0,0
"1307","ARI","S.J",2013021218,16172,20132014,1,60,2,3,-1,4.73584978823283,2.92817056667991,1.80767922155292,32,32,0,48,37,11,66,49,17,1,3,0,0
"1308","ARI","DAL",2013021230,16173,20132014,1,60,2,1,1,4.65085300111241,2.18261520841667,2.46823779269574,31,17,14,45,25,20,55,33,22,6,3,0,0
"1309","ARI","WPG",2014020016,16352,20142015,1,60,2,6,-4,3.6874571973749,2.08673031092235,1.60072688645255,28,27,1,41,35,6,57,43,14,6,8,0,0
"1310","ARI","L.A",2014020030,16354,20142015,1,64.7666666666667,3,2,1,6.92637278217516,2.84049684734782,4.08587593482734,40,26,14,53,40,13,63,62,1,7,6,0,0
"1311","ARI","EDM",2014020049,16358,20142015,1,60,7,4,3,7.36056018577074,3.35949579312341,4.00106439264733,30,27,3,41,37,4,53,54,-1,5,3,0,0
"1312","ARI","STL",2014020072,16361,20142015,1,60,1,6,-5,3.42050141538493,4.90917343183537,-1.48867201645044,25,36,-11,37,52,-15,52,66,-14,5,5,0,0
"1313","ARI","NSH",2014020083,16364,20142015,0,65,3,3,0,5.90003309142776,5.318042403047,0.581990688380756,36,26,10,42,43,-1,59,59,0,5,5,0,0
"1314","ARI","MIN",2014020097,16366,20142015,0,60,0,2,-2,4.0355773250035,4.94632789898697,-0.910750573983474,26,29,-3,41,41,0,55,60,-5,2,3,0,0
"1315","ARI","FLA",2014020115,16368,20142015,1,62.3333333333333,2,1,1,5.30137320153881,2.53104061440216,2.77033258713665,41,24,17,56,36,20,77,45,32,8,2,0,0
"1316","ARI","T.B",2014020130,16371,20142015,0,60,3,7,-4,5.37237704542349,6.1141918564681,-0.741814811044605,25,35,-10,36,50,-14,52,63,-11,0,3,0,0
"1317","ARI","FLA",2014020143,16373,20142015,0,60,1,2,-1,5.10788997076452,4.50554886000464,0.60234111075988,33,26,7,42,34,8,50,50,0,6,5,0,0
"1318","ARI","CAR",2014020160,16375,20142015,0,60,0,3,-3,4.40169816391426,7.04428074309106,-2.6425825791768,25,35,-10,39,45,-6,53,56,-3,5,4,0,0
"1319","ARI","WSH",2014020167,16376,20142015,0,60,6,5,1,5.16210468049394,4.48724083460876,0.674863845885184,30,37,-7,47,49,-2,68,62,6,8,5,0,0
"1320","ARI","TOR",2014020183,16378,20142015,1,60,3,2,1,4.68490620801066,3.29449643445196,1.39040977355869,33,30,3,43,38,5,59,50,9,5,6,0,0
"1321","ARI","ANA",2014020201,16381,20142015,0,65,2,2,0,3.74441687046783,4.82121938364071,-1.07680251317288,25,39,-14,35,60,-25,52,81,-29,3,4,0,0
"1322","ARI","NYI",2014020212,16382,20142015,1,60,0,1,-1,2.32554999245299,5.40133421018095,-3.07578421772796,19,33,-14,33,50,-17,49,63,-14,5,3,0,0
"1323","ARI","DAL",2014020229,16385,20142015,1,60,3,4,-1,4.8998829886259,1.59996013323689,3.29992285538901,37,32,5,53,38,15,78,55,23,6,4,0,0
"1324","ARI","CGY",2014020239,16387,20142015,0,60,3,5,-2,4.94678854646918,3.34903653993295,1.59775200653623,23,25,-2,34,42,-8,52,61,-9,2,4,0,0
"1325","ARI","VAN",2014020247,16388,20142015,0,60,5,0,5,2.77452390146209,6.01254707043877,-3.23802316897668,23,35,-12,34,47,-13,42,70,-28,5,4,0,0
"1326","ARI","EDM",2014020265,16390,20142015,0,60,2,1,1,4.89525422433508,7.00773932075481,-2.11248509641973,28,34,-6,36,45,-9,57,70,-13,4,4,0,0
"1327","ARI","WSH",2014020276,16392,20142015,1,63.2666666666667,1,2,-1,3.98568356024043,3.84966644644555,0.136017113794878,24,24,0,36,33,3,50,50,0,4,3,0,0
"1328","ARI","DAL",2014020285,16394,20142015,0,60,1,3,-2,4.04818248740048,4.68549943260587,-0.637316945205384,27,27,0,40,47,-7,56,58,-2,2,2,0,0
"1329","ARI","S.J",2014020307,16396,20142015,0,65,3,3,0,3.96379841482849,6.55249619983718,-2.58869778500869,25,43,-18,29,60,-31,48,91,-43,2,4,0,0
"1330","ARI","ANA",2014020310,16397,20142015,0,60,1,2,-1,5.17458637163509,4.05711564789817,1.11747072373691,27,30,-3,40,47,-7,51,61,-10,3,2,0,0
"1331","ARI","COL",2014020320,16399,20142015,1,63.2666666666667,3,4,-1,4.05031334121668,8.06430191158597,-4.01398857036929,33,35,-2,47,42,5,54,60,-6,1,2,0,0
"1332","ARI","CGY",2014020353,16403,20142015,1,60,0,3,-3,2.14286386762069,4.54784131608176,-2.40497744846107,26,29,-3,37,36,1,63,52,11,1,2,0,0
"1333","ARI","EDM",2014020360,16405,20142015,0,60,5,2,3,0,0,0,24,27,-3,31,37,-6,42,50,-8,3,5,0,0
"1334","ARI","CGY",2014020369,16406,20142015,0,60,2,5,-3,6.00061619649442,2.7895026326878,3.21111356380662,29,24,5,41,35,6,67,46,21,1,3,0,0
"1335","ARI","L.A",2014020385,16408,20142015,1,60,0,4,-4,5.09196674666087,7.71600692179709,-2.62404017513622,26,43,-17,40,56,-16,51,73,-22,2,3,0,0
"1336","ARI","BOS",2014020400,16410,20142015,1,60,2,5,-3,6.33888654409384,8.60116050799115,-2.26227396389731,26,33,-7,43,44,-1,53,57,-4,4,2,0,0
"1337","ARI","NSH",2014020429,16415,20142015,1,60,1,5,-4,8.27141782793478,4.5677810034249,3.70363682450989,32,38,-6,45,47,-2,61,63,-2,3,5,0,0
"1338","ARI","MIN",2014020444,16417,20142015,1,65,3,3,0,5.7614416892975,5.7273220888892,0.0341196004083031,30,35,-5,52,48,4,80,69,11,4,4,0,0
"1339","ARI","EDM",2014020463,16420,20142015,1,64.9833333333333,2,1,1,8.45311354484875,9.06103675680478,-0.607923211956034,44,32,12,57,52,5,76,71,5,4,2,0,0
"1340","ARI","L.A",2014020479,16424,20142015,0,60,2,4,-2,3.04864465579602,3.95121003923123,-0.902565383435203,17,35,-18,36,54,-18,51,66,-15,3,5,0,0
"1341","ARI","VAN",2014020500,16426,20142015,0,60,1,7,-6,6.91289239587786,4.60551172328996,2.3073806725879,39,40,-1,52,46,6,75,56,19,6,8,0,0
"1342","ARI","EDM",2014020510,16427,20142015,0,60,5,1,4,4.6437550535893,4.33217302018738,0.311582033401919,22,27,-5,34,39,-5,52,54,-2,3,7,0,0
"1343","ARI","ANA",2014020523,16431,20142015,1,65,1,1,0,5.11792262308882,7.16044798607751,-2.0425253629887,29,36,-7,36,52,-16,58,67,-9,1,1,0,0
"1344","ARI","PHI",2014020540,16433,20142015,1,60,4,2,2,4.52469944246695,5.67340256439638,-1.14870312192943,25,32,-7,36,51,-15,45,66,-21,2,2,0,0
"1345","ARI","DAL",2014020553,16435,20142015,0,60,0,6,-6,3.69205846083581,6.9404910449684,-3.24843258413259,32,31,1,40,51,-11,56,62,-6,3,2,0,0
"1346","ARI","CBJ",2014020573,16438,20142015,1,60,6,3,3,4.30943689026753,2.79245684080805,1.51698004945949,34,26,8,50,30,20,63,45,18,4,3,0,0
"1347","ARI","STL",2014020591,16441,20142015,1,60,0,6,-6,3.86682627368714,6.40680781483024,-2.53998154114311,23,39,-16,34,57,-23,46,65,-19,1,5,0,0
"1348","ARI","WPG",2014020605,16443,20142015,1,60,4,1,3,5.48771383179076,6.243989542083,-0.756275710292243,30,35,-5,42,54,-12,49,74,-25,5,6,0,0
"1349","ARI","OTT",2014020619,16445,20142015,1,60,1,5,-4,5.18114726975909,3.57230945536867,1.60883781439043,32,33,-1,39,42,-3,50,56,-6,5,5,0,0
"1350","ARI","S.J",2014020639,16448,20142015,1,60,2,3,-1,4.74536107538734,5.10087880131323,-0.355517725925893,29,25,4,42,36,6,58,56,2,3,3,0,0
"1351","ARI","CGY",2014020652,16450,20142015,1,60,1,4,-3,2.51475944026606,4.3068027299305,-1.79204328966443,28,25,3,43,39,4,57,51,6,0,2,0,0
"1352","ARI","MIN",2014020669,16452,20142015,0,60,1,3,-2,4.51397312758806,6.03048211889109,-1.51650899130303,26,33,-7,35,44,-9,51,53,-2,4,5,0,0
"1353","ARI","WPG",2014020674,16453,20142015,0,65,3,3,0,5.80101322414703,3.2586158334783,2.54239739066873,31,30,1,43,44,-1,54,59,-5,6,5,0,0
"1354","ARI","CHI",2014020689,16455,20142015,0,60,1,6,-5,3.7295443121111,7.37466027880146,-3.64511596669035,36,51,-15,39,62,-23,49,82,-33,2,5,0,0
"1355","ARI","PHI",2014020698,16462,20142015,0,65,3,3,0,4.42128855441115,6.1864714861731,-1.76518293176196,27,42,-15,41,60,-19,48,79,-31,1,2,0,0
"1356","ARI","TOR",2014020714,16464,20142015,0,60,3,1,2,6.53959182587869,4.57179096636446,1.96780085951423,45,25,20,61,41,20,71,56,15,3,3,0,0
"1357","ARI","OTT",2014020729,16466,20142015,0,60,2,7,-5,5.59101224463666,4.14690217858879,1.44411006604787,37,31,6,44,47,-3,60,63,-3,4,6,0,0
"1358","ARI","MTL",2014020738,16467,20142015,0,60,3,2,1,6.39857607442332,3.56010120222345,2.83847487219987,32,20,12,42,33,9,56,53,3,2,2,0,0
"1359","ARI","CBJ",2014020748,16469,20142015,0,60,4,1,3,3.70891108925571,3.47245475701882,0.236456332236884,29,31,-2,36,45,-9,51,59,-8,3,3,0,0
"1360","ARI","CAR",2014020766,16471,20142015,1,65,1,1,0,3.68893764608574,7.46668370826228,-3.77774606217654,29,41,-12,40,51,-11,56,68,-12,0,3,0,0
"1361","ARI","DET",2014020781,16473,20142015,1,60,1,3,-2,3.06724695753235,4.26446056523127,-1.19721360769893,23,26,-3,36,37,-1,50,53,-3,5,6,0,0
"1362","ARI","CHI",2014020795,16475,20142015,0,65,2,2,0,2.64566267643193,5.31810324635444,-2.67244056992251,29,38,-9,39,47,-8,58,65,-7,2,4,0,0
"1363","ARI","S.J",2014020821,16479,20142015,1,60,2,4,-2,6.52804425009526,4.23938377760351,2.28866047249176,36,26,10,53,34,19,71,48,23,3,4,0,0
"1364","ARI","NYR",2014020829,16480,20142015,1,60,1,5,-4,7.25506134959869,5.9739328537043,1.28112849589439,35,32,3,56,47,9,66,62,4,3,0,0,0
"1365","ARI","COL",2014020842,16482,20142015,0,60,2,5,-3,3.65790760940905,4.42309154116083,-0.765183931751778,17,34,-17,30,45,-15,47,49,-2,1,3,0,0
"1366","ARI","T.B",2014020882,16487,20142015,1,60,2,4,-2,7.83601237533216,4.79567007120932,3.04034230412285,24,27,-3,40,45,-5,52,65,-13,1,5,0,0
"1367","ARI","N.J",2014020892,16489,20142015,0,60,0,3,-3,2.61508701206185,4.66887722949837,-2.05379021743652,38,28,10,48,34,14,59,42,17,4,2,0,0
"1368","ARI","NYI",2014020895,16490,20142015,0,60,1,5,-4,4.87064945400084,6.50672641733945,-1.63607696333861,28,39,-11,45,50,-5,69,72,-3,4,2,0,0
"1369","ARI","NYR",2014020909,16492,20142015,0,60,3,4,-1,7.50855696536428,5.67472160575562,1.83383535960866,40,38,2,56,49,7,64,68,-4,4,3,0,0
"1370","ARI","BOS",2014020927,16494,20142015,0,60,1,4,-3,4.2027633766093,5.88274891674519,-1.67998554013588,32,34,-2,40,45,-5,51,57,-6,1,5,0,0
"1371","ARI","ANA",2014020949,16497,20142015,1,60,1,4,-3,2.92313924337031,8.03777722816449,-5.11463798479417,30,35,-5,41,54,-13,52,65,-13,3,1,0,0
"1372","ARI","VAN",2014020962,16499,20142015,1,65,2,2,0,5.94775289948201,3.79799481123337,2.14975808824865,35,34,1,45,47,-2,59,66,-7,1,3,0,0
"1373","ARI","MTL",2014020977,16501,20142015,1,60,0,2,-2,2.79389076327425,6.51883792451088,-3.72494716123663,28,35,-7,46,48,-2,63,63,0,3,2,0,0
"1374","ARI","NSH",2014020989,16503,20142015,1,62.75,1,2,-1,5.53496957694733,5.39033587724043,0.144633699706901,28,40,-12,48,64,-16,68,80,-12,4,6,0,0
"1375","ARI","CHI",2014021011,16506,20142015,1,60,1,2,-1,3.03537718008738,8.68843531471248,-5.6530581346251,18,44,-26,26,56,-30,36,79,-43,2,6,0,0
"1376","ARI","N.J",2014021027,16508,20142015,1,60,1,4,-3,4.52745049163466,6.08406816893694,-1.55661767730228,31,29,2,46,40,6,66,52,14,2,4,0,0
"1377","ARI","L.A",2014021040,16510,20142015,0,60,0,1,-1,3.41729406069499,3.07738676309327,0.339907297601712,25,35,-10,31,47,-16,42,65,-23,2,3,0,0
"1378","ARI","COL",2014021062,16513,20142015,1,60,2,5,-3,5.03310604602302,3.20338438378531,1.82972166223772,30,29,1,50,39,11,59,50,9,1,2,0,0
"1379","ARI","VAN",2014021082,16516,20142015,1,60,1,3,-2,4.15679020015523,5.18676014829543,-1.02996994814021,27,44,-17,44,60,-16,64,81,-17,1,2,0,0
"1380","ARI","DET",2014021094,16518,20142015,0,63.1333333333333,5,4,1,2.03491071678349,4.49313165541389,-2.4582209386304,22,37,-15,30,48,-18,40,62,-22,4,5,0,0
"1381","ARI","S.J",2014021166,16528,20142015,0,60,1,3,-2,5.17087769735099,5.24842038376119,-0.0775426864101973,21,37,-16,34,55,-21,51,79,-28,2,3,0,0
"1382","ARI","S.J",2014021177,16529,20142015,1,60,5,3,2,7.04564321895396,8.65587435054636,-1.6102311315924,36,45,-9,52,65,-13,68,86,-18,4,6,0,0
"1383","ARI","CGY",2014021198,16532,20142015,0,60,2,3,-1,4.06333295325749,4.4793541324907,-0.416021179233212,24,32,-8,33,45,-12,59,66,-7,0,4,0,0
"1384","ARI","VAN",2014021213,16534,20142015,0,60,0,5,-5,3.14157333220417,5.63144081245741,-2.48986748025324,28,32,-4,39,43,-4,53,56,-3,5,5,0,0
"1385","ARI","ANA",2014021229,16536,20142015,1,60,1,2,-1,4.99930474307621,7.11732734019046,-2.11802259711425,24,38,-14,36,60,-24,50,69,-19,4,4,0,0
"1386","ARI","L.A",2015020016,16717,20152016,0,60,4,1,3,2.76593132037669,5.65703936933551,-2.89110804895881,22,41,-19,29,63,-34,36,73,-37,4,5,0,0
"1387","ARI","ANA",2015020049,16722,20152016,0,60,4,0,4,3.79587261064444,5.50556258607151,-1.70968997542707,29,37,-8,38,46,-8,53,54,-1,6,3,0,0
"1388","ARI","MIN",2015020057,16723,20152016,1,60,3,4,-1,3.9091870875011,3.50279635608155,0.406390731419545,30,24,6,43,33,10,58,41,17,9,7,0,0
"1389","ARI","BOS",2015020074,16725,20152016,1,60,3,5,-2,1.8073731209638,7.21183465985609,-5.40446153889229,24,43,-19,34,56,-22,57,73,-16,4,6,0,0
"1390","ARI","N.J",2015020081,16728,20152016,0,60.7166666666667,2,3,-1,3.21873432658685,2.6268291141605,0.591905212426354,20,25,-5,31,33,-2,41,37,4,5,3,0,0
"1391","ARI","NYR",2015020092,16730,20152016,0,60,1,4,-3,6.13466826024601,3.3937119062175,2.7409563540285,35,28,7,47,34,13,52,49,3,3,3,0,0
"1392","ARI","OTT",2015020109,16732,20152016,0,60,4,1,3,4.34067201227253,6.68662658720655,-2.34595457493401,26,36,-10,34,55,-21,44,68,-24,2,3,0,0
"1393","ARI","TOR",2015020122,16734,20152016,0,60,4,3,1,4.33759889607609,3.64884077455554,0.688758121520543,24,27,-3,31,47,-16,39,63,-24,5,3,0,0
"1394","ARI","BOS",2015020124,16735,20152016,0,60,0,6,-6,2.07428848145719,3.55031600334041,-1.47602752188322,24,27,-3,35,39,-4,53,48,5,3,4,0,0
"1395","ARI","VAN",2015020153,16738,20152016,1,60,3,4,-1,4.6136972483276,5.33671406042413,-0.72301681209653,31,22,9,45,31,14,61,40,21,2,4,0,0
"1396","ARI","COL",2015020191,16744,20152016,1,60,4,2,2,5.70596621189907,3.90465580196678,1.80131040993228,28,28,0,37,41,-4,47,57,-10,6,5,0,0
"1397","ARI","NYR",2015020208,16746,20152016,1,60,1,4,-3,5.47345869638993,4.37229410826694,1.10116458812298,40,30,10,52,40,12,72,47,25,4,3,0,0
"1398","ARI","ANA",2015020215,16748,20152016,0,61.3,4,3,1,1.97280170024952,4.87429117841607,-2.90148947816655,28,36,-8,41,49,-8,53,61,-8,5,4,0,0
"1399","ARI","L.A",2015020226,16749,20152016,0,60,3,2,1,2.76950025302358,4.42969520670158,-1.660194953678,25,35,-10,35,51,-16,48,68,-20,3,2,0,0
"1400","ARI","EDM",2015020240,16751,20152016,1,60,4,1,3,2.88939627630502,4.58207520890392,-1.69267893259889,21,28,-7,31,37,-6,41,52,-11,3,4,0,0
"1401","ARI","CBJ",2015020254,16753,20152016,0,60,2,5,-3,5.29981204192154,3.61472662806804,1.6850854138535,29,21,8,41,27,14,56,29,27,10,9,0,0
"1402","ARI","NYI",2015020261,16755,20152016,0,60,2,5,-3,2.58352519234177,5.01337130235333,-2.42984611001157,33,32,1,39,37,2,50,57,-7,3,4,0,0
"1403","ARI","MTL",2015020282,16758,20152016,0,60,3,2,1,6.21115485421615,4.27180235555666,1.93935249865948,20,33,-13,37,54,-17,49,75,-26,2,5,0,0
"1404","ARI","WPG",2015020299,16760,20152016,0,60,2,3,-1,3.8620652295258,2.14504242888261,1.71702280064319,29,23,6,35,33,2,45,46,-1,7,6,0,0
"1405","ARI","ANA",2015020327,16764,20152016,1,60,4,2,2,5.47350434761029,3.9081387877708,1.56536555983949,34,31,3,42,44,-2,62,52,10,4,4,0,0
"1406","ARI","CGY",2015020341,16766,20152016,1,64.3333333333333,2,1,1,2.83589110802859,2.62487794528442,0.211013162744166,21,26,-5,31,37,-6,45,56,-11,3,7,0,0
"1407","ARI","OTT",2015020351,16767,20152016,1,60,4,3,1,3.56124843965517,2.77066318464495,0.790585255010228,19,38,-19,29,56,-27,36,70,-34,2,3,0,0
"1408","ARI","NSH",2015020364,16770,20152016,0,60,2,5,-3,3.26779987453483,7.41069496667478,-4.14289509213995,15,41,-26,20,55,-35,38,66,-28,2,2,0,0
"1409","ARI","DET",2015020377,16772,20152016,0,60,1,5,-4,2.99209800660174,5.70885452850052,-2.71675652189879,27,44,-17,30,53,-23,38,67,-29,1,4,0,0
"1410","ARI","CAR",2015020398,16775,20152016,0,60,4,5,-1,1.74285505826265,2.65669436922257,-0.913839310959919,23,18,5,30,32,-2,42,45,-3,4,4,0,0
"1411","ARI","MIN",2015020433,16780,20152016,1,60.5666666666667,2,1,1,2.6265928784851,5.07099928897878,-2.44440641049368,21,28,-7,31,35,-4,42,47,-5,6,4,0,0
"1412","ARI","CAR",2015020442,16781,20152016,1,60.8833333333333,4,5,-1,4.20442429254763,2.91934620220127,1.28507809034636,29,33,-4,43,50,-7,56,59,-3,2,3,0,0
"1413","ARI","CBJ",2015020476,16786,20152016,1,60,5,7,-2,0,0,0,32,21,11,48,30,18,70,37,33,3,1,0,0
"1414","ARI","NYI",2015020491,16788,20152016,1,60,1,0,1,3.4928574484675,3.15437928927713,0.338478159190366,29,25,4,42,38,4,58,54,4,2,3,0,0
"1415","ARI","TOR",2015020515,16791,20152016,1,60,3,2,1,5.94066920969635,4.33784882850209,1.60282038119427,26,39,-13,37,55,-18,46,75,-29,4,2,0,0
"1416","ARI","L.A",2015020524,16795,20152016,1,60.6,3,4,-1,3.87109930709994,5.75633005518016,-1.88523074808022,27,33,-6,44,50,-6,60,66,-6,5,7,0,0
"1417","ARI","COL",2015020532,16796,20152016,0,64.2833333333333,2,1,1,4.27911320058781,5.7777083036505,-1.49859510306269,28,39,-11,39,48,-9,53,68,-15,6,5,0,0
"1418","ARI","CHI",2015020550,16798,20152016,1,60,5,7,-2,4.91183101180366,5.2359898078979,-0.324158796094239,37,29,8,53,41,12,65,47,18,8,4,0,0
"1419","ARI","WPG",2015020564,16800,20152016,1,60,4,2,2,4.87697923055384,6.01979038894922,-1.14281115839538,21,37,-16,33,60,-27,42,80,-38,6,4,0,0
"1420","ARI","EDM",2015020568,16802,20152016,0,65,3,3,0,3.97855897513681,4.91275334608087,-0.934194370944065,34,41,-7,49,51,-2,65,70,-5,4,5,0,0
"1421","ARI","VAN",2015020587,16804,20152016,0,60,3,2,1,3.15490830130875,3.95214088899652,-0.797232587687773,29,37,-8,37,47,-10,46,63,-17,2,2,0,0
"1422","ARI","CGY",2015020605,16807,20152016,0,60,2,1,1,3.03750602476066,3.64903466537146,-0.6115286406108,33,26,7,44,38,6,60,52,8,3,3,0,0
"1423","ARI","NSH",2015020621,16809,20152016,1,60,4,0,4,4.42435089292849,4.71419049380347,-0.289839600874984,29,26,3,37,50,-13,43,67,-24,3,4,0,0
"1424","ARI","EDM",2015020641,16812,20152016,1,64.85,4,3,1,4.86163734635102,7.47187504791287,-2.61023770156186,31,28,3,48,54,-6,63,64,-1,4,3,0,0
"1425","ARI","DET",2015020652,16814,20152016,1,62.1333333333333,2,3,-1,5.4267724529559,6.75380694924388,-1.32703449628798,29,25,4,43,46,-3,51,56,-5,4,4,0,0
"1426","ARI","N.J",2015020667,16816,20152016,1,60,0,2,-2,7.19424250924749,2.2319063544701,4.96233615477739,38,16,22,69,25,44,96,31,65,6,3,0,0
"1427","ARI","S.J",2015020701,16821,20152016,1,60,1,3,-2,3.35906480528951,3.62907142995391,-0.270006624664404,24,23,1,40,43,-3,54,53,1,1,2,0,0
"1428","ARI","L.A",2015020718,16823,20152016,1,60,3,2,1,4.11029663572481,3.40211271244334,0.708183923281467,24,28,-4,36,37,-1,46,62,-16,5,3,0,0
"1429","ARI","MIN",2015020730,16825,20152016,0,65,1,1,0,5.97795687621692,2.39760662075983,3.58035025545709,24,35,-11,41,42,-1,56,61,-5,3,2,0,0
"1430","ARI","WPG",2015020737,16826,20152016,0,60,2,5,-3,3.66021720898012,4.45179556077665,-0.791578351796527,34,37,-3,41,43,-2,64,53,11,5,4,0,0
"1431","ARI","L.A",2015020754,16833,20152016,1,60,2,6,-4,5.97293724707561,4.86175974360768,1.11117750346793,26,35,-9,35,53,-18,54,69,-15,6,8,0,0
"1432","ARI","CHI",2015020768,16835,20152016,1,64.5166666666667,4,5,-1,2.7873246781528,5.03472349548247,-2.24739881732967,28,40,-12,37,58,-21,46,69,-23,6,6,0,0
"1433","ARI","ANA",2015020774,16836,20152016,0,60,2,5,-3,4.1336421337428,7.21219701378996,-3.07855488004716,25,41,-16,37,55,-18,51,74,-23,5,7,0,0
"1434","ARI","VAN",2015020808,16841,20152016,1,60,1,2,-1,3.8764343548981,6.07115145795156,-2.19471710305346,34,26,8,45,41,4,67,61,6,4,4,0,0
"1435","ARI","CGY",2015020824,16843,20152016,1,60,4,1,3,4.70847812625713,2.2826229800412,2.42585514621593,35,27,8,52,36,16,68,47,21,10,9,0,0
"1436","ARI","S.J",2015020834,16844,20152016,0,60,1,4,-3,1.78398298145402,1.9175631430553,-0.133580161601287,23,28,-5,31,45,-14,52,63,-11,4,6,0,0
"1437","ARI","MTL",2015020845,16846,20152016,1,60,6,2,4,2.33199941762723,1.76181294893382,0.570186468693407,27,19,8,42,34,8,55,44,11,3,4,0,0
"1438","ARI","DAL",2015020867,16849,20152016,1,60,6,3,3,8.26838274343027,6.28725170157304,1.98113104185722,42,39,3,55,54,1,64,70,-6,4,3,0,0
"1439","ARI","WSH",2015020890,16853,20152016,0,60,2,3,-1,3.62858535692794,3.83390707025501,-0.205321713327066,27,34,-7,35,53,-18,52,65,-13,6,4,0,0
"1440","ARI","T.B",2015020897,16854,20152016,0,60,1,2,-1,5.63294910534751,1.83321217593038,3.79973692941712,30,36,-6,41,44,-3,57,66,-9,3,4,0,0
"1441","ARI","PHI",2015020921,16858,20152016,0,60,2,4,-2,4.01995061460184,4.44845445400279,-0.428503839400946,31,33,-2,41,42,-1,73,54,19,4,4,0,0
"1442","ARI","PIT",2015020939,16860,20152016,0,60,0,6,-6,4.32488167101246,3.79618680223437,0.528694868778097,30,33,-3,34,40,-6,54,57,-3,3,5,0,0
"1443","ARI","ANA",2015020963,16863,20152016,1,60,1,5,-4,2.69289832384486,3.18169731068886,-0.488798986844003,28,21,7,44,27,17,55,43,12,9,12,0,0
"1444","ARI","COL",2015020989,16867,20152016,0,60,1,3,-2,6.01937990921942,4.43004336807644,1.58933654114298,38,37,1,58,46,12,76,58,18,3,2,0,0
"1445","ARI","VAN",2015021005,16869,20152016,0,61.7,2,3,-1,5.24112385031185,3.08951892967161,2.15160492064024,34,31,3,45,40,5,56,56,0,1,4,0,0
"1446","ARI","CGY",2015021017,16871,20152016,0,60,4,1,3,7.42660887195143,4.41040786681697,3.01620100513446,26,25,1,36,32,4,49,45,4,4,3,0,0
"1447","ARI","EDM",2015021026,16872,20152016,0,60,4,0,4,3.8067797776981,7.09878905044752,-3.29200927274943,29,44,-15,38,61,-23,49,75,-26,6,7,0,0
"1448","ARI","S.J",2015021059,16877,20152016,1,60,3,1,2,4.8625230495818,2.54839399226967,2.31412905731213,22,28,-6,31,45,-14,47,65,-18,2,2,0,0
"1449","ARI","T.B",2015021076,16879,20152016,1,60,0,2,-2,3.56113221832345,5.22356415222022,-1.66243193389677,32,36,-4,44,48,-4,55,65,-10,7,6,0,0
"1450","ARI","S.J",2015021084,16880,20152016,0,60,0,3,-3,4.05500064557418,4.51029672287405,-0.455296077299863,25,36,-11,34,44,-10,52,60,-8,4,5,0,0
"1451","ARI","EDM",2015021097,16882,20152016,1,60,4,2,2,3.98951560250134,3.8315403732704,0.157975229230942,31,29,2,47,45,2,64,65,-1,3,4,0,0
"1452","ARI","DAL",2015021110,16884,20152016,1,60,3,1,2,5.71224205527725,6.42729721902694,-0.715055163749688,30,38,-8,50,55,-5,76,70,6,6,3,0,0
"1453","ARI","PHI",2015021127,16886,20152016,1,60,2,1,1,1.96735175451613,7.48043178307125,-5.51308002855512,17,35,-18,25,51,-26,41,62,-21,4,4,0,0
"1454","ARI","CGY",2015021138,16888,20152016,1,60,2,5,-3,6.49325339315692,4.73161216673907,1.76164122641785,24,21,3,40,35,5,53,50,3,4,3,0,0
"1455","ARI","DAL",2015021159,16891,20152016,0,60,1,4,-3,0,0,0,32,33,-1,37,56,-19,48,69,-21,3,4,0,0
"1456","ARI","WSH",2015021177,16893,20152016,1,60,3,0,3,3.14742161654578,4.35624834345072,-1.20882672690493,27,31,-4,36,47,-11,51,68,-17,1,2,0,0
"1457","ARI","CHI",2015021196,16896,20152016,0,60,2,6,-4,3.99504120855687,4.00944199969808,-0.0144007911412096,31,32,-1,41,40,1,54,54,0,6,3,0,0
"1458","ARI","NSH",2015021209,16898,20152016,0,60.3333333333333,2,3,-1,1.85156535031274,4.62230791160255,-2.77074256128981,18,31,-13,19,51,-32,31,59,-28,3,6,0,0
"1459","ARI","S.J",2015021230,16900,20152016,0,60,0,1,-1,4.00321239952481,6.29582618848809,-2.29261378896328,20,32,-12,32,51,-19,45,69,-24,4,6,0,0
"1460","ARI","PHI",2016020028,17089,20162017,1,63.2,4,3,1,5.80488978115753,3.06636924292252,2.73852053823501,35,30,5,50,46,4,61,62,-1,7,4,0,0
"1461","ARI","OTT",2016020041,17092,20162017,0,60,4,7,-3,0,0,0,35,42,-7,47,52,-5,70,61,9,7,4,0,0
"1462","ARI","MTL",2016020054,17094,20162017,0,60,2,5,-3,3.02879376051533,7.9611040905662,-4.93231033005087,29,43,-14,39,60,-21,58,77,-19,3,5,0,0
"1463","ARI","NYI",2016020062,17095,20162017,0,60,2,3,-1,2.31239257569541,2.63201056236318,-0.319617986667765,25,31,-6,37,41,-4,52,61,-9,5,4,0,0
"1464","ARI","NYR",2016020079,17097,20162017,0,60,2,3,-1,4.7717138852604,3.87741462979466,0.894299255465739,29,26,3,41,42,-1,69,50,19,1,2,0,0
"1465","ARI","N.J",2016020084,17099,20162017,0,60,3,5,-2,4.52222408651141,6.49419329443481,-1.97196920792339,31,35,-4,37,41,-4,46,50,-4,3,3,0,0
"1466","ARI","PHI",2016020099,17101,20162017,0,60,5,4,1,3.09559950304123,6.80121987058487,-3.70562036754364,25,32,-7,33,55,-22,49,75,-26,3,8,0,0
"1467","ARI","COL",2016020120,17103,20162017,1,60,2,3,-1,3.70084353174136,6.41814513468439,-2.71730160294303,26,34,-8,35,48,-13,45,60,-15,4,3,0,0
"1468","ARI","S.J",2016020141,17106,20162017,1,60,3,2,1,4.98257987340912,5.95523806032725,-0.972658186918125,30,41,-11,48,59,-11,60,86,-26,2,2,0,0
"1469","ARI","NSH",2016020155,17108,20162017,1,65,2,2,0,3.46002599797794,4.14387371088378,-0.683847712905845,28,37,-9,38,49,-11,48,69,-21,3,7,0,0
"1470","ARI","ANA",2016020160,17109,20162017,0,60,1,5,-4,3.13084852152558,3.0634919875738,0.0673565339517777,22,33,-11,31,43,-12,40,53,-13,2,3,0,0
"1471","ARI","COL",2016020192,17113,20162017,0,60,4,2,2,3.28330589534016,4.06994612428025,-0.786640228940087,25,27,-2,36,36,0,59,50,9,4,1,0,0
"1472","ARI","WPG",2016020205,17115,20162017,1,60,2,3,-1,2.89907750031603,3.25958992959931,-0.36051242928329,25,27,-2,37,50,-13,48,57,-9,1,2,0,0
"1473","ARI","BOS",2016020221,17117,20162017,1,60,1,2,-1,6.49152606254211,3.03081803373061,3.4607080288115,32,29,3,50,44,6,59,61,-2,3,0,0,0
"1474","ARI","CGY",2016020244,17121,20162017,0,60.8166666666667,1,2,-1,1.70569247475942,3.88109555928531,-2.1754030845259,21,24,-3,31,41,-10,37,68,-31,4,4,0,0
"1475","ARI","VAN",2016020252,17122,20162017,0,62.5666666666667,2,3,-1,0,0,0,36,42,-6,41,55,-14,55,69,-14,2,3,0,0
"1476","ARI","S.J",2016020269,17124,20162017,1,61.2666666666667,3,2,1,2.49986156416407,5.96069670831816,-3.46083514415409,26,45,-19,33,64,-31,46,79,-33,4,3,0,0
"1477","ARI","VAN",2016020297,17128,20162017,1,60,1,4,-3,4.99385471995629,4.58949190062884,0.404362819327446,36,27,9,58,38,20,69,46,23,2,2,0,0
"1478","ARI","EDM",2016020312,17130,20162017,1,65,2,2,0,3.79000191955217,6.67379588863696,-2.88379396908479,41,34,7,49,54,-5,58,67,-9,3,3,0,0
"1479","ARI","EDM",2016020323,17132,20162017,0,60,2,1,1,5.22399355480593,6.01092409079365,-0.786930535987722,23,42,-19,31,56,-25,49,74,-25,3,4,0,0
"1480","ARI","S.J",2016020341,17134,20162017,0,60.3166666666667,1,2,-1,4.48223937270814,4.20160197762016,0.280637395087979,19,42,-23,30,55,-25,44,64,-20,3,3,0,0
"1481","ARI","L.A",2016020355,17136,20162017,1,60,3,4,-1,5.61244406567084,4.78460821793851,0.827835847732331,32,33,-1,44,47,-3,53,65,-12,7,7,0,0
"1482","ARI","CBJ",2016020368,17138,20162017,1,65,2,2,0,3.67076397122582,7.9870190803581,-4.31625510913227,34,60,-26,41,75,-34,60,93,-33,7,8,0,0
"1483","ARI","CBJ",2016020381,17140,20162017,0,60,1,4,-3,1.90124076008942,7.23309371605865,-5.33185295596923,18,34,-16,28,48,-20,35,59,-24,3,8,0,0
"1484","ARI","CHI",2016020389,17141,20162017,0,60,0,4,-4,2.53400627280644,4.40332407745753,-1.86931780465109,22,27,-5,29,33,-4,42,50,-8,2,3,0,0
"1485","ARI","CGY",2016020403,17143,20162017,1,61.15,1,2,-1,4.36796128130903,5.77888475684449,-1.41092347553546,28,35,-7,43,46,-3,59,60,-1,4,5,0,0
"1486","ARI","NSH",2016020418,17145,20162017,1,60,4,1,3,3.40698275127121,7.44995940370427,-4.04297665243306,34,45,-11,43,69,-26,51,86,-35,3,5,0,0
"1487","ARI","PIT",2016020429,17147,20162017,0,60,0,7,-7,2.68553349848889,4.95273399194957,-2.26720049346068,32,34,-2,46,45,1,59,56,3,3,7,0,0
"1488","ARI","DET",2016020436,17148,20162017,0,60,4,1,3,3.6049935631728,5.68418563572777,-2.07919207255497,19,38,-19,25,52,-27,36,63,-27,2,4,0,0
"1489","ARI","TOR",2016020447,17150,20162017,0,65,2,2,0,5.37921037944011,6.38237415866465,-1.00316377922454,30,46,-16,46,62,-16,59,85,-26,3,4,0,0
"1490","ARI","MIN",2016020461,17152,20162017,0,60,1,4,-3,5.471796491649,4.82758033374557,0.644216157903429,28,30,-2,38,47,-9,49,67,-18,1,3,0,0
"1491","ARI","CGY",2016020480,17154,20162017,1,60,2,4,-2,4.40837371698581,5.70645945956494,-1.29808574257913,27,28,-1,40,48,-8,55,64,-9,6,7,0,0
"1492","ARI","EDM",2016020494,17156,20162017,1,60,2,3,-1,7.90546317495147,3.55543690771447,4.35002626723701,36,21,15,55,29,26,78,41,37,6,7,0,0
"1493","ARI","TOR",2016020515,17158,20162017,1,60,1,4,-3,6.78144507302204,5.11017611964053,1.67126895338151,32,32,0,61,44,17,84,58,26,4,1,0,0
"1494","ARI","DAL",2016020525,17162,20162017,1,60,2,3,-1,5.1303972362075,4.51877851716752,0.611618719039984,37,29,8,48,43,5,66,55,11,4,4,0,0
"1495","ARI","NYR",2016020543,17164,20162017,1,60,3,6,-3,2.95424176227061,5.98723420696471,-3.0329924446941,21,32,-11,38,53,-15,50,61,-11,3,7,0,0
"1496","ARI","CGY",2016020556,17166,20162017,0,60,2,4,-2,4.29138562585656,3.29672785757998,0.99465776827658,29,24,5,41,35,6,55,50,5,5,5,0,0
"1497","ARI","VAN",2016020576,17170,20162017,0,60,0,3,-3,3.55135825125899,4.26149998772598,-0.710141736466994,22,24,-2,35,36,-1,48,51,-3,2,3,0,0
"1498","ARI","ANA",2016020590,17172,20162017,0,64.4,2,3,-1,3.55499078414822,6.30463153327582,-2.7496407491276,23,35,-12,29,52,-23,40,70,-30,2,3,0,0
"1499","ARI","NYI",2016020600,17173,20162017,1,65,1,1,0,5.06060599112425,4.29452075058362,0.766085240540633,27,28,-1,45,49,-4,66,61,5,2,4,0,0
"1500","ARI","WPG",2016020639,17179,20162017,1,60,4,3,1,3.3398186720151,3.97518715141632,-0.635368479401222,29,37,-8,39,47,-8,49,61,-12,3,2,0,0
"1501","ARI","ANA",2016020647,17180,20162017,1,60,0,3,-3,3.74331013100891,3.40200123949035,0.341308891518565,26,23,3,53,31,22,66,44,22,3,2,0,0
"1502","ARI","EDM",2016020662,17182,20162017,0,60,1,3,-2,1.28108388225885,3.76320955188021,-2.48212566962136,22,27,-5,30,38,-8,51,45,6,5,2,0,0
"1503","ARI","WPG",2016020673,17184,20162017,0,60,3,6,-3,3.90169960456114,4.94178466856829,-1.04008506400714,33,39,-6,38,53,-15,50,75,-25,4,3,0,0
"1504","ARI","MIN",2016020681,17185,20162017,0,60,3,4,-1,3.1559333219775,2.05419845572338,1.10173486625412,23,25,-2,32,35,-3,44,52,-8,4,6,0,0
"1505","ARI","T.B",2016020698,17187,20162017,1,60,5,3,2,3.52212772848009,4.70738324493868,-1.1852555164586,23,48,-25,38,68,-30,47,88,-41,3,5,0,0
"1506","ARI","VAN",2016020739,17192,20162017,1,60,3,0,3,6.61278927046806,3.95305472753975,2.65973454292831,31,19,12,48,42,6,65,58,7,2,0,0,0
"1507","ARI","L.A",2016020752,17197,20162017,1,60,2,3,-1,3.65236455598733,5.95616153103765,-2.30379697505032,32,39,-7,42,61,-19,61,72,-11,1,3,0,0
"1508","ARI","CHI",2016020764,17199,20162017,1,60,3,4,-1,2.86754411339415,3.30786001078991,-0.440315897395758,27,26,1,34,37,-3,55,48,7,7,6,0,0
"1509","ARI","S.J",2016020783,17201,20162017,0,65,2,2,0,4.50912141765826,7.80615389216109,-3.29703247450283,28,40,-12,43,52,-9,55,65,-10,5,5,0,0
"1510","ARI","MTL",2016020812,17206,20162017,1,62.2166666666667,4,5,-1,4.00176439380555,5.92150107040652,-1.91973667660097,25,40,-15,36,65,-29,48,82,-34,3,2,0,0
"1511","ARI","PIT",2016020826,17208,20162017,1,64.6333333333333,4,3,1,3.29077822889667,3.89630425717958,-0.605526028282906,25,31,-6,31,47,-16,43,62,-19,4,4,0,0
"1512","ARI","CGY",2016020835,17210,20162017,0,60,5,0,5,2.67834089344251,2.29691578230268,0.381425111139833,32,36,-4,36,54,-18,43,72,-29,1,5,0,0
"1513","ARI","EDM",2016020842,17211,20162017,0,60,2,5,-3,4.00853128539165,5.69756260321083,-1.68903131781917,25,33,-8,34,48,-14,54,63,-9,5,4,0,0
"1514","ARI","L.A",2016020854,17213,20162017,0,60,5,3,2,3.07566471245082,7.38604202459101,-4.31037731214019,22,44,-22,33,64,-31,40,83,-43,4,4,0,0
"1515","ARI","S.J",2016020866,17215,20162017,1,60,1,4,-3,5.59379721542427,7.44969458435662,-1.85589736893235,37,33,4,53,51,2,71,62,9,0,2,0,0
"1516","ARI","ANA",2016020881,17217,20162017,1,60,3,2,1,2.88186643758672,4.07511217899628,-1.19324574140956,20,36,-16,33,53,-20,41,71,-30,3,2,0,0
"1517","ARI","CHI",2016020898,17220,20162017,0,60,3,6,-3,5.85554555180352,3.76012927423976,2.09541627756375,37,29,8,46,40,6,64,53,11,3,2,0,0
"1518","ARI","DAL",2016020903,17221,20162017,0,60,2,5,-3,2.60260391581301,5.29081101913471,-2.6882071033217,27,37,-10,39,53,-14,55,80,-25,4,6,0,0
"1519","ARI","BOS",2016020922,17225,20162017,0,60,1,4,-3,3.437467344693,3.99152598845504,-0.554058643762032,23,25,-2,31,34,-3,46,40,6,4,4,0,0
"1520","ARI","CAR",2016020947,17228,20162017,0,60,4,2,2,3.64252902266253,3.69287307634659,-0.0503440536840571,22,34,-12,32,47,-15,39,57,-18,3,3,0,0
"1521","ARI","CAR",2016020968,17230,20162017,1,60,1,2,-1,6.48433371301508,4.55485916583348,1.9294745471816,26,35,-9,42,52,-10,58,62,-4,4,3,0,0
"1522","ARI","OTT",2016020991,17234,20162017,1,60.6666666666667,2,3,-1,5.1496269589461,3.70000419320286,1.44962276574324,41,31,10,59,48,11,76,61,15,4,3,0,0
"1523","ARI","N.J",2016021008,17236,20162017,1,60,5,4,1,3.63213012670167,4.68732511904091,-1.05519499233924,31,30,1,40,40,0,48,57,-9,5,5,0,0
"1524","ARI","COL",2016021022,17238,20162017,1,60,1,0,1,3.37883377916296,5.21553931088923,-1.83670553172627,35,22,13,50,46,4,57,59,-2,2,3,0,0
"1525","ARI","L.A",2016021031,17239,20162017,0,65,2,2,0,4.1796351737139,9.07728727340873,-4.89765209969482,32,46,-14,47,59,-12,57,74,-17,3,3,0,0
"1526","ARI","DET",2016021046,17241,20162017,1,65,4,4,0,5.4226950037496,5.73312888694394,-0.310433883194349,26,33,-7,44,52,-8,57,72,-15,5,9,0,0
"1527","ARI","NSH",2016021072,17245,20162017,0,60,1,3,-2,5.09726083877467,4.43571587698534,0.661544961789332,26,31,-5,39,48,-9,47,63,-16,2,1,0,0
"1528","ARI","T.B",2016021080,17246,20162017,0,60,5,3,2,4.21154600579757,4.50173742920742,-0.290191423409851,35,39,-4,39,55,-16,45,80,-35,4,5,0,0
"1529","ARI","WSH",2016021112,17250,20162017,0,60,1,4,-3,6.02139824782898,6.36387178234872,-0.34247353451974,29,33,-4,37,54,-17,46,69,-23,5,5,0,0
"1530","ARI","WSH",2016021156,17256,20162017,1,60,6,3,3,2.78011039714329,6.25181840151831,-3.47170800437502,25,48,-23,32,59,-27,41,80,-39,2,1,0,0
"1531","ARI","L.A",2016021175,17258,20162017,0,60,2,1,1,1.42238392494619,5.10763150400453,-3.68524757905834,15,35,-20,23,54,-31,33,70,-37,1,6,0,0
"1532","ARI","DAL",2016021187,17260,20162017,0,63.75,2,3,-1,4.41013258995008,5.34078989647878,-0.930657306528701,26,31,-5,35,52,-17,47,68,-21,3,3,0,0
"1533","ARI","VAN",2016021202,17262,20162017,1,60,4,3,1,2.13081191736273,6.05353539180942,-3.92272347444668,22,29,-7,31,42,-11,39,57,-18,4,4,0,0
"1534","ARI","MIN",2016021217,17264,20162017,1,60,1,3,-2,3.46596066462371,8.28879591141595,-4.82283524679224,21,45,-24,32,58,-26,37,64,-27,1,3,0,0
"1535","ARI","ANA",2017020011,17444,20172018,0,60,4,5,-1,4.31102361768113,9.07709806528874,-4.7660744476076,30,41,-11,43,57,-14,61,68,-7,4,3,0,0
"1536","ARI","VGK",2017020026,17446,20172018,1,63.7666666666667,1,2,-1,2.35196163258962,5.92849818004002,-3.5765365474504,28,42,-14,41,61,-20,57,85,-28,3,4,0,0
"1537","ARI","VGK",2017020045,17449,20172018,0,60,2,5,-3,3.79063542678516,2.59182501066243,1.19881041612273,33,28,5,43,38,5,57,54,3,3,3,0,0
"1538","ARI","DET",2017020056,17451,20172018,1,60,2,4,-2,3.91199697690899,7.79606375037426,-3.88406677346526,35,33,2,47,46,1,64,52,12,6,3,0,0
"1539","ARI","BOS",2017020072,17453,20172018,1,60,2,6,-4,4.74147499810027,3.01932978945479,1.72214520864548,31,29,2,56,42,14,69,59,10,3,3,0,0
"1540","ARI","DAL",2017020088,17456,20172018,0,60,1,3,-2,3.28926738773589,6.59482990938704,-3.30556252165115,28,34,-6,37,46,-9,52,58,-6,2,1,0,0
"1541","ARI","DAL",2017020103,17458,20172018,1,60,4,5,-1,5.12374728335999,5.16264643505201,-0.0388991516920214,31,31,0,42,45,-3,55,57,-2,4,2,0,0
"1542","ARI","CHI",2017020119,17460,20172018,1,60,2,4,-2,6.26823558058823,7.31357934180414,-1.04534376121592,29,29,0,51,45,6,67,63,4,6,5,0,0
"1543","ARI","NYI",2017020126,17463,20172018,0,60,3,5,-2,4.32722052594181,2.94692187849432,1.38029864744749,35,25,10,47,33,14,64,49,15,3,3,0,0
"1544","ARI","NYR",2017020140,17465,20172018,0,60,2,5,-3,4.62889575765879,5.04590489777456,-0.417009140115773,29,30,-1,37,45,-8,50,59,-9,3,3,0,0
"1545","ARI","N.J",2017020161,17467,20172018,0,60,3,4,-1,5.170942584984,1.39537305392589,3.77556953105811,37,25,12,48,33,15,63,42,21,5,3,0,0
"1546","ARI","PHI",2017020171,17469,20172018,0,64.75,4,3,1,3.64272825024091,7.15038127686569,-3.50765302662478,34,31,3,43,48,-5,59,60,-1,4,3,0,0
"1547","ARI","DET",2017020179,17470,20172018,0,60,3,5,-2,4.87379363176569,4.93562964174841,-0.0618360099827218,33,40,-7,43,55,-12,56,65,-9,2,1,0,0
"1548","ARI","CAR",2017020209,17474,20172018,1,65,1,1,0,0,0,0,24,37,-13,36,51,-15,47,74,-27,2,4,0,0
"1549","ARI","WSH",2017020220,17476,20172018,0,64.2333333333333,2,3,-1,5.97315146783889,6.50982522207924,-0.53667375424035,26,40,-14,38,60,-22,49,75,-26,3,6,0,0
"1550","ARI","PIT",2017020226,17477,20172018,0,60,1,3,-2,2.0711701919392,4.1146389804635,-2.0434687885243,25,37,-12,31,49,-18,53,56,-3,1,6,0,0
"1551","ARI","WPG",2017020259,17481,20172018,1,60,1,4,-3,3.42763266882685,4.33584084179106,-0.908208172964216,30,21,9,48,32,16,67,44,23,4,2,0,0
"1552","ARI","WPG",2017020272,17484,20172018,0,60,1,4,-3,3.98725787764704,2.48556663941417,1.50169123823287,34,30,4,45,38,7,61,45,16,6,4,0,0
"1553","ARI","MTL",2017020280,17486,20172018,0,60,5,4,1,5.02639690319393,4.43143184669316,0.594965056500769,32,37,-5,44,52,-8,55,72,-17,7,6,0,0
"1554","ARI","OTT",2017020293,17488,20172018,0,61.3833333333333,3,2,1,5.43398368714179,5.01699591948043,0.416987767661356,28,32,-4,38,47,-9,53,63,-10,3,5,0,0
"1555","ARI","TOR",2017020311,17490,20172018,0,60,4,1,3,5.59886904218001,6.21076926758178,-0.611900225401769,31,28,3,42,45,-3,51,62,-11,4,1,0,0
"1556","ARI","S.J",2017020331,17492,20172018,1,60,1,3,-2,3.78750409812983,2.90976500812442,0.877739090005406,27,26,1,35,35,0,51,46,5,3,1,0,0
"1557","ARI","L.A",2017020346,17494,20172018,1,62.7166666666667,3,2,1,5.54410641332879,4.99662366427947,0.547482749049323,33,25,8,51,44,7,65,65,0,4,1,0,0
"1558","ARI","VGK",2017020355,17495,20172018,1,60,2,4,-2,3.43789602175457,6.14342838482779,-2.70553236307322,26,28,-2,40,41,-1,63,54,9,5,4,0,0
"1559","ARI","EDM",2017020375,17498,20172018,0,64.3333333333333,2,3,-1,5.68847818646464,4.1338429232128,1.55463526325184,31,27,4,49,48,1,69,73,-4,3,4,0,0
"1560","ARI","CGY",2017020386,17500,20172018,0,60,0,3,-3,4.36505221882172,6.12372820838209,-1.75867598956037,28,44,-16,42,56,-14,57,70,-13,2,1,0,0
"1561","ARI","N.J",2017020405,17502,20172018,1,60,5,0,5,3.22278084105346,2.78443204320502,0.438348797848448,27,27,0,37,44,-7,52,70,-18,2,3,0,0
"1562","ARI","VGK",2017020411,17503,20172018,0,63.85,2,3,-1,8.15941230020326,6.65742853228585,1.50198376791741,33,45,-12,50,66,-16,63,88,-25,2,1,0,0
"1563","ARI","BOS",2017020430,17507,20172018,0,60,1,6,-5,4.85687483188653,5.84472255827859,-0.987847726392065,21,32,-11,34,51,-17,45,57,-12,0,4,0,0
"1564","ARI","CBJ",2017020451,17509,20172018,0,60,0,1,-1,2.41918974440409,4.65511216842771,-2.23592242402361,35,34,1,43,40,3,55,55,0,4,2,0,0
"1565","ARI","CHI",2017020457,17510,20172018,0,60,1,3,-2,5.91301547200419,5.87426060612779,0.038754865876399,32,37,-5,42,51,-9,56,60,-4,1,2,0,0
"1566","ARI","T.B",2017020489,17514,20172018,1,60,1,4,-3,4.60017434704059,6.81678902620191,-2.21661467916132,33,48,-15,45,67,-22,61,80,-19,5,5,0,0
"1567","ARI","PIT",2017020504,17516,20172018,1,60,2,4,-2,3.13076359208208,9.376606903621,-6.24584331153892,17,33,-16,24,59,-35,37,74,-37,3,5,0,0
"1568","ARI","WSH",2017020542,17522,20172018,1,64.55,3,2,1,4.26730228231281,2.65502990582536,1.61227237648745,27,17,10,39,39,0,52,58,-6,2,2,0,0
"1569","ARI","COL",2017020554,17523,20172018,1,60,2,6,-4,4.74542476916758,6.10642740182811,-1.36100263266053,34,28,6,47,48,-1,72,59,13,7,4,0,0
"1570","ARI","COL",2017020567,17527,20172018,0,60,3,1,2,3.81625195982633,5.26537452425691,-1.44912256443058,27,26,1,33,39,-6,49,50,-1,4,2,0,0
"1571","ARI","TOR",2017020572,17528,20172018,1,60,4,7,-3,4.84118558408227,5.81610204519538,-0.974916461113109,34,33,1,57,45,12,78,52,26,8,3,0,0
"1572","ARI","ANA",2017020598,17531,20172018,0,60,2,5,-3,3.00243721477455,6.5457771901747,-3.54333997540016,25,26,-1,38,43,-5,60,52,8,4,1,0,0
"1573","ARI","NSH",2017020627,17535,20172018,1,62.3166666666667,3,2,1,5.14382241736166,10.0962493568368,-4.95242693947512,25,39,-14,37,55,-18,53,80,-27,2,2,0,0
"1574","ARI","NYR",2017020639,17537,20172018,1,65,1,1,0,0,0,0,39,25,14,53,39,14,67,53,14,2,1,0,0
"1575","ARI","EDM",2017020669,17543,20172018,1,60,2,4,-2,4.5856300110172,6.20387069135904,-1.61824068034184,22,27,-5,37,41,-4,50,51,-1,1,1,0,0
"1576","ARI","S.J",2017020678,17544,20172018,0,62.7,5,6,-1,6.91956234841928,6.23258307935248,0.686979269066796,21,44,-23,30,65,-35,47,86,-39,1,1,0,0
"1577","ARI","S.J",2017020692,17547,20172018,1,65,2,2,0,5.35667680396,2.37232956930529,2.98434723465471,32,22,10,48,32,16,77,47,30,2,2,0,0
"1578","ARI","NSH",2017020702,17549,20172018,0,65,2,2,0,3.17040087562054,4.5089599974026,-1.33855912178205,29,39,-10,37,57,-20,49,69,-20,2,2,0,0
"1579","ARI","NYI",2017020731,17553,20172018,1,62.35,3,2,1,6.08157069994195,6.46302993084043,-0.381459230898486,33,34,-1,58,43,15,73,51,22,2,2,0,0
"1580","ARI","CBJ",2017020756,17556,20172018,1,60,1,2,-1,4.44687272207557,3.16122027224446,1.2856524498311,39,27,12,50,36,14,73,48,25,2,2,0,0
"1581","ARI","DAL",2017020786,17563,20172018,1,60,1,4,-3,3.25486179478617,5.77530425106488,-2.52044245627872,18,25,-7,36,37,-1,60,49,11,6,7,0,0
"1582","ARI","L.A",2017020804,17565,20172018,0,60,0,6,-6,2.53319427541282,4.42753496385262,-1.8943406884398,27,35,-8,40,50,-10,52,58,-6,2,2,0,0
"1583","ARI","WPG",2017020820,17568,20172018,0,60,3,4,-1,4.2244002289005,3.23861689574551,0.98578333315499,24,23,1,33,39,-6,44,51,-7,4,4,0,0
"1584","ARI","MIN",2017020832,17570,20172018,0,63.9166666666667,4,3,1,5.3481888614624,2.37644017545972,2.97174868600268,40,28,12,57,38,19,76,47,29,1,1,0,0
"1585","ARI","PHI",2017020850,17572,20172018,1,65,3,3,0,2.59150258940645,4.99713584715209,-2.40563325774565,27,43,-16,37,57,-20,54,68,-14,3,5,0,0
"1586","ARI","CHI",2017020863,17574,20172018,1,60,6,1,5,4.80377344020847,5.08081945073077,-0.277046010522292,22,38,-16,32,54,-22,44,72,-28,6,8,0,0
"1587","ARI","S.J",2017020875,17575,20172018,0,60,2,1,1,4.06184071012753,7.95019895787301,-3.88835824774547,26,41,-15,34,63,-29,46,79,-33,3,5,0,0
"1588","ARI","MTL",2017020887,17577,20172018,1,60,5,2,3,2.72512215177204,5.92522674566135,-3.20010459388931,21,36,-15,29,61,-32,47,85,-38,3,4,0,0
"1589","ARI","EDM",2017020897,17579,20172018,1,60,1,0,1,4.7222543611424,8.27440214515281,-3.5521477840104,32,40,-8,40,53,-13,60,65,-5,4,2,0,0
"1590","ARI","CGY",2017020939,17584,20172018,1,60,2,5,-3,5.74392730848285,6.83249315145508,-1.08856584297223,37,38,-1,47,57,-10,65,69,-4,7,5,0,0
"1591","ARI","ANA",2017020956,17586,20172018,1,60,2,0,2,4.79448328620467,5.68105702560842,-0.886573739403756,38,26,12,52,39,13,66,56,10,4,2,0,0
"1592","ARI","VAN",2017020963,17587,20172018,1,60,1,3,-2,5.03262610067031,3.28279265864642,1.74983344202389,42,27,15,58,46,12,76,56,20,6,4,0,0
"1593","ARI","MIN",2017020988,17591,20172018,1,60,5,3,2,4.15663086820859,5.70433579600649,-1.54770492779789,25,35,-10,39,53,-14,56,66,-10,3,5,0,0
"1594","ARI","OTT",2017021006,17593,20172018,1,60,2,1,1,4.80602767021628,5.42025357829698,-0.614225908080698,27,24,3,40,39,1,57,54,3,3,2,0,0
"1595","ARI","EDM",2017021018,17595,20172018,0,60.8333333333333,3,4,-1,3.28743956014184,4.84479062855873,-1.55735106841688,35,36,-1,47,43,4,62,61,1,5,6,0,0
"1596","ARI","VAN",2017021031,17597,20172018,0,60,2,1,1,2.35731652231334,3.32572458943469,-0.968408067121345,34,17,17,44,29,15,63,40,23,3,1,0,0
"1597","ARI","COL",2017021052,17600,20172018,0,60,2,5,-3,6.47721632436151,4.05826815009641,2.4189481742651,28,31,-3,44,41,3,55,54,1,6,7,0,0
"1598","ARI","VAN",2017021062,17601,20172018,1,60,1,0,1,4.1588722706656,6.71152087986047,-2.55264860919488,24,27,-3,37,41,-4,60,59,1,2,1,0,0
"1599","ARI","L.A",2017021077,17603,20172018,1,65,3,3,0,4.24501994008205,6.0429058734735,-1.79788593339145,29,37,-8,39,49,-10,62,66,-4,1,4,0,0
"1600","ARI","NSH",2017021090,17605,20172018,1,60,2,3,-1,7.08969686945967,4.86036828350916,2.22932858595051,34,29,5,50,41,9,70,56,14,6,4,0,0
"1601","ARI","MIN",2017021106,17607,20172018,1,60,1,3,-2,6.77484875687514,5.38074217072256,1.39410658615259,31,33,-2,49,42,7,68,50,18,2,5,0,0
"1602","ARI","CGY",2017021120,17609,20172018,1,60,5,2,3,6.55359915250234,5.86410963498929,0.689489517513046,30,44,-14,43,65,-22,64,81,-17,3,5,0,0
"1603","ARI","CAR",2017021138,17612,20172018,0,60,5,6,-1,5.02912189537892,4.32345228779013,0.705669607588788,33,30,3,46,44,2,60,65,-5,4,2,0,0
"1604","ARI","T.B",2017021173,17616,20172018,0,60,4,1,3,4.78622398387233,3.6730520221754,1.11317196169693,35,20,15,42,34,8,56,43,13,4,2,0,0
"1605","ARI","VGK",2017021189,17618,20172018,0,60,3,2,1,5.90169174895709,4.48654290055856,1.41514884839853,32,29,3,40,46,-6,56,65,-9,3,5,0,0
"1606","ARI","L.A",2017021199,17619,20172018,0,60,2,4,-2,5.02160168425229,4.54817683834699,0.473424845905299,22,35,-13,35,49,-14,47,61,-14,3,3,0,0
"1607","ARI","CGY",2017021235,17624,20172018,0,60,4,1,3,3.40271230356302,6.20480826330037,-2.80209595973735,21,43,-22,34,62,-28,46,77,-31,4,1,0,0
"1608","ARI","VAN",2017021250,17626,20172018,0,62.55,3,4,-1,2.60662733286154,3.17714631588082,-0.570518983019281,19,40,-21,26,51,-25,44,73,-29,2,3,0,0
"1609","ARI","ANA",2017021267,17628,20172018,1,60,0,3,-3,3.62591435922241,5.19575137935743,-1.56983702013503,31,27,4,48,41,7,65,51,14,5,3,0,0
"1610","ARI","DAL",2018020012,17808,20182019,0,60,0,3,-3,4.10594748822041,2.51848673660663,1.58746075161378,30,25,5,39,37,2,54,51,3,4,4,0,0
"1611","ARI","ANA",2018020027,17810,20182019,1,60,0,1,-1,6.72933613384787,3.5830016860009,3.14633444784697,41,20,21,58,31,27,79,36,43,4,2,0,0
"1612","ARI","ANA",2018020044,17814,20182019,0,65,2,2,0,4.51748146634054,2.54626932135375,1.97121214498679,39,25,14,56,35,21,75,48,27,3,3,0,0
"1613","ARI","MIN",2018020083,17820,20182019,0,60,1,2,-1,4.57613802339672,3.72151925294838,0.854618770448343,32,28,4,45,36,9,63,46,17,4,3,0,0
"1614","ARI","CHI",2018020095,17822,20182019,0,60,4,1,3,7.24834363944448,6.71167367181624,0.536669967628239,31,34,-3,43,50,-7,57,77,-20,1,3,0,0
"1615","ARI","WPG",2018020104,17824,20182019,0,60,3,5,-2,5.8721389566781,4.43208461039467,1.44005434628343,45,32,13,54,43,11,69,57,12,5,4,0,0
"1616","ARI","CBJ",2018020123,17827,20182019,0,60,4,1,3,5.19591670285445,4.53695684602258,0.658959856831871,26,36,-10,37,53,-16,50,65,-15,5,5,0,0
"1617","ARI","VAN",2018020143,17829,20182019,1,60,4,1,3,4.48123508955359,7.06124216958855,-2.58000708003496,30,28,2,46,44,2,54,52,2,4,4,0,0
"1618","ARI","T.B",2018020157,17831,20182019,1,60,7,1,6,3.77206570394765,3.58071610827016,0.191349595677484,30,31,-1,45,43,2,55,56,-1,4,5,0,0
"1619","ARI","OTT",2018020175,17834,20182019,1,60,5,1,4,4.90234048589173,6.68436610717561,-1.78202562128388,35,26,9,45,48,-3,59,60,-1,3,5,0,0
"1620","ARI","CAR",2018020194,17837,20182019,1,61.2833333333333,4,3,1,5.04697252360977,8.30029665885377,-3.253324135244,25,51,-26,33,66,-33,41,92,-51,3,6,0,0
"1621","ARI","PHI",2018020214,17840,20182019,1,60,2,5,-3,4.52736353001092,4.47719104827236,0.0501724817385547,36,34,2,53,38,15,76,55,21,8,8,0,0
"1622","ARI","PHI",2018020229,17843,20182019,0,61.0166666666667,4,5,-1,5.12256381788757,6.79969818735117,-1.6771343694636,34,31,3,38,47,-9,49,67,-18,2,4,0,0
"1623","ARI","PIT",2018020249,17845,20182019,0,60,0,4,-4,5.63062896754127,3.35260405496228,2.27802491257899,39,32,7,51,38,13,76,48,28,4,3,0,0
"1624","ARI","WSH",2018020255,17846,20182019,0,60,4,1,3,3.79697077786113,5.19043736336095,-1.39346658549981,22,39,-17,38,53,-15,52,64,-12,6,2,0,0
"1625","ARI","DET",2018020268,17848,20182019,0,60,1,6,-5,3.46282294657431,3.60992984427139,-0.147106897697086,25,26,-1,45,32,13,64,44,20,6,5,0,0
"1626","ARI","NSH",2018020284,17850,20182019,1,60,2,1,1,5.46896913582896,7.59860362626205,-2.12963449043309,23,46,-23,37,63,-26,46,82,-36,2,5,0,0
"1627","ARI","BOS",2018020300,17852,20182019,1,60,1,2,-1,6.4147930850645,5.71523438917939,0.699558695885116,33,23,10,44,31,13,59,43,16,4,2,0,0
"1628","ARI","VGK",2018020328,17856,20182019,1,63.6,2,3,-1,3.41927816346647,3.19458278327498,0.224695380191491,21,25,-4,33,38,-5,44,58,-14,3,2,0,0
"1629","ARI","COL",2018020345,17858,20182019,1,60,1,5,-4,4.09358458686935,8.12448821088765,-4.0309036240183,38,39,-1,55,57,-2,69,76,-7,3,5,0,0
"1630","ARI","CGY",2018020358,17860,20182019,1,60,1,6,-5,4.16701110017503,6.58305904812372,-2.4160479479487,29,27,2,41,39,2,56,53,3,4,6,0,0
"1631","ARI","MIN",2018020372,17862,20182019,0,60,4,3,1,2.37550428393297,3.45111179369269,-1.07560750975972,14,25,-11,22,39,-17,34,53,-19,1,2,0,0
"1632","ARI","NSH",2018020386,17864,20182019,0,60,3,0,3,3.17192805600644,4.04658005324718,-0.87465199724074,25,29,-4,34,43,-9,56,61,-5,7,4,0,0
"1633","ARI","L.A",2018020425,17869,20182019,0,60,2,1,1,3.55111611291068,3.37366066103857,0.177455451872106,20,26,-6,32,41,-9,50,59,-9,4,2,0,0
"1634","ARI","WSH",2018020436,17871,20182019,1,60,2,4,-2,4.64246643120833,6.98199881741311,-2.33953238620478,29,29,0,45,44,1,63,59,4,3,2,0,0
"1635","ARI","S.J",2018020452,17873,20182019,1,60,3,5,-2,4.14948592643486,6.25178489630343,-2.10229896986857,20,33,-13,32,44,-12,46,67,-21,1,1,0,0
"1636","ARI","BOS",2018020465,17876,20182019,0,60,3,4,-1,5.82338865753263,6.11974417454621,-0.296355517013581,33,26,7,49,40,9,64,49,15,2,2,0,0
"1637","ARI","NYR",2018020488,17879,20182019,0,64.4666666666667,4,3,1,5.2315234058799,8.54839742484934,-3.31687401896944,34,30,4,46,42,4,66,52,14,5,7,0,0
"1638","ARI","CAR",2018020506,17881,20182019,0,60,0,3,-3,2.67238413177755,4.4647076533917,-1.79232352161415,23,27,-4,33,43,-10,44,53,-9,4,6,0,0
"1639","ARI","NYI",2018020525,17883,20182019,1,60,1,3,-2,5.00753077082857,4.9687862640825,0.0387445067460703,37,32,5,54,48,6,77,63,14,3,2,0,0
"1640","ARI","MTL",2018020538,17885,20182019,1,60,1,2,-1,3.90951141732373,3.42973396624438,0.479777451079343,37,28,9,52,33,19,65,50,15,4,3,0,0
"1641","ARI","COL",2018020555,17887,20182019,1,60,6,4,2,6.62422511412098,5.86600273984391,0.758222374277073,39,28,11,50,45,5,69,56,13,2,4,0,0
"1642","ARI","S.J",2018020566,17888,20182019,0,65,3,3,0,2.10960468818423,7.04548921275154,-4.93588452456731,26,38,-12,33,46,-13,45,74,-29,5,6,0,0
"1643","ARI","L.A",2018020578,17892,20182019,0,60,1,2,-1,4.3165035115635,3.37007080287731,0.946432708686189,27,26,1,39,36,3,51,49,2,4,3,0,0
"1644","ARI","ANA",2018020597,17894,20182019,0,60.55,5,4,1,7.45971265820827,5.99235885765947,1.4673538005488,30,41,-11,43,57,-14,54,66,-12,3,5,0,0
"1645","ARI","VGK",2018020598,17895,20182019,1,60,1,5,-4,4.10750212403877,4.40909520039393,-0.301593076355152,30,37,-7,43,49,-6,61,64,-3,6,3,0,0
"1646","ARI","EDM",2018020620,17898,20182019,1,60,1,3,-2,2.48319381561828,5.21405018557562,-2.73085636995734,30,24,6,47,32,15,60,48,12,1,3,0,0
"1647","ARI","N.J",2018020634,17900,20182019,1,65,2,2,0,5.78733368384422,3.95780584944665,1.82952783439757,25,35,-10,34,45,-11,51,56,-5,5,4,0,0
"1648","ARI","NYR",2018020645,17902,20182019,1,60,5,0,5,3.72427065505326,6.62611076165922,-2.90184010660596,40,23,17,51,29,22,69,43,26,3,1,0,0
"1649","ARI","VAN",2018020680,17906,20182019,0,64.1666666666667,4,3,1,4.55710693262517,4.55407863666414,0.00302829596103926,22,36,-14,30,49,-19,41,65,-24,2,2,0,0
"1650","ARI","EDM",2018020696,17908,20182019,0,60,3,2,1,5.45358335280787,6.73343906906666,-1.27985571625879,29,25,4,39,35,4,49,54,-5,3,2,0,0
"1651","ARI","CGY",2018020704,17909,20182019,0,60,1,7,-6,4.36007097535912,4.1641432621438,0.195927713215326,23,26,-3,40,35,5,52,42,10,3,1,0,0
"1652","ARI","S.J",2018020725,17912,20182019,1,60,6,3,3,7.44269259127122,4.06283185168286,3.37986073958837,41,29,12,54,42,12,65,66,-1,4,3,0,0
"1653","ARI","PIT",2018020738,17914,20182019,1,64.1666666666667,2,3,-1,7.58328822794576,3.86861428321572,3.71467394473004,33,35,-2,46,46,0,66,63,3,4,4,0,0
"1654","ARI","TOR",2018020754,17916,20182019,0,60,4,2,2,6.3005521716841,4.46752750615751,1.83302466552659,31,26,5,40,45,-5,51,75,-24,4,1,0,0
"1655","ARI","OTT",2018020761,17918,20182019,0,60,3,2,1,5.3936442839331,5.44643634327076,-0.0527920593376621,33,27,6,42,41,1,59,63,-4,1,2,0,0
"1656","ARI","MTL",2018020766,17919,20182019,0,60,1,2,-1,5.92068501355484,5.88464377999154,0.0360412335633038,31,24,7,42,35,7,58,55,3,3,2,0,0
"1657","ARI","S.J",2018020801,17929,20182019,0,63.2333333333333,2,3,-1,2.65280435139721,2.89036072160798,-0.237556370210768,33,35,-2,48,40,8,59,57,2,5,2,0,0
"1658","ARI","DAL",2018020808,17931,20182019,0,60,4,5,-1,5.00212416195791,2.84825119831481,2.1538729636431,42,29,13,52,36,16,69,57,12,4,5,0,0
"1659","ARI","NSH",2018020817,17932,20182019,0,60,2,5,-3,2.5381539926425,7.5537007731109,-5.0155467804684,26,47,-21,35,61,-26,44,82,-38,3,5,0,0
"1660","ARI","CBJ",2018020836,17934,20182019,1,60,2,4,-2,7.89430380195336,3.62185030045025,4.27245350150311,31,33,-2,54,47,7,66,56,10,3,2,0,0
"1661","ARI","DAL",2018020845,17936,20182019,1,60,3,2,1,5.7610248404817,5.47872710209257,0.282297738389122,39,35,4,44,53,-9,54,71,-17,3,3,0,0
"1662","ARI","VGK",2018020874,17939,20182019,0,60,5,2,3,6.19330222697317,5.77208647118096,0.421215755792218,26,43,-17,36,50,-14,58,63,-5,3,2,0,0
"1663","ARI","TOR",2018020898,17943,20182019,1,60,2,0,2,4.7821245621111,5.99038139347297,-1.20825683136188,29,22,7,38,39,-1,55,66,-11,1,3,0,0
"1664","ARI","CGY",2018020910,17945,20182019,0,60,2,5,-3,4.00242689602345,3.87990665335033,0.122520242673113,29,33,-4,42,45,-3,53,65,-12,3,2,0,0
"1665","ARI","EDM",2018020924,17946,20182019,0,65,2,2,0,4.64417038793399,6.11451451026278,-1.47034412232879,35,37,-2,44,54,-10,58,67,-9,4,3,0,0
"1666","ARI","VAN",2018020939,17948,20182019,0,61.9,3,2,1,5.42621052939649,4.38745643256698,1.03875409682951,38,32,6,51,51,0,66,64,2,2,3,0,0
"1667","ARI","WPG",2018020961,17951,20182019,1,60,4,1,3,4.40552268189601,5.27241101756954,-0.866888335673526,24,35,-11,39,49,-10,53,65,-12,2,4,0,0
"1668","ARI","VAN",2018020988,17955,20182019,1,60,5,2,3,3.5090867898184,7.63025742745072,-4.12117063763231,24,39,-15,39,60,-21,50,79,-29,4,4,0,0
"1669","ARI","DET",2018021007,17957,20182019,1,60,3,1,2,9.30940136572463,5.68735433812253,3.62204702760209,44,23,21,63,35,28,73,55,18,4,2,0,0
"1670","ARI","ANA",2018021027,17960,20182019,1,60,1,3,-2,2.5611158022584,4.121782759903,-1.5606669576446,23,31,-8,31,38,-7,45,56,-11,5,5,0,0
"1671","ARI","CGY",2018021041,17962,20182019,1,60,2,0,2,3.44788352579053,3.87959046297965,-0.431706937189119,26,30,-4,40,53,-13,56,80,-24,4,3,0,0
"1672","ARI","L.A",2018021058,17964,20182019,1,60,4,2,2,7.88324801373528,6.47286824545229,1.41037976828299,32,36,-4,48,55,-7,63,74,-11,5,2,0,0
"1673","ARI","CHI",2018021069,17966,20182019,0,60,1,7,-6,5.80677861458389,4.7722328735108,1.03454574107309,25,34,-9,31,36,-5,39,50,-11,2,2,0,0
"1674","ARI","ANA",2018021090,17969,20182019,1,60,6,1,5,3.44105910498183,3.83650600237888,-0.395446897397051,24,37,-13,35,53,-18,51,69,-18,6,5,0,0
"1675","ARI","EDM",2018021109,17971,20182019,1,60.9666666666667,2,3,-1,4.09229998989531,4.8104350692712,-0.718135079375894,30,25,5,44,35,9,51,48,3,5,3,0,0
"1676","ARI","T.B",2018021118,17973,20182019,0,60,1,4,-3,4.08144404074756,3.37320412790381,0.708239912843741,29,24,5,39,31,8,51,43,8,3,2,0,0
"1677","ARI","N.J",2018021150,17978,20182019,0,65,1,1,0,5.31621893314878,4.66570052057944,0.650518412569332,24,32,-8,41,51,-10,55,62,-7,3,5,0,0
"1678","ARI","NYI",2018021165,17979,20182019,0,60,0,2,-2,5.39607897292626,1.70646209723782,3.68961687568844,31,26,5,39,34,5,58,48,10,1,1,0,0
"1679","ARI","CHI",2018021184,17981,20182019,1,60,1,0,1,3.09702618990559,5.25206746141856,-2.15504127151297,29,31,-2,39,44,-5,57,58,-1,2,1,0,0
"1680","ARI","COL",2018021200,17984,20182019,0,65,2,2,0,6.49954837601035,4.70426679853039,1.79528157747996,44,27,17,50,37,13,71,48,23,3,4,0,0
"1681","ARI","MIN",2018021217,17986,20182019,1,60,4,0,4,6.02224759120024,7.38210150233099,-1.35985391113075,23,39,-16,41,53,-12,54,80,-26,3,3,0,0
"1682","ARI","L.A",2018021238,17988,20182019,1,60,1,3,-2,6.66795878946141,4.07012155470795,2.59783723475346,50,24,26,67,32,35,81,46,35,6,1,0,0
"1683","ARI","VGK",2018021253,17990,20182019,0,60,4,1,3,3.39534044645428,5.36852258251747,-1.97318213606319,41,38,3,47,46,1,63,62,1,3,2,0,0
"1684","ARI","WPG",2018021269,17992,20182019,1,60,2,4,-2,2.39447609260969,3.87552539689932,-1.48104930428963,21,32,-11,29,45,-16,35,61,-26,4,3,0,0
"1685","ATL","WSH",2008020013,14162,20082009,1,60,7,4,3,0,0,0,31,43,-12,32,49,-17,41,59,-18,9,7,0,0
"1686","ATL","FLA",2008020021,14163,20082009,0,63.9,2,3,-1,0,0,0,33,39,-6,40,51,-11,47,61,-14,6,6,0,0
"1687","ATL","MIN",2008020040,14166,20082009,1,60,2,4,-2,0,0,0,26,26,0,43,36,7,51,44,7,4,5,0,0
"1688","ATL","N.J",2008020049,14168,20082009,1,60,0,1,-1,0,0,0,25,35,-10,37,45,-8,47,63,-16,5,3,0,0
"1689","ATL","BUF",2008020068,14170,20082009,1,65,2,2,0,0,0,0,37,30,7,55,41,14,72,55,17,7,6,0,0
"1690","ATL","T.B",2008020085,14173,20082009,0,61.6833333333333,2,3,-1,0,0,0,33,38,-5,45,49,-4,62,58,4,3,5,0,0
"1691","ATL","DET",2008020103,14176,20082009,0,60,3,5,-2,0,0,0,33,46,-13,46,51,-5,51,61,-10,7,4,0,0
"1692","ATL","BOS",2008020105,14177,20082009,0,60,4,5,-1,0,0,0,32,33,-1,40,47,-7,49,61,-12,5,6,0,0
"1693","ATL","PHI",2008020127,14180,20082009,1,60,0,7,-7,0,0,0,24,31,-7,30,42,-12,40,51,-11,6,8,0,0
"1694","ATL","NYR",2008020137,14182,20082009,0,60,2,3,-1,0,0,0,29,33,-4,41,50,-9,58,65,-7,4,6,0,0
"1695","ATL","N.J",2008020154,14184,20082009,0,60,1,6,-5,0,0,0,20,32,-12,32,40,-8,42,46,-4,3,6,0,0
"1696","ATL","FLA",2008020164,14185,20082009,1,60,5,3,2,0,0,0,31,21,10,44,34,10,54,44,10,4,3,0,0
"1697","ATL","NYI",2008020184,14189,20082009,1,60,4,3,1,0,0,0,27,27,0,40,39,1,50,52,-2,4,5,0,0
"1698","ATL","BUF",2008020194,14190,20082009,0,60.8,5,4,1,0,0,0,26,32,-6,33,46,-13,42,56,-14,4,4,0,0
"1699","ATL","CAR",2008020208,14192,20082009,0,60,5,2,3,0,0,0,22,37,-15,38,50,-12,54,70,-16,3,4,0,0
"1700","ATL","CAR",2008020238,14197,20082009,1,60,3,2,1,0,0,0,25,29,-4,35,39,-4,47,55,-8,8,7,0,0
"1701","ATL","PHI",2008020254,14199,20082009,0,60,3,4,-1,0,0,0,32,32,0,43,44,-1,57,54,3,3,4,0,0
"1702","ATL","PIT",2008020272,14203,20082009,1,60,2,3,-1,0,0,0,23,31,-8,29,43,-14,36,53,-17,4,4,0,0
"1703","ATL","CBJ",2008020291,14205,20082009,1,60,0,2,-2,0,0,0,15,31,-16,25,40,-15,41,50,-9,3,4,0,0
"1704","ATL","TOR",2008020307,14208,20082009,0,60,6,3,3,0,0,0,30,35,-5,41,56,-15,54,70,-16,7,8,0,0
"1705","ATL","WSH",2008020311,14209,20082009,0,60,3,5,-2,0,0,0,18,33,-15,28,48,-20,40,59,-19,3,4,0,0
"1706","ATL","NSH",2008020330,14211,20082009,1,61.7333333333333,3,4,-1,0,0,0,25,26,-1,33,38,-5,42,49,-7,4,3,0,0
"1707","ATL","STL",2008020347,14213,20082009,1,60,2,4,-2,0,0,0,30,47,-17,42,59,-17,52,78,-26,2,4,0,0
"1708","ATL","MTL",2008020357,14215,20082009,0,60,4,5,-1,0,0,0,26,33,-7,37,43,-6,50,61,-11,3,3,0,0
"1709","ATL","OTT",2008020361,14216,20082009,0,60,1,5,-4,0,0,0,23,34,-11,35,37,-2,50,44,6,8,5,0,0
"1710","ATL","NYI",2008020383,14219,20082009,0,60,5,1,4,0,0,0,17,29,-12,27,44,-17,42,59,-17,10,7,0,0
"1711","ATL","NYR",2008020408,14223,20082009,1,60.3,2,3,-1,0,0,0,29,33,-4,37,41,-4,51,56,-5,7,4,0,0
"1712","ATL","BOS",2008020425,14225,20082009,1,60,3,7,-4,0,0,0,33,25,8,51,36,15,62,46,16,5,2,0,0
"1713","ATL","BOS",2008020431,14226,20082009,0,60,2,4,-2,0,0,0,22,29,-7,31,39,-8,38,50,-12,4,7,0,0
"1714","ATL","OTT",2008020450,14229,20082009,0,60,4,1,3,0,0,0,25,29,-4,33,41,-8,46,56,-10,7,5,0,0
"1715","ATL","PIT",2008020463,14231,20082009,1,60,3,6,-3,0,0,0,31,20,11,42,24,18,57,29,28,6,4,0,0
"1716","ATL","T.B",2008020479,14233,20082009,1,60,4,3,1,0,0,0,30,39,-9,36,50,-14,47,58,-11,6,8,0,0
"1717","ATL","TOR",2008020491,14235,20082009,1,60,2,6,-4,0,0,0,21,38,-17,32,45,-13,47,62,-15,2,5,0,0
"1718","ATL","NYI",2008020495,14236,20082009,0,60,4,2,2,0,0,0,27,25,2,41,34,7,53,59,-6,3,3,0,0
"1719","ATL","CAR",2008020510,14239,20082009,1,60,4,5,-1,0,0,0,31,39,-8,39,49,-10,52,59,-7,3,4,0,0
"1720","ATL","BOS",2008020527,14241,20082009,1,60,1,2,-1,0,0,0,33,28,5,42,36,6,47,55,-8,5,5,0,0
"1721","ATL","TOR",2008020540,14243,20082009,0,60.55,3,4,-1,0,0,0,32,47,-15,46,66,-20,65,86,-21,5,4,0,0
"1722","ATL","CAR",2008020549,14244,20082009,0,60,1,3,-2,0,0,0,21,28,-7,34,47,-13,50,66,-16,4,4,0,0
"1723","ATL","VAN",2008020561,14246,20082009,1,65,3,3,0,0,0,0,37,38,-1,48,42,6,57,56,1,6,4,0,0
"1724","ATL","T.B",2008020577,14248,20082009,1,60,1,4,-3,0,0,0,28,35,-7,36,41,-5,46,51,-5,3,5,0,0
"1725","ATL","PIT",2008020590,14250,20082009,0,60,1,3,-2,0,0,0,28,29,-1,38,40,-2,57,51,6,3,6,0,0
"1726","ATL","N.J",2008020599,14252,20082009,0,60,4,0,4,0,0,0,24,29,-5,31,41,-10,37,54,-17,5,7,0,0
"1727","ATL","FLA",2008020619,14254,20082009,0,60,4,8,-4,0,0,0,32,29,3,46,36,10,54,46,8,5,5,0,0
"1728","ATL","OTT",2008020643,14258,20082009,1,60,2,3,-1,0,0,0,31,30,1,44,37,7,56,54,2,4,7,0,0
"1729","ATL","TOR",2008020658,14260,20082009,1,63.85,4,3,1,0,0,0,38,17,21,44,30,14,53,43,10,4,4,0,0
"1730","ATL","NSH",2008020668,14261,20082009,0,60,7,2,5,0,0,0,32,33,-1,37,49,-12,42,73,-31,2,6,0,0
"1731","ATL","MTL",2008020685,14264,20082009,1,60,4,2,2,0,0,0,24,36,-12,34,47,-13,46,66,-20,3,2,0,0
"1732","ATL","PHI",2008020694,14265,20082009,0,60,3,5,-2,0,0,0,31,33,-2,42,43,-1,53,63,-10,7,7,0,0
"1733","ATL","DAL",2008020708,14271,20082009,0,60,0,2,-2,0,0,0,25,33,-8,31,44,-13,36,57,-21,2,5,0,0
"1734","ATL","NYI",2008020718,14273,20082009,1,60,4,5,-1,0,0,0,37,33,4,50,40,10,66,50,16,5,4,0,0
"1735","ATL","CAR",2008020737,14275,20082009,0,60,0,2,-2,0,0,0,19,40,-21,36,53,-17,54,71,-17,3,2,0,0
"1736","ATL","NYR",2008020750,14278,20082009,0,65,1,1,0,0,0,0,22,40,-18,36,52,-16,40,67,-27,3,2,0,0
"1737","ATL","N.J",2008020774,14281,20082009,1,60,1,5,-4,0,0,0,32,31,1,39,37,2,58,46,12,8,7,0,0
"1738","ATL","PHI",2008020790,14283,20082009,1,60,2,3,-1,0,0,0,31,23,8,48,29,19,64,36,28,7,5,0,0
"1739","ATL","T.B",2008020798,14285,20082009,0,60,3,1,2,0,0,0,24,41,-17,35,53,-18,51,64,-13,3,5,0,0
"1740","ATL","CHI",2008020804,14286,20082009,1,60,1,3,-2,0,0,0,37,28,9,46,36,10,62,45,17,4,3,0,0
"1741","ATL","ANA",2008020839,14290,20082009,0,60,8,4,4,0,0,0,43,35,8,52,51,1,62,64,-2,6,3,0,0
"1742","ATL","L.A",2008020846,14291,20082009,0,65,6,6,0,0,0,0,27,45,-18,36,62,-26,41,89,-48,3,8,0,0
"1743","ATL","ARI",2008020869,14294,20082009,0,65,3,3,0,0,0,0,22,40,-18,39,53,-14,52,72,-20,2,5,0,0
"1744","ATL","S.J",2008020878,14296,20082009,0,60,1,3,-2,0,0,0,23,31,-8,33,37,-4,45,58,-13,5,3,0,0
"1745","ATL","COL",2008020896,14299,20082009,1,60,4,3,1,0,0,0,26,33,-7,37,41,-4,50,57,-7,5,6,0,0
"1746","ATL","WSH",2008020912,14301,20082009,0,60,3,4,-1,0,0,0,24,40,-16,29,53,-24,45,69,-24,5,8,0,0
"1747","ATL","CAR",2008020930,14303,20082009,1,60,5,3,2,0,0,0,32,35,-3,43,42,1,59,56,3,3,4,0,0
"1748","ATL","FLA",2008020943,14306,20082009,1,60,3,4,-1,0,0,0,30,34,-4,43,45,-2,55,57,-2,2,3,0,0
"1749","ATL","MTL",2008020966,14309,20082009,1,60,2,0,2,0,0,0,28,25,3,43,30,13,59,44,15,11,8,0,0
"1750","ATL","CGY",2008020982,14311,20082009,1,60,5,2,3,0,0,0,20,29,-9,31,42,-11,38,58,-20,10,7,0,0
"1751","ATL","COL",2008020999,14313,20082009,0,60,3,0,3,0,0,0,36,35,1,44,54,-10,67,64,3,5,3,0,0
"1752","ATL","EDM",2008021015,14315,20082009,0,64.1666666666667,4,3,1,0,0,0,33,32,1,41,43,-2,52,63,-11,6,6,0,0
"1753","ATL","BUF",2008021022,14317,20082009,0,65,3,3,0,0,0,0,32,37,-5,46,51,-5,54,71,-17,6,3,0,0
"1754","ATL","PIT",2008021043,14320,20082009,0,60,2,6,-4,0,0,0,20,31,-11,27,50,-23,45,60,-15,8,8,0,0
"1755","ATL","DET",2008021067,14323,20082009,1,60,3,6,-3,0,0,0,34,38,-4,38,46,-8,43,55,-12,9,7,0,0
"1756","ATL","T.B",2008021076,14324,20082009,0,65,3,3,0,0,0,0,36,29,7,44,43,1,58,61,-3,8,7,0,0
"1757","ATL","MTL",2008021090,14327,20082009,0,60,3,6,-3,0,0,0,25,22,3,38,35,3,54,47,7,8,8,0,0
"1758","ATL","NYR",2008021103,14329,20082009,1,65,4,4,0,0,0,0,30,27,3,39,37,2,46,49,-3,6,10,0,0
"1759","ATL","OTT",2008021121,14331,20082009,1,60,6,3,3,0,0,0,32,21,11,39,28,11,50,38,12,9,7,0,0
"1760","ATL","FLA",2008021161,14337,20082009,0,60,3,1,2,0,0,0,32,36,-4,36,52,-16,45,67,-22,3,4,0,0
"1761","ATL","FLA",2008021202,14343,20082009,1,60,2,3,-1,0,0,0,25,31,-6,36,41,-5,46,55,-9,6,9,0,0
"1762","ATL","T.B",2008021222,14345,20082009,1,60,6,2,4,0,0,0,26,35,-9,43,45,-2,62,52,10,7,5,0,0
"1763","ATL","T.B",2009020016,14520,20092010,1,60,6,3,3,0,0,0,28,39,-11,41,50,-9,48,64,-16,8,7,0,0
"1764","ATL","STL",2009020042,14525,20092010,0,60,4,2,2,0,0,0,22,31,-9,29,42,-13,38,48,-10,2,3,0,0
"1765","ATL","OTT",2009020051,14527,20092010,0,60,2,4,-2,0,0,0,28,34,-6,38,41,-3,51,51,0,4,4,0,0
"1766","ATL","N.J",2009020087,14533,20092010,0,60,4,2,2,0,0,0,19,30,-11,24,47,-23,33,61,-28,4,7,0,0
"1767","ATL","MTL",2009020110,14537,20092010,0,65,1,1,0,0,0,0,23,35,-12,35,54,-19,61,74,-13,7,7,0,0
"1768","ATL","S.J",2009020134,14541,20092010,1,60,3,4,-1,0,0,0,27,25,2,33,33,0,52,44,8,4,4,0,0
"1769","ATL","OTT",2009020182,14548,20092010,0,60,3,1,2,0,0,0,21,51,-30,30,63,-33,42,79,-37,2,4,0,0
"1770","ATL","MTL",2009020200,14551,20092010,0,60,5,4,1,0,0,0,30,38,-8,42,57,-15,56,67,-11,5,4,0,0
"1771","ATL","NYI",2009020230,14555,20092010,0,60,3,6,-3,0,0,0,34,45,-11,50,55,-5,65,72,-7,4,4,0,0
"1772","ATL","STL",2009020238,14556,20092010,1,65,2,2,0,0,0,0,40,32,8,51,45,6,70,54,16,6,4,0,0
"1773","ATL","NYR",2009020254,14560,20092010,0,60,5,3,2,0,0,0,27,36,-9,38,48,-10,52,55,-3,6,6,0,0
"1774","ATL","L.A",2009020266,14561,20092010,1,60,7,0,7,0,0,0,21,38,-17,25,49,-24,34,66,-32,4,7,0,0
"1775","ATL","EDM",2009020281,14563,20092010,1,60,3,2,1,0,0,0,30,36,-6,41,44,-3,48,50,-2,3,5,0,0
"1776","ATL","BOS",2009020300,14567,20092010,1,65,3,3,0,0,0,0,35,42,-7,48,49,-1,61,62,-1,7,2,0,0
"1777","ATL","PIT",2009020319,14569,20092010,1,60,2,3,-1,0,0,0,33,34,-1,40,47,-7,52,60,-8,3,3,0,0
"1778","ATL","T.B",2009020326,14570,20092010,1,62.9333333333333,3,4,-1,0,0,0,31,40,-9,37,53,-16,45,64,-19,5,7,0,0
"1779","ATL","DET",2009020345,14573,20092010,0,60,2,0,2,0,0,0,25,40,-15,30,51,-21,39,66,-27,4,3,0,0
"1780","ATL","CAR",2009020360,14575,20092010,0,60,6,4,2,0,0,0,34,36,-2,44,49,-5,56,70,-14,2,5,0,0
"1781","ATL","PHI",2009020371,14576,20092010,1,60,1,0,1,0,0,0,18,34,-16,27,43,-16,41,56,-15,6,4,0,0
"1782","ATL","FLA",2009020385,14578,20092010,1,60,4,3,1,0,0,0,35,28,7,43,34,9,62,43,19,1,3,0,0
"1783","ATL","NYI",2009020401,14581,20092010,1,60,1,4,-3,0,0,0,27,27,0,33,41,-8,46,55,-9,2,3,0,0
"1784","ATL","FLA",2009020420,14583,20092010,0,65,1,1,0,0,0,0,37,31,6,52,42,10,71,53,18,5,6,0,0
"1785","ATL","TOR",2009020430,14585,20092010,0,60,2,5,-3,0,0,0,24,28,-4,34,48,-14,47,64,-17,2,4,0,0
"1786","ATL","CGY",2009020450,14587,20092010,0,60,1,3,-2,0,0,0,25,32,-7,38,47,-9,47,61,-14,4,5,0,0
"1787","ATL","VAN",2009020456,14588,20092010,0,60,2,4,-2,0,0,0,24,38,-14,28,50,-22,33,60,-27,5,3,0,0
"1788","ATL","MTL",2009020471,14590,20092010,1,61.3,4,3,1,0,0,0,34,19,15,46,26,20,67,34,33,7,4,0,0
"1789","ATL","NYR",2009020483,14592,20092010,0,65,2,2,0,0,0,0,27,48,-21,37,61,-24,51,78,-27,3,5,0,0
"1790","ATL","FLA",2009020499,14594,20092010,0,60,3,4,-1,0,0,0,23,29,-6,33,36,-3,53,45,8,2,4,0,0
"1791","ATL","DAL",2009020505,14595,20092010,1,61.2666666666667,6,5,1,0,0,0,25,47,-22,32,54,-22,47,71,-24,4,4,0,0
"1792","ATL","N.J",2009020525,14597,20092010,1,60,4,5,-1,0,0,0,26,42,-16,38,50,-12,52,59,-7,2,2,0,0
"1793","ATL","MTL",2009020535,14599,20092010,1,62.3833333333333,3,4,-1,0,0,0,50,23,27,56,33,23,73,44,29,6,3,0,0
"1794","ATL","BOS",2009020545,14601,20092010,0,60,4,6,-2,0,0,0,29,31,-2,38,34,4,53,42,11,4,5,0,0
"1795","ATL","T.B",2009020563,14604,20092010,0,60,3,4,-1,0,0,0,27,34,-7,39,42,-3,58,55,3,6,4,0,0
"1796","ATL","BOS",2009020590,14608,20092010,0,60,0,4,-4,0,0,0,18,30,-12,31,44,-13,45,54,-9,4,5,0,0
"1797","ATL","NYI",2009020615,14611,20092010,0,65,5,5,0,0,0,0,27,36,-9,40,50,-10,57,62,-5,6,5,0,0
"1798","ATL","PIT",2009020633,14614,20092010,0,60,2,5,-3,0,0,0,33,37,-4,45,47,-2,57,56,1,2,4,0,0
"1799","ATL","NYR",2009020647,14616,20092010,1,65,1,1,0,0,0,0,32,30,2,40,37,3,58,48,10,6,7,0,0
"1800","ATL","OTT",2009020684,14621,20092010,1,60,6,1,5,0,0,0,28,31,-3,36,40,-4,45,50,-5,6,2,0,0
"1801","ATL","CAR",2009020715,14625,20092010,0,60,5,3,2,0,0,0,37,32,5,51,50,1,66,72,-6,3,5,0,0
"1802","ATL","FLA",2009020728,14627,20092010,0,60,0,1,-1,0,0,0,27,24,3,43,37,6,64,45,19,3,4,0,0
"1803","ATL","TOR",2009020736,14628,20092010,1,60,4,3,1,0,0,0,32,40,-8,39,51,-12,46,67,-21,8,6,0,0
"1804","ATL","CAR",2009020748,14630,20092010,1,60,2,5,-3,0,0,0,34,22,12,42,27,15,61,40,21,7,5,0,0
"1805","ATL","T.B",2009020767,14632,20092010,0,65,1,1,0,0,0,0,38,26,12,60,36,24,74,45,29,8,6,0,0
"1806","ATL","ANA",2009020780,14635,20092010,1,60,2,1,1,0,0,0,34,35,-1,44,45,-1,51,64,-13,4,4,0,0
"1807","ATL","PHI",2009020793,14637,20092010,0,60,4,3,1,0,0,0,28,37,-9,40,47,-7,51,60,-9,5,4,0,0
"1808","ATL","NSH",2009020813,14639,20092010,0,60,3,4,-1,0,0,0,26,31,-5,32,41,-9,44,52,-8,5,5,0,0
"1809","ATL","T.B",2009020829,14642,20092010,1,60,1,2,-1,0,0,0,27,24,3,37,35,2,59,45,14,4,4,0,0
"1810","ATL","FLA",2009020862,14646,20092010,1,60,4,2,2,0,0,0,35,28,7,48,39,9,64,49,15,5,8,0,0
"1811","ATL","COL",2009020889,14650,20092010,0,60.15,3,4,-1,0,0,0,36,35,1,50,47,3,66,61,5,5,5,0,0
"1812","ATL","MIN",2009020903,14652,20092010,0,60,3,2,1,0,0,0,24,38,-14,38,47,-9,54,61,-7,8,3,0,0
"1813","ATL","CHI",2009020913,14653,20092010,0,65,4,4,0,0,0,0,27,40,-13,34,55,-21,44,74,-30,6,7,0,0
"1814","ATL","FLA",2009020926,14670,20092010,1,60,4,2,2,0,0,0,39,36,3,49,46,3,71,52,19,5,8,0,0
"1815","ATL","NYI",2009020945,14672,20092010,1,60,6,3,3,0,0,0,22,37,-15,31,43,-12,40,55,-15,3,5,0,0
"1816","ATL","T.B",2009020960,14674,20092010,0,60,2,6,-4,0,0,0,31,30,1,40,39,1,56,49,7,7,6,0,0
"1817","ATL","CAR",2009020968,14675,20092010,1,60,0,4,-4,0,0,0,27,33,-6,35,39,-4,51,54,-3,4,8,0,0
"1818","ATL","NSH",2009020978,14677,20092010,1,60,1,2,-1,0,0,0,31,32,-1,42,43,-1,56,55,1,2,2,0,0
"1819","ATL","NYR",2009021003,14680,20092010,1,60,2,5,-3,0,0,0,31,35,-4,39,44,-5,51,54,-3,5,7,0,0
"1820","ATL","OTT",2009021045,14686,20092010,1,60,6,3,3,0,0,0,27,39,-12,39,52,-13,53,68,-15,7,5,0,0
"1821","ATL","PHI",2009021061,14688,20092010,1,60,5,2,3,0,0,0,28,27,1,37,39,-2,47,60,-13,4,5,0,0
"1822","ATL","PHI",2009021073,14689,20092010,0,60,3,1,2,0,0,0,31,45,-14,34,63,-29,42,85,-43,3,3,0,0
"1823","ATL","BOS",2009021082,14691,20092010,1,60,0,4,-4,0,0,0,27,33,-6,39,46,-7,53,61,-8,2,2,0,0
"1824","ATL","TOR",2009021101,14693,20092010,1,60.65,1,2,-1,0,0,0,20,30,-10,32,48,-16,52,63,-11,5,5,0,0
"1825","ATL","CAR",2009021116,14695,20092010,0,60,4,0,4,0,0,0,43,34,9,59,53,6,71,71,0,3,4,0,0
"1826","ATL","CAR",2009021129,14697,20092010,1,60,1,4,-3,0,0,0,27,22,5,32,29,3,51,49,2,7,4,0,0
"1827","ATL","TOR",2009021133,14698,20092010,0,60,3,2,1,0,0,0,25,29,-4,36,41,-5,50,58,-8,2,2,0,0
"1828","ATL","PIT",2009021164,14702,20092010,0,62.8333333333333,3,4,-1,0,0,0,24,35,-11,32,55,-23,42,72,-30,5,5,0,0
"1829","ATL","N.J",2009021185,14705,20092010,1,60,0,3,-3,0,0,0,19,27,-8,26,35,-9,40,48,-8,2,2,0,0
"1830","ATL","PIT",2009021217,14709,20092010,1,60,1,0,1,0,0,0,22,33,-11,33,44,-11,43,59,-16,7,5,0,0
"1831","ATL","T.B",2010020018,14891,20102011,0,60,3,5,-2,5.76435802354422,3.22710924497187,2.53724877857235,30,36,-6,51,44,7,63,61,2,7,6,0,0
"1832","ATL","L.A",2010020035,14894,20102011,0,60,1,3,-2,2.87002322505577,6.50431478396058,-3.63429155890481,32,35,-3,41,52,-11,52,69,-17,5,2,0,0
"1833","ATL","ANA",2010020053,14897,20102011,0,65,4,4,0,3.88185887584992,7.29435317792377,-3.41249430207385,33,41,-8,46,66,-20,58,79,-21,4,7,0,0
"1834","ATL","S.J",2010020066,14898,20102011,0,60,4,2,2,5.37826356838923,5.86947238292431,-0.491208814535085,28,39,-11,37,56,-19,49,70,-21,4,5,0,0
"1835","ATL","T.B",2010020095,14904,20102011,1,60,2,5,-3,2.85949180234275,7.11799747503903,-4.25850567269629,30,33,-3,36,41,-5,56,46,10,9,8,0,0
"1836","ATL","NYR",2010020123,14909,20102011,0,60,6,4,2,3.31630362708529,3.17960345267784,0.136700174407451,26,28,-2,36,41,-5,50,62,-12,3,1,0,0
"1837","ATL","STL",2010020149,14912,20102011,0,65,3,3,0,5.69936154491734,4.96563697476557,0.733724570151765,28,35,-7,45,50,-5,59,63,-4,7,3,0,0
"1838","ATL","FLA",2010020167,14916,20102011,0,60,4,3,1,5.15849254396744,6.19200711560552,-1.03351457163808,23,55,-32,33,64,-31,47,79,-32,1,1,0,0
"1839","ATL","CHI",2010020193,14919,20102011,1,65,4,4,0,2.83219868841115,4.03731087849337,-1.20511219008222,37,40,-3,45,50,-5,53,65,-12,5,2,0,0
"1840","ATL","OTT",2010020207,14922,20102011,0,60,2,5,-3,6.8558037392213,5.05243067190167,1.80337306731963,37,29,8,46,36,10,52,49,3,5,3,0,0
"1841","ATL","MIN",2010020221,14924,20102011,1,60,5,1,4,3.57471666741185,2.8730042518709,0.701712415540946,34,33,1,43,43,0,56,56,0,2,3,0,0
"1842","ATL","PIT",2010020238,14926,20102011,1,60,2,4,-2,4.44095069215109,3.15327052093524,1.28768017121585,33,28,5,43,36,7,55,49,6,6,6,0,0
"1843","ATL","FLA",2010020262,14930,20102011,1,60,1,2,-1,5.08690245965082,3.81273282552138,1.27416963412944,39,34,5,50,45,5,61,62,-1,1,3,0,0
"1844","ATL","NYI",2010020294,14934,20102011,1,61.5,2,1,1,3.76452200984144,4.66148489236366,-0.896962882522217,35,29,6,48,35,13,71,54,17,4,4,0,0
"1845","ATL","DET",2010020310,14937,20102011,1,60,5,1,4,4.05216689668905,3.81962218583794,0.232544710851106,38,33,5,46,43,3,60,56,4,3,4,0,0
"1846","ATL","MTL",2010020330,14939,20102011,1,60,3,0,3,7.22961567380116,3.2734720142045,3.95614365959666,47,25,22,57,30,27,68,46,22,8,4,0,0
"1847","ATL","BOS",2010020346,14941,20102011,1,60,4,1,3,3.45824355192599,5.57979299056751,-2.12154943864152,26,41,-15,35,47,-12,48,59,-11,5,6,0,0
"1848","ATL","COL",2010020356,14943,20102011,0,61.8166666666667,3,2,1,5.53194740792969,3.62288299080408,1.90906441712561,31,31,0,38,48,-10,52,66,-14,4,4,0,0
"1849","ATL","PIT",2010020369,14945,20102011,0,60,2,3,-1,3.29785556427669,4.63343459021416,-1.33557902593748,22,28,-6,32,41,-9,49,48,1,2,2,0,0
"1850","ATL","NSH",2010020398,14949,20102011,1,62.1833333333333,3,2,1,4.3927134215046,3.84246267313938,0.550250748365215,37,29,8,48,36,12,63,47,16,4,1,0,0
"1851","ATL","COL",2010020421,14953,20102011,1,60,2,4,-2,2.92803415365051,4.15294039432774,-1.22490624067723,26,29,-3,37,37,0,55,50,5,4,4,0,0
"1852","ATL","NYI",2010020429,14954,20102011,0,60,5,4,1,4.73618066775594,4.38871887335435,0.347461794401585,35,29,6,51,43,8,76,68,8,5,5,0,0
"1853","ATL","OTT",2010020442,14956,20102011,0,61.15,4,3,1,3.97324569418561,5.18655676516937,-1.21331107098376,24,30,-6,42,51,-9,57,75,-18,0,2,0,0
"1854","ATL","T.B",2010020455,14958,20102011,0,65,1,1,0,2.24391849689073,4.93816081703665,-2.69424232014592,28,31,-3,41,48,-7,55,65,-10,5,2,0,0
"1855","ATL","CAR",2010020462,14959,20102011,1,65,2,2,0,4.65711003273282,3.93067153357468,0.726438499158135,47,29,18,64,40,24,81,56,25,4,2,0,0
"1856","ATL","N.J",2010020477,14961,20102011,1,60,7,1,6,2.87126923556207,7.22309914242942,-4.35182990686735,22,27,-5,28,37,-9,40,53,-13,3,4,0,0
"1857","ATL","TOR",2010020489,14963,20102011,0,60,6,3,3,6.10594981282142,5.61691906127817,0.489030751543254,23,40,-17,38,58,-20,51,91,-40,1,4,0,0
"1858","ATL","STL",2010020497,14964,20102011,1,60,2,4,-2,8.68179101329292,6.38532273358351,2.29646827970942,39,27,12,47,38,9,57,55,2,4,4,0,0
"1859","ATL","BOS",2010020506,14966,20102011,0,60,1,4,-3,3.88012205613086,6.0494400210664,-2.16931796493554,27,36,-9,38,52,-14,52,71,-19,3,7,0,0
"1860","ATL","T.B",2010020523,14969,20102011,1,61.2166666666667,2,3,-1,3.2698958545756,4.62191654169328,-1.35202068711768,28,34,-6,34,44,-10,53,58,-5,3,5,0,0
"1861","ATL","PIT",2010020537,14971,20102011,0,60,3,6,-3,4.58794581099254,3.86489509324588,0.723050717746666,34,36,-2,49,46,3,58,53,5,9,4,0,0
"1862","ATL","BOS",2010020552,14973,20102011,1,65,2,2,0,3.42517852295532,6.29733318890027,-2.87215466594495,32,44,-12,39,64,-25,62,92,-30,6,4,0,0
"1863","ATL","N.J",2010020557,14974,20102011,0,60,1,3,-2,4.4307132238755,3.8668404935961,0.5638727302794,29,28,1,36,35,1,43,48,-5,2,2,0,0
"1864","ATL","MTL",2010020573,14976,20102011,0,63.7166666666667,4,3,1,3.54359115561512,6.36892664418755,-2.82533548857244,28,50,-22,39,71,-32,52,91,-39,2,3,0,0
"1865","ATL","FLA",2010020593,14979,20102011,0,60,3,2,1,3.12212788797569,3.25135148048682,-0.129223592511124,31,35,-4,38,44,-6,51,62,-11,5,2,0,0
"1866","ATL","TOR",2010020605,14981,20102011,1,60,3,9,-6,6.57832536640763,3.22283656439049,3.35548880201713,44,34,10,52,40,12,65,49,16,4,3,0,0
"1867","ATL","CAR",2010020623,14983,20102011,0,62.15,3,4,-1,5.28109531612427,5.66190923073153,-0.38081391460727,28,34,-6,40,46,-6,55,58,-3,4,4,0,0
"1868","ATL","PHI",2010020657,14988,20102011,1,60,2,5,-3,3.50999651463428,4.934262099443,-1.42426558480872,29,36,-7,42,46,-4,57,63,-6,3,3,0,0
"1869","ATL","DAL",2010020668,14989,20102011,0,60,1,6,-5,3.08955999937006,4.23618669854477,-1.14662669917471,30,27,3,41,41,0,55,54,1,3,4,0,0
"1870","ATL","FLA",2010020681,14991,20102011,0,65,2,2,0,6.38185762555804,7.6366869112461,-1.25482928568806,30,40,-10,45,61,-16,65,76,-11,2,5,0,0
"1871","ATL","T.B",2010020702,14994,20102011,1,65,2,2,0,0,0,0,29,31,-2,35,40,-5,47,50,-3,3,3,0,0
"1872","ATL","NYR",2010020718,14996,20102011,1,65,2,2,0,3.74339023954235,3.8461211505055,-0.102730910963146,22,31,-9,35,35,0,50,56,-6,3,2,0,0
"1873","ATL","T.B",2010020726,14997,20102011,0,60,1,7,-6,3.63357167822662,5.5163555659783,-1.88278388775168,22,39,-17,33,54,-21,43,70,-27,3,3,0,0
"1874","ATL","NYI",2010020756,15006,20102011,1,60,1,4,-3,5.10700151120545,3.89218818204245,1.21481332916301,26,33,-7,42,40,2,52,57,-5,1,1,0,0
"1875","ATL","CGY",2010020774,15008,20102011,1,60,2,4,-2,3.85744426083905,4.87478972971439,-1.01734546887535,24,24,0,36,36,0,56,53,3,2,2,0,0
"1876","ATL","CAR",2010020788,15010,20102011,0,62.8,3,4,-1,7.08495396950934,6.99422735335511,0.0907266161542282,37,37,0,53,50,3,68,63,5,8,8,0,0
"1877","ATL","TOR",2010020796,15012,20102011,0,60,4,5,-1,3.9457378195948,6.0489154781517,-2.1031776585569,34,32,2,50,48,2,63,70,-7,7,5,0,0
"1878","ATL","NYR",2010020825,15016,20102011,1,60,3,2,1,0,0,0,35,29,6,51,36,15,67,47,20,6,5,0,0
"1879","ATL","CAR",2010020840,15018,20102011,1,60,2,3,-1,6.12335169980156,2.40424238191918,3.71910931788238,43,17,26,57,23,34,65,45,20,2,2,0,0
"1880","ATL","EDM",2010020877,15024,20102011,0,60,3,5,-2,3.66750730189051,4.25073582023463,-0.583228518344123,31,26,5,50,39,11,63,52,11,5,7,0,0
"1881","ATL","FLA",2010020919,15030,20102011,1,65,1,1,0,5.24948048302969,3.94923548734914,1.30024499568054,46,32,14,56,37,19,76,48,28,3,5,0,0
"1882","ATL","TOR",2010020934,15032,20102011,1,62.5166666666667,3,2,1,7.38349175944607,2.4518689410761,4.93162281836997,43,24,19,63,30,33,83,41,42,4,4,0,0
"1883","ATL","MTL",2010020945,15034,20102011,1,60,1,3,-2,0,0,0,41,23,18,52,28,24,69,40,29,7,6,0,0
"1884","ATL","OTT",2010020962,15036,20102011,1,60,1,3,-2,3.96353973267833,4.59694487252273,-0.633405139844399,43,27,16,54,40,14,70,53,17,2,2,0,0
"1885","ATL","FLA",2010020978,15038,20102011,1,60.4166666666667,4,3,1,5.22763309122456,3.6019084446281,1.62572464659646,36,34,2,51,41,10,64,60,4,4,4,0,0
"1886","ATL","CAR",2010021002,15042,20102011,0,61.6333333333333,3,2,1,5.37440992193297,7.24768089173449,-1.87327096980152,29,37,-8,40,56,-16,51,79,-28,2,3,0,0
"1887","ATL","N.J",2010021019,15044,20102011,1,64.3,2,3,-1,1.51073742974222,4.42203447065549,-2.91129704091327,26,30,-4,33,41,-8,44,57,-13,4,6,0,0
"1888","ATL","PHI",2010021026,15045,20102011,0,61.2833333333333,5,4,1,6.26716928387759,4.0285014793852,2.23866780449239,41,24,17,56,31,25,73,49,24,4,3,0,0
"1889","ATL","N.J",2010021042,15048,20102011,0,60,2,4,-2,4.49652266170597,4.46128254077843,0.0352401209275399,20,24,-4,27,38,-11,35,45,-10,1,2,0,0
"1890","ATL","PHI",2010021055,15050,20102011,1,65,3,3,0,4.57827636367324,2.73272036573926,1.84555599793398,25,24,1,40,31,9,58,41,17,4,3,0,0
"1891","ATL","NYI",2010021103,15057,20102011,0,60,2,1,1,4.05877551030972,1.58488617089461,2.47388933941511,34,15,19,53,27,26,74,47,27,4,5,0,0
"1892","ATL","VAN",2010021114,15058,20102011,1,60,1,3,-2,4.99091367468645,4.01874372605744,0.972169948629016,31,26,5,42,34,8,56,44,12,4,2,0,0
"1893","ATL","OTT",2010021129,15060,20102011,1,65,4,4,0,4.81837792699812,5.30944911317366,-0.491071186175532,47,28,19,66,36,30,82,46,36,4,1,0,0
"1894","ATL","MTL",2010021139,15062,20102011,0,60,1,3,-2,5.06610075172958,3.8179266913794,1.24817406035018,28,31,-3,43,40,3,57,53,4,4,6,0,0
"1895","ATL","PHI",2010021152,15064,20102011,0,60,1,0,1,4.04676402243786,3.30461728405769,0.742146738380164,22,43,-21,31,52,-21,44,71,-27,7,6,0,0
"1896","ATL","BOS",2010021164,15066,20102011,0,60,2,3,-1,7.28474984793974,2.30037263986237,4.98437720807736,30,24,6,43,35,8,53,57,-4,3,2,0,0
"1897","ATL","NSH",2010021190,15069,20102011,0,60,3,6,-3,4.94501046975569,3.80195442768309,1.1430560420726,36,24,12,44,29,15,62,37,25,3,5,0,0
"1898","ATL","NYR",2010021201,15071,20102011,0,60,3,0,3,4.5329339139862,4.26869058798547,0.264243326000724,26,29,-3,41,41,0,52,60,-8,2,4,0,0
"1899","ATL","CAR",2010021208,15072,20102011,1,60,1,6,-5,4.17712970206048,4.69818690681132,-0.521057204750832,19,32,-13,32,38,-6,40,55,-15,2,8,0,0
"1900","ATL","PIT",2010021227,15074,20102011,1,60,2,5,-3,6.03472059725281,2.67983451220789,3.35488608504492,39,20,19,56,28,28,71,41,30,5,3,0,0
"1901","BOS","COL",2008020006,14161,20082009,0,60,5,4,1,0,0,0,20,39,-19,28,47,-19,38,69,-31,2,5,0,0
"1902","BOS","MIN",2008020025,14163,20082009,0,60,3,4,-1,0,0,0,37,26,11,52,36,16,63,44,19,5,5,0,0
"1903","BOS","MTL",2008020045,14167,20082009,0,65,3,3,0,0,0,0,34,28,6,47,41,6,73,63,10,7,5,0,0
"1904","BOS","OTT",2008020065,14170,20082009,0,60,4,2,2,0,0,0,27,23,4,36,35,1,48,55,-7,2,5,0,0
"1905","BOS","PIT",2008020078,14172,20082009,1,65,1,1,0,0,0,0,36,32,4,48,36,12,64,45,19,6,4,0,0
"1906","BOS","BUF",2008020082,14173,20082009,0,65,2,2,0,0,0,0,32,30,2,42,37,5,54,51,3,6,4,0,0
"1907","BOS","TOR",2008020092,14175,20082009,1,60,2,4,-2,0,0,0,28,37,-9,39,47,-8,58,57,1,4,7,0,0
"1908","BOS","ATL",2008020105,14177,20082009,1,60,5,4,1,0,0,0,33,32,1,47,40,7,61,49,12,6,5,0,0
"1909","BOS","EDM",2008020124,14179,20082009,0,63.3,1,0,1,0,0,0,36,27,9,48,39,9,64,57,7,5,3,0,0
"1910","BOS","VAN",2008020131,14180,20082009,0,60,1,0,1,0,0,0,30,31,-1,35,43,-8,46,61,-15,2,3,0,0
"1911","BOS","CGY",2008020144,14182,20082009,0,60,2,3,-1,0,0,0,31,38,-7,52,51,1,56,65,-9,3,5,0,0
"1912","BOS","DAL",2008020151,14184,20082009,1,60,5,1,4,0,0,0,25,36,-11,35,42,-7,46,47,-1,12,11,0,0
"1913","BOS","TOR",2008020181,14189,20082009,1,60,5,2,3,0,0,0,35,36,-1,45,44,1,53,55,-2,3,4,0,0
"1914","BOS","BUF",2008020196,14191,20082009,1,60,3,1,2,0,0,0,40,33,7,48,43,5,59,50,9,3,2,0,0
"1915","BOS","CHI",2008020226,14195,20082009,0,65,1,1,0,0,0,0,39,32,7,42,38,4,59,50,9,8,8,0,0
"1916","BOS","MTL",2008020228,14196,20082009,1,60,6,1,5,0,0,0,31,28,3,38,34,4,56,43,13,4,2,0,0
"1917","BOS","NYR",2008020245,14198,20082009,0,65,2,2,0,0,0,0,25,31,-6,32,56,-24,39,71,-32,2,6,0,0
"1918","BOS","BUF",2008020268,14202,20082009,1,60,7,4,3,0,0,0,23,29,-6,38,39,-1,51,44,7,8,5,0,0
"1919","BOS","FLA",2008020279,14204,20082009,1,60,4,2,2,0,0,0,39,32,7,47,39,8,55,50,5,3,5,0,0
"1920","BOS","MTL",2008020289,14205,20082009,0,65,2,2,0,0,0,0,27,35,-8,41,48,-7,56,77,-21,3,5,0,0
"1921","BOS","BUF",2008020309,14209,20082009,0,60,2,3,-1,0,0,0,29,23,6,43,37,6,56,45,11,2,2,0,0
"1922","BOS","NYI",2008020323,14211,20082009,1,60,7,2,5,0,0,0,39,24,15,53,32,21,67,37,30,5,4,0,0
"1923","BOS","DET",2008020336,14212,20082009,1,60,4,1,3,0,0,0,19,30,-11,27,41,-14,30,56,-26,2,4,0,0
"1924","BOS","T.B",2008020370,14217,20082009,0,60,3,1,2,0,0,0,26,31,-5,37,43,-6,47,60,-13,1,3,0,0
"1925","BOS","FLA",2008020385,14219,20082009,0,60,4,0,4,0,0,0,32,27,5,49,37,12,61,44,17,4,2,0,0
"1926","BOS","T.B",2008020397,14221,20082009,1,60,5,3,2,0,0,0,24,29,-5,37,35,2,44,45,-1,7,4,0,0
"1927","BOS","WSH",2008020407,14223,20082009,0,60,1,3,-2,0,0,0,34,26,8,49,38,11,67,51,16,3,2,0,0
"1928","BOS","ATL",2008020425,14225,20082009,0,60,7,3,4,0,0,0,25,33,-8,36,51,-15,46,62,-16,2,5,0,0
"1929","BOS","ATL",2008020431,14226,20082009,1,60,4,2,2,0,0,0,29,22,7,39,31,8,50,38,12,7,4,0,0
"1930","BOS","TOR",2008020460,14231,20082009,1,60,8,5,3,0,0,0,27,36,-9,35,42,-7,44,53,-9,7,6,0,0
"1931","BOS","CAR",2008020474,14233,20082009,1,60,4,2,2,0,0,0,36,34,2,47,38,9,58,43,15,1,3,0,0
"1932","BOS","STL",2008020487,14234,20082009,0,60,6,3,3,0,0,0,28,32,-4,39,41,-2,48,49,-1,4,3,0,0
"1933","BOS","N.J",2008020494,14236,20082009,0,60,2,0,2,0,0,0,24,25,-1,33,34,-1,39,42,-3,4,3,0,0
"1934","BOS","CAR",2008020518,14240,20082009,0,60,4,2,2,0,0,0,22,31,-9,33,52,-19,54,64,-10,3,4,0,0
"1935","BOS","ATL",2008020527,14241,20082009,0,60,2,1,1,0,0,0,28,33,-5,36,42,-6,55,47,8,5,5,0,0
"1936","BOS","PIT",2008020541,14243,20082009,0,60,5,2,3,0,0,0,40,34,6,54,37,17,76,43,33,9,4,0,0
"1937","BOS","PIT",2008020555,14245,20082009,1,60,4,2,2,0,0,0,26,32,-6,36,45,-9,52,62,-10,6,5,0,0
"1938","BOS","BUF",2008020565,14247,20082009,1,60,2,4,-2,0,0,0,31,25,6,42,31,11,53,34,19,6,4,0,0
"1939","BOS","MIN",2008020585,14250,20082009,1,60,0,1,-1,0,0,0,28,24,4,39,37,2,48,46,2,3,6,0,0
"1940","BOS","OTT",2008020598,14252,20082009,1,60,6,4,2,0,0,0,22,30,-8,31,33,-2,47,42,5,2,1,0,0
"1941","BOS","CAR",2008020614,14254,20082009,1,60,5,1,4,0,0,0,32,30,2,47,37,10,67,50,17,5,3,0,0
"1942","BOS","MTL",2008020631,14257,20082009,1,60,3,1,2,0,0,0,29,35,-6,41,39,2,46,52,-6,4,5,0,0
"1943","BOS","NYI",2008020646,14259,20082009,0,60,2,1,1,0,0,0,27,41,-14,35,58,-23,45,81,-36,3,3,0,0
"1944","BOS","WSH",2008020666,14261,20082009,0,60,1,2,-1,0,0,0,24,30,-6,37,42,-5,46,63,-17,4,5,0,0
"1945","BOS","STL",2008020677,14263,20082009,1,65,4,4,0,0,0,0,26,31,-5,38,40,-2,55,54,1,6,5,0,0
"1946","BOS","TOR",2008020695,14265,20082009,0,65,3,3,0,0,0,0,30,34,-4,45,50,-5,56,73,-17,4,4,0,0
"1947","BOS","WSH",2008020701,14271,20082009,1,61.9166666666667,3,2,1,0,0,0,28,36,-8,39,48,-9,50,61,-11,5,6,0,0
"1948","BOS","N.J",2008020716,14273,20082009,1,61.1833333333333,3,4,-1,0,0,0,27,30,-3,37,41,-4,53,47,6,4,1,0,0
"1949","BOS","NYR",2008020731,14275,20082009,1,60,1,0,1,0,0,0,27,35,-8,43,44,-1,53,55,-2,2,1,0,0
"1950","BOS","MTL",2008020743,14276,20082009,0,60,3,1,2,0,0,0,23,28,-5,34,38,-4,50,53,-3,8,8,0,0
"1951","BOS","PHI",2008020759,14279,20082009,0,60,3,1,2,0,0,0,33,26,7,47,35,12,65,47,18,5,2,0,0
"1952","BOS","OTT",2008020765,14280,20082009,0,65,3,3,0,0,0,0,30,22,8,39,29,10,52,52,0,4,2,0,0
"1953","BOS","PHI",2008020777,14282,20082009,1,63,3,4,-1,0,0,0,37,30,7,52,40,12,62,59,3,3,6,0,0
"1954","BOS","S.J",2008020795,14285,20082009,1,60,2,5,-3,0,0,0,30,31,-1,39,42,-3,51,51,0,5,1,0,0
"1955","BOS","N.J",2008020818,14288,20082009,0,60,0,1,-1,0,0,0,31,18,13,37,27,10,55,33,22,2,2,0,0
"1956","BOS","NSH",2008020830,14289,20082009,0,65,2,2,0,0,0,0,25,31,-6,41,51,-10,52,68,-16,4,6,0,0
"1957","BOS","CAR",2008020847,14292,20082009,0,60,5,1,4,0,0,0,34,32,2,50,41,9,74,56,18,5,6,0,0
"1958","BOS","FLA",2008020882,14296,20082009,0,60,0,2,-2,0,0,0,41,29,12,60,41,19,68,61,7,4,4,0,0
"1959","BOS","T.B",2008020889,14297,20082009,0,60,3,4,-1,0,0,0,43,18,25,60,30,30,80,38,42,5,6,0,0
"1960","BOS","FLA",2008020893,14299,20082009,1,60,6,1,5,0,0,0,39,25,14,49,36,13,68,51,17,2,1,0,0
"1961","BOS","ANA",2008020908,14301,20082009,1,60,6,0,6,0,0,0,27,35,-8,32,43,-11,47,54,-7,5,4,0,0
"1962","BOS","WSH",2008020923,14303,20082009,1,60.3666666666667,3,4,-1,0,0,0,37,32,5,45,44,1,61,57,4,4,5,0,0
"1963","BOS","PHI",2008020941,14306,20082009,1,60,2,4,-2,0,0,0,24,26,-2,34,33,1,45,46,-1,6,6,0,0
"1964","BOS","ARI",2008020955,14308,20082009,1,60,1,2,-1,0,0,0,26,18,8,37,27,10,59,39,20,3,2,0,0
"1965","BOS","CHI",2008020969,14310,20082009,1,60,5,3,2,0,0,0,39,35,4,42,52,-10,56,69,-13,3,3,0,0
"1966","BOS","NYR",2008020980,14311,20082009,0,60,3,4,-1,0,0,0,39,30,9,52,44,8,60,60,0,5,6,0,0
"1967","BOS","OTT",2008021003,14315,20082009,1,60,5,3,2,0,0,0,22,28,-6,31,39,-8,42,50,-8,4,5,0,0
"1968","BOS","NYI",2008021018,14317,20082009,1,60,2,1,1,0,0,0,25,22,3,34,32,2,47,51,-4,4,6,0,0
"1969","BOS","PIT",2008021032,14318,20082009,0,60,4,6,-2,0,0,0,25,34,-9,38,46,-8,50,61,-11,5,8,0,0
"1970","BOS","L.A",2008021055,14322,20082009,1,64.4166666666667,2,3,-1,0,0,0,26,38,-12,39,47,-8,51,63,-12,4,3,0,0
"1971","BOS","N.J",2008021078,14325,20082009,1,60,4,1,3,0,0,0,30,42,-12,36,49,-13,46,69,-23,5,6,0,0
"1972","BOS","TOR",2008021117,14331,20082009,0,60,7,5,2,0,0,0,31,38,-7,48,54,-6,57,67,-10,2,2,0,0
"1973","BOS","PHI",2008021130,14332,20082009,0,60,4,3,1,0,0,0,31,48,-17,45,59,-14,66,75,-9,3,3,0,0
"1974","BOS","T.B",2008021137,14334,20082009,1,60,3,1,2,0,0,0,39,25,14,49,29,20,53,41,12,7,6,0,0
"1975","BOS","OTT",2008021150,14336,20082009,1,60,2,1,1,0,0,0,33,32,1,43,39,4,53,58,-5,4,5,0,0
"1976","BOS","NYR",2008021164,14338,20082009,1,60,1,0,1,0,0,0,24,31,-7,33,41,-8,42,58,-16,4,4,0,0
"1977","BOS","OTT",2008021189,14341,20082009,0,60,2,3,-1,0,0,0,33,32,1,40,46,-6,50,57,-7,5,5,0,0
"1978","BOS","MTL",2008021199,14343,20082009,1,62.7,5,4,1,0,0,0,33,39,-6,40,45,-5,48,52,-4,10,13,0,0
"1979","BOS","NYI",2008021228,14346,20082009,0,60,6,2,4,0,0,0,33,34,-1,45,41,4,66,58,8,5,4,0,0
"1980","BOS","MTL",2008030111,14350,20082009,1,60,4,2,2,0,0,0,39,28,11,49,39,10,58,49,9,6,4,0,0
"1981","BOS","MTL",2008030112,14352,20082009,1,60,5,1,4,0,0,0,31,31,0,41,47,-6,53,54,-1,9,4,0,0
"1982","BOS","MTL",2008030113,14354,20082009,0,60,4,2,2,0,0,0,30,25,5,40,38,2,57,61,-4,3,5,0,0
"1983","BOS","MTL",2008030114,14356,20082009,0,60,4,1,3,0,0,0,30,27,3,45,38,7,66,53,13,6,3,0,0
"1984","BOS","CAR",2008030211,14365,20082009,1,60,4,1,3,0,0,0,24,27,-3,33,34,-1,41,50,-9,4,2,0,0
"1985","BOS","CAR",2008030212,14367,20082009,1,60,0,3,-3,0,0,0,36,25,11,45,34,11,58,51,7,4,1,0,0
"1986","BOS","CAR",2008030213,14370,20082009,0,62.8,2,3,-1,0,0,0,23,41,-18,32,58,-26,48,66,-18,2,3,0,0
"1987","BOS","CAR",2008030214,14372,20082009,0,60,1,4,-3,0,0,0,21,31,-10,30,43,-13,49,54,-5,7,9,0,0
"1988","BOS","CAR",2008030215,14374,20082009,1,60,4,0,4,0,0,0,40,19,21,55,21,34,60,30,30,14,10,0,0
"1989","BOS","CAR",2008030216,14376,20082009,0,60,4,2,2,0,0,0,19,33,-14,29,44,-15,38,56,-18,2,3,0,0
"1990","BOS","CAR",2008030217,14378,20082009,1,78.7666666666667,2,3,-1,0,0,0,36,37,-1,52,47,5,71,55,16,4,2,0,0
"1991","BOS","CAR",2009020010,14520,20092010,1,60,7,2,5,0,0,0,42,27,15,49,38,11,56,49,7,12,12,0,0
"1992","BOS","ANA",2009020035,14525,20092010,1,60,1,6,-5,0,0,0,34,30,4,44,40,4,59,49,10,6,2,0,0
"1993","BOS","NYI",2009020049,14527,20092010,1,65,3,3,0,0,0,0,30,38,-8,46,51,-5,57,63,-6,5,6,0,0
"1994","BOS","COL",2009020064,14529,20092010,1,60,3,4,-1,0,0,0,32,22,10,47,27,20,68,36,32,6,5,0,0
"1995","BOS","DAL",2009020090,14533,20092010,0,60,3,0,3,0,0,0,29,27,2,40,39,1,56,63,-7,1,3,0,0
"1996","BOS","NSH",2009020112,14538,20092010,1,60,3,2,1,0,0,0,27,30,-3,31,36,-5,42,43,-1,2,3,0,0
"1997","BOS","PHI",2009020120,14539,20092010,0,65,3,3,0,0,0,0,26,39,-13,37,56,-19,59,72,-13,2,2,0,0
"1998","BOS","OTT",2009020131,14541,20092010,0,65,3,3,0,0,0,0,28,30,-2,39,42,-3,51,52,-1,4,3,0,0
"1999","BOS","N.J",2009020165,14546,20092010,1,60,1,2,-1,0,0,0,32,31,1,49,37,12,59,47,12,2,1,0,0
"2000","BOS","EDM",2009020180,14548,20092010,1,60,2,0,2,0,0,0,27,19,8,41,24,17,57,30,27,2,2,0,0
"2001","BOS","NYR",2009020191,14549,20092010,0,60,0,1,-1,0,0,0,29,23,6,41,29,12,55,43,12,5,2,0,0
"2002","BOS","DET",2009020198,14551,20092010,0,60,0,2,-2,0,0,0,29,26,3,39,39,0,59,49,10,4,4,0,0
"2003","BOS","MTL",2009020209,14553,20092010,1,65,1,1,0,0,0,0,43,26,17,53,33,20,62,35,27,4,3,0,0
"2004","BOS","PIT",2009020241,14558,20092010,1,60,3,0,3,0,0,0,29,27,2,33,38,-5,44,60,-16,1,2,0,0
"2005","BOS","FLA",2009020253,14560,20092010,1,65,0,0,0,0,0,0,40,23,17,53,30,23,70,44,26,3,3,0,0
"2006","BOS","PIT",2009020274,14562,20092010,0,61.4,5,6,-1,0,0,0,33,33,0,51,46,5,73,57,16,3,3,0,0
"2007","BOS","NYI",2009020283,14564,20092010,1,60,1,4,-3,0,0,0,29,21,8,40,30,10,55,40,15,4,6,0,0
"2008","BOS","ATL",2009020300,14567,20092010,0,65,3,3,0,0,0,0,42,35,7,49,48,1,62,61,1,2,7,0,0
"2009","BOS","STL",2009020333,14571,20092010,0,60,4,2,2,0,0,0,23,31,-8,33,45,-12,42,64,-22,3,3,0,0
"2010","BOS","MIN",2009020346,14573,20092010,0,65,1,1,0,0,0,0,16,29,-13,29,49,-20,52,62,-10,4,6,0,0
"2011","BOS","N.J",2009020355,14575,20092010,1,65,1,1,0,0,0,0,33,37,-4,41,45,-4,58,52,6,3,3,0,0
"2012","BOS","OTT",2009020368,14576,20092010,1,65,3,3,0,0,0,0,33,22,11,45,25,20,59,38,21,5,4,0,0
"2013","BOS","T.B",2009020394,14580,20092010,1,60,4,1,3,0,0,0,39,40,-1,48,46,2,55,55,0,3,6,0,0
"2014","BOS","MTL",2009020410,14582,20092010,0,60,1,5,-4,0,0,0,38,29,9,57,36,21,79,46,33,7,4,0,0
"2015","BOS","TOR",2009020416,14583,20092010,1,60,7,2,5,0,0,0,33,33,0,37,44,-7,57,57,0,7,5,0,0
"2016","BOS","TOR",2009020452,14588,20092010,1,60,5,2,3,0,0,0,34,34,0,50,45,5,54,53,1,4,3,0,0
"2017","BOS","NYI",2009020469,14590,20092010,0,60.4,2,3,-1,0,0,0,32,19,13,45,25,20,61,34,27,3,2,0,0
"2018","BOS","PHI",2009020480,14592,20092010,1,60,1,3,-2,0,0,0,27,38,-11,36,50,-14,48,58,-10,4,5,0,0
"2019","BOS","CHI",2009020515,14596,20092010,0,65,4,4,0,0,0,0,29,44,-15,38,56,-18,50,65,-15,1,2,0,0
"2020","BOS","TOR",2009020521,14597,20092010,0,60,0,2,-2,0,0,0,25,31,-6,35,47,-12,56,66,-10,3,5,0,0
"2021","BOS","OTT",2009020536,14599,20092010,0,60,2,0,2,0,0,0,29,29,0,39,41,-2,55,57,-2,5,2,0,0
"2022","BOS","ATL",2009020545,14601,20092010,1,60,6,4,2,0,0,0,31,29,2,34,38,-4,42,53,-11,5,4,0,0
"2023","BOS","FLA",2009020571,14605,20092010,0,60,2,1,1,0,0,0,28,26,2,39,34,5,51,40,11,2,3,0,0
"2024","BOS","T.B",2009020580,14606,20092010,0,60,1,2,-1,0,0,0,32,39,-7,42,49,-7,55,55,0,4,7,0,0
"2025","BOS","ATL",2009020590,14608,20092010,1,60,4,0,4,0,0,0,30,18,12,44,31,13,54,45,9,5,4,0,0
"2026","BOS","PHI",2009020609,14610,20092010,1,61.95,2,1,1,0,0,0,26,25,1,40,34,6,60,46,14,4,3,0,0
"2027","BOS","NYR",2009020627,14613,20092010,0,60,2,3,-1,0,0,0,28,35,-7,45,48,-3,69,61,8,3,5,0,0
"2028","BOS","OTT",2009020632,14614,20092010,0,60,4,1,3,0,0,0,35,28,7,44,40,4,58,54,4,10,9,0,0
"2029","BOS","CHI",2009020645,14616,20092010,1,60,2,5,-3,0,0,0,21,36,-15,31,45,-14,47,56,-9,5,3,0,0
"2030","BOS","NYR",2009020660,14618,20092010,1,60,1,3,-2,0,0,0,30,34,-4,38,42,-4,52,49,3,2,4,0,0
"2031","BOS","ANA",2009020692,14622,20092010,0,60,3,4,-1,0,0,0,30,32,-2,44,41,3,53,48,5,5,7,0,0
"2032","BOS","S.J",2009020704,14623,20092010,0,65,1,1,0,0,0,0,31,42,-11,44,55,-11,56,77,-21,2,2,0,0
"2033","BOS","L.A",2009020710,14625,20092010,0,65,3,3,0,0,0,0,24,34,-10,38,51,-13,51,66,-15,1,5,0,0
"2034","BOS","OTT",2009020723,14627,20092010,1,60,1,5,-4,0,0,0,23,26,-3,27,33,-6,38,46,-8,2,6,0,0
"2035","BOS","OTT",2009020760,14632,20092010,1,60,1,2,-1,0,0,0,33,23,10,43,28,15,52,38,14,1,1,0,0
"2036","BOS","CAR",2009020773,14633,20092010,0,60,1,5,-4,0,0,0,28,20,8,41,29,12,66,39,27,4,4,0,0
"2037","BOS","L.A",2009020808,14639,20092010,1,65,2,2,0,0,0,0,33,29,4,40,33,7,52,43,9,7,5,0,0
"2038","BOS","MTL",2009020841,14644,20092010,1,65,2,2,0,0,0,0,47,25,22,60,42,18,71,49,22,6,2,0,0
"2039","BOS","VAN",2009020855,14646,20092010,1,65,2,2,0,0,0,0,43,31,12,55,36,19,66,48,18,6,5,0,0
"2040","BOS","MTL",2009020869,14647,20092010,0,60,3,0,3,0,0,0,27,36,-9,45,43,2,63,58,5,1,2,0,0
"2041","BOS","T.B",2009020893,14651,20092010,0,60,5,4,1,0,0,0,36,35,1,48,43,5,65,54,11,6,8,0,0
"2042","BOS","FLA",2009020909,14653,20092010,0,65,2,2,0,0,0,0,39,28,11,47,42,5,70,52,18,2,4,0,0
"2043","BOS","MTL",2009020923,14670,20092010,1,60,1,4,-3,0,0,0,24,32,-8,33,36,-3,43,52,-9,4,2,0,0
"2044","BOS","TOR",2009020941,14672,20092010,1,65,2,2,0,0,0,0,31,26,5,43,33,10,52,42,10,4,5,0,0
"2045","BOS","NYI",2009020956,14674,20092010,0,60,3,2,1,0,0,0,34,39,-5,45,51,-6,60,67,-7,2,1,0,0
"2046","BOS","PIT",2009020965,14675,20092010,0,60,1,2,-1,0,0,0,22,33,-11,33,38,-5,43,50,-7,5,2,0,0
"2047","BOS","TOR",2009020976,14677,20092010,0,64.1666666666667,3,4,-1,0,0,0,29,30,-1,42,47,-5,61,69,-8,2,3,0,0
"2048","BOS","PHI",2009020992,14679,20092010,0,60,5,1,4,0,0,0,37,32,5,41,40,1,62,54,8,2,2,0,0
"2049","BOS","MTL",2009021008,14681,20092010,0,60,2,3,-1,0,0,0,23,27,-4,35,38,-3,49,51,-2,5,5,0,0
"2050","BOS","N.J",2009021025,14683,20092010,0,60,2,3,-1,0,0,0,36,28,8,41,35,6,45,38,7,2,1,0,0
"2051","BOS","CAR",2009021029,14684,20092010,0,60,5,2,3,0,0,0,37,32,5,57,45,12,67,63,4,5,5,0,0
"2052","BOS","PIT",2009021042,14686,20092010,1,60,0,3,-3,0,0,0,17,31,-14,27,39,-12,43,52,-9,4,4,0,0
"2053","BOS","NYR",2009021068,14689,20092010,1,60,2,1,1,0,0,0,31,24,7,40,31,9,51,45,6,6,8,0,0
"2054","BOS","ATL",2009021082,14691,20092010,0,60,4,0,4,0,0,0,33,27,6,46,39,7,61,53,8,2,2,0,0
"2055","BOS","T.B",2009021096,14693,20092010,1,60,3,5,-2,0,0,0,50,18,32,56,28,28,69,32,37,4,4,0,0
"2056","BOS","CGY",2009021110,14695,20092010,1,60,5,0,5,0,0,0,35,31,4,46,40,6,51,54,-3,5,3,0,0
"2057","BOS","N.J",2009021134,14698,20092010,0,64.6833333333333,1,0,1,0,0,0,34,21,13,48,31,17,60,41,19,2,2,0,0
"2058","BOS","FLA",2009021149,14700,20092010,1,60,0,1,-1,0,0,0,36,20,16,54,24,30,86,30,56,3,1,0,0
"2059","BOS","TOR",2009021167,14702,20092010,0,63.4166666666667,2,1,1,0,0,0,30,28,2,49,40,9,71,60,11,2,3,0,0
"2060","BOS","CAR",2009021212,14709,20092010,1,60,4,2,2,0,0,0,42,35,7,53,45,8,65,56,9,5,4,0,0
"2061","BOS","PHI",2009030221,14730,20092010,1,73.8666666666667,5,4,1,0,0,0,46,36,10,60,40,20,79,56,23,5,7,0,0
"2062","BOS","PHI",2009030222,14732,20092010,1,60,3,2,1,0,0,0,27,26,1,35,30,5,48,42,6,5,4,0,0
"2063","BOS","PHI",2009030223,14734,20092010,0,60,4,1,3,0,0,0,20,35,-15,23,50,-27,31,71,-40,2,4,0,0
"2064","BOS","PHI",2009030224,14736,20092010,0,74.6666666666667,4,5,-1,0,0,0,37,34,3,46,50,-4,61,77,-16,5,3,0,0
"2065","BOS","PHI",2009030225,14739,20092010,1,60,0,4,-4,0,0,0,23,31,-8,35,39,-4,41,60,-19,4,10,0,0
"2066","BOS","PHI",2009030226,14741,20092010,0,60,1,2,-1,0,0,0,31,27,4,49,33,16,79,43,36,4,5,0,0
"2067","BOS","PHI",2009030227,14743,20092010,1,60,3,4,-1,0,0,0,25,27,-2,39,34,5,57,46,11,3,3,0,0
"2068","BOS","N.J",2010020056,14898,20102011,0,60,4,1,3,2.80802522109161,3.69593545331736,-0.887910232225749,35,32,3,44,46,-2,49,58,-9,3,4,0,0
"2069","BOS","NYR",2010020098,14905,20102011,1,60,2,3,-1,3.46489965012083,3.46993586995964,-0.00503621983880986,37,30,7,50,43,7,65,61,4,6,5,0,0
"2070","BOS","TOR",2010020129,14910,20102011,1,60,2,0,2,5.46930959759758,2.60787335742498,2.8614362401726,32,20,12,46,35,11,57,48,9,3,5,0,0
"2071","BOS","OTT",2010020145,14912,20102011,0,60,4,0,4,3.80551742532407,6.52347460656893,-2.71795718124486,25,29,-4,38,43,-5,48,70,-22,4,3,0,0
"2072","BOS","STL",2010020188,14919,20102011,1,65,1,1,0,3.6544660111207,6.98630736810455,-3.33184135698386,34,35,-1,41,46,-5,55,63,-8,4,5,0,0
"2073","BOS","PIT",2010020212,14923,20102011,0,60,7,4,3,4.96211832710916,6.38600282176594,-1.42388449465679,33,46,-13,39,56,-17,54,74,-20,3,2,0,0
"2074","BOS","MTL",2010020217,14924,20102011,1,60,1,3,-2,2.97356729972709,3.65544266358341,-0.681875363856316,35,41,-6,45,51,-6,59,66,-7,5,6,0,0
"2075","BOS","OTT",2010020233,14926,20102011,1,60,0,2,-2,5.21353778612429,3.35012793498226,1.86340985114203,31,33,-2,38,38,0,43,51,-8,3,3,0,0
"2076","BOS","N.J",2010020248,14928,20102011,1,60,3,0,3,4.12907859144616,4.82191649351171,-0.692837902065548,24,28,-4,31,40,-9,44,54,-10,6,3,0,0
"2077","BOS","NYR",2010020258,14930,20102011,0,60,3,2,1,1.88300809078373,4.22319139467436,-2.34018330389063,20,36,-16,30,47,-17,42,62,-20,3,4,0,0
"2078","BOS","FLA",2010020269,14931,20102011,1,60,4,0,4,5.76980519543765,7.56207739023431,-1.79227219479667,40,41,-1,45,56,-11,63,68,-5,2,5,0,0
"2079","BOS","L.A",2010020283,14933,20102011,1,65,3,3,0,3.60352913767447,2.36185722425125,1.24167191342321,41,26,15,58,33,25,78,50,28,5,5,0,0
"2080","BOS","T.B",2010020304,14935,20102011,0,60,1,3,-2,5.26589098157032,4.22747266027727,1.03841832129305,27,36,-9,41,50,-9,54,59,-5,2,3,0,0
"2081","BOS","FLA",2010020315,14937,20102011,0,60,3,1,2,5.64177671711741,4.53165924863424,1.11011746848317,37,32,5,50,45,5,59,55,4,4,2,0,0
"2082","BOS","CAR",2010020321,14939,20102011,1,60,0,3,-3,7.90629776462447,2.96407969298889,4.94221807163558,37,21,16,49,24,25,65,37,28,4,3,0,0
"2083","BOS","ATL",2010020346,14941,20102011,0,60,1,4,-3,5.57979299056751,3.45824355192599,2.12154943864152,41,26,15,47,35,12,59,48,11,6,5,0,0
"2084","BOS","PHI",2010020359,14944,20102011,0,60,3,0,3,5.18053145868308,7.25303800654365,-2.07250654786057,32,41,-9,43,61,-18,54,75,-21,3,6,0,0
"2085","BOS","T.B",2010020365,14945,20102011,1,60,8,1,7,5.78452393301995,5.67741438536905,0.107109547650907,32,38,-6,41,49,-8,51,63,-12,4,1,0,0
"2086","BOS","TOR",2010020381,14947,20102011,0,65,2,2,0,2.66905342732207,4.19864508737621,-1.52959166005414,27,40,-13,41,57,-16,62,74,-12,3,5,0,0
"2087","BOS","NYI",2010020411,14952,20102011,1,60,5,2,3,7.61922151977342,3.88847397002344,3.73074754974998,37,35,2,50,46,4,70,62,8,5,4,0,0
"2088","BOS","PHI",2010020425,14954,20102011,1,64.95,1,2,-1,4.428675623603,6.43429184397282,-2.00561622036982,36,33,3,49,43,6,70,60,10,1,1,0,0
"2089","BOS","MTL",2010020463,14959,20102011,0,60,3,4,-1,4.7218975258617,7.33134101858694,-2.60944349272524,37,41,-4,53,47,6,71,61,10,4,3,0,0
"2090","BOS","ANA",2010020488,14963,20102011,1,60,0,3,-3,5.89303284735104,2.44039137467952,3.45264147267152,45,25,20,65,34,31,88,44,44,2,1,0,0
"2091","BOS","ATL",2010020506,14966,20102011,1,60,4,1,3,6.0494400210664,3.88012205613086,2.16931796493554,36,27,9,52,38,14,71,52,19,7,3,0,0
"2092","BOS","FLA",2010020532,14970,20102011,0,65,2,2,0,4.55886546396721,3.399578996934,1.15928646703321,42,34,8,57,37,20,68,54,14,2,3,0,0
"2093","BOS","T.B",2010020539,14971,20102011,0,60,4,3,1,4.65641599682976,5.82279927726631,-1.16638328043655,29,34,-5,38,48,-10,55,63,-8,8,7,0,0
"2094","BOS","ATL",2010020552,14973,20102011,0,65,2,2,0,6.29733318890027,3.42517852295532,2.87215466594495,44,32,12,64,39,25,92,62,30,4,6,0,0
"2095","BOS","TOR",2010020581,14977,20102011,0,60,2,1,1,3.95784367294982,5.35052805561494,-1.39268438266512,33,37,-4,47,53,-6,73,71,2,2,2,0,0
"2096","BOS","MIN",2010020597,14980,20102011,1,60,1,3,-2,3.22314397174341,4.50488079131269,-1.28173681956928,36,34,2,50,40,10,59,50,9,4,2,0,0
"2097","BOS","MTL",2010020614,14982,20102011,0,63.7166666666667,2,3,-1,4.22906860124203,7.64277479492011,-3.41370619367808,29,42,-13,41,62,-21,53,80,-27,3,3,0,0
"2098","BOS","PIT",2010020628,14984,20102011,0,60,4,2,2,5.73787857729557,2.43484209245435,3.30303648484122,32,25,7,42,38,4,59,54,5,6,7,0,0
"2099","BOS","OTT",2010020632,14985,20102011,1,60,6,0,6,4.72369268723156,2.48312310469919,2.24056958253237,39,31,8,46,40,6,55,47,8,3,3,0,0
"2100","BOS","PHI",2010020646,14987,20102011,1,60,7,5,2,6.79941197574954,3.93967899487162,2.85973298087792,37,35,2,47,42,5,63,51,12,5,1,0,0
"2101","BOS","PIT",2010020660,14989,20102011,1,60,2,3,-1,5.9129148912325,4.15693785893882,1.75597703229369,46,36,10,58,43,15,74,50,24,3,1,0,0
"2102","BOS","CAR",2010020677,14991,20102011,1,60,7,0,7,5.77145690105681,4.89370874011527,0.877748160941536,38,31,7,52,40,12,72,56,16,5,5,0,0
"2103","BOS","CAR",2010020686,14992,20102011,0,60,3,2,1,5.95424143713899,6.76012527296552,-0.805883835826535,28,45,-17,41,59,-18,53,87,-34,6,5,0,0
"2104","BOS","COL",2010020714,14996,20102011,0,60,6,2,4,5.00906769305584,5.23535164285568,-0.226283949799836,40,34,6,51,46,5,69,53,16,4,4,0,0
"2105","BOS","L.A",2010020733,14998,20102011,0,60,0,2,-2,3.75333765278629,6.05047194692418,-2.29713429413789,34,34,0,42,51,-9,60,66,-6,3,3,0,0
"2106","BOS","FLA",2010020742,15000,20102011,1,60,2,1,1,5.37164677319578,3.20366456886404,2.16798220433174,35,35,0,52,41,11,71,50,21,1,1,0,0
"2107","BOS","CAR",2010020755,15006,20102011,0,60,3,2,1,4.64848573512074,7.99039713689126,-3.34191140177052,33,26,7,43,49,-6,56,72,-16,0,4,0,0
"2108","BOS","DAL",2010020770,15008,20102011,1,60,6,3,3,5.83781250659036,2.65038201385401,3.18743049273635,35,33,2,50,44,6,63,57,6,5,3,0,0
"2109","BOS","S.J",2010020782,15010,20102011,1,60,0,2,-2,3.38511225992128,3.53212072093365,-0.147008461012369,26,18,8,35,26,9,60,39,21,4,2,0,0
"2110","BOS","MTL",2010020808,15014,20102011,1,60,8,6,2,4.2074268568831,3.74483251168585,0.46259434519725,34,33,1,37,41,-4,44,47,-3,10,16,0,0
"2111","BOS","DET",2010020821,15016,20102011,1,60,1,6,-5,3.6543605739061,7.34022590608924,-3.68586533218314,26,34,-8,33,45,-12,46,57,-11,3,7,0,0
"2112","BOS","DET",2010020842,15018,20102011,0,60,2,4,-2,3.49752064125278,4.09451596258602,-0.596995321333246,25,36,-11,35,47,-12,41,55,-14,3,3,0,0
"2113","BOS","TOR",2010020848,15020,20102011,1,60,3,4,-1,7.15210488507,6.51695773459823,0.63514715047177,35,28,7,54,36,18,70,49,21,4,3,0,0
"2114","BOS","NYI",2010020863,15022,20102011,0,60,6,3,3,3.42999012264772,6.26115175726591,-2.83116163461818,34,37,-3,44,50,-6,61,64,-3,2,1,0,0
"2115","BOS","OTT",2010020873,15023,20102011,0,60,4,2,2,6.19301754565095,7.21022380530194,-1.01720625965099,33,34,-1,45,46,-1,59,60,-1,5,3,0,0
"2116","BOS","CGY",2010020906,15027,20102011,0,60,3,1,2,5.93111479151412,6.29243991731737,-0.361325125803253,29,29,0,40,47,-7,56,67,-11,1,2,0,0
"2117","BOS","VAN",2010020931,15031,20102011,0,60,3,1,2,2.85438138933387,4.45836490773172,-1.60398351839785,25,28,-3,34,42,-8,47,65,-18,2,3,0,0
"2118","BOS","EDM",2010020938,15032,20102011,0,60,3,2,1,4.04034579065046,3.49910157013801,0.541244220512453,40,17,23,51,30,21,75,44,31,2,1,0,0
"2119","BOS","OTT",2010020946,15034,20102011,0,60,1,0,1,2.24865271692397,7.52670426751094,-5.27805155058697,21,33,-12,32,52,-20,49,69,-20,2,2,0,0
"2120","BOS","T.B",2010020957,15036,20102011,1,60,2,1,1,3.83171255359593,5.12842102418654,-1.2967084705906,28,28,0,37,35,2,44,49,-5,3,4,0,0
"2121","BOS","PIT",2010020976,15038,20102011,1,61.8666666666667,2,3,-1,4.47992677626064,5.58308482109328,-1.10315804483264,31,39,-8,37,48,-11,51,65,-14,1,2,0,0
"2122","BOS","MTL",2010020996,15041,20102011,0,60,1,4,-3,3.78635991628729,5.14754449295551,-1.36118457666822,31,26,5,42,40,2,77,49,28,5,4,0,0
"2123","BOS","NYI",2010021015,15044,20102011,0,60,2,4,-2,3.82220473733469,7.42694403946371,-3.60473930212902,28,42,-14,45,52,-7,61,76,-15,4,3,0,0
"2124","BOS","NSH",2010021060,15050,20102011,0,63.6166666666667,3,4,-1,3.99132489322801,5.36702157997934,-1.37569668675133,38,31,7,46,39,7,62,53,9,2,4,0,0
"2125","BOS","TOR",2010021072,15052,20102011,0,60,2,5,-3,5.00252756576356,4.92993204202503,0.0725955237385278,37,29,8,61,46,15,83,60,23,2,2,0,0
"2126","BOS","N.J",2010021088,15055,20102011,1,60,4,1,3,3.72771554416977,4.43269569711295,-0.704980152943184,30,31,-1,38,36,2,47,41,6,5,2,0,0
"2127","BOS","MTL",2010021102,15057,20102011,1,60,7,0,7,4.60003894100056,2.38004178289884,2.21999715810172,41,24,17,57,33,24,70,44,26,6,6,0,0
"2128","BOS","NYR",2010021116,15059,20102011,1,60,0,1,-1,2.50292828894453,2.27681029323127,0.22611799571326,26,23,3,36,37,-1,65,45,20,1,4,0,0
"2129","BOS","PHI",2010021131,15060,20102011,0,60,2,1,1,8.0380147773626,6.80909186153713,1.22892291582548,36,28,8,50,37,13,70,50,20,3,1,0,0
"2130","BOS","CHI",2010021134,15062,20102011,1,60,3,0,3,4.98928810319921,5.59823449054966,-0.608946387350443,34,32,2,42,49,-7,53,68,-15,0,2,0,0
"2131","BOS","TOR",2010021150,15064,20102011,1,65,3,3,0,3.78586991357543,5.56373411337046,-1.77786419979503,38,31,7,52,45,7,75,61,14,6,6,0,0
"2132","BOS","ATL",2010021164,15066,20102011,1,60,3,2,1,2.30037263986237,7.28474984793974,-4.98437720807736,24,30,-6,35,43,-8,57,53,4,2,3,0,0
"2133","BOS","NYR",2010021182,15068,20102011,0,60,3,5,-2,5.11312155163478,4.70220070284518,0.410920848789601,30,26,4,42,41,1,60,61,-1,1,4,0,0
"2134","BOS","NYI",2010021193,15070,20102011,1,60,3,2,1,3.7529459700454,2.30530011428527,1.44764585576013,33,32,1,45,36,9,61,51,10,6,3,0,0
"2135","BOS","OTT",2010021216,15073,20102011,1,60,3,1,2,3.15240922238445,4.76424594333679,-1.61183672095234,29,32,-3,37,37,0,57,47,10,4,3,0,0
"2136","BOS","N.J",2010021226,15074,20102011,0,60,2,3,-1,4.16773407394066,3.57094683893956,0.596787235001102,26,32,-6,35,43,-8,44,53,-9,2,1,0,0
"2137","BOS","MTL",2010030131,15078,20102011,1,60,0,2,-2,4.06071654922562,3.87053559657277,0.190180952652844,31,20,11,40,30,10,59,43,16,3,4,0,0
"2138","BOS","MTL",2010030132,15080,20102011,1,60,1,3,-2,5.04387556337943,3.06491464513022,1.97896091824921,35,26,9,46,30,16,73,38,35,4,3,0,0
"2139","BOS","MTL",2010030133,15082,20102011,0,60,4,2,2,3.58000628357357,8.39259066239356,-4.81258437881999,25,36,-11,39,45,-6,56,67,-11,4,5,0,0
"2140","BOS","MTL",2010030134,15085,20102011,0,61.9833333333333,5,4,1,4.92318095987335,6.50663738849107,-1.58345642861772,35,38,-3,54,54,0,70,71,-1,1,2,0,0
"2141","BOS","MTL",2010030137,15091,20102011,1,65.7166666666667,4,3,1,6.3618588312529,4.8300170393444,1.53184179190851,34,37,-3,41,41,0,59,54,5,2,4,0,0
"2142","BOS","PHI",2010030221,15094,20102011,0,60,7,3,4,4.20132869273948,5.00879266260723,-0.807463969867751,33,34,-1,41,41,0,66,57,9,7,7,0,0
"2143","BOS","PHI",2010030222,15096,20102011,0,74,3,2,1,6.92225131737376,9.37952385627318,-2.45727253889942,41,54,-13,60,66,-6,82,89,-7,3,5,0,0
"2144","BOS","PHI",2010030223,15098,20102011,1,60,5,1,4,2.82938065057056,5.44475290825345,-2.61537225768289,28,38,-10,39,45,-6,45,56,-11,4,2,0,0
"2145","BOS","PHI",2010030224,15100,20102011,1,60,5,1,4,6.22120511102366,2.68716775687062,3.53403735415304,27,23,4,40,30,10,55,42,13,8,6,0,0
"2146","BOS","T.B",2010030311,15108,20102011,1,60,2,5,-3,6.24671643812098,7.80809993802046,-1.56138349989948,33,34,-1,49,45,4,66,54,12,4,5,0,0
"2147","BOS","T.B",2010030312,15111,20102011,1,60,6,5,1,5.4717962420375,5.7126092528341,-0.240813010796598,35,41,-6,50,52,-2,67,64,3,8,6,0,0
"2148","BOS","T.B",2010030313,15113,20102011,0,60,2,0,2,3.40635729125052,4.52929120429326,-1.12293391304274,25,31,-6,31,43,-12,40,57,-17,4,4,0,0
"2149","BOS","T.B",2010030314,15115,20102011,0,60,3,5,-2,4.09988519057515,6.8156519268391,-2.71576673626395,30,37,-7,38,53,-15,57,71,-14,3,3,0,0
"2150","BOS","T.B",2010030315,15117,20102011,1,60,3,1,2,3.85880289462287,4.7667095756995,-0.907906681076632,20,34,-14,31,42,-11,39,54,-15,5,5,0,0
"2151","BOS","T.B",2010030316,15119,20102011,0,60,4,5,-1,0,0,0,20,26,-6,30,39,-9,46,50,-4,5,5,0,0
"2152","BOS","T.B",2010030317,15121,20102011,1,60,1,0,1,6.46460478939116,2.03424074337818,4.43036404601298,38,24,14,56,30,26,73,47,26,0,0,0,0
"2153","BOS","VAN",2010030411,15126,20102011,0,60,0,1,-1,3.32978963394395,3.53156082319856,-0.201771189254612,36,34,2,46,50,-4,58,69,-11,6,7,0,0
"2154","BOS","VAN",2010030412,15129,20102011,0,60.1833333333333,2,3,-1,5.65384437749162,6.79060802412179,-1.13676364663016,30,33,-3,42,47,-5,58,65,-7,3,2,0,0
"2155","BOS","VAN",2010030413,15131,20102011,1,60,8,1,7,3.55591508134238,6.38339307862298,-2.8274779972806,38,41,-3,44,51,-7,55,63,-8,5,9,0,0
"2156","BOS","VAN",2010030414,15133,20102011,1,60,4,0,4,5.30702334437404,4.69129979372079,0.615723550653257,29,38,-9,39,49,-10,56,64,-8,8,10,0,0
"2157","BOS","VAN",2010030415,15135,20102011,0,60,0,1,-1,2.70520928376936,2.27119739496584,0.434011888803525,31,25,6,40,37,3,57,56,1,5,4,0,0
"2158","BOS","VAN",2010030416,15138,20102011,1,60,5,2,3,5.70070612279414,4.5456039190758,1.15510220371834,40,38,2,45,53,-8,59,70,-11,7,8,0,0
"2159","BOS","PHI",2011020001,15253,20112012,1,60,1,2,-1,1.97205546550686,3.60456262211871,-1.63250715661186,23,29,-6,35,38,-3,52,47,5,7,5,0,0
"2160","BOS","T.B",2011020010,15255,20112012,1,60,4,1,3,6.38340968784264,2.66918622695626,3.71422346088638,42,26,16,63,37,26,85,46,39,8,8,0,0
"2161","BOS","COL",2011020025,15257,20112012,1,60,0,1,-1,6.03325493268494,3.88716573273996,2.14608919994498,30,36,-6,42,51,-9,60,62,-2,3,4,0,0
"2162","BOS","CAR",2011020036,15259,20112012,0,60,2,3,-1,5.98050518520176,4.29788462169377,1.68262056350799,28,34,-6,47,44,3,69,62,7,5,4,0,0
"2163","BOS","CHI",2011020060,15262,20112012,0,65,2,2,0,3.52175558592353,5.27452081546584,-1.75276522954231,37,29,8,50,45,5,64,64,0,3,3,0,0
"2164","BOS","CAR",2011020069,15265,20112012,1,60,1,4,-3,3.33440990467653,4.14946312364191,-0.815053218965383,34,23,11,46,35,11,62,49,13,6,11,0,0
"2165","BOS","TOR",2011020080,15267,20112012,1,60,6,2,4,5.47332195762699,4.51106503148912,0.962256926137862,43,28,15,52,34,18,72,53,19,6,4,0,0
"2166","BOS","S.J",2011020097,15269,20112012,1,60,2,4,-2,10.2569583749864,4.88937086417902,5.3675875108074,39,30,9,59,41,18,80,50,30,2,1,0,0
"2167","BOS","MTL",2011020125,15274,20112012,1,60,1,2,-1,3.38829642516794,3.20106406066814,0.187232364499799,30,35,-5,40,42,-2,61,49,12,8,4,0,0
"2168","BOS","MTL",2011020143,15276,20112012,0,60,2,4,-2,4.56152640646724,4.24103825583006,0.320488150637175,28,27,1,40,44,-4,69,56,13,2,7,0,0
"2169","BOS","OTT",2011020160,15279,20112012,1,60,5,3,2,6.63983914091638,2.89361885305436,3.74622028786202,41,26,15,49,33,16,65,43,22,8,4,0,0
"2170","BOS","TOR",2011020184,15283,20112012,0,60,7,0,7,2.46865904129186,4.8989355644153,-2.43027652312344,20,25,-5,29,39,-10,53,60,-7,2,4,0,0
"2171","BOS","NYI",2011020200,15285,20112012,1,60,6,2,4,6.13539186998969,5.60642015450867,0.528971715481021,37,26,11,45,35,10,53,47,6,1,4,0,0
"2172","BOS","EDM",2011020214,15288,20112012,1,60,6,3,3,3.68457951154596,2.57785932569323,1.10672018585273,28,30,-2,40,39,1,52,51,1,5,5,0,0
"2173","BOS","N.J",2011020247,15293,20112012,1,60,4,3,1,8.52449389332787,3.63630432308128,4.8881895702466,37,30,7,46,40,6,59,50,9,2,5,0,0
"2174","BOS","NYI",2011020279,15297,20112012,0,60,6,0,6,5.2025175057388,3.48882131358667,1.71369619215213,30,23,7,42,29,13,60,43,17,5,1,0,0
"2175","BOS","MTL",2011020294,15299,20112012,0,60,1,0,1,1.91316397003175,6.68752592292731,-4.77436195289556,18,33,-15,29,53,-24,41,70,-29,1,3,0,0
"2176","BOS","DET",2011020313,15303,20112012,1,65,2,2,0,8.64181193199693,3.49895879952237,5.14285313247456,43,31,12,55,45,10,71,61,10,3,3,0,0
"2177","BOS","WPG",2011020329,15304,20112012,1,60,4,2,2,6.0172131023483,5.5138123894867,0.503400712861598,36,42,-6,46,46,0,55,58,-3,6,4,0,0
"2178","BOS","TOR",2011020353,15308,20112012,0,60,6,3,3,8.21819931536447,5.71632993797357,2.5018693773909,40,37,3,53,49,4,72,67,5,5,2,0,0
"2179","BOS","TOR",2011020373,15311,20112012,1,60,4,1,3,5.10860427421974,2.51433767139679,2.59426660282296,30,22,8,40,29,11,55,42,13,2,4,0,0
"2180","BOS","WPG",2011020397,15314,20112012,0,60,1,2,-1,4.285404700855,5.1756486226077,-0.890243921752699,40,35,5,52,47,5,74,62,12,4,4,0,0
"2181","BOS","FLA",2011020405,15316,20112012,1,60,0,2,-2,7.73489037004356,5.41254696630826,2.3223434037353,40,30,10,54,35,19,70,45,25,4,1,0,0
"2182","BOS","L.A",2011020436,15321,20112012,1,60,3,0,3,2.55267858526872,3.38456494622966,-0.831886360960933,22,41,-19,38,55,-17,46,80,-34,3,5,0,0
"2183","BOS","OTT",2011020448,15322,20112012,0,60,5,2,3,5.54483311991157,5.19059657248727,0.354236547424307,29,49,-20,39,64,-25,52,82,-30,1,3,0,0
"2184","BOS","PHI",2011020466,15325,20112012,0,60,6,0,6,4.90804615676461,4.837499254264,0.0705469025006096,37,31,6,51,42,9,63,59,4,9,6,0,0
"2185","BOS","MTL",2011020481,15327,20112012,1,60,3,2,1,4.11241595947013,4.25799186812947,-0.145575908659339,31,35,-4,45,40,5,58,51,7,2,2,0,0
"2186","BOS","FLA",2011020508,15331,20112012,1,60,8,0,8,4.84209387941519,3.15261293170374,1.68948094771144,35,30,5,50,36,14,66,49,17,5,2,0,0
"2187","BOS","DAL",2011020565,15339,20112012,0,60,2,4,-2,3.78973642703204,4.33249194230302,-0.542755515270983,20,27,-7,33,38,-5,53,49,4,3,6,0,0
"2188","BOS","N.J",2011020581,15343,20112012,0,60,6,1,5,4.7909266156571,3.06545618925884,1.72547042639826,27,31,-4,37,35,2,53,46,7,3,3,0,0
"2189","BOS","CGY",2011020584,15344,20112012,1,60,9,0,9,5.1999507463297,3.05434665107168,2.14560409525802,42,25,17,46,34,12,54,48,6,2,2,0,0
"2190","BOS","VAN",2011020598,15346,20112012,1,60,3,4,-1,4.07792713899535,4.73349672748401,-0.655569588488659,39,36,3,47,46,1,57,53,4,11,10,0,0
"2191","BOS","WPG",2011020616,15349,20112012,1,60,5,3,2,7.05372404546089,3.68943521855493,3.36428882690596,42,32,10,57,45,12,76,55,21,4,5,0,0
"2192","BOS","MTL",2011020631,15351,20112012,1,60,2,1,1,3.95077751191275,4.13048089337245,-0.179703381459699,30,34,-4,43,40,3,57,54,3,6,3,0,0
"2193","BOS","CAR",2011020652,15353,20112012,0,60,2,4,-2,3.9760854400738,4.91681774205063,-0.940732301976823,35,21,14,48,32,16,64,47,17,3,1,0,0
"2194","BOS","FLA",2011020667,15355,20112012,0,65,2,2,0,0,0,0,35,40,-5,45,50,-5,52,59,-7,2,3,0,0
"2195","BOS","T.B",2011020677,15356,20112012,0,60,3,5,-2,5.10205973674778,4.16869982372737,0.933359913020413,29,31,-2,41,41,0,58,55,3,4,5,0,0
"2196","BOS","N.J",2011020686,15358,20112012,0,60,4,1,3,4.07119128046907,3.1854788470082,0.885712433460867,25,31,-6,34,37,-3,38,42,-4,1,1,0,0
"2197","BOS","NYR",2011020699,15360,20112012,1,64.9333333333333,2,3,-1,5.973697424899,3.18303403328821,2.79066339161079,34,33,1,44,37,7,66,51,15,5,3,0,0
"2198","BOS","PHI",2011020713,15361,20112012,0,65,5,5,0,4.92494477843866,8.24206144154078,-3.31711666310213,37,38,-1,51,56,-5,70,74,-4,8,11,0,0
"2199","BOS","OTT",2011020736,15370,20112012,1,60,4,3,1,3.28725125174969,5.46567198321827,-2.17842073146858,30,33,-3,37,49,-12,48,65,-17,4,0,0,0
"2200","BOS","CAR",2011020754,15372,20112012,1,60,0,3,-3,5.36001858082905,4.71012757903372,0.649891001795321,47,31,16,63,43,20,71,52,19,2,4,0,0
"2201","BOS","NSH",2011020816,15381,20112012,1,65,3,3,0,4.6073891511478,2.61458736492904,1.99280178621876,41,22,19,54,29,25,83,38,45,4,3,0,0
"2202","BOS","NYR",2011020837,15384,20112012,1,60,0,3,-3,8.89434837411682,2.26168615493225,6.63266221918457,42,20,22,57,24,33,79,31,48,3,3,0,0
"2203","BOS","MTL",2011020847,15385,20112012,0,65,3,3,0,5.47908841492608,7.4711176820893,-1.99202926716321,34,29,5,44,35,9,61,58,3,6,5,0,0
"2204","BOS","WPG",2011020863,15387,20112012,0,60,2,4,-2,4.14511908116401,3.1495727393189,0.995546341845107,33,25,8,46,30,16,57,43,14,3,3,0,0
"2205","BOS","MIN",2011020876,15389,20112012,0,60,0,2,-2,6.36291556050128,4.59825849247864,1.76465706802264,48,29,19,67,34,33,91,45,46,1,1,0,0
"2206","BOS","STL",2011020897,15392,20112012,0,60,4,2,2,2.47173210496294,3.05363401869545,-0.581901913732509,19,32,-13,26,49,-23,38,70,-32,1,1,0,0
"2207","BOS","OTT",2011020919,15395,20112012,0,60,5,3,2,5.77901426548488,9.80592677684035,-4.02691251135548,38,30,8,50,44,6,61,61,0,2,2,0,0
"2208","BOS","OTT",2011020937,15398,20112012,1,60,0,1,-1,5.15875501739981,4.33501667581731,0.823738341582491,32,38,-6,46,48,-2,64,59,5,4,3,0,0
"2209","BOS","N.J",2011020950,15400,20112012,1,62.9833333333333,4,3,1,2.43372128734219,3.13240852914168,-0.698687241799495,25,31,-6,33,34,-1,51,53,-2,3,3,0,0
"2210","BOS","NYI",2011020965,15402,20112012,1,60,2,3,-1,3.40540137392236,4.72250677064585,-1.31710539672349,34,25,9,51,37,14,64,42,22,5,3,0,0
"2211","BOS","NYR",2011020975,15403,20112012,0,60,3,4,-1,4.66255565086612,4.26906611694722,0.39348953391891,33,17,16,61,26,35,76,37,39,3,2,0,0
"2212","BOS","TOR",2011020984,15405,20112012,0,60,5,4,1,4.76319679265725,3.91611706935441,0.847079723302841,33,29,4,46,31,15,64,47,17,3,6,0,0
"2213","BOS","T.B",2011021040,15412,20112012,0,60,1,6,-5,3.4010173495044,2.13899774363381,1.26201960587059,34,17,17,49,24,25,60,34,26,3,3,0,0
"2214","BOS","FLA",2011021057,15414,20112012,0,60,2,6,-4,5.53069282422075,4.6179464526067,0.912746371614048,26,29,-3,37,40,-3,49,50,-1,2,3,0,0
"2215","BOS","PHI",2011021065,15416,20112012,1,65,2,2,0,5.01632963872331,5.45077229340313,-0.434442654679828,33,29,4,46,39,7,64,55,9,2,4,0,0
"2216","BOS","TOR",2011021082,15418,20112012,1,60,8,0,8,4.03118941458524,2.01485868712189,2.01633072746336,24,13,11,32,22,10,40,33,7,2,2,0,0
"2217","BOS","S.J",2011021109,15421,20112012,0,60,1,2,-1,4.69282488540193,5.40771388902346,-0.714889003621522,17,27,-10,29,36,-7,46,49,-3,1,1,0,0
"2218","BOS","L.A",2011021117,15423,20112012,0,60,4,2,2,4.32319600625124,6.70903717523834,-2.3858411689871,26,42,-16,36,58,-22,47,68,-21,1,4,0,0
"2219","BOS","ANA",2011021132,15424,20112012,0,60,3,2,1,3.26801184207579,3.07530528814823,0.192706553927565,25,27,-2,32,35,-3,45,50,-5,2,3,0,0
"2220","BOS","T.B",2011021140,15426,20112012,1,60,5,2,3,4.49528092916012,2.61201685952084,1.88326406963928,38,18,20,46,27,19,63,33,30,6,5,0,0
"2221","BOS","NYI",2011021169,15430,20112012,0,60,6,3,3,5.02448865609442,3.68288139716606,1.34160725892837,27,22,5,38,36,2,54,56,-2,1,2,0,0
"2222","BOS","NYR",2011021182,15431,20112012,0,60,2,1,1,3.04765806152136,5.02820077986689,-1.98054271834553,21,34,-13,34,46,-12,53,55,-2,2,3,0,0
"2223","BOS","OTT",2011021207,15435,20112012,0,60,3,1,2,5.16667261984432,5.79684424638221,-0.630171626537885,27,45,-18,32,63,-31,40,85,-45,4,4,0,0
"2224","BOS","NYR",2012020004,15724,20122013,1,60,3,1,2,2.54656386198232,2.31427725345539,0.232286608526927,34,21,13,43,31,12,53,36,17,7,5,0,0
"2225","BOS","WPG",2012020020,15726,20122013,1,65,1,1,0,2.32149396079194,2.70954584859271,-0.388051887800771,27,27,0,41,41,0,57,63,-6,2,4,0,0
"2226","BOS","NYR",2012020037,15728,20122013,0,60.45,3,4,-1,4.794004969802,3.36333393832319,1.43067103147881,29,33,-4,40,45,-5,65,54,11,6,6,0,0
"2227","BOS","NYI",2012020050,15730,20122013,1,60,4,2,2,4.53492714057526,1.8277054323511,2.70722170822417,27,26,1,42,31,11,61,46,15,4,4,0,0
"2228","BOS","CAR",2012020073,15733,20122013,0,60,5,3,2,0,0,0,38,32,6,50,41,9,61,51,10,5,7,0,0
"2229","BOS","N.J",2012020078,15734,20122013,1,65,1,1,0,3.54222496836155,4.27082623098613,-0.728601262624579,28,26,2,39,35,4,58,49,9,3,5,0,0
"2230","BOS","TOR",2012020111,15738,20122013,0,60,1,0,1,3.44352024432737,2.47994467170793,0.963575572619447,34,21,13,45,31,14,57,53,4,3,4,0,0
"2231","BOS","MTL",2012020138,15742,20122013,0,60,2,1,1,5.58086271239761,3.89696546539199,1.68389724700562,23,21,2,33,28,5,45,52,-7,5,7,0,0
"2232","BOS","T.B",2012020154,15820,20122013,1,60,2,0,2,4.014258836748,3.11098490469158,0.903273932056428,24,30,-6,36,38,-2,49,53,-4,1,3,0,0
"2233","BOS","NYR",2012020179,15748,20122013,1,65,3,3,0,5.03917598198178,1.70464732093726,3.33452866104453,40,29,11,49,32,17,74,41,33,4,4,0,0
"2234","BOS","WPG",2012020214,15753,20122013,0,60,3,2,1,2.92555352472118,5.36072969046654,-2.43517616574536,26,24,2,42,50,-8,62,70,-8,1,2,0,0
"2235","BOS","T.B",2012020243,15757,20122013,0,60,4,2,2,3.84193180815782,4.35587891394971,-0.513947105791885,26,26,0,33,38,-5,43,50,-7,1,3,0,0
"2236","BOS","FLA",2012020262,15760,20122013,0,60,4,1,3,3.97373796736429,5.84460110565083,-1.87086313828655,32,35,-3,43,52,-9,53,70,-17,1,4,0,0
"2237","BOS","NYI",2012020278,15762,20122013,0,60,4,1,3,5.93099455937045,6.59086401531385,-0.659869455943408,34,37,-3,42,47,-5,57,61,-4,4,3,0,0
"2238","BOS","OTT",2012020288,15764,20122013,1,63.6333333333333,2,1,1,3.40254501573338,5.39477505320834,-1.99223003747496,46,31,15,57,45,12,71,60,11,3,5,0,0
"2239","BOS","T.B",2012020303,15766,20122013,1,60,3,2,1,2.72314461268252,4.7829316968855,-2.05978708420298,27,22,5,40,35,5,54,46,8,5,8,0,0
"2240","BOS","MTL",2012020316,15767,20122013,1,60,3,4,-1,6.15891983385063,4.79041523009073,1.3685046037599,34,26,8,49,34,15,69,48,21,3,6,0,0
"2241","BOS","TOR",2012020339,15771,20122013,1,60,4,2,2,5.97485765062856,4.51865037390962,1.45620727671894,25,27,-2,36,39,-3,48,50,-2,4,4,0,0
"2242","BOS","PHI",2012020355,15773,20122013,1,60,3,0,3,3.19373556075152,4.98337197092249,-1.78963641017097,28,23,5,44,37,7,69,55,14,2,3,0,0
"2243","BOS","OTT",2012020375,15775,20122013,0,65,2,2,0,4.9922452022717,5.30511795167877,-0.312872749407063,35,32,3,52,38,14,64,49,15,4,3,0,0
"2244","BOS","FLA",2012020391,15778,20122013,1,60,4,1,3,5.80656956969324,1.28528995852532,4.52127961116792,32,30,2,44,37,7,54,52,2,2,2,0,0
"2245","BOS","WPG",2012020435,15783,20122013,0,60,1,3,-2,3.92693304724547,3.95720149125555,-0.0302684440100762,28,25,3,42,32,10,61,45,16,4,2,0,0
"2246","BOS","OTT",2012020447,15785,20122013,0,60,2,1,1,6.14433416805696,6.90797275450313,-0.763638586446177,29,28,1,42,39,3,57,56,1,3,1,0,0
"2247","BOS","TOR",2012020459,15787,20122013,0,60,2,3,-1,6.96538186544421,2.90550531249028,4.05987655295394,33,13,20,49,24,25,80,38,42,1,2,0,0
"2248","BOS","TOR",2012020472,15789,20122013,1,65,2,2,0,3.90502820827179,2.36098097271612,1.54404723555567,29,25,4,50,30,20,69,38,31,2,4,0,0
"2249","BOS","MTL",2012020488,15791,20122013,1,65,5,5,0,5.9362918489845,4.32758409714934,1.60870775183515,41,28,13,51,37,14,67,51,16,5,7,0,0
"2250","BOS","PHI",2012020506,15794,20122013,0,60,1,3,-2,6.2684565136442,4.54566946047772,1.72278705316647,34,22,12,47,30,17,67,43,24,4,3,0,0
"2251","BOS","OTT",2012020531,15797,20122013,1,60,3,2,1,6.28101150242173,5.50132014748855,0.779691354933186,50,47,3,64,55,9,72,72,0,3,3,0,0
"2252","BOS","N.J",2012020543,15799,20122013,1,60,1,0,1,2.97174175464917,3.48434326488655,-0.512601510237374,26,40,-14,32,51,-19,46,64,-18,1,1,0,0
"2253","BOS","MTL",2012020562,15801,20122013,0,60,1,2,-1,6.86833493322774,4.39863424397481,2.46970068925293,27,29,-2,41,43,-2,64,56,8,2,2,0,0
"2254","BOS","CAR",2012020577,15803,20122013,1,60,6,2,4,3.15138813381054,5.12437279277401,-1.97298465896347,36,42,-6,46,56,-10,59,71,-12,2,1,0,0
"2255","BOS","N.J",2012020591,15805,20122013,0,60,5,4,1,2.25397825931542,4.98983567511095,-2.73585741579553,18,28,-10,26,46,-20,34,56,-22,3,8,0,0
"2256","BOS","NYI",2012020596,15806,20122013,1,60,1,2,-1,2.20190879117763,4.81203475279835,-2.61012596162072,31,36,-5,40,47,-7,56,54,2,1,1,0,0
"2257","BOS","CAR",2012020615,15808,20122013,0,60,2,4,-2,6.61253693975953,7.89970226644073,-1.2871653266812,30,38,-8,53,57,-4,70,70,0,3,3,0,0
"2258","BOS","OTT",2012020624,15823,20122013,1,60,2,4,-2,7.6716243197734,4.083869139115,3.5877551806584,36,22,14,52,31,21,63,45,18,3,3,0,0
"2259","BOS","FLA",2012020668,15816,20122013,1,60,3,0,3,6.21152378949478,3.86338382790564,2.34813996158914,39,28,11,52,41,11,64,52,12,2,2,0,0
"2260","BOS","PHI",2012020684,15818,20122013,0,60,2,5,-3,7.74104994896584,4.18225553978533,3.55879440918051,41,30,11,50,40,10,70,53,17,3,3,0,0
"2261","BOS","TOR",2012030141,15826,20122013,1,60,4,1,3,5.02020061940448,3.64271025735558,1.3774903620489,40,20,20,55,25,30,71,33,38,7,4,0,0
"2262","BOS","TOR",2012030142,15829,20122013,1,60,2,4,-2,5.47672472354557,1.7852935824485,3.69143114109707,41,32,9,53,40,13,70,53,17,1,4,0,0
"2263","BOS","TOR",2012030143,15831,20122013,0,60,5,2,3,5.96462754873156,9.32943056402083,-3.36480301528928,38,47,-9,49,57,-8,64,71,-7,5,7,0,0
"2264","BOS","TOR",2012030144,15833,20122013,0,73.1,4,3,1,9.86813166609426,7.33225025204592,2.53588141404833,45,48,-3,65,66,-1,96,86,10,5,4,0,0
"2265","BOS","TOR",2012030145,15835,20122013,1,60,1,2,-1,5.08822609818162,3.77181468088793,1.31641141729369,44,33,11,59,42,17,86,55,31,3,2,0,0
"2266","BOS","TOR",2012030146,15837,20122013,0,60,1,2,-1,5.27177311883133,2.82537251419853,2.4464006046328,30,26,4,53,38,15,73,55,18,2,1,0,0
"2267","BOS","TOR",2012030147,15838,20122013,1,66.0833333333333,5,4,1,6.23521356087031,3.71115300542442,2.52406055544589,35,28,7,53,38,15,68,45,23,4,5,0,0
"2268","BOS","NYR",2012030221,15841,20122013,1,75.6666666666667,3,2,1,8.40710984396889,5.82848381553777,2.57862602843113,48,35,13,64,45,19,93,66,27,4,3,0,0
"2269","BOS","NYR",2012030222,15844,20122013,1,60,5,2,3,3.98921130340403,3.0577003102851,0.93151099311893,32,37,-5,38,44,-6,50,59,-9,3,7,0,0
"2270","BOS","NYR",2012030223,15846,20122013,0,60,2,1,1,6.66322478328948,4.55944111570716,2.10378366758232,34,24,10,58,40,18,75,60,15,1,3,0,0
"2271","BOS","NYR",2012030224,15848,20122013,0,67.05,3,4,-1,6.89707114943303,6.65132666511124,0.24574448432179,40,32,8,57,49,8,74,70,4,4,4,0,0
"2272","BOS","NYR",2012030225,15850,20122013,1,60,3,1,2,6.6097949590478,4.69294467030522,1.91685028874257,32,29,3,48,36,12,61,52,9,4,3,0,0
"2273","BOS","PIT",2012030311,15857,20122013,0,60,3,0,3,2.4334072779828,4.18981639103679,-1.75640911305399,30,29,1,39,41,-2,49,52,-3,4,6,0,0
"2274","BOS","PIT",2012030312,15859,20122013,0,60,6,1,5,2.36830877902685,4.28815925665549,-1.91985047762864,29,27,2,37,42,-5,46,58,-12,2,3,0,0
"2275","BOS","PIT",2012030313,15861,20122013,1,80,1,1,0,3.91320623180536,6.1829252330226,-2.26971900121724,34,46,-12,46,63,-17,68,81,-13,8,8,0,0
"2276","BOS","PIT",2012030314,15863,20122013,1,60,1,0,1,3.04121231275386,5.85869713831926,-2.8174848255654,24,26,-2,33,41,-8,45,60,-15,4,4,0,0
"2277","BOS","CHI",2012030411,15868,20122013,0,80,3,3,0,3.6618479190729,5.84959969957708,-2.18775178050419,37,47,-10,43,68,-25,61,99,-38,2,3,0,0
"2278","BOS","CHI",2012030412,15871,20122013,0,73.8,2,1,1,4.51785773639494,3.86921349113585,0.648644245259097,28,34,-6,32,46,-14,48,64,-16,2,3,0,0
"2279","BOS","CHI",2012030413,15873,20122013,1,60,2,0,2,6.65350423346536,3.55614799676388,3.09735623670148,35,28,7,44,39,5,51,56,-5,5,6,0,0
"2280","BOS","CHI",2012030414,15875,20122013,1,69.85,5,6,-1,6.81406376315954,8.95075910126972,-2.13669533811018,33,47,-14,47,59,-12,60,70,-10,6,5,0,0
"2281","BOS","CHI",2012030415,15878,20122013,0,60,1,3,-2,1.83202500254265,4.41954916535178,-2.58752416280913,25,32,-7,32,41,-9,49,55,-6,2,4,0,0
"2282","BOS","CHI",2012030416,15880,20122013,1,60,2,3,-1,2.51394165754061,4.77957755761915,-2.26563590007853,25,31,-6,38,41,-3,62,48,14,4,2,0,0
"2283","BOS","T.B",2013020007,15981,20132014,1,60,3,1,2,3.65235767658144,5.01215193414828,-1.35979425756684,25,33,-8,38,41,-3,54,53,1,4,5,0,0
"2284","BOS","DET",2013020021,15983,20132014,1,60,4,1,3,4.78656145046494,3.90118587721372,0.885375573251224,37,26,11,50,34,16,59,45,14,4,2,0,0
"2285","BOS","COL",2013020048,15988,20132014,1,60,0,2,-2,2.79520139741181,4.22750537185766,-1.43230397444585,39,30,9,58,39,19,72,56,16,7,8,0,0
"2286","BOS","CBJ",2013020068,15990,20132014,0,60,3,1,2,4.49213778377543,5.69054490650888,-1.19840712273344,36,27,9,45,34,11,58,52,6,3,4,0,0
"2287","BOS","DET",2013020079,15992,20132014,1,60,2,3,-1,5.07184791727923,3.33771908058574,1.73412883669349,30,27,3,47,38,9,69,42,27,6,1,0,0
"2288","BOS","FLA",2013020103,15995,20132014,0,60,3,2,1,4.21492484753253,3.26338506976026,0.951539777772268,40,29,11,49,35,14,63,38,25,2,1,0,0
"2289","BOS","T.B",2013020114,15997,20132014,0,60,5,0,5,3.14417034457438,2.6996778511857,0.44449249338868,22,23,-1,31,34,-3,45,42,3,5,5,0,0
"2290","BOS","S.J",2013020139,16002,20132014,1,60,2,1,1,3.06397578377312,6.97132138994493,-3.90734560617182,17,39,-22,30,53,-23,43,71,-28,1,1,0,0
"2291","BOS","N.J",2013020155,16004,20132014,1,60,3,4,-1,2.75760856610594,5.0574656794779,-2.29985711337196,28,32,-4,36,40,-4,43,51,-8,2,6,0,0
"2292","BOS","ANA",2013020188,16009,20132014,1,65,2,2,0,3.49931755744243,6.78469111584127,-3.28537355839884,23,23,0,35,34,1,51,44,7,2,4,0,0
"2293","BOS","NYI",2013020204,16011,20132014,0,60,1,3,-2,3.20852773927618,3.34984205846195,-0.141314319185767,27,34,-7,43,47,-4,62,67,-5,4,4,0,0
"2294","BOS","DAL",2013020217,16014,20132014,1,65,2,2,0,3.88536475342198,4.49917917902349,-0.613814425601504,36,36,0,46,48,-2,66,57,9,6,5,0,0
"2295","BOS","FLA",2013020230,16016,20132014,1,60,4,1,3,3.45683268071274,2.13770098774694,1.3191316929658,30,24,6,43,31,12,55,51,4,1,4,0,0
"2296","BOS","TOR",2013020247,16018,20132014,1,60,3,1,2,5.44861171324737,7.0196296160866,-1.57101790283923,34,34,0,50,43,7,67,58,9,2,3,0,0
"2297","BOS","T.B",2013020262,16020,20132014,1,60,3,0,3,3.2267098479536,4.13362999734818,-0.90692014939458,26,28,-2,39,44,-5,44,58,-14,1,4,0,0
"2298","BOS","CBJ",2013020277,16023,20132014,1,64.1833333333333,3,2,1,2.64211441179214,5.99420656336588,-3.35209215157374,31,34,-3,40,41,-1,60,52,8,1,4,0,0
"2299","BOS","OTT",2013020289,16024,20132014,0,60,2,4,-2,6.8928238264416,7.04305475215733,-0.150230925715732,32,31,1,44,43,1,56,56,0,1,2,0,0
"2300","BOS","CAR",2013020309,16027,20132014,0,60,4,1,3,6.89283595542656,2.33607979514636,4.5567561602802,30,24,6,46,39,7,66,49,17,2,4,0,0
"2301","BOS","NYR",2013020317,16028,20132014,0,60,2,1,1,5.59928662516177,5.61758642357286,-0.0182997984110926,22,44,-22,32,62,-30,53,85,-32,3,4,0,0
"2302","BOS","STL",2013020326,16030,20132014,1,65,2,2,0,3.99539312582056,5.296928619151,-1.30153549333045,31,26,5,43,33,10,66,51,15,1,1,0,0
"2303","BOS","CAR",2013020341,16032,20132014,1,61.4666666666667,3,2,1,4.757403347832,2.34731526654286,2.41008808128913,38,24,14,48,32,16,61,43,18,4,2,0,0
"2304","BOS","DET",2013020370,16036,20132014,0,60,1,6,-5,3.36776190967066,4.13455300383339,-0.766791094162727,17,28,-11,25,38,-13,38,43,-5,4,5,0,0
"2305","BOS","NYR",2013020380,16038,20132014,1,60,3,2,1,6.06648789462489,2.47609319380717,3.59039470081771,28,19,9,41,26,15,56,36,20,4,7,0,0
"2306","BOS","CBJ",2013020393,16039,20132014,1,60,3,1,2,5.11555511239567,2.29192477605898,2.82363033633669,36,14,22,50,24,26,67,42,25,7,3,0,0
"2307","BOS","MTL",2013020425,16044,20132014,0,60,1,2,-1,7.1424078362179,5.41693627217319,1.72547156404471,33,27,6,46,36,10,68,51,17,2,4,0,0
"2308","BOS","TOR",2013020450,16047,20132014,0,60,5,2,3,6.97665175802604,3.48221325286431,3.49443850516172,39,32,7,53,52,1,68,75,-7,4,5,0,0
"2309","BOS","CGY",2013020467,16049,20132014,0,60,2,1,1,6.21637959386499,3.04960646067047,3.16677313319451,24,27,-3,41,33,8,59,44,15,3,2,0,0
"2310","BOS","EDM",2013020482,16051,20132014,0,60,4,2,2,3.03011528667209,5.38073237985373,-2.35061709318163,31,41,-10,36,54,-18,48,74,-26,1,3,0,0
"2311","BOS","VAN",2013020498,16053,20132014,0,60,2,6,-4,3.49477761379239,2.52285517434939,0.971922439443006,41,30,11,53,35,18,72,50,22,4,3,0,0
"2312","BOS","CGY",2013020509,16056,20132014,1,60,2,0,2,4.45360047035683,2.777115753619,1.67648471673783,31,21,10,44,30,14,53,39,14,2,3,0,0
"2313","BOS","NSH",2013020562,16062,20132014,0,60,6,2,4,5.44317022687756,5.77664365933742,-0.333473432459868,33,34,-1,43,43,0,50,62,-12,3,2,0,0
"2314","BOS","OTT",2013020567,16066,20132014,1,60,5,0,5,7.67526062908857,5.3238444416996,2.35141618738897,42,33,9,51,43,8,67,57,10,3,4,0,0
"2315","BOS","OTT",2013020577,16067,20132014,0,60,3,4,-1,5.11191846744623,3.67034495150074,1.44157351594549,32,30,2,53,41,12,61,63,-2,4,2,0,0
"2316","BOS","NYI",2013020602,16070,20132014,1,60,3,5,-2,4.56215917220956,4.52684530618717,0.0353138660223884,38,31,7,47,41,6,59,58,1,4,9,0,0
"2317","BOS","NSH",2013020612,16072,20132014,1,60.9,3,2,1,4.07794202373004,3.93713695307068,0.140805070659354,25,35,-10,41,39,2,64,50,14,2,1,0,0
"2318","BOS","WPG",2013020626,16074,20132014,1,60,4,1,3,6.29899903261794,7.54375831215293,-1.24475927953499,29,37,-8,45,48,-3,58,62,-4,2,3,0,0
"2319","BOS","ANA",2013020655,16077,20132014,0,60,2,5,-3,5.15602783422219,3.07756871770835,2.07845911651384,32,20,12,55,31,24,73,42,31,3,3,0,0
"2320","BOS","L.A",2013020667,16079,20132014,0,60,2,4,-2,3.32406975834806,4.79702218517195,-1.47295242682389,22,35,-13,37,47,-10,45,60,-15,3,6,0,0
"2321","BOS","S.J",2013020684,16081,20132014,0,60,1,0,1,5.14082459712453,4.72494388872292,0.415880708401607,22,26,-4,38,44,-6,59,60,-1,3,1,0,0
"2322","BOS","TOR",2013020696,16084,20132014,1,60,3,4,-1,7.02245739195591,2.29202961243573,4.73042777952018,41,26,15,57,30,27,76,40,36,3,5,0,0
"2323","BOS","DAL",2013020717,16086,20132014,0,60,4,2,2,7.38127111300182,4.11718236534361,3.26408874765821,41,34,7,60,47,13,77,61,16,6,8,0,0
"2324","BOS","CHI",2013020736,16089,20132014,0,65,2,2,0,6.07944058244109,6.93359730171505,-0.854156719273959,36,37,-1,44,46,-2,62,58,4,3,2,0,0
"2325","BOS","L.A",2013020739,16090,20132014,1,60,3,2,1,2.58386892534327,2.75981739145936,-0.175948466116097,23,23,0,32,37,-5,43,53,-10,5,5,0,0
"2326","BOS","PHI",2013020776,16095,20132014,0,60,6,1,5,4.09413334286077,3.06361310080683,1.03052024205394,33,26,7,43,33,10,62,51,11,4,2,0,0
"2327","BOS","NYI",2013020789,16097,20132014,0,60,6,3,3,3.2732887645252,4.67456116194339,-1.40127239741818,37,37,0,40,51,-11,59,78,-19,2,5,0,0
"2328","BOS","FLA",2013020795,16098,20132014,1,60,6,2,4,4.53088934640982,6.09268940077163,-1.56180005436181,41,30,11,53,42,11,65,51,14,4,2,0,0
"2329","BOS","MTL",2013020809,16100,20132014,1,60,1,4,-3,5.7768537088632,5.16500457026268,0.611849138600519,35,33,2,46,45,1,62,58,4,4,5,0,0
"2330","BOS","EDM",2013020824,16102,20132014,1,60,4,0,4,4.96215089415182,4.96815851652354,-0.00600762237172603,41,22,19,58,34,24,74,40,34,6,5,0,0
"2331","BOS","VAN",2013020844,16105,20132014,1,60,3,1,2,6.00432096541044,5.42004385513176,0.584277110278683,32,28,4,48,50,-2,63,67,-4,3,2,0,0
"2332","BOS","STL",2013020864,16107,20132014,0,63.4833333333333,2,3,-1,6.91874662658665,4.89621614844975,2.0225304781369,38,27,11,44,37,7,61,46,15,6,5,0,0
"2333","BOS","OTT",2013020874,16109,20132014,1,60,7,2,5,6.39030506238578,4.3953901504579,1.99491491192788,42,28,14,60,37,23,69,43,26,4,3,0,0
"2334","BOS","NYR",2013020916,16131,20132014,0,60,6,3,3,4.84850498458218,4.78925351222279,0.0592514723593922,33,42,-9,46,55,-9,63,73,-10,2,6,0,0
"2335","BOS","FLA",2013020924,16133,20132014,1,60,4,1,3,5.87942282544135,4.40044210674301,1.47898071869835,39,24,15,45,38,7,57,51,6,2,3,0,0
"2336","BOS","T.B",2013020956,16137,20132014,0,65,3,3,0,7.66223322425503,4.39755542864978,3.26467779560525,32,20,12,49,29,20,65,37,28,3,1,0,0
"2337","BOS","FLA",2013020963,16138,20132014,0,60,5,2,3,5.33953504043549,2.6795691723874,2.65996586804808,42,22,20,57,28,29,72,44,28,4,4,0,0
"2338","BOS","MTL",2013020985,16141,20132014,0,60,4,1,3,5.69522970894101,5.06004451867193,0.635185190269076,32,36,-4,38,55,-17,51,73,-22,3,4,0,0
"2339","BOS","ARI",2013020989,16142,20132014,1,60,2,1,1,4.91817280004034,2.47974408394657,2.43842871609377,20,22,-2,30,28,2,41,43,-2,1,4,0,0
"2340","BOS","CAR",2013021004,16144,20132014,1,60,5,1,4,6.40479837013118,5.14188533709967,1.26291303303151,41,30,11,51,40,11,63,56,7,3,4,0,0
"2341","BOS","MIN",2013021022,16146,20132014,1,60,4,1,3,5.87777102683322,4.46135523717385,1.41641578965937,29,34,-5,33,44,-11,49,48,1,0,1,0,0
"2342","BOS","N.J",2013021026,16147,20132014,0,60,4,2,2,2.20926927911933,2.16253099445021,0.046738284669118,31,24,7,35,31,4,44,45,-1,2,4,0,0
"2343","BOS","COL",2013021053,16150,20132014,0,60,2,0,2,2.15307618599036,3.05949693915318,-0.90642075316282,28,31,-3,36,41,-5,48,54,-6,1,3,0,0
"2344","BOS","ARI",2013021063,16151,20132014,0,60,4,2,2,6.7607676795742,4.64573538050172,2.11503229907248,28,33,-5,44,47,-3,63,59,4,5,5,0,0
"2345","BOS","MTL",2013021075,16153,20132014,1,65,1,1,0,2.81700516608566,2.93824234917044,-0.121237183084779,29,22,7,45,32,13,65,47,18,6,6,0,0
"2346","BOS","CHI",2013021092,16156,20132014,1,60,3,0,3,2.36244018575105,2.94626490332303,-0.58382471757198,23,28,-5,33,37,-4,44,47,-3,1,2,0,0
"2347","BOS","PHI",2013021121,16159,20132014,0,65,3,3,0,4.07945595059846,7.90052259475851,-3.82106664416006,30,52,-22,35,61,-26,49,71,-22,2,4,0,0
"2348","BOS","DET",2013021141,16162,20132014,0,60,2,3,-1,3.13882900973476,2.00250745945746,1.1363215502773,35,20,15,45,26,19,56,29,27,4,2,0,0
"2349","BOS","TOR",2013021144,16163,20132014,0,62.85,3,4,-1,7.83972648373297,6.93908427697565,0.900642206757315,38,31,7,59,39,20,80,46,34,2,3,0,0
"2350","BOS","PHI",2013021160,16165,20132014,1,60,5,2,3,6.46429416257942,2.51143625343684,3.95285790914258,42,26,16,56,36,20,71,47,24,1,3,0,0
"2351","BOS","MIN",2013021187,16168,20132014,0,65,3,3,0,2.09177168368478,3.73418694047723,-1.64241525679245,24,24,0,32,37,-5,54,47,7,5,3,0,0
"2352","BOS","WPG",2013021202,16170,20132014,0,65,1,1,0,5.85618549966966,6.74476051848615,-0.888575018816482,33,37,-4,48,51,-3,62,67,-5,5,2,0,0
"2353","BOS","N.J",2013021221,16173,20132014,0,60,2,3,-1,2.68714408395198,2.64639387701573,0.0407502069362522,18,31,-13,24,36,-12,28,45,-17,3,3,0,0
"2354","BOS","DET",2013030111,16178,20132014,1,60,0,1,-1,5.8618766738673,3.25295304807969,2.60892362578761,25,24,1,31,35,-4,42,54,-12,1,2,0,0
"2355","BOS","DET",2013030112,16180,20132014,1,60,4,1,3,5.08633530774296,4.59817126800772,0.488164039735238,29,35,-6,36,44,-8,43,58,-15,7,7,0,0
"2356","BOS","DET",2013030113,16182,20132014,0,60,3,0,3,5.94090397101911,3.51320674279123,2.42769722822788,34,23,11,46,33,13,56,46,10,4,4,0,0
"2357","BOS","DET",2013030114,16184,20132014,0,73.5333333333333,3,2,1,7.69234063285694,7.38916971907281,0.303170913784129,40,37,3,51,50,1,77,63,14,3,4,0,0
"2358","BOS","DET",2013030115,16186,20132014,1,60,4,2,2,4.19015256271907,4.97477399429397,-0.784621431574902,33,33,0,38,42,-4,51,58,-7,6,7,0,0
"2359","BOS","MTL",2013030211,16191,20132014,1,80,3,3,0,7.37551358920609,8.53721156940901,-1.16169798020292,50,29,21,66,40,26,96,52,44,3,3,0,0
"2360","BOS","MTL",2013030212,16193,20132014,1,60,5,3,2,5.21509563327618,5.77379609322776,-0.558700459951585,35,28,7,46,40,6,63,54,9,6,9,0,0
"2361","BOS","MTL",2013030213,16196,20132014,0,60,2,4,-2,3.01163373383497,5.35221623361576,-2.34058249978079,28,26,2,38,33,5,67,53,14,1,1,0,0
"2362","BOS","MTL",2013030214,16198,20132014,0,61.3166666666667,1,0,1,5.57081813663899,3.01702844974352,2.55378968689547,35,33,2,49,43,6,69,55,14,2,1,0,0
"2363","BOS","MTL",2013030215,16200,20132014,1,60,4,2,2,3.957031616721,4.82536990765948,-0.868338290938482,30,31,-1,42,42,0,58,60,-2,5,6,0,0
"2364","BOS","MTL",2013030216,16202,20132014,0,60,0,4,-4,5.6571132698773,5.73327497670519,-0.0761617068278886,26,28,-2,43,41,2,63,58,5,5,7,0,0
"2365","BOS","MTL",2013030217,16204,20132014,1,60,1,3,-2,2.90516545627969,2.43465721614664,0.470508240133055,30,18,12,40,32,8,54,47,7,4,6,0,0
"2366","BOS","PHI",2014020002,16351,20142015,1,60,2,1,1,2.61099573737488,1.92548416436473,0.685511573010153,33,20,13,43,29,14,58,44,14,3,5,0,0
"2367","BOS","DET",2014020009,16352,20142015,0,60,1,2,-1,2.37758468026827,3.7641060640949,-1.38652138382663,17,24,-7,23,33,-10,29,46,-17,5,5,0,0
"2368","BOS","COL",2014020035,16356,20142015,1,60,1,2,-1,3.38953204025665,4.71830691915288,-1.32877487889623,28,30,-2,39,37,2,51,46,5,3,3,0,0
"2369","BOS","DET",2014020047,16358,20142015,0,65,2,2,0,5.50339942087612,3.33588533336297,2.16751408751315,39,20,19,48,28,20,65,40,25,3,5,0,0
"2370","BOS","MTL",2014020053,16359,20142015,0,60,4,6,-2,7.57083530091759,4.8044481741963,2.7663871267213,29,26,3,41,33,8,60,49,11,4,4,0,0
"2371","BOS","S.J",2014020079,16364,20142015,1,60,5,3,2,5.04934994548967,5.42278533084436,-0.373435385354696,33,34,-1,47,42,5,63,58,5,3,2,0,0
"2372","BOS","NYI",2014020093,16366,20142015,1,60,2,3,-1,6.19606575511318,6.77188338359701,-0.575817628483832,32,38,-6,50,50,0,69,54,15,1,1,0,0
"2373","BOS","TOR",2014020107,16368,20142015,0,60,4,1,3,3.55736494841403,3.49508634779585,0.0622786006181784,33,33,0,48,43,5,66,56,10,5,4,0,0
"2374","BOS","MIN",2014020124,16371,20142015,1,60,3,4,-1,4.55743898655055,8.76577093574451,-4.20833194919396,28,42,-14,37,54,-17,57,71,-14,3,3,0,0
"2375","BOS","OTT",2014020153,16375,20142015,1,60,4,2,2,8.75986297619238,5.56544577485314,3.19441720133924,30,29,1,45,35,10,62,45,17,3,1,0,0
"2376","BOS","FLA",2014020172,16378,20142015,1,63.45,2,1,1,5.29447838186752,5.16928916017059,0.125189221696928,25,19,6,40,32,8,52,44,8,0,1,0,0
"2377","BOS","EDM",2014020187,16380,20142015,1,60,5,2,3,4.62552549926412,3.1307160484721,1.49480945079202,32,26,6,40,39,1,54,50,4,4,4,0,0
"2378","BOS","N.J",2014020218,16384,20142015,1,60,4,2,2,5.44808795728022,3.88598613115028,1.56210182612995,23,28,-5,35,38,-3,48,53,-5,3,2,0,0
"2379","BOS","TOR",2014020231,16386,20142015,0,60,1,6,-5,4.20755623758305,3.09168424292875,1.1158719946543,26,33,-7,41,46,-5,68,55,13,3,4,0,0
"2380","BOS","MTL",2014020235,16387,20142015,0,60,1,5,-4,2.84613187066861,5.36423136666417,-2.51809949599556,22,34,-12,27,45,-18,51,57,-6,4,7,0,0
"2381","BOS","CAR",2014020248,16389,20142015,1,60,2,1,1,3.05873738478113,4.14221463026479,-1.08347724548366,25,34,-9,37,41,-4,47,55,-8,2,3,0,0
"2382","BOS","STL",2014020267,16392,20142015,1,60,2,0,2,1.61274840820142,4.19061478169169,-2.57786637349027,17,33,-16,27,43,-16,39,55,-16,1,2,0,0
"2383","BOS","CBJ",2014020293,16395,20142015,0,65,3,3,0,7.71770943736055,5.81474870810052,1.90296072926003,41,28,13,52,48,4,70,60,10,2,3,0,0
"2384","BOS","MTL",2014020296,16396,20142015,1,60,0,2,-2,5.91449822057189,3.88501216191798,2.0294860586539,33,23,10,49,34,15,64,44,20,2,3,0,0
"2385","BOS","WPG",2014020336,16402,20142015,1,63.65,2,1,1,4.558389691617,4.88087549109804,-0.322485799481034,38,36,2,46,48,-2,61,63,-2,3,4,0,0
"2386","BOS","ANA",2014020361,16405,20142015,0,60,2,3,-1,5.1519352751712,4.15586316748522,0.99607210768598,34,28,6,57,41,16,85,56,29,3,3,0,0
"2387","BOS","L.A",2014020371,16406,20142015,0,60,0,2,-2,5.22969349909644,7.46096113778185,-2.23126763868541,31,35,-4,48,49,-1,57,63,-6,1,4,0,0
"2388","BOS","S.J",2014020386,16408,20142015,0,60,4,7,-3,3.62889263234683,6.48933662586933,-2.86044399352249,24,44,-20,37,62,-25,52,81,-29,3,5,0,0
"2389","BOS","ARI",2014020400,16410,20142015,0,60,5,2,3,8.60116050799115,6.33888654409384,2.26227396389731,33,26,7,44,43,1,57,53,4,2,4,0,0
"2390","BOS","CHI",2014020421,16415,20142015,1,60,2,3,-1,2.93678350504442,4.20980476238765,-1.27302125734323,34,21,13,46,35,11,57,43,14,3,5,0,0
"2391","BOS","OTT",2014020435,16417,20142015,1,65,2,2,0,6.47747121971571,4.1674134156201,2.31005780409561,31,31,0,47,39,8,61,57,4,1,3,0,0
"2392","BOS","MIN",2014020465,16421,20142015,0,61.5,3,2,1,4.50322579516796,5.96070245558254,-1.45747666041458,25,37,-12,32,52,-20,43,63,-20,2,2,0,0
"2393","BOS","WPG",2014020477,16423,20142015,0,60,1,2,-1,0,0,0,31,27,4,42,33,9,52,48,4,3,4,0,0
"2394","BOS","CBJ",2014020519,16431,20142015,0,60,2,6,-4,2.97972842736635,3.74685353941459,-0.767125112048234,28,30,-2,40,37,3,54,43,11,4,3,0,0
"2395","BOS","DET",2014020529,16433,20142015,1,60,5,2,3,4.88607647270672,3.60713657247834,1.27893990022839,45,30,15,54,36,18,61,49,12,1,4,0,0
"2396","BOS","TOR",2014020547,16435,20142015,1,65,3,3,0,5.96464748135259,5.04778076065122,0.916866720701364,28,21,7,43,36,7,65,46,19,3,4,0,0
"2397","BOS","OTT",2014020566,16438,20142015,1,60.7333333333333,2,3,-1,4.2576987411594,4.4851003845688,-0.227401643409394,28,26,2,41,36,5,57,44,13,3,5,0,0
"2398","BOS","CAR",2014020576,16439,20142015,0,65,1,1,0,4.70100464880306,7.37441536133156,-2.67341071252849,20,36,-16,41,52,-11,56,67,-11,2,3,0,0
"2399","BOS","N.J",2014020598,16443,20142015,1,60,3,0,3,7.3543669694991,4.43645786400884,2.91790910549025,43,14,29,48,27,21,68,36,32,3,1,0,0
"2400","BOS","PHI",2014020613,16445,20142015,0,60,3,1,2,2.80132316056307,4.49610607558861,-1.69478291502554,18,25,-7,27,43,-16,40,57,-17,4,6,0,0
"2401","BOS","T.B",2014020630,16448,20142015,1,60,4,3,1,4.79588848745715,2.12756622140296,2.66832226605419,34,19,15,50,25,25,60,34,26,7,9,0,0
"2402","BOS","NYR",2014020644,16450,20142015,1,60,3,0,3,3.58654531369773,4.73848112879274,-1.15193581509502,32,30,2,41,41,0,55,49,6,3,4,0,0
"2403","BOS","CBJ",2014020660,16452,20142015,1,60,1,3,-2,5.27229352817812,4.93097372935154,0.341319798826589,35,31,4,44,40,4,59,53,6,2,3,0,0
"2404","BOS","DAL",2014020690,16455,20142015,0,60,3,1,2,4.62537387375505,6.2641889587976,-1.63881508504255,27,37,-10,41,61,-20,57,83,-26,4,6,0,0
"2405","BOS","COL",2014020694,16456,20142015,0,65,2,2,0,3.94017771648429,8.7421515075257,-4.80197379104141,24,36,-12,39,45,-6,54,72,-18,3,6,0,0
"2406","BOS","NYI",2014020711,16464,20142015,0,60,5,2,3,5.61194815488548,5.62063548444712,-0.00868732956164031,33,45,-12,43,58,-15,60,74,-14,1,2,0,0
"2407","BOS","L.A",2014020730,16466,20142015,1,60,3,1,2,4.56540328231964,4.41787844855571,0.147524833763924,33,31,2,39,41,-2,48,55,-7,1,1,0,0
"2408","BOS","NYR",2014020756,16470,20142015,0,60,2,3,-1,4.01412039444237,6.50419173740289,-2.49007134296052,20,25,-5,34,37,-3,52,57,-5,2,2,0,0
"2409","BOS","NYI",2014020775,16473,20142015,1,60,2,1,1,4.63238870677014,5.50214024819434,-0.869751541424193,36,40,-4,44,52,-8,55,69,-14,3,4,0,0
"2410","BOS","MTL",2014020791,16474,20142015,1,60,1,3,-2,6.40610894519864,5.57031005391036,0.835798891288277,35,34,1,49,45,4,70,58,12,0,3,0,0
"2411","BOS","DAL",2014020797,16476,20142015,1,60,3,5,-2,6.05888829799369,7.09614198138752,-1.03725368339383,44,32,12,54,43,11,69,51,18,3,2,0,0
"2412","BOS","VAN",2014020822,16479,20142015,0,60,2,5,-3,4.44601195982978,6.27204385283403,-1.82603189300426,23,25,-2,42,37,5,60,49,11,3,2,0,0
"2413","BOS","EDM",2014020857,16484,20142015,0,65,3,3,0,7.72184435883537,4.58336846742168,3.13847589141369,41,30,11,58,39,19,74,58,16,1,4,0,0
"2414","BOS","CHI",2014020885,16488,20142015,0,60,6,2,4,3.47328593728719,4.84195395529969,-1.3686680180125,30,28,2,41,35,6,52,53,-1,6,6,0,0
"2415","BOS","VAN",2014020894,16490,20142015,1,60,1,2,-1,7.3923925490235,1.94307594094294,5.44931660808056,41,28,13,63,35,28,80,41,39,5,3,0,0
"2416","BOS","N.J",2014020917,16493,20142015,0,62.7666666666667,3,2,1,6.19105385662988,5.7975644954422,0.393489361187676,34,31,3,42,39,3,55,46,9,2,2,0,0
"2417","BOS","ARI",2014020927,16494,20142015,1,60,4,1,3,5.88274891674519,4.2027633766093,1.67998554013588,34,32,2,45,40,5,57,51,6,5,1,0,0
"2418","BOS","PHI",2014020970,16501,20142015,1,63.8666666666667,3,2,1,3.97878235963641,5.55082899317495,-1.57204663353854,37,31,6,50,41,9,75,48,27,4,2,0,0
"2419","BOS","DET",2014020984,16502,20142015,1,60,5,3,2,3.76063583767973,4.81315319717669,-1.05251735949696,30,39,-9,41,49,-8,48,63,-15,5,5,0,0
"2420","BOS","OTT",2014020995,16504,20142015,0,60,3,1,2,4.18798724460186,5.59994586765889,-1.41195862305703,22,40,-18,35,53,-18,43,74,-31,4,4,0,0
"2421","BOS","T.B",2014021002,16506,20142015,1,65,2,2,0,5.05797410279047,5.18212341305957,-0.124149310269104,30,37,-7,47,48,-1,56,59,-3,5,3,0,0
"2422","BOS","OTT",2014021055,16513,20142015,0,60,4,6,-2,7.07298800790817,5.14475838110548,1.92822962680269,35,32,3,44,49,-5,58,65,-7,3,3,0,0
"2423","BOS","T.B",2014021080,16516,20142015,0,60,3,5,-2,2.60029728146037,1.96716631551681,0.633130965943565,28,19,9,35,25,10,56,43,13,3,2,0,0
"2424","BOS","ANA",2014021101,16520,20142015,1,63.15,2,3,-1,3.49321072528547,3.30881682558103,0.184393899704434,29,32,-3,38,44,-6,50,55,-5,6,4,0,0
"2425","BOS","NYR",2014021116,16522,20142015,1,60,4,2,2,4.2234229836904,3.83955407500434,0.383868908686054,30,32,-2,43,42,1,53,57,-4,2,1,0,0
"2426","BOS","CAR",2014021131,16523,20142015,0,64.3833333333333,2,1,1,4.22634156157437,8.03940575922934,-3.81306419765497,30,31,-1,40,61,-21,47,73,-26,3,3,0,0
"2427","BOS","DET",2014021156,16527,20142015,0,60,3,2,1,2.76840721502435,5.44659462157324,-2.67818740654889,25,37,-12,30,54,-24,38,62,-24,4,5,0,0
"2428","BOS","TOR",2014021170,16529,20142015,1,65,1,1,0,8.56122161689325,2.9379201784181,5.62330143847515,50,28,22,57,32,25,79,43,36,3,2,0,0
"2429","BOS","T.B",2014021225,16536,20142015,0,65,2,2,0,3.89840592033966,5.32881510678271,-1.43040918644305,38,25,13,51,36,15,75,47,28,4,2,0,0
"2430","BOS","WPG",2015020005,16716,20152016,1,60,2,6,-4,6.90173432277516,5.4577689937156,1.44396532905955,31,32,-1,50,41,9,63,50,13,3,1,0,0
"2431","BOS","MTL",2015020018,16718,20152016,1,60,2,4,-2,3.47579101467858,6.27883444321924,-2.80304342854066,21,38,-17,31,51,-20,43,62,-19,3,6,0,0
"2432","BOS","T.B",2015020032,16720,20152016,1,60,3,6,-3,4.2180321252672,4.61401972810563,-0.395987602838431,30,23,7,39,39,0,49,48,1,4,4,0,0
"2433","BOS","COL",2015020048,16722,20152016,0,60,6,2,4,3.93039476551348,3.62981165522065,0.300583110292838,25,23,2,35,38,-3,45,47,-2,2,3,0,0
"2434","BOS","ARI",2015020074,16725,20152016,0,60,5,3,2,7.21183465985609,1.8073731209638,5.40446153889229,43,24,19,56,34,22,73,57,16,6,4,0,0
"2435","BOS","PHI",2015020089,16729,20152016,1,62.15,4,5,-1,2.14004887738065,5.20964156976507,-3.06959269238442,30,37,-7,37,47,-10,54,53,1,3,2,0,0
"2436","BOS","NYI",2015020101,16731,20152016,0,60,5,3,2,5.01898156457173,4.02855829172768,0.990423272844055,26,26,0,38,32,6,62,49,13,3,2,0,0
"2437","BOS","ARI",2015020124,16735,20152016,1,60,6,0,6,3.55031600334041,2.07428848145719,1.47602752188322,27,24,3,39,35,4,48,53,-5,4,3,0,0
"2438","BOS","T.B",2015020159,16739,20152016,0,60,3,1,2,4.53386323100676,4.86264840466902,-0.328785173662254,34,22,12,44,37,7,53,51,2,3,5,0,0
"2439","BOS","DAL",2015020172,16742,20152016,1,60,3,5,-2,5.93661096605229,3.45613650534125,2.48047446071103,39,19,20,56,33,23,77,44,33,4,4,0,0
"2440","BOS","MTL",2015020202,16746,20152016,0,60,2,4,-2,4.2012044765288,5.61438036293539,-1.41317588640659,31,33,-2,41,47,-6,50,64,-14,4,3,0,0
"2441","BOS","NYI",2015020213,16747,20152016,0,60,2,1,1,2.02484127995558,5.02626995902165,-3.00142867906607,27,37,-10,32,44,-12,45,61,-16,4,8,0,0
"2442","BOS","COL",2015020230,16751,20152016,1,60,2,3,-1,4.69704804866342,3.82719502357577,0.86985302508765,27,30,-3,41,44,-3,55,63,-8,1,4,0,0
"2443","BOS","DET",2015020247,16753,20152016,1,60,3,1,2,2.39424150778996,4.55527427975903,-2.16103277196908,31,23,8,38,41,-3,49,57,-8,1,3,0,0
"2444","BOS","S.J",2015020267,16756,20152016,1,60,4,5,-1,2.39445372384844,3.75481058476726,-1.36035686091881,29,28,1,39,35,4,51,48,3,3,5,0,0
"2445","BOS","MIN",2015020278,16758,20152016,1,60,4,2,2,4.84381665302135,3.69776395310427,1.14605269991708,38,26,12,51,36,15,61,52,9,7,7,0,0
"2446","BOS","TOR",2015020293,16760,20152016,1,60,2,0,2,5.2787557200063,4.31536442540394,0.96339129460236,37,22,15,52,40,12,67,60,7,1,1,0,0
"2447","BOS","TOR",2015020312,16762,20152016,0,65,3,3,0,2.5509788047845,4.48617832732599,-1.93519952254149,29,42,-13,36,62,-26,54,79,-25,5,8,0,0
"2448","BOS","DET",2015020325,16764,20152016,0,63.5333333333333,3,2,1,4.91809519328763,6.66529339569388,-1.74719820240625,22,34,-12,26,41,-15,33,53,-20,3,3,0,0
"2449","BOS","NYR",2015020330,16766,20152016,1,60,4,3,1,3.8464864619018,1.97974833415356,1.86673812774825,34,27,7,49,42,7,64,55,9,3,3,0,0
"2450","BOS","EDM",2015020371,16771,20152016,0,65,2,2,0,4.90864537228578,3.26149245072884,1.64715292155694,40,36,4,56,45,11,65,57,8,2,5,0,0
"2451","BOS","VAN",2015020396,16774,20152016,0,60,4,0,4,4.40914995787898,2.24040173165849,2.16874822622049,22,17,5,34,27,7,44,43,1,3,5,0,0
"2452","BOS","MTL",2015020417,16778,20152016,0,60,3,1,2,2.8032141778649,6.69263689615764,-3.88942271829274,23,33,-10,27,47,-20,41,72,-31,3,4,0,0
"2453","BOS","EDM",2015020448,16783,20152016,1,60.6833333333333,2,3,-1,7.0085229066558,1.83426636195091,5.17425654470489,49,24,25,63,29,34,79,41,38,3,3,0,0
"2454","BOS","PIT",2015020465,16785,20152016,1,60,3,0,3,4.76035899015733,5.55335801347678,-0.792999023319453,29,34,-5,43,55,-12,52,69,-17,4,3,0,0
"2455","BOS","PIT",2015020477,16787,20152016,0,60,6,2,4,6.27007943956414,6.28168972558342,-0.0116102860192768,34,32,2,42,48,-6,60,62,-2,5,6,0,0
"2456","BOS","N.J",2015020494,16789,20152016,1,65,1,1,0,5.64276205486842,3.3938592917666,2.24890276310182,39,30,9,51,39,12,66,58,8,3,4,0,0
"2457","BOS","OTT",2015020526,16796,20152016,0,60,1,3,-2,6.75534223535215,5.39390077759865,1.36144145775349,39,22,17,55,30,25,65,43,22,2,2,0,0
"2458","BOS","OTT",2015020541,16798,20152016,1,60,7,3,4,4.15162067499935,4.62287455878572,-0.471253883786376,37,32,5,46,47,-1,63,66,-3,9,6,0,0
"2459","BOS","MTL",2015020565,16801,20152016,1,60,1,5,-4,4.95257126382046,2.19324734702865,2.75932391679181,28,30,-2,35,45,-10,43,59,-16,7,8,0,0
"2460","BOS","N.J",2015020608,16808,20152016,0,60,4,1,3,3.72405562183121,4.1116709256271,-0.387615303795883,31,20,11,39,30,9,48,39,9,4,3,0,0
"2461","BOS","OTT",2015020617,16809,20152016,0,64.3666666666667,1,2,-1,6.99003246227949,6.54129562989692,0.448736832382565,34,40,-6,45,51,-6,64,74,-10,2,3,0,0
"2462","BOS","NYR",2015020630,16811,20152016,0,60,1,2,-1,5.6382782922592,5.71326656639576,-0.0749882741365582,33,30,3,47,39,8,71,47,24,1,0,0,0
"2463","BOS","PHI",2015020643,16813,20152016,0,60,2,3,-1,6.20483443208815,3.17136163118994,3.03347280089821,32,21,11,44,38,6,55,58,-3,2,3,0,0
"2464","BOS","TOR",2015020662,16816,20152016,1,60,3,2,1,5.12569733291083,7.21480409122887,-2.08910675831804,45,29,16,63,42,21,73,56,17,3,6,0,0
"2465","BOS","MTL",2015020686,16819,20152016,0,60,4,1,3,5.14250286801058,6.39257544035143,-1.25007257234085,24,39,-15,33,46,-13,50,71,-21,3,5,0,0
"2466","BOS","VAN",2015020693,16821,20152016,1,60,2,4,-2,3.63812945746031,5.26300711245858,-1.62487765499827,30,27,3,44,37,7,58,46,12,0,0,0,0
"2467","BOS","CBJ",2015020711,16823,20152016,1,65,2,2,0,2.03498698544286,3.91493287660435,-1.87994589116149,34,33,1,41,44,-3,57,59,-2,5,4,0,0
"2468","BOS","PHI",2015020727,16825,20152016,0,60,3,2,1,7.16090991214514,5.37030723237456,1.79060267977059,31,36,-5,44,48,-4,63,74,-11,4,5,0,0
"2469","BOS","ANA",2015020731,16826,20152016,1,60,2,6,-4,4.9106781389093,5.22286873288575,-0.312190593976448,34,39,-5,53,51,2,66,62,4,5,5,0,0
"2470","BOS","TOR",2015020744,16833,20152016,1,63.1,3,4,-1,6.03555727526054,5.96190034948813,0.0736569257724113,42,35,7,50,55,-5,65,73,-8,5,4,0,0
"2471","BOS","L.A",2015020794,16840,20152016,1,60,2,9,-7,3.68139789940324,8.70464282625471,-5.02324492685148,37,57,-20,49,70,-21,66,80,-14,3,3,0,0
"2472","BOS","WPG",2015020814,16842,20152016,0,60,6,2,4,0,0,0,39,36,3,47,52,-5,66,66,0,4,6,0,0
"2473","BOS","MIN",2015020826,16844,20152016,0,60,4,2,2,0,0,0,19,33,-14,32,44,-12,42,60,-18,5,5,0,0
"2474","BOS","DET",2015020837,16845,20152016,0,60,5,6,-1,4.01736679871101,4.06261551787611,-0.0452487191651016,22,35,-13,27,52,-25,34,64,-30,3,6,0,0
"2475","BOS","CBJ",2015020850,16847,20152016,0,60.55,2,1,1,6.17962949155481,5.72862199303563,0.451007498519175,30,29,1,46,42,4,60,55,5,4,4,0,0
"2476","BOS","DAL",2015020880,16851,20152016,0,60,7,3,4,6.2626622164367,4.21611320991391,2.04654900652279,42,29,13,59,48,11,75,57,18,6,1,0,0
"2477","BOS","CBJ",2015020889,16853,20152016,1,60,4,6,-2,4.27900674920033,8.85519217226367,-4.57618542306333,30,35,-5,43,51,-8,56,64,-8,2,3,0,0
"2478","BOS","PIT",2015020903,16855,20152016,1,60,5,1,4,4.18046788539505,4.50993697874947,-0.329469093354419,29,42,-13,33,60,-27,44,77,-33,1,1,0,0
"2479","BOS","CAR",2015020918,16857,20152016,0,60,4,1,3,3.61982018167027,6.96305276381327,-3.343232582143,22,40,-18,29,59,-30,42,80,-38,2,4,0,0
"2480","BOS","T.B",2015020933,16859,20152016,1,60,1,4,-3,3.43075470465286,2.48919144376785,0.941563260885005,33,30,3,43,40,3,62,47,15,7,5,0,0
"2481","BOS","CHI",2015020954,16863,20152016,1,60,4,2,2,2.92160424712347,4.92874933424173,-2.00714508711826,25,27,-2,34,42,-8,47,59,-12,2,2,0,0
"2482","BOS","T.B",2015020998,16868,20152016,0,60.1666666666667,1,0,1,3.29337109066864,4.93829457723768,-1.64492348656904,33,42,-9,35,57,-22,42,74,-32,1,5,0,0
"2483","BOS","CAR",2015021007,16870,20152016,1,61.5,2,3,-1,3.53393472557946,2.64456555034849,0.889369175230968,32,28,4,43,40,3,53,58,-5,2,3,0,0
"2484","BOS","NYI",2015021018,16872,20152016,1,60,3,1,2,3.73817051411606,4.31240403838456,-0.574233524268493,31,26,5,44,40,4,62,57,5,2,1,0,0
"2485","BOS","S.J",2015021046,16875,20152016,0,60,2,3,-1,2.40024008542971,3.8034992602561,-1.40325917482639,23,27,-4,37,44,-7,54,69,-15,1,4,0,0
"2486","BOS","ANA",2015021066,16878,20152016,0,60,0,4,-4,3.54818440424424,3.75760513343466,-0.209420729190416,38,26,12,54,45,9,70,57,13,3,3,0,0
"2487","BOS","L.A",2015021077,16879,20152016,0,60,1,2,-1,5.15005872863073,3.5061798769093,1.64387885172143,28,20,8,43,39,4,60,47,13,4,2,0,0
"2488","BOS","NYR",2015021100,16883,20152016,0,60,2,5,-3,7.5676646351208,4.63457584014031,2.93308879498048,41,24,17,57,37,20,75,46,29,2,5,0,0
"2489","BOS","TOR",2015021119,16886,20152016,0,60,3,1,2,2.88801726684324,4.24488164152216,-1.35686437467893,33,26,7,43,44,-1,56,64,-8,6,4,0,0
"2490","BOS","N.J",2015021140,16889,20152016,0,60,1,2,-1,6.55706232238117,2.31085478416935,4.24620753821182,40,15,25,53,19,34,64,29,35,3,6,0,0
"2491","BOS","CHI",2015021178,16894,20152016,0,60,4,6,-2,7.03223380001145,8.05902523838449,-1.02679143837304,46,34,12,59,43,16,76,60,16,3,5,0,0
"2492","BOS","CAR",2015021188,16896,20152016,1,65,1,1,0,5.8704419561617,4.59817502618674,1.27226692997495,36,28,8,49,43,6,69,49,20,4,4,0,0
"2493","BOS","DET",2015021202,16898,20152016,1,60,5,2,3,3.36719978084464,3.49134213162324,-0.124142350778598,34,15,19,44,22,22,56,37,19,4,4,0,0
"2494","BOS","OTT",2015021216,16900,20152016,1,60,1,6,-5,4.93881919543492,6.06435561092803,-1.12553641549312,40,36,4,61,39,22,76,42,34,5,1,0,0
"2495","BOS","CBJ",2016020008,17087,20162017,0,60,6,3,3,6.07162114185849,5.04826402281186,1.02335711904662,37,31,6,45,40,5,60,63,-3,3,4,0,0
"2496","BOS","TOR",2016020017,17089,20162017,0,60,1,4,-3,4.04701943359495,3.44383896600911,0.603180467585841,25,24,1,40,37,3,58,50,8,4,4,0,0
"2497","BOS","WPG",2016020036,17091,20162017,0,60,4,1,3,4.97915146068,4.50624684509239,0.472904615587609,25,35,-10,36,43,-7,46,58,-12,4,5,0,0
"2498","BOS","N.J",2016020051,17094,20162017,1,60,2,1,1,5.21401900110327,4.63331758657796,0.580701414525308,36,29,7,56,40,16,71,58,13,4,3,0,0
"2499","BOS","MTL",2016020065,17096,20162017,1,60,2,4,-2,4.15791209321469,3.97085284561035,0.187059247604338,21,29,-8,38,44,-6,55,50,5,7,7,0,0
"2500","BOS","MIN",2016020083,17099,20162017,1,60,0,5,-5,4.67988005140614,4.15221231813484,0.527667733271299,27,33,-6,45,45,0,61,53,8,4,5,0,0
"2501","BOS","NYR",2016020095,17100,20162017,0,60,2,5,-3,4.8256770535445,5.22552753775381,-0.39985048420931,29,31,-2,36,43,-7,44,61,-17,2,7,0,0
"2502","BOS","DET",2016020115,17103,20162017,0,60,1,0,1,4.82471145630188,3.54093902512977,1.28377243117211,36,24,12,45,29,16,60,43,17,6,6,0,0
"2503","BOS","T.B",2016020151,17108,20162017,0,65,3,3,0,3.65274942375254,5.57001027523074,-1.9172608514782,31,30,1,38,38,0,55,52,3,4,4,0,0
"2504","BOS","NYR",2016020162,17110,20162017,1,60,2,5,-3,4.03228977994877,4.18626385264048,-0.15397407269171,37,24,13,53,33,20,71,44,27,3,3,0,0
"2505","BOS","MTL",2016020189,17113,20162017,0,60,2,3,-1,8.83396131469635,3.85708559452905,4.9768757201673,43,23,20,55,35,20,83,56,27,2,2,0,0
"2506","BOS","CBJ",2016020196,17115,20162017,1,60,5,2,3,2.9804929694219,1.74151909074862,1.23897387867328,32,18,14,43,33,10,54,44,10,2,3,0,0
"2507","BOS","ARI",2016020221,17117,20162017,0,60,2,1,1,3.03081803373061,6.49152606254211,-3.4607080288115,29,32,-3,44,50,-6,61,59,2,0,3,0,0
"2508","BOS","COL",2016020227,17118,20162017,0,60,2,0,2,6.69461233945913,6.31427534366958,0.380336995789548,46,21,25,54,30,24,65,46,19,2,2,0,0
"2509","BOS","MIN",2016020250,17122,20162017,0,60,0,1,-1,4.35484716994688,6.05391046925797,-1.69906329931109,25,29,-4,32,44,-12,47,62,-15,3,4,0,0
"2510","BOS","WPG",2016020262,17124,20162017,1,60,4,1,3,5.32939678104594,1.69534810978803,3.63404867125791,38,12,26,51,23,28,67,33,34,5,5,0,0
"2511","BOS","T.B",2016020322,17132,20162017,1,60,4,1,3,3.75533586684162,6.07643534688395,-2.32109948004234,30,31,-1,43,51,-8,50,63,-13,2,3,0,0
"2512","BOS","PHI",2016020331,17134,20162017,0,65,2,2,0,6.35373149797488,4.47768009174615,1.87605140622873,47,21,26,61,35,26,80,44,36,6,8,0,0
"2513","BOS","CAR",2016020345,17136,20162017,1,65,1,1,0,4.78300603313255,1.79786510240046,2.98514093073209,35,30,5,58,37,21,80,50,30,4,2,0,0
"2514","BOS","COL",2016020395,17143,20162017,1,60,2,4,-2,5.74974142994324,3.53708090692935,2.21266052301389,31,22,9,48,31,17,62,39,23,3,3,0,0
"2515","BOS","TOR",2016020413,17145,20162017,1,60,1,4,-3,5.52412789487835,3.68153798300773,1.84258991187062,33,20,13,48,33,15,70,39,31,1,2,0,0
"2516","BOS","MTL",2016020430,17147,20162017,0,63.3333333333333,2,1,1,3.85652642470902,3.98369953071233,-0.127173106003312,29,31,-2,39,49,-10,47,74,-27,2,6,0,0
"2517","BOS","PIT",2016020442,17149,20162017,0,61.4,3,4,-1,4.07937110018429,5.78459848475177,-1.70522738456748,44,37,7,50,50,0,69,62,7,4,4,0,0
"2518","BOS","ANA",2016020445,17150,20162017,1,60,3,4,-1,6.97841706953477,5.46800294576678,1.51041412376799,34,28,6,56,40,16,82,53,29,4,3,0,0
"2519","BOS","L.A",2016020470,17153,20162017,1,60,1,0,1,1.90789907846647,2.56124609780822,-0.653347019341751,30,18,12,36,28,8,53,48,5,3,4,0,0
"2520","BOS","NYI",2016020481,17155,20162017,1,60,2,4,-2,6.80710421940603,2.49565357036216,4.31145064904387,50,29,21,70,34,36,95,44,51,5,5,0,0
"2521","BOS","CAR",2016020511,17158,20162017,0,63.0166666666667,2,3,-1,6.93268727799841,4.2983076168457,2.63437966115271,33,23,10,46,31,15,64,49,15,3,2,0,0
"2522","BOS","CBJ",2016020520,17162,20162017,0,60,3,4,-1,5.74858338919512,3.72167035554594,2.02691303364918,40,22,18,54,38,16,74,51,23,4,4,0,0
"2523","BOS","N.J",2016020563,17168,20162017,0,60,0,3,-3,3.20930882846005,4.53324159461772,-1.32393276615767,22,26,-4,36,36,0,41,44,-3,3,6,0,0
"2524","BOS","EDM",2016020578,17171,20162017,1,60,3,4,-1,4.75800619502843,3.51180029264651,1.24620590238192,36,25,11,56,25,31,75,32,43,3,1,0,0
"2525","BOS","CAR",2016020604,17174,20162017,0,61.5666666666667,3,4,-1,3.4592114352603,6.4423534989917,-2.9831420637314,35,30,5,45,42,3,62,60,2,1,1,0,0
"2526","BOS","PHI",2016020640,17180,20162017,1,60,6,3,3,6.3339460220347,5.03184476933765,1.30210125269704,39,24,15,53,37,16,67,51,16,5,5,0,0
"2527","BOS","NYI",2016020656,17182,20162017,1,60,0,4,-4,5.13445121697821,6.20125134461523,-1.06680012763702,32,27,5,45,35,10,55,50,5,2,4,0,0
"2528","BOS","DET",2016020674,17184,20162017,0,65,5,5,0,5.21643263979058,4.49299556481856,0.723437074972026,33,25,8,49,37,12,61,44,17,2,4,0,0
"2529","BOS","CHI",2016020685,17186,20162017,1,60,0,1,-1,4.46147414210129,3.21490380315663,1.24657033894466,30,22,8,42,27,15,61,42,19,2,3,0,0
"2530","BOS","PIT",2016020702,17188,20162017,0,60,1,5,-4,6.04378729284508,5.09801069594687,0.945776596898213,45,36,9,60,41,19,87,48,39,5,2,0,0
"2531","BOS","DET",2016020714,17190,20162017,1,64.2166666666667,4,3,1,6.29274770948894,3.90688844164833,2.3858592678406,49,26,23,63,35,28,78,45,33,3,2,0,0
"2532","BOS","PIT",2016020728,17192,20162017,1,60,4,3,1,3.8129134583578,4.59940301320603,-0.786489554848231,37,23,14,52,30,22,65,40,25,8,8,0,0
"2533","BOS","T.B",2016020747,17197,20162017,0,60,4,3,1,4.98042666498804,2.63426091731526,2.34616574767279,35,21,14,48,33,15,57,45,12,3,4,0,0
"2534","BOS","TOR",2016020774,17201,20162017,1,60,5,6,-1,6.34613959790357,4.10642926426544,2.23971033363813,41,26,15,60,31,29,79,50,29,6,3,0,0
"2535","BOS","S.J",2016020802,17206,20162017,1,60,6,3,3,5.79059205474186,3.05353248101071,2.73705957373115,33,26,7,42,37,5,50,49,1,3,2,0,0
"2536","BOS","VAN",2016020815,17208,20162017,1,60,4,3,1,6.16668502071274,6.13365046965191,0.0330345510608296,30,32,-2,43,46,-3,55,55,0,2,3,0,0
"2537","BOS","MTL",2016020832,17209,20162017,1,60,4,0,4,5.13355537491384,2.37236722921656,2.76118814569728,36,25,11,44,37,7,51,47,4,6,6,0,0
"2538","BOS","S.J",2016020877,17216,20162017,0,62.6,2,1,1,3.89589468197664,4.12839377485216,-0.232499092875514,28,30,-2,42,42,0,57,65,-8,2,2,0,0
"2539","BOS","ANA",2016020893,17219,20162017,0,60,3,5,-2,5.5228887452017,5.11152953598173,0.411359209219967,29,25,4,46,37,9,66,47,19,5,3,0,0
"2540","BOS","L.A",2016020899,17220,20162017,0,60,4,1,3,4.96544359121443,3.47750285174698,1.48794073946745,25,28,-3,40,49,-9,48,68,-20,2,4,0,0
"2541","BOS","DAL",2016020912,17223,20162017,0,60,6,3,3,3.98535017512404,4.93890514813793,-0.953554973013892,28,36,-8,39,41,-2,51,62,-11,2,2,0,0
"2542","BOS","ARI",2016020922,17225,20162017,1,60,4,1,3,3.99152598845504,3.437467344693,0.554058643762032,25,23,2,34,31,3,40,46,-6,4,4,0,0
"2543","BOS","NYR",2016020936,17227,20162017,1,60,1,2,-1,6.25568702679892,2.72188847997859,3.53379854682033,33,21,12,49,33,16,63,44,19,2,4,0,0
"2544","BOS","N.J",2016020952,17229,20162017,1,60,3,2,1,6.19548263230691,2.71860392880916,3.47687870349775,40,17,23,58,27,31,68,31,37,5,1,0,0
"2545","BOS","DET",2016020982,17233,20162017,1,60,6,1,5,4.5075327874365,2.76286837391879,1.74466441351771,29,27,2,47,39,8,57,50,7,4,5,0,0
"2546","BOS","PHI",2016021000,17236,20162017,1,60,2,1,1,5.14108928712085,3.29349867520796,1.84759061191289,27,27,0,40,41,-1,56,54,2,3,2,0,0
"2547","BOS","VAN",2016021021,17238,20162017,0,60,6,3,3,7.1600953302368,2.92724080996413,4.23285452027267,43,29,14,55,35,20,67,40,27,2,2,0,0
"2548","BOS","EDM",2016021044,17241,20162017,0,60,4,7,-3,4.88374743438908,5.43285862891935,-0.549111194530269,36,36,0,47,49,-2,68,66,2,5,7,0,0
"2549","BOS","TOR",2016021070,17245,20162017,0,60,2,4,-2,5.54665796835616,6.81969063566066,-1.27303266730451,34,30,4,52,50,2,65,63,2,3,5,0,0
"2550","BOS","T.B",2016021089,17248,20162017,1,60,3,6,-3,2.92275012737923,4.1608899241,-1.23813979672077,31,29,2,34,35,-1,47,47,0,6,7,0,0
"2551","BOS","NYI",2016021111,17250,20162017,0,60,2,1,1,2.43149228539551,1.43697415062343,0.994518134772079,18,19,-1,28,29,-1,45,42,3,3,6,0,0
"2552","BOS","DAL",2016021141,17255,20162017,1,60,2,0,2,3.44321034233144,4.74364889375283,-1.30043855142139,24,27,-3,31,41,-10,51,58,-7,3,2,0,0
"2553","BOS","CHI",2016021165,17258,20162017,0,60,3,2,1,2.99440077040211,6.9447137019597,-3.95031293155759,29,43,-14,40,52,-12,54,71,-17,1,3,0,0
"2554","BOS","T.B",2016021179,17260,20162017,1,60,4,0,4,5.28607019430274,2.32816608791472,2.95790410638801,38,28,10,51,36,15,64,49,15,2,1,0,0
"2555","BOS","COL",2017020032,17448,20172018,1,60,0,4,-4,3.8997405162736,3.79581689139923,0.103923624874369,29,23,6,45,33,12,59,44,15,4,1,0,0
"2556","BOS","COL",2017020048,17450,20172018,0,60,3,6,-3,6.00105326782119,5.36588946177562,0.635163806045576,23,37,-14,35,48,-13,52,63,-11,4,5,0,0
"2557","BOS","ARI",2017020072,17453,20172018,0,60,6,2,4,3.01932978945479,4.74147499810027,-1.72214520864548,29,31,-2,42,56,-14,59,69,-10,3,3,0,0
"2558","BOS","VGK",2017020077,17454,20172018,0,60,1,3,-2,3.52856662434442,4.36476045128678,-0.83619382694236,22,26,-4,34,41,-7,44,54,-10,3,5,0,0
"2559","BOS","VAN",2017020095,17458,20172018,1,60,6,3,3,5.02541773847406,4.82229777381872,0.203119964655343,35,29,6,53,41,12,64,56,8,4,6,0,0
"2560","BOS","S.J",2017020138,17465,20172018,1,60,2,1,1,2.64425969763818,3.40201925463771,-0.757759556999531,33,37,-4,42,55,-13,56,71,-15,2,6,0,0
"2561","BOS","L.A",2017020156,17467,20172018,1,64.9833333333333,1,2,-1,3.0974945964922,2.92184485734154,0.175649739150654,30,30,0,48,43,5,58,63,-5,3,3,0,0
"2562","BOS","CBJ",2017020172,17469,20172018,0,65,3,3,0,3.91499688611475,3.45855750204646,0.45643938406829,30,32,-2,44,40,4,63,57,6,3,6,0,0
"2563","BOS","VGK",2017020186,17472,20172018,1,60,2,1,1,3.92043007276483,3.16410297351734,0.756327099247487,28,29,-1,41,38,3,61,51,10,1,3,0,0
"2564","BOS","MIN",2017020217,17476,20172018,1,60,5,3,2,4.16874702004134,2.39120966497317,1.77753735506817,34,27,7,47,37,10,59,43,16,4,2,0,0
"2565","BOS","NYR",2017020233,17478,20172018,0,60,2,4,-2,5.867400399904,3.93583512193784,1.93156527796616,33,33,0,47,43,4,68,56,12,4,1,0,0
"2566","BOS","TOR",2017020243,17480,20172018,0,61.1166666666667,2,3,-1,3.66258908590437,6.55080780710614,-2.88821872120177,35,33,2,45,49,-4,60,66,-6,4,5,0,0
"2567","BOS","TOR",2017020250,17481,20172018,1,60,1,4,-3,2.81559820963594,4.26699462748277,-1.45139641784683,39,25,14,50,32,18,61,48,13,5,4,0,0
"2568","BOS","ANA",2017020277,17485,20172018,0,60,2,4,-2,5.61548165942077,4.83536451851251,0.78011714090826,42,27,15,59,38,21,71,49,22,2,0,0,0
"2569","BOS","L.A",2017020288,17486,20172018,0,60,2,1,1,3.59750241143,3.63452814319498,-0.0370257317649809,30,28,2,39,43,-4,55,57,-2,5,6,0,0
"2570","BOS","S.J",2017020304,17488,20172018,0,60,3,1,2,4.15313724550651,6.06451023666159,-1.91137299115508,20,37,-17,35,56,-21,47,86,-39,3,5,0,0
"2571","BOS","N.J",2017020322,17492,20172018,0,65,2,2,0,3.18915990024107,6.52569752797399,-3.33653762773292,29,42,-13,40,54,-14,55,68,-13,5,4,0,0
"2572","BOS","PIT",2017020334,17494,20172018,1,60,4,3,1,3.24964695629376,3.95377731816717,-0.70413036187341,33,20,13,43,33,10,54,51,3,2,1,0,0
"2573","BOS","EDM",2017020361,17496,20172018,1,60,2,4,-2,2.68911112868227,3.81256580591435,-1.12345467723208,25,36,-11,33,45,-12,44,50,-6,2,2,0,0
"2574","BOS","T.B",2017020377,17499,20172018,1,60,3,2,1,4.33042528113583,2.43012949181139,1.90029578932445,36,21,15,53,34,19,64,49,15,5,5,0,0
"2575","BOS","PHI",2017020396,17502,20172018,0,60,3,0,3,2.66638969722499,3.47406945400871,-0.807679756783727,27,28,-1,39,36,3,52,57,-5,2,6,0,0
"2576","BOS","ARI",2017020430,17507,20172018,1,60,6,1,5,5.84472255827859,4.85687483188653,0.987847726392065,32,21,11,51,34,17,57,45,12,4,0,0,0
"2577","BOS","NYI",2017020444,17509,20172018,1,60,3,1,2,3.58540836119138,4.59898535703542,-1.01357699584404,33,31,2,44,40,4,54,61,-7,4,2,0,0
"2578","BOS","DET",2017020477,17513,20172018,0,60.5833333333333,3,2,1,6.67104027594905,4.20416891453564,2.46687136141342,32,33,-1,40,39,1,60,47,13,3,3,0,0
"2579","BOS","NYR",2017020497,17516,20172018,1,61.9333333333333,2,3,-1,4.95083770028123,2.10634479147953,2.84449290880169,35,28,7,55,40,15,71,46,25,7,5,0,0
"2580","BOS","CBJ",2017020511,17518,20172018,1,60,7,2,5,4.07077926424114,2.77699114626358,1.29378811797756,45,18,27,58,28,30,77,42,35,7,7,0,0
"2581","BOS","WPG",2017020529,17521,20172018,1,65,1,1,0,4.04784527966694,4.49295810962212,-0.445112829955178,33,38,-5,46,48,-2,66,61,5,3,3,0,0
"2582","BOS","DET",2017020543,17523,20172018,1,60,3,1,2,4.46692563926217,2.7883049644297,1.67862067483247,26,31,-5,36,42,-6,52,54,-2,2,2,0,0
"2583","BOS","NYI",2017020603,17533,20172018,0,60,5,1,4,4.60857176303216,4.124965618852,0.483606144180158,38,26,12,48,40,8,66,58,8,4,5,0,0
"2584","BOS","CAR",2017020636,17537,20172018,1,60,7,1,6,2.37190712797928,3.6826247218778,-1.31071759389852,30,28,2,37,38,-1,51,52,-1,2,3,0,0
"2585","BOS","PIT",2017020650,17538,20172018,0,62.85,5,6,-1,3.9128926503472,3.87211824320548,0.0407744071417255,25,35,-10,35,46,-11,53,61,-8,3,3,0,0
"2586","BOS","MTL",2017020672,17544,20172018,0,65,3,3,0,2.89882468117526,5.06047549497453,-2.16165081379927,32,30,2,36,46,-10,50,61,-11,2,5,0,0
"2587","BOS","DAL",2017020683,17546,20172018,1,62.9833333333333,2,3,-1,4.70225514925551,1.88204735146081,2.82020779779469,32,32,0,42,39,3,55,48,7,4,2,0,0
"2588","BOS","MTL",2017020693,17548,20172018,1,60,4,1,3,5.50690838446747,4.69177885481622,0.815129529651244,32,22,10,42,29,13,63,39,24,3,2,0,0
"2589","BOS","NYI",2017020696,17549,20172018,0,60,5,2,3,6.08384130617992,1.57265295810066,4.51118834807926,34,24,10,47,29,18,58,44,14,1,2,0,0
"2590","BOS","MTL",2017020712,17551,20172018,0,60,4,1,3,5.04353584803175,3.40812155535241,1.63541429267934,31,25,6,39,32,7,61,45,16,3,1,0,0
"2591","BOS","N.J",2017020732,17554,20172018,1,60,3,2,1,3.69445016770978,4.99027894871244,-1.29582878100266,24,39,-15,32,46,-14,41,57,-16,4,4,0,0
"2592","BOS","ANA",2017020761,17561,20172018,1,60,1,3,-2,3.2160736402584,3.16385919291928,0.052214447339118,31,27,4,42,34,8,58,43,15,5,3,0,0
"2593","BOS","TOR",2017020794,17565,20172018,1,60,4,1,3,3.73860110031628,2.65807380399943,1.08052729631686,30,24,6,46,38,8,61,47,14,3,4,0,0
"2594","BOS","DET",2017020817,17568,20172018,0,60,3,2,1,3.01273180686235,4.92567631543086,-1.91294450856851,31,28,3,40,37,3,55,50,5,3,3,0,0
"2595","BOS","NYR",2017020824,17569,20172018,0,60,6,1,5,7.92021757053044,3.09168625750681,4.82853131302363,34,22,12,48,30,18,59,44,15,2,2,0,0
"2596","BOS","N.J",2017020857,17573,20172018,0,60,5,3,2,5.3933445208417,4.36359038205644,1.02975413878526,27,38,-11,36,50,-14,44,66,-22,4,9,0,0
"2597","BOS","VAN",2017020904,17579,20172018,0,60,1,6,-5,4.11891032081621,1.84006640014573,2.27884392067049,45,24,21,59,30,29,77,32,45,5,0,0,0
"2598","BOS","EDM",2017020925,17582,20172018,0,60,3,2,1,9.57520989933982,3.27582132391399,6.29938857542584,45,20,25,58,32,26,74,42,32,4,2,0,0
"2599","BOS","TOR",2017020948,17586,20172018,0,60,3,4,-1,3.42201347943046,4.00970229115993,-0.587688811729464,23,36,-13,37,51,-14,48,73,-25,2,3,0,0
"2600","BOS","CAR",2017020969,17589,20172018,1,61.1333333333333,4,3,1,3.35664124089408,3.96905006777223,-0.612408826878152,32,32,0,48,47,1,56,57,-1,2,2,0,0
"2601","BOS","PIT",2017020983,17591,20172018,1,60,8,4,4,6.94492500214255,3.59665308290982,3.34827191923273,38,26,12,49,35,14,74,40,34,7,6,0,0
"2602","BOS","MTL",2017021003,17593,20172018,1,62.1,2,1,1,6.20381923381905,3.35984177531921,2.84397745849983,50,28,22,70,39,31,88,45,43,6,4,0,0
"2603","BOS","DET",2017021020,17596,20172018,1,60.5666666666667,6,5,1,4.52050603143875,3.18497140501972,1.33553462641903,37,35,2,49,47,2,61,62,-1,5,6,0,0
"2604","BOS","PHI",2017021032,17598,20172018,1,60,3,2,1,2.8235127814547,3.6798666677141,-0.856353886259408,27,33,-6,43,46,-3,51,61,-10,3,4,0,0
"2605","BOS","CHI",2017021048,17600,20172018,1,60,7,4,3,6.26053375500405,5.77275472653307,0.487779028470971,40,27,13,59,35,24,72,45,27,5,2,0,0
"2606","BOS","CHI",2017021059,17601,20172018,0,60,1,3,-2,4.99343348055845,5.579604176266,-0.586170695707551,32,39,-7,44,46,-2,61,64,-3,1,4,0,0
"2607","BOS","CAR",2017021071,17603,20172018,0,60,6,4,2,5.04246174888976,6.74143782112515,-1.69897607223538,34,33,1,39,51,-12,52,69,-17,4,5,0,0
"2608","BOS","T.B",2017021102,17607,20172018,0,60,3,0,3,3.46313727011899,4.18043825172936,-0.717300981610364,27,23,4,37,46,-9,46,62,-16,4,4,0,0
"2609","BOS","CBJ",2017021116,17609,20172018,1,62.9166666666667,4,5,-1,5.85133774625137,2.38460519307353,3.46673255317785,38,25,13,55,30,25,68,41,27,4,2,0,0
"2610","BOS","DAL",2017021150,17613,20172018,0,60,3,2,1,4.82783564834995,3.26240523813267,1.56543041021728,36,42,-6,49,48,1,74,67,7,3,4,0,0
"2611","BOS","MIN",2017021166,17615,20172018,0,60.4666666666667,2,1,1,3.35067530971719,5.06159252616635,-1.71091721644916,28,25,3,42,39,3,55,46,9,2,2,0,0
"2612","BOS","WPG",2017021182,17617,20172018,0,65,4,4,0,8.22168662631884,4.32292351187539,3.89876311444345,32,32,0,47,39,8,64,50,14,3,1,0,0
"2613","BOS","T.B",2017021190,17619,20172018,1,60,4,2,2,5.51208643824793,5.57112738684373,-0.0590409485957935,30,28,2,43,44,-1,56,61,-5,8,9,0,0
"2614","BOS","PHI",2017021218,17622,20172018,0,63.65,3,4,-1,6.60778833355289,3.30940602913161,3.29838230442128,39,24,15,54,33,21,70,53,17,3,2,0,0
"2615","BOS","T.B",2017021233,17624,20172018,0,60,0,4,-4,3.85679014190586,4.88247646007221,-1.02568631816635,33,36,-3,48,45,3,60,51,9,2,4,0,0
"2616","BOS","T.B",2017030211,17649,20172018,0,60,6,2,4,4.11140041204635,5.04927433752164,-0.937873925475287,24,36,-12,31,57,-26,37,78,-41,1,3,0,0
"2617","BOS","T.B",2017030212,17651,20172018,0,60,2,4,-2,2.83481100541873,5.10118113440694,-2.26637012898821,20,31,-11,30,41,-11,38,54,-16,6,7,0,0
"2618","BOS","T.B",2017030213,17653,20172018,1,60,1,4,-3,3.9662158057934,4.33124763169326,-0.365031825899864,29,37,-8,46,47,-1,65,59,6,2,6,0,0
"2619","BOS","T.B",2017030214,17655,20172018,1,63.3,3,4,-1,5.29835425858096,5.55531960528509,-0.256965346704133,32,28,4,44,43,1,68,62,6,4,4,0,0
"2620","BOS","T.B",2017030215,17657,20172018,0,60,1,3,-2,3.54670413002386,6.62892031192314,-3.08221618189928,28,22,6,36,37,-1,53,49,4,4,4,0,0
"2621","BOS","EDM",2018020045,17815,20182019,1,60,4,1,3,4.95837342424784,4.39014584289158,0.568227581356254,32,26,6,44,32,12,52,43,9,5,3,0,0
"2622","BOS","DET",2018020061,17817,20182019,1,60,8,2,6,4.11232299230684,2.94758286087708,1.16474013142976,39,34,5,51,41,10,63,50,13,7,7,0,0
"2623","BOS","EDM",2018020096,17822,20182019,0,60.6166666666667,2,3,-1,3.92931910176412,2.51494976664952,1.4143693351146,29,22,7,41,37,4,58,51,7,5,4,0,0
"2624","BOS","VAN",2018020112,17824,20182019,0,63.2,1,2,-1,4.01968814869178,5.20134561442879,-1.181657465737,31,22,9,50,36,14,64,45,19,3,1,0,0
"2625","BOS","PHI",2018020134,17829,20182019,1,60,3,0,3,3.40445392019592,4.27760470673698,-0.873150786541061,25,26,-1,34,38,-4,48,51,-3,8,6,0,0
"2626","BOS","MTL",2018020152,17831,20182019,1,60,0,3,-3,4.94410165734007,4.71460279838357,0.229498858956504,33,23,10,44,35,9,56,43,13,4,4,0,0
"2627","BOS","CAR",2018020169,17834,20182019,0,60,3,2,1,5.44820655859525,6.66314006580446,-1.21493350720921,31,44,-13,46,64,-18,63,76,-13,5,4,0,0
"2628","BOS","DAL",2018020210,17840,20182019,1,64.4833333333333,2,1,1,8.82749775357661,5.82718973405281,3.0003080195238,35,25,10,60,34,26,73,38,35,3,1,0,0
"2629","BOS","VAN",2018020227,17843,20182019,1,60,5,8,-3,4.9514627911513,2.52270130144379,2.42876148970751,28,33,-5,48,46,2,57,58,-1,6,6,0,0
"2630","BOS","TOR",2018020245,17845,20182019,1,60,5,1,4,4.19267820561365,4.00509449762474,0.187583707988906,34,41,-7,45,52,-7,57,64,-7,3,3,0,0
"2631","BOS","VGK",2018020256,17846,20182019,1,60,4,1,3,5.09530265891374,2.41577260686471,2.67953005204902,37,38,-1,51,48,3,59,55,4,7,4,0,0
"2632","BOS","COL",2018020275,17849,20182019,0,60,3,6,-3,4.33676972684043,4.7912799687528,-0.454510241912374,23,25,-2,36,34,2,54,54,0,4,4,0,0
"2633","BOS","DAL",2018020286,17851,20182019,0,61.5666666666667,0,1,-1,4.28535591585432,3.44464486830884,0.840711047545483,23,37,-14,33,53,-20,45,69,-24,7,9,0,0
"2634","BOS","ARI",2018020300,17852,20182019,0,60,2,1,1,5.71523438917939,6.4147930850645,-0.699558695885116,23,33,-10,31,44,-13,43,59,-16,2,4,0,0
"2635","BOS","DET",2018020324,17856,20182019,0,60.8166666666667,2,3,-1,7.75600272079464,3.19555298710071,4.56044973369393,36,27,9,45,37,8,56,43,13,1,0,0,0
"2636","BOS","PIT",2018020340,17858,20182019,1,61.95,2,1,1,5.21393833120237,5.53735860265442,-0.323420271452051,37,37,0,46,51,-5,60,67,-7,0,2,0,0
"2637","BOS","MTL",2018020349,17859,20182019,0,60,3,2,1,4.33721807976082,3.0513285994889,1.28588948027191,35,33,2,48,50,-2,65,78,-13,7,7,0,0
"2638","BOS","TOR",2018020362,17861,20182019,0,60,2,4,-2,7.03487307554878,5.02769907569746,2.00717399985133,40,31,9,67,47,20,89,64,25,2,1,0,0
"2639","BOS","NYI",2018020382,17864,20182019,1,65,1,1,0,5.33657187822973,4.62390536547173,0.712666512758005,36,29,7,54,36,18,70,52,18,1,1,0,0
"2640","BOS","DET",2018020397,17866,20182019,1,60,2,4,-2,5.83143158198982,3.60966760428946,2.22176397770036,40,27,13,51,39,12,67,48,19,7,5,0,0
"2641","BOS","T.B",2018020434,17871,20182019,0,60,2,3,-1,3.59923019558119,3.05503896347727,0.544191232103913,35,30,5,46,38,8,62,54,8,2,1,0,0
"2642","BOS","TOR",2018020446,17873,20182019,1,60,6,3,3,3.97842927966121,6.97196089536749,-2.99353161570627,32,32,0,40,49,-9,48,62,-14,5,4,0,0
"2643","BOS","ARI",2018020465,17876,20182019,1,60,4,3,1,6.11974417454621,5.82338865753263,0.296355517013581,26,33,-7,40,49,-9,49,64,-15,2,2,0,0
"2644","BOS","PIT",2018020489,17879,20182019,0,60,3,5,-2,5.85350183025002,5.06135060836095,0.792151221889071,51,28,23,66,30,36,81,37,44,2,1,0,0
"2645","BOS","MTL",2018020514,17882,20182019,0,60,4,0,4,4.04743793784041,2.69375051290262,1.35368742493778,35,22,13,45,34,11,63,51,12,4,4,0,0
"2646","BOS","ANA",2018020530,17885,20182019,1,60,3,1,2,4.21251663397031,3.43126598396339,0.781250650006927,31,25,6,48,35,13,58,45,13,4,4,0,0
"2647","BOS","CAR",2018020560,17888,20182019,0,60,3,5,-2,4.1051911940533,7.54577375343536,-3.44058255938205,30,37,-7,46,52,-6,60,68,-8,5,3,0,0
"2648","BOS","N.J",2018020567,17892,20182019,1,60,2,5,-3,4.03581870889232,5.73222217935216,-1.69640347045985,42,33,9,53,46,7,72,50,22,2,4,0,0
"2649","BOS","CHI",2018020612,17897,20182019,0,60,4,2,2,6.06893830960786,3.73940786669846,2.3295304429094,36,38,-2,44,44,0,57,63,-6,5,4,0,0
"2650","BOS","CGY",2018020622,17899,20182019,1,60,6,4,2,3.42218523605617,4.22678442184497,-0.804599185788799,27,37,-10,32,55,-23,45,71,-26,3,4,0,0
"2651","BOS","MIN",2018020657,17904,20182019,1,60,4,0,4,4.97358667838853,4.31892514209903,0.654661536289495,27,24,3,39,33,6,48,51,-3,2,3,0,0
"2652","BOS","TOR",2018020690,17908,20182019,0,60,3,2,1,2.54002170327294,4.35252412922523,-1.81250242595229,29,32,-3,44,53,-9,55,73,-18,2,2,0,0
"2653","BOS","MTL",2018020705,17910,20182019,1,60.25,2,3,-1,5.32751434430247,2.30169738481345,3.02581695948902,43,22,21,59,36,23,70,50,20,5,2,0,0
"2654","BOS","PHI",2018020722,17912,20182019,0,60,3,4,-1,5.16678934409829,2.25162582600024,2.91516351809805,42,19,23,54,26,28,84,34,50,3,3,0,0
"2655","BOS","NYR",2018020742,17915,20182019,1,60,2,3,-1,2.47519519313937,3.23463967928958,-0.759444486150205,29,20,9,44,25,19,56,28,28,5,4,0,0
"2656","BOS","WPG",2018020773,17925,20182019,1,65,3,3,0,5.5649811979456,1.69757864649549,3.86740255145011,39,27,12,55,32,23,76,48,28,3,2,0,0
"2657","BOS","PHI",2018020778,17927,20182019,1,62.9333333333333,2,3,-1,6.17080829452553,4.34761061280005,1.82319768172547,25,41,-16,38,47,-9,56,67,-11,1,3,0,0
"2658","BOS","NYI",2018020809,17932,20182019,1,60,3,1,2,4.23196828911202,4.02106341591571,0.210904873196313,27,29,-2,37,35,2,52,52,0,3,5,0,0
"2659","BOS","NYR",2018020822,17933,20182019,0,65,3,3,0,4.05395192496735,4.46975342139803,-0.415801496430678,30,39,-9,43,49,-6,55,59,-4,4,6,0,0
"2660","BOS","L.A",2018020838,17936,20182019,1,62.5666666666667,5,4,1,3.25922449599238,3.24859213658194,0.0106323594104456,33,29,4,44,39,5,58,58,0,3,5,0,0
"2661","BOS","COL",2018020853,17937,20182019,1,64.05,2,1,1,5.19747951168169,3.67455642649116,1.52292308519053,35,36,-1,50,45,5,62,63,-1,5,4,0,0
"2662","BOS","CHI",2018020863,17939,20182019,1,60,6,3,3,4.40213950253383,3.46182050800962,0.940318994524205,37,26,11,54,33,21,66,44,22,6,4,0,0
"2663","BOS","ANA",2018020891,17942,20182019,0,60,3,0,3,4.05840309877021,3.80485299455904,0.253550104211172,29,30,-1,41,45,-4,57,58,-1,4,3,0,0
"2664","BOS","L.A",2018020903,17943,20182019,0,60,4,2,2,4.03477236476845,3.75542902506389,0.27934333970456,24,25,-1,37,32,5,46,49,-3,2,5,0,0
"2665","BOS","S.J",2018020915,17945,20182019,0,63.9833333333333,6,5,1,3.12735284425435,5.16908576136469,-2.04173291711034,20,38,-18,31,55,-24,39,66,-27,5,4,0,0
"2666","BOS","VGK",2018020928,17947,20182019,0,65,2,2,0,5.45491054576269,6.59446057619149,-1.13955003042881,27,33,-6,35,56,-21,53,76,-23,3,2,0,0
"2667","BOS","S.J",2018020968,17953,20182019,1,60,4,1,3,2.53058968714513,2.86445110505792,-0.333861417912796,32,20,12,44,30,14,51,46,5,5,5,0,0
"2668","BOS","T.B",2018020984,17955,20182019,1,60,4,1,3,4.21548862362397,3.98446344619473,0.231025177429235,41,21,20,50,38,12,66,50,16,3,3,0,0
"2669","BOS","N.J",2018021001,17957,20182019,1,60,1,0,1,3.21604700946409,2.63968665210996,0.576360357354133,30,20,10,40,29,11,54,41,13,2,2,0,0
"2670","BOS","CAR",2018021019,17960,20182019,1,61.7666666666667,4,3,1,5.62714145949995,3.14016551629175,2.4869759432082,38,37,1,49,46,3,58,60,-2,2,5,0,0
"2671","BOS","PIT",2018021062,17965,20182019,0,60,2,4,-2,4.96806970976479,5.25077921905904,-0.28270950929425,41,37,4,49,47,2,65,63,2,5,5,0,0
"2672","BOS","CBJ",2018021074,17967,20182019,0,60,4,7,-3,2.65035470666228,4.33422036409195,-1.68386565742966,31,35,-4,43,44,-1,56,52,4,3,4,0,0
"2673","BOS","WPG",2018021089,17969,20182019,0,60,3,4,-1,4.66674637746473,3.67401401418309,0.992732363281647,39,24,15,46,34,12,65,42,23,1,2,0,0
"2674","BOS","CBJ",2018021102,17971,20182019,1,63.5,2,1,1,5.73506831686973,3.74065316000997,1.99441515685976,33,25,8,45,39,6,65,46,19,2,1,0,0
"2675","BOS","NYI",2018021123,17974,20182019,0,60,5,0,5,5.80377139903339,2.52497715246864,3.27879424656476,39,13,26,48,22,26,68,31,37,1,2,0,0
"2676","BOS","N.J",2018021137,17976,20182019,0,60,5,1,4,5.17963977967156,2.88937193672957,2.29026784294199,27,22,5,43,29,14,58,36,22,3,1,0,0
"2677","BOS","T.B",2018021172,17980,20182019,0,60,4,5,-1,1.8249445541951,3.55453604419289,-1.72959148999779,17,28,-11,29,42,-13,40,52,-12,3,5,0,0
"2678","BOS","NYR",2018021186,17982,20182019,1,60,6,3,3,7.43493380859582,3.3503701784648,4.08456363013102,32,23,9,43,30,13,52,39,13,8,6,0,0
"2679","BOS","DET",2018021219,17986,20182019,0,60,3,6,-3,4.27574649252934,6.03480140925725,-1.75905491672791,34,28,6,48,35,13,62,51,11,4,5,0,0
"2680","BOS","CBJ",2018021230,17988,20182019,0,60,6,2,4,4.89334725070512,5.1537960297137,-0.260448779008584,28,34,-6,36,48,-12,41,65,-24,1,3,0,0
"2681","BOS","MIN",2018021250,17990,20182019,0,60,3,0,3,4.47230468035923,2.84705136455861,1.62525331580062,35,26,9,52,38,14,67,52,15,3,2,0,0
"2682","BOS","T.B",2018021257,17992,20182019,1,60,3,6,-3,4.14429402163172,3.17848562590696,0.965808395724761,33,22,11,49,24,25,57,33,24,3,3,0,0
"2683","BOS","CBJ",2018030211,18011,20182019,1,65.25,3,2,1,6.57152246597832,4.25030914641684,2.32121331956148,37,22,15,56,31,25,75,38,37,4,4,0,0
"2684","BOS","CBJ",2018030212,18013,20182019,1,80,2,2,0,7.44682473921082,5.17034253924876,2.27648219996207,31,36,-5,48,49,-1,69,65,4,3,3,0,0
"2685","BOS","CBJ",2018030213,18016,20182019,0,60,1,2,-1,3.63838475655302,5.23453388062087,-1.59614912406784,37,34,3,50,44,6,72,61,11,2,3,0,0
"2686","BOS","CBJ",2018030214,18018,20182019,0,60,4,1,3,5.69714843365364,5.04473645681646,0.652411976837175,46,40,6,54,52,2,69,65,4,6,5,0,0
"2687","BOS","CBJ",2018030215,18020,20182019,1,60,4,3,1,8.36068056587828,5.73741059529129,2.62326997058699,36,36,0,49,45,4,67,60,7,2,2,0,0
"2688","BOS","CBJ",2018030216,18022,20182019,0,60,3,0,3,2.25224665363479,4.08142852066973,-1.82918186703494,29,39,-10,39,55,-16,50,70,-20,1,4,0,0
"2689","BOS","CAR",2018030311,18025,20182019,1,60,5,2,3,4.92556510458235,2.53695415921506,2.38861094536729,28,31,-3,38,42,-4,48,53,-5,5,3,0,0
"2690","BOS","CAR",2018030312,18028,20182019,1,60,6,2,4,4.0861225446497,3.20999250776139,0.876130036888306,25,23,2,31,31,0,38,41,-3,2,4,0,0
"2691","BOS","CAR",2018030313,18030,20182019,0,60,2,1,1,4.54465541484538,4.64714517196337,-0.102489757117992,31,36,-5,42,54,-12,55,70,-15,7,7,0,0
"2692","BOS","CAR",2018030314,18032,20182019,0,60,4,0,4,5.15333502408711,5.06195599923376,0.0913790248533468,23,24,-1,37,39,-2,53,62,-9,3,2,0,0
"2693","BUF","MTL",2008020012,14162,20082009,1,65,1,1,0,0,0,0,36,28,8,47,46,1,64,59,5,6,5,0,0
"2694","BUF","NYI",2008020033,14165,20082009,0,60,7,1,6,0,0,0,35,24,11,42,35,7,61,48,13,13,7,0,0
"2695","BUF","NYR",2008020044,14167,20082009,0,60,3,1,2,0,0,0,19,20,-1,24,32,-8,33,50,-17,3,4,0,0
"2696","BUF","VAN",2008020059,14169,20082009,1,60,5,2,3,0,0,0,31,25,6,39,36,3,55,50,5,6,4,0,0
"2697","BUF","ATL",2008020068,14170,20082009,0,65,2,2,0,0,0,0,30,37,-7,41,55,-14,55,72,-17,6,7,0,0
"2698","BUF","BOS",2008020082,14173,20082009,1,65,2,2,0,0,0,0,30,32,-2,37,42,-5,51,54,-3,4,6,0,0
"2699","BUF","MIN",2008020096,14175,20082009,0,60.7333333333333,4,3,1,0,0,0,24,33,-9,33,39,-6,41,50,-9,2,3,0,0
"2700","BUF","COL",2008020117,14177,20082009,0,65,1,1,0,0,0,0,30,29,1,46,48,-2,62,61,1,3,3,0,0
"2701","BUF","OTT",2008020120,14179,20082009,1,60,2,5,-3,0,0,0,27,28,-1,34,35,-1,59,49,10,11,7,0,0
"2702","BUF","T.B",2008020136,14182,20082009,1,60,2,5,-3,0,0,0,31,40,-9,40,50,-10,46,59,-13,6,4,0,0
"2703","BUF","WSH",2008020152,14184,20082009,1,60,5,0,5,0,0,0,27,29,-2,38,39,-1,45,56,-11,8,5,0,0
"2704","BUF","N.J",2008020168,14186,20082009,0,60,2,0,2,0,0,0,30,24,6,42,41,1,61,54,7,6,8,0,0
"2705","BUF","ATL",2008020194,14190,20082009,1,60.8,4,5,-1,0,0,0,32,26,6,46,33,13,56,42,14,4,4,0,0
"2706","BUF","BOS",2008020196,14191,20082009,0,60,1,3,-2,0,0,0,33,40,-7,43,48,-5,50,59,-9,2,3,0,0
"2707","BUF","STL",2008020221,14195,20082009,1,60,4,3,1,0,0,0,32,33,-1,48,46,2,57,57,0,4,2,0,0
"2708","BUF","CBJ",2008020237,14197,20082009,1,60,1,6,-5,0,0,0,37,25,12,43,31,12,57,39,18,8,3,0,0
"2709","BUF","PIT",2008020247,14198,20082009,0,60,2,5,-3,0,0,0,23,25,-2,31,36,-5,46,61,-15,5,6,0,0
"2710","BUF","BOS",2008020268,14202,20082009,0,60,4,7,-3,0,0,0,29,23,6,39,38,1,44,51,-7,5,8,0,0
"2711","BUF","PHI",2008020282,14204,20082009,1,60,0,3,-3,0,0,0,40,25,15,53,36,17,61,48,13,6,4,0,0
"2712","BUF","NYI",2008020287,14205,20082009,1,60,2,4,-2,0,0,0,37,26,11,46,33,13,64,40,24,2,6,0,0
"2713","BUF","BOS",2008020309,14209,20082009,1,60,3,2,1,0,0,0,23,29,-6,37,43,-6,45,56,-11,2,2,0,0
"2714","BUF","PIT",2008020329,14211,20082009,1,60,4,3,1,0,0,0,32,30,2,46,42,4,62,56,6,5,8,0,0
"2715","BUF","MTL",2008020338,14212,20082009,0,60,2,3,-1,0,0,0,28,34,-6,36,52,-16,48,76,-28,6,6,0,0
"2716","BUF","NSH",2008020350,14214,20082009,1,60,0,2,-2,0,0,0,30,27,3,36,36,0,53,47,6,2,2,0,0
"2717","BUF","FLA",2008020371,14217,20082009,0,60,1,2,-1,0,0,0,46,25,21,58,41,17,75,55,20,4,2,0,0
"2718","BUF","T.B",2008020387,14219,20082009,0,60,4,3,1,0,0,0,27,23,4,35,35,0,52,46,6,7,7,0,0
"2719","BUF","PIT",2008020400,14221,20082009,0,60,4,3,1,0,0,0,29,32,-3,41,44,-3,60,54,6,4,9,0,0
"2720","BUF","T.B",2008020405,14223,20082009,1,60,4,2,2,0,0,0,37,28,9,44,38,6,61,43,18,7,5,0,0
"2721","BUF","TOR",2008020424,14225,20082009,1,60,1,2,-1,0,0,0,25,33,-8,39,40,-1,53,47,6,4,4,0,0
"2722","BUF","N.J",2008020434,14226,20082009,0,60,4,2,2,0,0,0,34,22,12,40,32,8,46,41,5,3,1,0,0
"2723","BUF","N.J",2008020455,14230,20082009,1,60,3,5,-2,0,0,0,26,30,-4,41,36,5,52,46,6,5,5,0,0
"2724","BUF","L.A",2008020470,14232,20082009,1,60,5,0,5,0,0,0,23,40,-17,30,53,-23,39,67,-28,5,2,0,0
"2725","BUF","MTL",2008020476,14233,20082009,0,64.5833333333333,3,4,-1,0,0,0,34,46,-12,52,60,-8,72,84,-12,4,8,0,0
"2726","BUF","PIT",2008020490,14235,20082009,1,60.7166666666667,3,4,-1,0,0,0,35,22,13,44,35,9,58,46,12,6,1,0,0
"2727","BUF","WSH",2008020509,14239,20082009,0,60,2,3,-1,0,0,0,24,34,-10,31,44,-13,48,61,-13,3,4,0,0
"2728","BUF","NYI",2008020516,14240,20082009,1,65,3,3,0,0,0,0,37,35,2,45,46,-1,57,61,-4,6,4,0,0
"2729","BUF","WSH",2008020539,14243,20082009,1,60,2,4,-2,0,0,0,33,31,2,46,42,4,59,50,9,5,4,0,0
"2730","BUF","TOR",2008020556,14245,20082009,0,60,4,1,3,0,0,0,20,28,-8,34,43,-9,43,61,-18,4,5,0,0
"2731","BUF","BOS",2008020565,14247,20082009,0,60,4,2,2,0,0,0,25,31,-6,31,42,-11,34,53,-19,4,6,0,0
"2732","BUF","OTT",2008020586,14250,20082009,1,60,4,2,2,0,0,0,26,33,-7,33,47,-14,38,58,-20,6,6,0,0
"2733","BUF","NYR",2008020610,14253,20082009,1,65,1,1,0,0,0,0,33,44,-11,42,55,-13,55,71,-16,0,2,0,0
"2734","BUF","DET",2008020620,14254,20082009,0,60,1,3,-2,0,0,0,22,48,-26,30,64,-34,37,74,-37,1,3,0,0
"2735","BUF","CHI",2008020644,14258,20082009,0,60,1,4,-3,0,0,0,23,25,-2,27,32,-5,38,37,1,9,6,0,0
"2736","BUF","DAL",2008020652,14259,20082009,0,65,4,4,0,0,0,0,35,25,10,47,38,9,66,45,21,4,3,0,0
"2737","BUF","CAR",2008020663,14261,20082009,1,60,3,1,2,0,0,0,26,37,-11,34,49,-15,43,71,-28,2,5,0,0
"2738","BUF","FLA",2008020681,14263,20082009,0,65,2,2,0,0,0,0,24,29,-5,34,42,-8,41,51,-10,6,5,0,0
"2739","BUF","T.B",2008020696,14265,20082009,0,60,3,5,-2,0,0,0,34,26,8,44,39,5,52,47,5,6,5,0,0
"2740","BUF","EDM",2008020710,14271,20082009,0,60,10,2,8,0,0,0,37,38,-1,44,56,-12,51,77,-26,6,8,0,0
"2741","BUF","CGY",2008020713,14272,20082009,0,60,2,5,-3,0,0,0,27,43,-16,38,61,-23,50,68,-18,5,5,0,0
"2742","BUF","ARI",2008020739,14275,20082009,0,60,2,0,2,0,0,0,21,28,-7,30,45,-15,42,63,-21,6,9,0,0
"2743","BUF","ANA",2008020747,14277,20082009,0,60,2,3,-1,0,0,0,23,37,-14,30,51,-21,36,58,-22,3,4,0,0
"2744","BUF","TOR",2008020760,14279,20082009,1,60,5,0,5,0,0,0,32,16,16,41,23,18,53,37,16,11,5,0,0
"2745","BUF","MTL",2008020772,14281,20082009,1,60,3,2,1,0,0,0,22,37,-15,32,45,-13,46,60,-14,5,4,0,0
"2746","BUF","OTT",2008020781,14282,20082009,0,65,2,2,0,0,0,0,30,42,-12,40,57,-17,52,75,-23,1,2,0,0
"2747","BUF","OTT",2008020805,14286,20082009,1,60,1,3,-2,0,0,0,32,23,9,42,33,9,58,38,20,13,8,0,0
"2748","BUF","S.J",2008020820,14288,20082009,1,65,5,5,0,0,0,0,35,35,0,43,43,0,52,51,1,7,2,0,0
"2749","BUF","CAR",2008020838,14290,20082009,1,60,0,3,-3,0,0,0,36,47,-11,49,60,-11,64,70,-6,4,5,0,0
"2750","BUF","TOR",2008020848,14292,20082009,0,60,4,1,3,0,0,0,30,28,2,40,37,3,53,51,2,4,2,0,0
"2751","BUF","PHI",2008020860,14294,20082009,0,60,3,6,-3,0,0,0,42,36,6,57,53,4,77,76,1,4,2,0,0
"2752","BUF","NYR",2008020879,14296,20082009,1,60,4,2,2,0,0,0,33,33,0,43,41,2,52,56,-4,4,2,0,0
"2753","BUF","ANA",2008020894,14299,20082009,1,60,2,3,-1,0,0,0,36,22,14,45,27,18,52,40,12,6,5,0,0
"2754","BUF","CAR",2008020913,14301,20082009,0,65,1,1,0,0,0,0,37,32,5,46,51,-5,52,73,-21,1,6,0,0
"2755","BUF","NYI",2008020928,14303,20082009,0,60,0,2,-2,0,0,0,31,34,-3,45,40,5,67,59,8,5,5,0,0
"2756","BUF","MTL",2008020953,14307,20082009,1,60,5,1,4,0,0,0,27,39,-12,43,48,-5,53,62,-9,4,6,0,0
"2757","BUF","ARI",2008020965,14309,20082009,1,60,5,1,4,0,0,0,31,30,1,50,44,6,56,57,-1,7,7,0,0
"2758","BUF","OTT",2008020973,14310,20082009,0,60,3,6,-3,0,0,0,30,36,-6,42,45,-3,53,52,1,5,6,0,0
"2759","BUF","PHI",2008020990,14313,20082009,0,60,2,5,-3,0,0,0,29,33,-4,39,46,-7,54,64,-10,5,8,0,0
"2760","BUF","FLA",2008021004,14315,20082009,1,60,3,1,2,0,0,0,23,31,-8,35,39,-4,45,56,-11,4,4,0,0
"2761","BUF","ATL",2008021022,14317,20082009,1,65,3,3,0,0,0,0,37,32,5,51,46,5,71,54,17,3,6,0,0
"2762","BUF","OTT",2008021042,14320,20082009,0,60,2,4,-2,0,0,0,13,36,-23,22,45,-23,32,56,-24,4,9,0,0
"2763","BUF","PHI",2008021065,14323,20082009,1,60,4,6,-2,0,0,0,43,31,12,60,38,22,77,49,28,10,6,0,0
"2764","BUF","NYR",2008021073,14324,20082009,0,60,3,5,-2,0,0,0,40,31,9,57,42,15,78,56,22,7,5,0,0
"2765","BUF","FLA",2008021096,14328,20082009,1,60,5,3,2,0,0,0,45,33,12,56,46,10,73,62,11,7,4,0,0
"2766","BUF","TOR",2008021111,14330,20082009,1,60,5,3,2,0,0,0,24,36,-12,38,44,-6,47,63,-16,2,5,0,0
"2767","BUF","MTL",2008021118,14331,20082009,0,65,3,3,0,0,0,0,37,35,2,44,49,-5,64,71,-7,5,6,0,0
"2768","BUF","N.J",2008021165,14338,20082009,1,60,2,3,-1,0,0,0,37,28,9,50,32,18,76,41,35,5,3,0,0
"2769","BUF","TOR",2008021197,14342,20082009,0,60,3,1,2,0,0,0,29,33,-4,42,54,-12,54,75,-21,2,6,0,0
"2770","BUF","MTL",2009020011,14520,20092010,1,62.7,1,2,-1,0,0,0,35,17,18,45,29,16,57,41,16,10,9,0,0
"2771","BUF","NYI",2009020088,14533,20092010,1,60,6,3,3,0,0,0,34,39,-5,47,49,-2,57,61,-4,5,2,0,0
"2772","BUF","FLA",2009020114,14538,20092010,0,60,5,2,3,0,0,0,36,43,-7,46,59,-13,55,69,-14,6,9,0,0
"2773","BUF","T.B",2009020137,14541,20092010,0,65,2,2,0,0,0,0,32,26,6,40,38,2,57,46,11,4,3,0,0
"2774","BUF","N.J",2009020155,14545,20092010,0,60,4,1,3,0,0,0,27,32,-5,30,38,-8,38,41,-3,5,6,0,0
"2775","BUF","NYI",2009020185,14548,20092010,0,60,0,5,-5,0,0,0,38,30,8,52,36,16,71,46,25,7,4,0,0
"2776","BUF","NYI",2009020203,14552,20092010,1,60,3,0,3,0,0,0,39,24,15,54,34,20,66,42,24,7,4,0,0
"2777","BUF","PHI",2009020221,14554,20092010,1,60,2,5,-3,0,0,0,30,37,-7,45,46,-1,56,55,1,7,5,0,0
"2778","BUF","EDM",2009020247,14559,20092010,1,60,3,1,2,0,0,0,26,29,-3,39,38,1,58,46,12,5,7,0,0
"2779","BUF","PHI",2009020271,14562,20092010,0,60,3,2,1,0,0,0,25,31,-6,34,52,-18,48,68,-20,9,6,0,0
"2780","BUF","FLA",2009020294,14566,20092010,1,60,2,6,-4,0,0,0,28,24,4,40,35,5,61,46,15,4,3,0,0
"2781","BUF","PHI",2009020356,14575,20092010,0,60,4,2,2,0,0,0,25,33,-8,33,45,-12,41,57,-16,5,5,0,0
"2782","BUF","TOR",2009020382,14578,20092010,0,60,3,0,3,0,0,0,31,38,-7,51,60,-9,64,79,-15,2,4,0,0
"2783","BUF","MTL",2009020398,14581,20092010,1,60,6,2,4,0,0,0,37,23,14,42,38,4,52,52,0,2,1,0,0
"2784","BUF","NYR",2009020417,14583,20092010,1,60,1,2,-1,0,0,0,37,32,5,50,41,9,63,50,13,3,2,0,0
"2785","BUF","N.J",2009020429,14585,20092010,1,60,0,3,-3,0,0,0,22,37,-15,31,46,-15,51,58,-7,5,5,0,0
"2786","BUF","NYR",2009020470,14590,20092010,0,60,3,2,1,0,0,0,32,38,-6,37,48,-11,47,70,-23,4,6,0,0
"2787","BUF","MTL",2009020485,14592,20092010,0,60,4,3,1,0,0,0,27,24,3,43,34,9,73,50,23,7,5,0,0
"2788","BUF","TOR",2009020512,14596,20092010,1,60,5,2,3,0,0,0,27,42,-15,37,52,-15,48,63,-15,2,1,0,0
"2789","BUF","PIT",2009020520,14597,20092010,1,65,1,1,0,0,0,0,32,24,8,49,43,6,65,63,2,8,5,0,0
"2790","BUF","TOR",2009020531,14599,20092010,0,63.5833333333333,3,2,1,0,0,0,30,36,-6,50,46,4,65,64,1,1,0,0,0
"2791","BUF","STL",2009020572,14605,20092010,0,60,5,3,2,0,0,0,24,35,-11,30,52,-22,37,69,-32,5,6,0,0
"2792","BUF","PIT",2009020584,14607,20092010,1,60,4,3,1,0,0,0,24,38,-14,34,54,-20,46,67,-21,5,3,0,0
"2793","BUF","MTL",2009020623,14612,20092010,0,60,1,0,1,0,0,0,30,30,0,34,42,-8,50,50,0,1,2,0,0
"2794","BUF","T.B",2009020639,14615,20092010,1,60,5,3,2,0,0,0,35,39,-4,44,49,-5,58,61,-3,4,4,0,0
"2795","BUF","TOR",2009020657,14617,20092010,1,60,3,2,1,0,0,0,31,50,-19,47,67,-20,58,79,-21,3,4,0,0
"2796","BUF","COL",2009020661,14618,20092010,1,65,3,3,0,0,0,0,35,30,5,53,39,14,67,51,16,4,5,0,0
"2797","BUF","NYI",2009020713,14625,20092010,0,65,2,2,0,0,0,0,33,38,-5,50,50,0,70,71,-1,3,5,0,0
"2798","BUF","ANA",2009020739,14628,20092010,0,60,4,5,-1,0,0,0,45,30,15,52,38,14,61,42,19,5,4,0,0
"2799","BUF","N.J",2009020786,14636,20092010,1,65,1,1,0,0,0,0,31,40,-9,37,50,-13,48,62,-14,1,1,0,0
"2800","BUF","PIT",2009020823,14641,20092010,0,60,4,5,-1,0,0,0,34,31,3,47,41,6,65,51,14,7,4,0,0
"2801","BUF","PIT",2009020929,14670,20092010,0,60,2,3,-1,0,0,0,28,28,0,36,47,-11,55,63,-8,5,3,0,0
"2802","BUF","PHI",2009020950,14673,20092010,1,62.5166666666667,3,2,1,0,0,0,35,29,6,44,38,6,53,56,-3,2,1,0,0
"2803","BUF","NYR",2009020969,14675,20092010,0,62.3666666666667,2,1,1,0,0,0,32,36,-4,44,49,-5,66,64,2,2,2,0,0
"2804","BUF","DAL",2009020985,14678,20092010,1,60,5,3,2,0,0,0,43,20,23,54,29,25,75,41,34,2,2,0,0
"2805","BUF","MIN",2009021002,14680,20092010,1,60,2,3,-1,0,0,0,45,33,12,54,38,16,68,45,23,7,3,0,0
"2806","BUF","T.B",2009021047,14686,20092010,0,60,6,2,4,0,0,0,28,25,3,37,36,1,49,52,-3,7,5,0,0
"2807","BUF","FLA",2009021062,14688,20092010,0,60,3,1,2,0,0,0,36,32,4,40,50,-10,49,61,-12,5,6,0,0
"2808","BUF","MTL",2009021092,14692,20092010,1,65,2,2,0,0,0,0,42,28,14,50,40,10,68,44,24,6,4,0,0
"2809","BUF","T.B",2009021112,14695,20092010,1,60,7,1,6,0,0,0,26,23,3,39,33,6,53,45,8,1,2,0,0
"2810","BUF","FLA",2009021142,14699,20092010,1,60,6,2,4,0,0,0,41,15,26,51,21,30,65,31,34,2,2,0,0
"2811","BUF","TOR",2009021150,14700,20092010,0,60,2,4,-2,0,0,0,24,34,-10,29,46,-17,45,66,-21,2,6,0,0
"2812","BUF","MTL",2009021168,14702,20092010,0,60,0,3,-3,0,0,0,29,38,-9,43,47,-4,57,58,-1,4,6,0,0
"2813","BUF","NYR",2009021182,14705,20092010,1,60,5,2,3,0,0,0,30,32,-2,37,38,-1,45,50,-5,6,5,0,0
"2814","BUF","N.J",2009021227,14710,20092010,0,60,1,2,-1,0,0,0,23,34,-11,26,43,-17,32,49,-17,2,5,0,0
"2815","BUF","NYR",2010020013,14891,20102011,1,60,3,6,-3,3.58855678130219,5.19946188301074,-1.61090510170855,36,28,8,48,40,8,67,60,7,5,4,0,0
"2816","BUF","N.J",2010020036,14895,20102011,1,60.8833333333333,0,1,-1,5.82009667134844,3.60331533812132,2.21678133322712,24,35,-11,36,47,-11,54,58,-4,2,3,0,0
"2817","BUF","MTL",2010020052,14897,20102011,1,60,1,2,-1,4.98129586243886,3.19258488895139,1.78871097348747,23,28,-5,31,45,-14,47,61,-14,1,3,0,0
"2818","BUF","N.J",2010020100,14905,20102011,0,60,6,1,5,2.6397619069586,2.47587075515185,0.163891151806752,29,27,2,33,34,-1,45,43,2,3,3,0,0
"2819","BUF","PHI",2010020118,14908,20102011,0,60,3,6,-3,4.52980978726055,7.14700755112975,-2.6171977638692,35,34,1,48,52,-4,65,66,-1,3,5,0,0
"2820","BUF","DAL",2010020151,14912,20102011,0,60,0,4,-4,5.81660094218387,7.01783568785322,-1.20123474566935,34,41,-7,46,67,-21,59,74,-15,2,7,0,0
"2821","BUF","MTL",2010020181,14918,20102011,1,60,2,3,-1,3.09704918979696,5.85789859708166,-2.7608494072847,31,32,-1,40,46,-6,53,60,-7,5,4,0,0
"2822","BUF","TOR",2010020189,14919,20102011,0,65,2,2,0,4.43879891790129,5.76716801753354,-1.32836909963224,31,25,6,50,44,6,73,59,14,3,2,0,0
"2823","BUF","N.J",2010020211,14923,20102011,0,65,4,4,0,4.73169776395662,3.27866404079396,1.45303372316266,42,32,10,48,39,9,59,45,14,2,2,0,0
"2824","BUF","NYR",2010020218,14924,20102011,0,61.5333333333333,2,3,-1,4.35989272932056,3.13920771521644,1.22068501410413,31,28,3,44,45,-1,56,58,-2,3,6,0,0
"2825","BUF","T.B",2010020284,14933,20102011,1,60,1,2,-1,4.67391561926901,1.70500006206566,2.96891555720335,30,22,8,38,28,10,49,42,7,3,4,0,0
"2826","BUF","PIT",2010020307,14937,20102011,1,60,0,1,-1,4.71523859781061,4.82092769973679,-0.105689101926174,30,29,1,43,38,5,60,49,11,5,6,0,0
"2827","BUF","TOR",2010020329,14939,20102011,1,60,3,1,2,2.88001206331455,4.57463136834917,-1.69461930503462,28,36,-8,33,45,-12,42,57,-15,5,7,0,0
"2828","BUF","MTL",2010020336,14940,20102011,0,60,1,3,-2,3.71798718208447,4.96774682629461,-1.24975964421014,36,33,3,43,52,-9,64,65,-1,7,8,0,0
"2829","BUF","PIT",2010020426,14954,20102011,1,60,2,5,-3,5.5210562428507,3.21619328181259,2.30486296103811,36,24,12,44,31,13,54,42,12,8,7,0,0
"2830","BUF","FLA",2010020470,14960,20102011,0,60,2,6,-4,6.53256059058332,3.37883210933069,3.15372848125264,43,26,17,57,41,16,72,50,22,7,7,0,0
"2831","BUF","T.B",2010020479,14961,20102011,0,60,1,3,-2,2.14634539105276,6.61621606146514,-4.46987067041238,23,37,-14,33,47,-14,50,57,-7,5,5,0,0
"2832","BUF","ANA",2010020495,14964,20102011,1,60,5,2,3,5.79102194200095,2.11972532335382,3.67129661864713,42,23,19,52,28,24,68,42,26,3,4,0,0
"2833","BUF","FLA",2010020507,14966,20102011,1,60,3,4,-1,7.73912647420866,3.97414673346979,3.76497974073887,48,29,19,64,40,24,82,50,32,7,6,0,0
"2834","BUF","EDM",2010020542,14971,20102011,0,60,4,2,2,3.12115483707748,3.99836457084166,-0.877209733764175,21,31,-10,35,38,-3,46,56,-10,1,4,0,0
"2835","BUF","COL",2010020588,14978,20102011,0,64.2833333333333,3,4,-1,5.54122824780643,3.38533802353437,2.15589022427206,40,34,6,47,46,1,57,61,-4,7,6,0,0
"2836","BUF","PHI",2010020633,14985,20102011,1,60,2,5,-3,4.19302589481231,4.93507286021486,-0.742046965402551,40,33,7,45,41,4,60,46,14,3,3,0,0
"2837","BUF","NYI",2010020663,14989,20102011,0,60,3,5,-2,11.0693308255941,5.06221949633618,6.0071113292579,43,37,6,63,50,13,83,65,18,5,3,0,0
"2838","BUF","MTL",2010020683,14992,20102011,1,61.15,2,1,1,7.96179975452529,3.67345688731701,4.28834286720828,39,30,9,54,39,15,72,55,17,6,5,0,0
"2839","BUF","NYI",2010020708,14995,20102011,1,60,2,5,-3,7.68277491186745,5.30660907243146,2.376165839436,38,29,9,54,39,15,70,44,26,3,3,0,0
"2840","BUF","NYI",2010020724,14997,20102011,0,60,5,3,2,3.74765936295091,5.61325666221092,-1.86559729926,23,34,-11,34,45,-11,49,61,-12,2,4,0,0
"2841","BUF","PIT",2010020777,15009,20102011,0,60,2,3,-1,4.0959566805476,4.69010851767962,-0.594151837132017,29,39,-10,33,52,-19,45,61,-16,3,7,0,0
"2842","BUF","TOR",2010020785,15010,20102011,1,60,6,2,4,7.94174428376937,3.24927256462787,4.69247171914149,43,25,18,48,32,16,66,48,18,5,4,0,0
"2843","BUF","T.B",2010020806,15013,20102011,0,60,7,4,3,4.23990192629972,3.70031237637208,0.539589549927645,28,34,-6,33,50,-17,49,68,-19,8,8,0,0
"2844","BUF","FLA",2010020820,15015,20102011,0,64.9166666666667,3,2,1,6.60828241606941,4.42749248503242,2.180789931037,27,26,1,37,31,6,51,39,12,2,1,0,0
"2845","BUF","NYI",2010020837,15018,20102011,1,62.9166666666667,6,7,-1,5.63873604137916,3.4061261956158,2.23260984576336,28,26,2,41,34,7,59,45,14,3,6,0,0
"2846","BUF","MTL",2010020849,15020,20102011,0,65,2,2,0,3.99224633976701,5.03955606749514,-1.04730972772813,32,34,-2,42,47,-5,62,65,-3,2,5,0,0
"2847","BUF","TOR",2010020855,15021,20102011,1,60,1,2,-1,5.45505159797904,5.72449227738244,-0.269440679403402,24,30,-6,38,46,-8,45,64,-19,5,4,0,0
"2848","BUF","STL",2010020872,15023,20102011,1,60,0,3,-3,3.69963710352455,4.73717602016404,-1.03753891663949,25,24,1,34,32,2,48,41,7,3,4,0,0
"2849","BUF","NYR",2010020942,15034,20102011,0,60,3,2,1,2.92665916832539,3.78680012339464,-0.860140955069255,26,31,-5,36,40,-4,48,56,-8,4,4,0,0
"2850","BUF","PHI",2010020974,15038,20102011,0,60,5,3,2,6.94002743886085,6.12455400821437,0.815473430646482,35,36,-1,42,54,-12,57,83,-26,5,5,0,0
"2851","BUF","MIN",2010020986,15039,20102011,0,60.7666666666667,3,2,1,8.68585234018974,3.27524277230716,5.41060956788258,33,26,7,43,38,5,55,49,6,2,2,0,0
"2852","BUF","PIT",2010020995,15041,20102011,0,60,1,3,-2,4.4493390281641,4.64741673725075,-0.198077709086647,30,31,-1,42,41,1,56,57,-1,4,8,0,0
"2853","BUF","TOR",2010021024,15045,20102011,0,60,3,4,-1,7.16693650427987,5.4378055461566,1.72913095812328,42,29,13,55,44,11,68,66,2,1,2,0,0
"2854","BUF","MTL",2010021092,15055,20102011,0,60,2,0,2,3.20616782635625,3.00126071897227,0.204907107383977,24,31,-7,41,40,1,58,52,6,5,2,0,0
"2855","BUF","FLA",2010021112,15058,20102011,1,60,4,2,2,5.22682680006308,3.25788637269397,1.96894042736911,32,24,8,40,40,0,46,52,-6,3,3,0,0
"2856","BUF","N.J",2010021118,15059,20102011,1,60,2,0,2,3.39183132732842,4.20735742186662,-0.8155260945382,28,30,-2,35,40,-5,46,53,-7,2,2,0,0
"2857","BUF","TOR",2010021135,15062,20102011,0,60,3,4,-1,3.32454084652954,3.8152552471729,-0.490714400643355,31,35,-4,41,50,-9,61,60,1,4,7,0,0
"2858","BUF","NYR",2010021145,15063,20102011,1,60,1,0,1,5.04098453823303,3.0761977439106,1.96478679432244,35,23,12,40,43,-3,48,57,-9,2,3,0,0
"2859","BUF","T.B",2010021184,15069,20102011,1,60,4,2,2,4.83520614863707,3.88732074914151,0.947885399495561,24,25,-1,35,35,0,47,46,1,3,2,0,0
"2860","BUF","PHI",2010021207,15072,20102011,1,61.2666666666667,4,3,1,6.15119474192124,3.9837383178791,2.16745642404214,29,27,2,39,37,2,46,54,-8,3,2,0,0
"2861","BUF","PHI",2010030121,15078,20102011,0,60,1,0,1,5.91685829048166,4.75119270123537,1.16566558924629,25,35,-10,32,58,-26,36,74,-38,2,6,0,0
"2862","BUF","PHI",2010030122,15080,20102011,0,60,4,5,-1,4.17051202115696,4.24377378396238,-0.0732617628054175,28,34,-6,39,46,-7,57,62,-5,10,12,0,0
"2863","BUF","PHI",2010030123,15082,20102011,1,60,2,4,-2,4.32037081400267,2.92203330868688,1.39833750531579,37,26,11,47,36,11,64,45,19,8,5,0,0
"2864","BUF","PHI",2010030124,15084,20102011,1,60,1,0,1,3.94671738643862,4.35599669439421,-0.409279307955585,29,32,-3,37,51,-14,52,65,-13,6,6,0,0
"2865","BUF","PHI",2010030125,15086,20102011,0,65.5166666666667,4,3,1,8.68010545699074,5.97858336893842,2.70152208805232,32,39,-7,42,58,-16,50,87,-37,4,6,0,0
"2866","BUF","PHI",2010030126,15088,20102011,1,64.7166666666667,4,5,-1,5.33206325175809,7.31719844054896,-1.98513518879088,33,49,-16,49,64,-15,66,80,-14,6,6,0,0
"2867","BUF","PHI",2010030127,15090,20102011,0,60,2,5,-3,6.79289452894591,5.59163964479963,1.20125488414628,28,36,-8,44,51,-7,72,70,2,6,6,0,0
"2868","BUF","ANA",2011020007,15254,20112012,1,60,4,1,3,2.62404053902719,4.15024344591438,-1.52620290688719,25,30,-5,37,45,-8,48,62,-14,6,7,0,0
"2869","BUF","PIT",2011020053,15262,20112012,0,60,3,2,1,7.60921321991754,5.27184624117217,2.33736697874537,28,31,-3,39,50,-11,52,60,-8,1,2,0,0
"2870","BUF","MTL",2011020072,15265,20112012,0,60,3,1,2,7.39758404626627,4.71519059239654,2.68239345386974,23,41,-18,33,59,-26,49,82,-33,1,5,0,0
"2871","BUF","FLA",2011020085,15267,20112012,0,60,3,0,3,5.15091598598519,3.44663547817618,1.70428050780902,38,22,16,48,29,19,60,39,21,3,1,0,0
"2872","BUF","T.B",2011020104,15269,20112012,0,60,0,3,-3,2.88070293262354,4.77061306558971,-1.88991013296618,21,26,-5,33,34,-1,55,40,15,4,2,0,0
"2873","BUF","T.B",2011020113,15272,20112012,1,60,3,4,-1,3.90200676694803,4.66897378065914,-0.76696701371111,39,23,16,47,28,19,61,35,26,4,4,0,0
"2874","BUF","FLA",2011020141,15276,20112012,1,60,2,3,-1,4.50235110503854,4.82389518615673,-0.321544081118191,26,36,-10,38,48,-10,46,55,-9,4,6,0,0
"2875","BUF","PHI",2011020165,15280,20112012,1,60,2,3,-1,5.70102993550245,4.64076780588198,1.06026212962047,31,26,5,41,31,10,59,38,21,8,6,0,0
"2876","BUF","WPG",2011020202,15286,20112012,1,64.5833333333333,6,5,1,7.06326683016766,5.07992693270691,1.98333989746076,45,31,14,63,37,26,80,44,36,12,5,0,0
"2877","BUF","MTL",2011020245,15292,20112012,0,65,2,2,0,4.2000555515157,2.71018350841337,1.48987204310233,32,27,5,39,42,-3,55,56,-1,5,7,0,0
"2878","BUF","N.J",2011020257,15294,20112012,1,60,3,5,-2,5.68831708730431,3.34197796217632,2.346339125128,32,21,11,45,31,14,58,38,20,4,4,0,0
"2879","BUF","NYI",2011020345,15307,20112012,1,60,1,2,-1,6.93706606270644,4.7329986281693,2.20406743453714,31,30,1,43,38,5,62,44,18,4,3,0,0
"2880","BUF","PHI",2011020403,15315,20112012,1,62.6166666666667,4,5,-1,2.57541765875067,8.09435603767633,-5.51893837892567,24,34,-10,33,49,-16,44,59,-15,5,2,0,0
"2881","BUF","FLA",2011020418,15317,20112012,1,62.3166666666667,2,1,1,4.25115257228026,4.42262620496564,-0.171473632685379,20,23,-3,31,35,-4,42,44,-2,5,4,0,0
"2882","BUF","NYR",2011020422,15318,20112012,1,60,1,4,-3,4.55553976001798,4.45686827940517,0.0986714806128077,33,33,0,46,41,5,66,52,14,3,4,0,0
"2883","BUF","TOR",2011020462,15324,20112012,1,60,5,4,1,4.44673519186472,4.09003730318545,0.356697888679264,29,33,-4,39,45,-6,52,60,-8,4,2,0,0
"2884","BUF","TOR",2011020500,15330,20112012,0,60,2,3,-1,4.44563917382623,3.5798653626116,0.865773811214626,42,31,11,55,40,15,71,58,13,7,7,0,0
"2885","BUF","N.J",2011020536,15336,20112012,0,60,1,3,-2,2.92928723641671,3.47410249677,-0.544815260353289,23,23,0,35,33,2,42,41,1,5,3,0,0
"2886","BUF","EDM",2011020574,15342,20112012,1,60,4,3,1,5.62810373630101,4.48433192481025,1.14377181149076,33,26,7,41,37,4,53,49,4,2,3,0,0
"2887","BUF","WPG",2011020602,15346,20112012,1,60.95,1,2,-1,3.79511920447133,8.28800327431442,-4.49288406984308,32,41,-9,44,61,-17,64,70,-6,4,4,0,0
"2888","BUF","TOR",2011020617,15349,20112012,0,60,0,2,-2,4.74795615959175,4.69369722774718,0.0542589318445739,32,28,4,42,35,7,60,48,12,2,6,0,0
"2889","BUF","TOR",2011020644,15352,20112012,1,60,3,2,1,2.75415344124081,1.55431164376205,1.19984179747876,25,26,-1,29,33,-4,39,44,-5,2,4,0,0
"2890","BUF","NYI",2011020651,15353,20112012,0,60,2,4,-2,3.0646348768496,6.01510261052908,-2.95046773367949,25,40,-15,37,54,-17,55,70,-15,1,2,0,0
"2891","BUF","WPG",2011020691,15358,20112012,0,60,1,4,-3,3.92583773031947,4.08125124534126,-0.155413515021792,26,33,-7,36,50,-14,53,67,-14,3,5,0,0
"2892","BUF","STL",2011020707,15360,20112012,0,60,2,4,-2,6.28391898539849,5.98950101620109,0.294417969197401,21,27,-6,40,47,-7,52,62,-10,6,5,0,0
"2893","BUF","N.J",2011020722,15363,20112012,0,65,1,1,0,1.38709697301965,3.15407918675191,-1.76698221373226,14,28,-14,21,42,-21,27,53,-26,1,2,0,0
"2894","BUF","MTL",2011020741,15370,20112012,0,60,3,1,2,6.32559793480323,3.03328483784571,3.29231309695751,40,28,12,58,36,22,79,52,27,4,2,0,0
"2895","BUF","NYR",2011020749,15371,20112012,1,65,0,0,0,4.12156434312148,3.80006936122663,0.321494981894851,34,29,5,42,34,8,58,45,13,6,3,0,0
"2896","BUF","NYI",2011020772,15374,20112012,0,65,3,3,0,5.59167519193218,5.65800488933019,-0.0663296973980083,37,38,-1,55,50,5,79,55,24,1,2,0,0
"2897","BUF","DAL",2011020812,15380,20112012,1,65,2,2,0,10.2708134292664,4.56347517791437,5.70733825135198,32,26,6,46,36,10,58,47,11,2,4,0,0
"2898","BUF","T.B",2011020821,15381,20112012,1,60,1,2,-1,4.0648729617643,6.50601118808845,-2.44113822632415,27,28,-1,43,38,5,59,55,4,1,3,0,0
"2899","BUF","N.J",2011020838,15384,20112012,1,60,1,4,-3,4.14193316141169,6.28558518725913,-2.14365202584744,30,31,-1,35,41,-6,47,60,-13,2,7,0,0
"2900","BUF","PHI",2011020852,15386,20112012,0,60,2,7,-5,5.904719352955,7.34254160450917,-1.43782225155417,29,35,-6,41,42,-1,58,49,9,7,4,0,0
"2901","BUF","MTL",2011020860,15387,20112012,1,65,3,3,0,6.0852095621023,3.27668721277291,2.80852234932939,30,19,11,43,28,15,59,42,17,4,3,0,0
"2902","BUF","NYI",2011020885,15391,20112012,1,60,2,1,1,5.94577793535427,2.64118045632495,3.30459747902933,37,31,6,42,39,3,50,49,1,2,2,0,0
"2903","BUF","NYR",2011020920,15395,20112012,0,62.9833333333333,2,3,-1,0,0,0,20,28,-8,32,44,-12,41,64,-23,3,3,0,0
"2904","BUF","ANA",2011020949,15399,20112012,0,60,2,0,2,2.99999298457988,9.45141773551888,-6.451424750939,24,43,-19,33,73,-40,42,82,-40,8,5,0,0
"2905","BUF","WPG",2011020982,15404,20112012,0,60,1,3,-2,2.40440936604864,3.0466725845763,-0.64226321852766,24,31,-7,33,50,-17,52,62,-10,3,3,0,0
"2906","BUF","MTL",2011021033,15411,20112012,1,62.0166666666667,3,2,1,6.88440154930473,3.35767133231275,3.52673021699198,36,28,8,50,34,16,62,47,15,2,2,0,0
"2907","BUF","COL",2011021046,15413,20112012,1,65,4,4,0,4.04972689619171,5.42603042593805,-1.37630352974634,24,42,-18,40,51,-11,60,67,-7,3,5,0,0
"2908","BUF","FLA",2011021072,15416,20112012,0,65,2,2,0,2.80807992815971,2.65177953569219,0.156300392467529,26,17,9,30,27,3,45,43,2,3,2,0,0
"2909","BUF","T.B",2011021084,15418,20112012,0,60,7,3,4,6.11622523819096,2.44442992975564,3.67179530843532,38,27,11,52,35,17,73,45,28,4,2,0,0
"2910","BUF","MTL",2011021097,15420,20112012,1,60,3,0,3,2.58655119088505,3.76275923998332,-1.17620804909827,31,34,-3,40,44,-4,50,55,-5,7,3,0,0
"2911","BUF","NYR",2011021111,15422,20112012,0,60,4,1,3,4.1006848521065,3.04390829016063,1.05677656194587,26,27,-1,40,41,-1,57,56,1,1,2,0,0
"2912","BUF","MIN",2011021118,15423,20112012,1,60,3,1,2,2.28307020620289,2.81529647033312,-0.53222626413023,37,25,12,44,30,14,57,43,14,4,2,0,0
"2913","BUF","TOR",2011021171,15430,20112012,0,60,3,4,-1,5.38819695985876,3.37625525105977,2.01194170879899,32,29,3,55,42,13,76,57,19,3,2,0,0
"2914","BUF","TOR",2011021190,15433,20112012,1,63.4833333333333,6,5,1,4.41514258566315,3.79310442690621,0.622038158756936,45,25,20,51,33,18,66,41,25,5,1,0,0
"2915","BUF","PHI",2011021203,15435,20112012,0,60,1,2,-1,7.39549569017254,4.28831716835134,3.1071785218212,26,35,-9,37,46,-9,53,65,-12,3,2,0,0
"2916","BUF","PHI",2012020014,15725,20122013,1,60,5,2,3,5.94876880179238,2.27021999453427,3.6785488072581,41,29,12,47,35,12,61,44,17,10,8,0,0
"2917","BUF","TOR",2012020023,15726,20122013,0,60,2,1,1,3.42391128565941,5.55972727003973,-2.13581598438032,20,35,-15,30,55,-25,38,73,-35,5,9,0,0
"2918","BUF","TOR",2012020079,15734,20122013,1,64.9666666666667,3,4,-1,7.0786984754377,4.7153087972838,2.36338967815391,32,24,8,42,35,7,58,49,9,2,3,0,0
"2919","BUF","MTL",2012020109,15738,20122013,0,60,1,6,-5,5.56645123321596,5.69543516828594,-0.128983935069982,31,32,-1,42,49,-7,52,61,-9,6,8,0,0
"2920","BUF","FLA",2012020121,15739,20122013,1,60,3,4,-1,3.25326522500836,5.07418646867154,-1.82092124366318,20,33,-13,29,40,-11,43,51,-8,1,3,0,0
"2921","BUF","MTL",2012020141,15743,20122013,1,65,4,4,0,6.13129761460004,5.95722365191506,0.174073962684986,40,32,8,56,42,14,68,53,15,8,5,0,0
"2922","BUF","NYI",2012020161,15745,20122013,0,60,3,2,1,2.337903074309,4.34806637791917,-2.01016330361017,15,43,-28,23,59,-36,37,82,-45,3,4,0,0
"2923","BUF","WPG",2012020226,15755,20122013,1,60,1,2,-1,3.11878566079258,3.07174764673709,0.047038014055488,30,28,2,41,40,1,60,55,5,4,2,0,0
"2924","BUF","TOR",2012020237,15757,20122013,0,60,1,3,-2,7.20228454706012,4.55998350643131,2.64230104062881,32,36,-4,46,52,-6,66,69,-3,4,6,0,0
"2925","BUF","NYI",2012020254,15759,20122013,1,60,0,4,-4,3.60624219250167,5.0265638170531,-1.42032162455143,35,32,3,43,44,-1,59,57,2,10,7,0,0
"2926","BUF","T.B",2012020279,15762,20122013,0,60,2,1,1,2.17258160747588,3.17127971519949,-0.998698107723612,21,31,-10,28,45,-17,36,59,-23,1,6,0,0
"2927","BUF","FLA",2012020292,15764,20122013,0,65,3,3,0,4.20013554392641,5.13505158817134,-0.934916044244922,25,43,-18,29,58,-29,39,71,-32,2,5,0,0
"2928","BUF","N.J",2012020304,15766,20122013,1,65,3,3,0,1.87970920385347,4.56828916815721,-2.68857996430374,23,31,-8,33,43,-10,47,61,-14,7,7,0,0
"2929","BUF","NYR",2012020317,15767,20122013,0,65,2,2,0,4.48217450996799,3.88377076096367,0.598403749004319,30,28,2,39,49,-10,54,69,-15,5,2,0,0
"2930","BUF","N.J",2012020340,15771,20122013,0,65,2,2,0,5.30936165886878,4.53532454415108,0.774037114717702,25,33,-8,38,47,-9,47,61,-14,4,4,0,0
"2931","BUF","PHI",2012020371,15774,20122013,0,60,2,3,-1,2.96133591998949,2.41763047072336,0.543705449266135,20,28,-8,26,38,-12,41,55,-14,4,7,0,0
"2932","BUF","NYR",2012020377,15776,20122013,1,60,3,1,2,2.08357974729734,5.01479487245457,-2.93121512515723,22,33,-11,36,40,-4,50,57,-7,5,1,0,0
"2933","BUF","MTL",2012020433,15783,20122013,0,62.2666666666667,3,2,1,2.87499314179877,5.95397120206076,-3.07897806026199,21,34,-13,26,58,-32,37,81,-44,4,2,0,0
"2934","BUF","TOR",2012020443,15785,20122013,1,65,4,4,0,6.19002090524737,5.75300416743016,0.437016737817203,36,34,2,48,48,0,64,56,8,6,5,0,0
"2935","BUF","MTL",2012020460,15787,20122013,0,60,2,1,1,3.14416571224592,7.51026435792664,-4.36609864568072,18,39,-21,22,54,-32,31,85,-54,3,3,0,0
"2936","BUF","T.B",2012020484,15790,20122013,0,60,1,2,-1,2.12123283516848,2.61035975714913,-0.489126921980642,14,25,-11,25,34,-9,42,43,-1,5,6,0,0
"2937","BUF","FLA",2012020496,15792,20122013,0,65,4,4,0,6.3662263137037,4.72826510146071,1.63796121224298,40,40,0,52,52,0,58,60,-2,5,6,0,0
"2938","BUF","N.J",2012020575,15802,20122013,1,65,2,2,0,3.159378672093,4.04605408868156,-0.88667541658856,26,39,-13,29,47,-18,42,65,-23,3,5,0,0
"2939","BUF","WPG",2012020587,15804,20122013,0,60,1,4,-3,6.4367032519076,3.55437629400905,2.88232695789855,30,30,0,38,42,-4,47,58,-11,3,1,0,0
"2940","BUF","MTL",2012020597,15806,20122013,1,60,1,5,-4,2.04084803781006,6.0041742704557,-3.96332623264564,15,42,-27,22,55,-33,35,69,-34,3,8,0,0
"2941","BUF","PHI",2012020610,15808,20122013,1,60,1,0,1,3.72904316772474,5.55356365034822,-1.82452048262348,21,29,-8,31,40,-9,40,52,-12,2,4,0,0
"2942","BUF","T.B",2012020622,15809,20122013,1,60,3,1,2,1.72754239180358,3.23238146821903,-1.50483907641545,22,33,-11,29,48,-19,39,56,-17,3,1,0,0
"2943","BUF","NYR",2012020655,15814,20122013,1,60,4,8,-4,4.24215879037729,1.74071091384394,2.50144787653335,28,29,-1,39,33,6,56,44,12,4,1,0,0
"2944","BUF","WPG",2012020676,15817,20122013,1,60,1,2,-1,5.19879187975312,5.6240370577143,-0.425245177961187,25,39,-14,42,53,-11,47,59,-12,1,3,0,0
"2945","BUF","NYI",2012020704,15821,20122013,1,65,1,1,0,1.85575358780625,2.91424921650582,-1.05849562869957,22,31,-9,35,41,-6,51,50,1,3,4,0,0
"2946","BUF","T.B",2013020041,15986,20132014,1,61.8333333333333,2,3,-1,4.72200010542292,4.87178948443034,-0.149789379007416,23,34,-11,35,43,-8,46,57,-11,4,3,0,0
"2947","BUF","MIN",2013020081,15992,20132014,1,60,1,2,-1,2.6901885002444,3.77730635504331,-1.0871178547989,23,20,3,34,39,-5,45,46,-1,4,3,0,0
"2948","BUF","NYI",2013020083,15993,20132014,0,65,3,3,0,6.39584467202076,4.1923449563094,2.20349971571136,34,44,-10,50,60,-10,66,78,-12,6,5,0,0
"2949","BUF","COL",2013020112,15997,20132014,1,60,2,4,-2,6.14761841134168,3.9925081920519,2.15511021928978,30,26,4,38,33,5,50,40,10,3,3,0,0
"2950","BUF","FLA",2013020152,16003,20132014,0,60,3,1,2,6.15248524684398,4.70948708429933,1.44299816254465,21,45,-24,30,62,-32,39,79,-40,1,2,0,0
"2951","BUF","T.B",2013020159,16004,20132014,0,60,2,3,-1,3.19415250918678,4.77316679049642,-1.57901428130964,22,39,-17,29,50,-21,37,60,-23,3,6,0,0
"2952","BUF","DAL",2013020171,16006,20132014,1,60,3,4,-1,3.11554282745527,4.52673178243776,-1.41118895498249,25,29,-4,34,40,-6,49,54,-5,4,4,0,0
"2953","BUF","NYR",2013020189,16009,20132014,0,60,0,2,-2,3.38326095371992,3.69299450221443,-0.309733548494513,29,46,-17,40,56,-16,50,76,-26,1,3,0,0
"2954","BUF","ANA",2013020201,16011,20132014,1,60,3,6,-3,3.95861676428467,5.20190386576724,-1.24328710148257,17,29,-12,25,40,-15,40,52,-12,2,3,0,0
"2955","BUF","ANA",2013020244,16017,20132014,0,60,2,6,-4,3.09195100639408,5.93171204619284,-2.83976103979876,27,46,-19,40,64,-24,55,70,-15,2,2,0,0
"2956","BUF","TOR",2013020284,16024,20132014,1,60,3,1,2,4.04097738757264,2.83222310617566,1.20875428139698,27,33,-6,31,43,-12,35,59,-24,3,3,0,0
"2957","BUF","TOR",2013020294,16025,20132014,0,60,2,4,-2,6.87289602497205,2.52345243433956,4.34944359063249,35,22,13,48,36,12,65,46,19,7,6,0,0
"2958","BUF","STL",2013020312,16028,20132014,1,60,1,4,-3,4.341330076335,4.08060555534757,0.260724520987424,24,31,-7,33,46,-13,46,63,-17,2,3,0,0
"2959","BUF","PHI",2013020328,16030,20132014,0,60,1,4,-3,5.71014342889457,7.10003206597837,-1.3898886370838,30,46,-16,41,60,-19,56,74,-18,5,8,0,0
"2960","BUF","MTL",2013020365,16036,20132014,1,60,1,3,-2,3.54704115488937,5.91548297082772,-2.36844181593835,25,31,-6,36,39,-3,49,53,-4,1,4,0,0
"2961","BUF","TOR",2013020388,16038,20132014,1,60.6333333333333,3,2,1,5.98034817355801,3.38220639180508,2.59814178175293,29,24,5,42,34,8,68,45,23,5,2,0,0
"2962","BUF","N.J",2013020396,16039,20132014,0,64.3166666666667,0,1,-1,1.87582523601076,4.12581697035521,-2.24999173434445,15,24,-9,27,38,-11,35,52,-17,4,3,0,0
"2963","BUF","NYR",2013020422,16044,20132014,1,60,1,3,-2,4.41054604426608,4.41936505081685,-0.00881900655076606,28,31,-3,37,46,-9,53,61,-8,2,2,0,0
"2964","BUF","MTL",2013020439,16046,20132014,0,60,2,3,-1,3.84117343864636,2.96498372552742,0.876189713118947,25,19,6,32,29,3,48,41,7,1,1,0,0
"2965","BUF","WPG",2013020510,16056,20132014,1,60,4,2,2,4.84533233121419,4.97009023001465,-0.124757898800453,31,27,4,44,43,1,59,56,3,6,2,0,0
"2966","BUF","TOR",2013020568,16066,20132014,0,65,3,3,0,4.7329892317014,4.56205325407791,0.170935977623486,35,42,-7,49,55,-6,60,71,-11,1,3,0,0
"2967","BUF","WPG",2013020604,16070,20132014,0,60,0,3,-3,3.52656202791695,5.1844905319158,-1.65792850399885,27,26,1,38,37,1,53,53,0,4,3,0,0
"2968","BUF","MIN",2013020617,16072,20132014,0,60,1,4,-3,5.01962742424803,4.7714808320452,0.248146592202829,20,32,-12,33,46,-13,44,55,-11,6,6,0,0
"2969","BUF","N.J",2013020628,16074,20132014,1,60,2,1,1,2.99983096960932,2.61515094306031,0.384680026549006,22,22,0,26,32,-6,34,52,-18,5,4,0,0
"2970","BUF","FLA",2013020660,16079,20132014,1,65,1,1,0,2.58981719089206,3.87800899557624,-1.28819180468417,24,35,-11,32,53,-21,42,67,-25,2,4,0,0
"2971","BUF","PHI",2013020699,16084,20132014,1,60,3,4,-1,4.12977087728086,3.06938201963949,1.06038885764137,19,33,-14,28,45,-17,36,61,-25,4,6,0,0
"2972","BUF","TOR",2013020707,16085,20132014,0,65,3,3,0,6.93745317508001,4.97574176419948,1.96171141088053,30,39,-9,44,50,-6,59,67,-8,3,3,0,0
"2973","BUF","FLA",2013020746,16091,20132014,1,60,3,4,-1,5.53869061454316,4.35856955118288,1.18012106336028,35,22,13,46,36,10,56,51,5,6,2,0,0
"2974","BUF","COL",2013020826,16102,20132014,0,60,1,7,-6,4.73734542515012,4.56510569742173,0.172239727728396,28,39,-11,37,48,-11,51,57,-6,5,5,0,0
"2975","BUF","EDM",2013020837,16104,20132014,1,60,2,3,-1,7.80872787633461,3.9745177827176,3.83421009361702,44,28,16,60,39,21,73,46,27,7,6,0,0
"2976","BUF","DAL",2013020921,16132,20132014,0,60,2,3,-1,1.59340203727811,6.00250545435119,-4.40910341707308,23,39,-16,38,59,-21,46,78,-32,1,6,0,0
"2977","BUF","T.B",2013020941,16135,20132014,0,60,3,1,2,2.60460918136414,4.51061291665451,-1.90600373529037,21,44,-23,32,64,-32,38,85,-47,3,4,0,0
"2978","BUF","FLA",2013020950,16136,20132014,0,60,0,2,-2,4.6475879452184,6.63189674101427,-1.98430879579588,25,44,-19,34,52,-18,47,64,-17,2,7,0,0
"2979","BUF","NYI",2013021008,16144,20132014,0,60,1,4,-3,3.91685793684692,7.23240630351602,-3.31554836666909,34,38,-4,49,51,-2,68,68,0,7,4,0,0
"2980","BUF","MTL",2013021018,16145,20132014,1,60,0,2,-2,4.18630815888901,4.3400750396213,-0.153766880732292,29,32,-3,35,42,-7,46,51,-5,3,4,0,0
"2981","BUF","EDM",2013021047,16149,20132014,0,60,3,1,2,1.47937361465002,5.30986379712704,-3.83049018247701,36,36,0,43,52,-9,56,67,-11,3,7,0,0
"2982","BUF","MTL",2013021083,16154,20132014,0,60,0,2,-2,2.69311068168543,6.73521562403766,-4.04210494235224,24,35,-11,30,42,-12,46,61,-15,4,7,0,0
"2983","BUF","T.B",2013021110,16158,20132014,1,61.8833333333333,3,4,-1,4.45126353718177,4.45565309902304,-0.00438956184126482,29,33,-4,38,46,-8,52,60,-8,3,4,0,0
"2984","BUF","N.J",2013021129,16161,20132014,1,65,2,2,0,4.24525602045469,5.00272504164604,-0.757469021191355,27,35,-8,31,45,-14,43,71,-28,3,2,0,0
"2985","BUF","STL",2013021149,16163,20132014,0,60,1,2,-1,3.26846652950917,3.2271072042131,0.0413593252960709,25,28,-3,33,45,-12,45,64,-19,3,2,0,0
"2986","BUF","PHI",2013021173,16166,20132014,0,60,2,5,-3,4.53804955862483,7.24649578764037,-2.70844622901554,19,37,-18,31,54,-23,45,74,-29,4,4,0,0
"2987","BUF","NYR",2013021194,16170,20132014,0,60,1,2,-1,1.84384356578084,4.4196056481973,-2.57576208241646,24,30,-6,31,43,-12,37,64,-27,3,5,0,0
"2988","BUF","NYI",2013021225,16173,20132014,1,65,3,3,0,6.86042088146496,4.7235253228669,2.13689555859806,39,25,14,53,42,11,63,58,5,3,3,0,0
"2989","BUF","ANA",2014020036,16356,20142015,1,60,1,5,-4,2.67224962945329,5.85291427859198,-3.18066464913869,12,44,-32,18,60,-42,35,75,-40,4,8,0,0
"2990","BUF","FLA",2014020056,16360,20142015,1,60,0,1,-1,4.97478567609903,2.80022866581567,2.17455701028337,26,35,-9,40,47,-7,50,64,-14,6,6,0,0
"2991","BUF","ANA",2014020092,16365,20142015,0,60,1,4,-3,3.30753348831331,5.46279366865281,-2.1552601803395,23,34,-11,38,52,-14,53,69,-16,2,4,0,0
"2992","BUF","TOR",2014020129,16371,20142015,0,60,0,4,-4,2.0692427954823,5.24460116188129,-3.175358366399,10,37,-27,20,54,-34,36,73,-37,3,7,0,0
"2993","BUF","MTL",2014020184,16379,20142015,1,65,1,1,0,2.47492241301813,6.23426742968149,-3.75934501666336,32,32,0,41,45,-4,48,59,-11,4,1,0,0
"2994","BUF","EDM",2014020197,16381,20142015,1,60,2,3,-1,3.16489506889047,3.91691076403367,-0.7520156951432,31,52,-21,43,68,-25,51,85,-34,1,2,0,0
"2995","BUF","STL",2014020226,16385,20142015,0,60,1,6,-5,2.47979575728692,3.84165970244794,-1.36186394516102,29,29,0,34,38,-4,45,56,-11,5,6,0,0
"2996","BUF","MIN",2014020238,16387,20142015,0,60,3,6,-3,4.12393379538533,6.6041282563765,-2.48019446099116,28,39,-11,32,57,-25,38,78,-40,2,4,0,0
"2997","BUF","TOR",2014020251,16389,20142015,1,60,6,2,4,5.26246689475101,4.73916655873416,0.523300336016852,35,34,1,39,54,-15,45,69,-24,4,5,0,0
"2998","BUF","NYR",2014020291,16486,20142015,1,60,1,3,-2,4.78357128569041,7.72057209121522,-2.9370008055248,25,43,-18,36,62,-26,43,75,-32,3,4,0,0
"2999","BUF","WPG",2014020323,16400,20142015,1,60,1,2,-1,3.47675604453332,5.97479250093,-2.49803645639668,20,26,-6,28,36,-8,38,51,-13,4,4,0,0
"3000","BUF","MTL",2014020337,16402,20142015,1,60,2,1,1,3.8282203694107,3.53003989475019,0.298180474660512,25,31,-6,32,45,-13,45,63,-18,4,3,0,0
"3001","BUF","MTL",2014020345,16403,20142015,0,65,3,3,0,6.61093554995023,7.72854105720762,-1.11760550725739,26,44,-18,30,60,-30,42,90,-48,1,2,0,0
"3002","BUF","T.B",2014020362,16406,20142015,1,65,1,1,0,3.94844967366953,3.22817884839606,0.720270825273474,22,27,-5,34,47,-13,45,69,-24,2,2,0,0
"3003","BUF","T.B",2014020381,16408,20142015,0,60,0,5,-5,1.55889624030052,4.91444446047535,-3.35554822017484,13,35,-22,22,51,-29,29,68,-39,6,9,0,0
"3004","BUF","FLA",2014020395,16410,20142015,0,60,2,3,-1,5.42889926180942,3.9346899387607,1.49420932304872,28,37,-9,36,50,-14,44,63,-19,2,1,0,0
"3005","BUF","FLA",2014020437,16417,20142015,1,60.4833333333333,4,3,1,5.4454202952038,3.94921605987736,1.49620423532645,32,28,4,42,38,4,52,51,1,2,1,0,0
"3006","BUF","WPG",2014020460,16420,20142015,0,60,1,5,-4,5.32623285031877,6.91669438964163,-1.59046153932286,28,36,-8,37,49,-12,45,69,-24,5,5,0,0
"3007","BUF","COL",2014020480,16424,20142015,1,60,1,5,-4,2.98502900007588,4.44954207481351,-1.46451307473762,29,23,6,37,30,7,51,44,7,4,3,0,0
"3008","BUF","NYI",2014020514,16431,20142015,1,65,3,3,0,4.20796752169554,5.28287879509614,-1.0749112734006,26,36,-10,33,46,-13,47,66,-19,5,4,0,0
"3009","BUF","T.B",2014020546,16435,20142015,1,60,1,5,-4,1.37420849641785,6.07713241752936,-4.70292392111151,11,25,-14,20,33,-13,31,48,-17,2,3,0,0
"3010","BUF","FLA",2014020558,16437,20142015,1,60,0,2,-2,5.8010675470432,4.30681423371425,1.49425331332895,30,33,-3,38,41,-3,51,50,1,1,1,0,0
"3011","BUF","NYR",2014020569,16438,20142015,0,60,1,6,-5,3.48016591946362,5.92167285937467,-2.44150693991105,25,39,-14,30,56,-26,39,74,-35,4,5,0,0
"3012","BUF","N.J",2014020584,16441,20142015,0,60,1,4,-3,3.32291184272617,3.79479387199535,-0.471882029269182,21,28,-7,27,39,-12,38,54,-16,2,2,0,0
"3013","BUF","T.B",2014020610,16444,20142015,0,60,1,2,-1,3.0085157185631,4.07274642470293,-1.06423070613982,21,47,-26,28,63,-35,39,75,-36,3,4,0,0
"3014","BUF","MIN",2014020645,16450,20142015,1,60,0,7,-7,1.79126684747439,3.94574498005244,-2.15447813257805,18,37,-19,29,45,-16,44,63,-19,3,6,0,0
"3015","BUF","PHI",2014020661,16452,20142015,1,60,3,4,-1,3.24357092258288,7.33859985597288,-4.09502893339,27,32,-5,36,48,-12,44,63,-19,4,4,0,0
"3016","BUF","EDM",2014020720,16464,20142015,0,60,2,3,-1,3.6651487602503,5.51895564421513,-1.85380688396482,20,34,-14,28,52,-24,37,74,-37,2,3,0,0
"3017","BUF","MTL",2014020749,16469,20142015,0,60,3,2,1,2.70527493438567,8.67360832647228,-5.96833339208661,18,34,-16,26,57,-31,40,92,-52,1,2,0,0
"3018","BUF","DAL",2014020776,16473,20142015,1,60,3,2,1,2.63117458403576,5.24968063922324,-2.61850605518748,24,40,-16,29,58,-29,37,86,-49,2,2,0,0
"3019","BUF","NYI",2014020787,16474,20142015,1,60,2,3,-1,3.50957803032361,4.21753358349611,-0.707955553172496,10,31,-21,19,47,-28,28,68,-40,4,3,0,0
"3020","BUF","PHI",2014020835,16481,20142015,1,60,1,2,-1,4.93495908460994,3.73204636897748,1.20291271563246,22,30,-8,34,43,-9,42,62,-20,3,2,0,0
"3021","BUF","N.J",2014020846,16483,20142015,0,65,1,1,0,2.15315787169675,5.01186932426936,-2.85871145257261,25,35,-10,37,47,-10,46,60,-14,3,5,0,0
"3022","BUF","PHI",2014020861,16485,20142015,0,65,2,2,0,5.11035979517328,6.7105699024832,-1.60021010730992,32,38,-6,42,60,-18,53,84,-31,4,5,0,0
"3023","BUF","T.B",2014020945,16497,20142015,0,60,0,3,-3,4.28251958228066,3.91761303427456,0.364906548006095,28,35,-7,37,46,-9,49,63,-14,2,2,0,0
"3024","BUF","TOR",2014020999,16505,20142015,0,65,3,3,0,3.30560834458856,7.1082540863824,-3.80264574179384,33,34,-1,47,49,-2,58,63,-5,2,5,0,0
"3025","BUF","NYR",2014021021,16508,20142015,1,60,0,2,-2,4.33551973167572,6.08379682672237,-1.74827709504665,20,33,-13,22,54,-32,26,72,-46,3,3,0,0
"3026","BUF","N.J",2014021063,16514,20142015,1,60,1,3,-2,6.15237189885556,3.64921790236258,2.50315399649298,29,27,2,41,37,4,55,53,2,4,2,0,0
"3027","BUF","DAL",2014021087,16517,20142015,0,60,3,4,-1,4.67494280466053,9.73927543456715,-5.06433262990662,28,39,-11,39,58,-19,49,101,-52,3,3,0,0
"3028","BUF","COL",2014021126,16522,20142015,0,60,3,5,-2,5.29052884087242,4.53225052350899,0.758278317363429,38,22,16,48,37,11,65,45,20,4,2,0,0
"3029","BUF","TOR",2014021149,16526,20142015,1,60,4,3,1,4.29639566690025,4.91666629059176,-0.620270623691511,31,27,4,45,37,8,57,53,4,5,4,0,0
"3030","BUF","NYI",2014021173,16529,20142015,0,60,0,3,-3,2.72294886200689,4.16510581942566,-1.44215695741877,21,36,-15,31,54,-23,45,68,-23,4,3,0,0
"3031","BUF","T.B",2015020017,16718,20152016,1,60,1,4,-3,0,0,0,25,31,-6,38,44,-6,51,54,-3,2,3,0,0
"3032","BUF","T.B",2015020067,16725,20152016,0,60,1,2,-1,2.77065921492399,4.98305422749507,-2.21239501257108,32,22,10,39,43,-4,47,55,-8,3,4,0,0
"3033","BUF","TOR",2015020088,16729,20152016,1,65,1,1,0,6.63602113694651,6.7532513599503,-0.117230223003787,35,24,11,42,36,6,61,49,12,4,1,0,0
"3034","BUF","MTL",2015020100,16731,20152016,1,60,2,7,-5,4.08050989460025,4.04093558398754,0.039574310612716,36,26,10,47,37,10,61,51,10,4,3,0,0
"3035","BUF","N.J",2015020107,16732,20152016,1,60,3,4,-1,3.92657791148224,5.91626558957159,-1.98968767808935,29,28,1,36,45,-9,47,61,-14,5,2,0,0
"3036","BUF","PHI",2015020126,16735,20152016,0,62.4833333333333,4,3,1,8.55007461793139,4.49611693588758,4.0539576820438,40,33,7,54,43,11,75,62,13,2,2,0,0
"3037","BUF","PHI",2015020145,16738,20152016,1,60,3,1,2,4.4157978441508,5.42905124090612,-1.01325339675532,36,28,8,48,36,12,59,58,1,8,5,0,0
"3038","BUF","NYI",2015020167,16740,20152016,0,60,2,1,1,4.16388101753546,4.68851839491981,-0.524637377384352,22,30,-8,28,44,-16,52,58,-6,0,0,0,0
"3039","BUF","T.B",2015020185,16744,20152016,1,60,1,4,-3,1.91346475846537,3.53709479016834,-1.62363003170297,31,22,9,44,30,14,62,38,24,2,3,0,0
"3040","BUF","T.B",2015020221,16749,20152016,0,60,4,1,3,3.36451987710461,4.05483303685722,-0.690313159752611,27,31,-4,32,47,-15,45,67,-22,3,5,0,0
"3041","BUF","DAL",2015020268,16756,20152016,1,60,1,3,-2,4.65446386300027,6.58612955968804,-1.93166569668777,25,29,-4,38,45,-7,52,60,-8,3,1,0,0
"3042","BUF","DAL",2015020301,16760,20152016,0,60,0,3,-3,3.91021245140587,5.09085875882158,-1.18064630741571,22,32,-10,37,53,-16,49,72,-23,3,5,0,0
"3043","BUF","EDM",2015020402,16775,20152016,0,60,2,4,-2,5.16648999141762,2.25414238803559,2.91234760338203,34,28,6,45,37,8,56,50,6,6,3,0,0
"3044","BUF","N.J",2015020453,16784,20152016,1,60,0,2,-2,4.44423163158353,3.05364377536995,1.39058785621359,25,21,4,37,32,5,55,42,13,3,1,0,0
"3045","BUF","ANA",2015020466,16786,20152016,1,60,3,0,3,2.22208101255819,6.41037939190574,-4.18829837934754,22,44,-22,29,52,-23,41,66,-25,4,4,0,0
"3046","BUF","NYI",2015020556,16800,20152016,1,60,1,2,-1,4.58648743680909,5.1880815454424,-0.601594108633307,43,33,10,53,45,8,68,61,7,4,2,0,0
"3047","BUF","WPG",2015020624,16810,20152016,0,60,4,2,2,6.8687097003567,6.37864601836645,0.49006368199025,29,44,-15,36,54,-18,44,67,-23,3,2,0,0
"3048","BUF","MIN",2015020637,16812,20152016,0,60,3,2,1,3.64821671613026,6.04649373958819,-2.39827702345792,23,30,-7,36,41,-5,48,54,-6,2,1,0,0
"3049","BUF","COL",2015020691,16820,20152016,0,60,1,2,-1,3.27424645671192,7.87186088516476,-4.59761442845284,28,35,-7,35,47,-12,47,55,-8,2,2,0,0
"3050","BUF","NYR",2015020726,16825,20152016,0,60,3,6,-3,5.27647505077948,4.67181787907617,0.604657171703309,26,33,-7,37,47,-10,53,58,-5,1,4,0,0
"3051","BUF","MTL",2015020756,16834,20152016,0,60,4,2,2,6.6039359412523,7.91139346491354,-1.30745752366124,32,35,-3,41,42,-1,62,57,5,3,2,0,0
"3052","BUF","PHI",2015020810,16842,20152016,0,60,1,5,-4,7.92441498772662,3.82787163135855,4.09654335636807,42,28,14,58,29,29,90,42,48,5,4,0,0
"3053","BUF","MTL",2015020818,16843,20152016,1,60,6,4,2,3.33710717444774,5.83686815475812,-2.49976098031038,22,30,-8,27,49,-22,35,62,-27,3,4,0,0
"3054","BUF","COL",2015020835,16845,20152016,1,60,4,1,3,6.58196018948957,3.40205111290778,3.17990907658179,21,35,-14,29,47,-18,42,60,-18,3,5,0,0
"3055","BUF","PIT",2015020883,16852,20152016,1,60,3,4,-1,5.67778503522277,4.72126583875797,0.956519196464797,27,31,-4,38,39,-1,50,60,-10,3,4,0,0
"3056","BUF","ANA",2015020905,16855,20152016,0,60,0,1,-1,3.41671622431022,3.0690013884072,0.34771483590302,26,29,-3,39,47,-8,53,64,-11,4,3,0,0
"3057","BUF","EDM",2015020944,16861,20152016,1,63.8,1,2,-1,4.90332058061056,6.08699853169674,-1.18367795108617,32,41,-9,40,56,-16,52,69,-17,1,3,0,0
"3058","BUF","MIN",2015020969,16865,20152016,1,65,2,2,0,6.13112587198339,3.91344571116497,2.21768016081842,32,30,2,47,39,8,58,53,5,2,2,0,0
"3059","BUF","TOR",2015020987,16867,20152016,0,65,3,3,0,3.17369067372056,3.94880834253854,-0.775117668817984,27,33,-6,35,50,-15,48,67,-19,7,6,0,0
"3060","BUF","NYR",2015020993,16868,20152016,1,60,2,4,-2,2.9698240592993,5.78918870267808,-2.81936464337878,36,26,10,45,39,6,56,52,4,2,2,0,0
"3061","BUF","MTL",2015021008,16870,20152016,0,60,2,3,-1,5.8653602392636,8.65285338024281,-2.78749314097921,38,34,4,52,53,-1,71,69,2,2,4,0,0
"3062","BUF","MTL",2015021047,16876,20152016,1,63.25,2,3,-1,4.37109060492433,5.39625588874333,-1.02516528381899,43,23,20,56,35,21,68,44,24,9,11,0,0
"3063","BUF","TOR",2015021070,16879,20152016,0,60,1,4,-3,3.88712592871161,5.02190564580033,-1.13477971708872,21,31,-10,34,50,-16,46,63,-17,5,4,0,0
"3064","BUF","WPG",2015021116,16886,20152016,1,60,3,2,1,5.88432902807835,3.19546647899551,2.68886254908284,29,20,9,47,31,16,63,40,23,2,1,0,0
"3065","BUF","PIT",2015021142,16889,20152016,0,65,4,4,0,2.88468584388823,6.1823811124998,-3.29769526861157,30,46,-16,34,59,-25,45,81,-36,4,4,0,0
"3066","BUF","TOR",2015021152,16891,20152016,1,60,4,1,3,6.3501934800297,6.226571472003,0.1236220080267,37,26,11,45,34,11,53,56,-3,5,4,0,0
"3067","BUF","NYR",2015021173,16893,20152016,0,60,4,3,1,2.77693443393218,4.46789392520077,-1.69095949126859,24,36,-12,34,51,-17,46,68,-22,2,3,0,0
"3068","BUF","N.J",2015021189,16896,20152016,0,60,3,1,2,2.36430086255533,3.04738101681005,-0.683080154254725,18,19,-1,26,35,-9,32,42,-10,4,6,0,0
"3069","BUF","NYI",2015021225,16900,20152016,0,62.7666666666667,4,3,1,3.36701955922763,3.16238680478273,0.204632754444901,26,24,2,38,37,1,55,49,6,2,1,0,0
"3070","BUF","MTL",2016020005,17087,20162017,1,60,1,4,-3,3.49921786329378,2.81128614657865,0.687931716715127,31,24,7,41,36,5,53,44,9,6,3,0,0
"3071","BUF","EDM",2016020031,17090,20162017,0,60,6,2,4,4.35744069845532,4.56454066934748,-0.207099970892159,24,33,-9,33,43,-10,44,58,-14,8,3,0,0
"3072","BUF","PHI",2016020085,17099,20162017,0,65,3,3,0,7.0769470456944,9.2401949713385,-2.1632479256441,25,41,-16,42,61,-19,56,79,-23,4,4,0,0
"3073","BUF","MIN",2016020098,17101,20162017,1,60,0,4,-4,5.32118766385247,4.10345560449059,1.21773205936188,38,22,16,50,33,17,61,42,19,2,2,0,0
"3074","BUF","WPG",2016020123,17104,20162017,0,60,3,1,2,3.46622196978112,5.898304187147,-2.43208221736589,28,38,-10,39,49,-10,51,64,-13,3,8,0,0
"3075","BUF","MIN",2016020137,17106,20162017,0,60,2,1,1,2.67355102673173,7.11055123229744,-4.43700020556571,24,28,-4,32,42,-10,41,60,-19,1,1,0,0
"3076","BUF","TOR",2016020146,17108,20162017,1,60,1,2,-1,5.64265032531694,4.83255249436871,0.810097830948223,43,29,14,53,38,15,70,46,24,2,0,0,0
"3077","BUF","N.J",2016020206,17116,20162017,1,60.4833333333333,1,2,-1,2.46122384372168,6.37697602272237,-3.91575217900069,26,43,-17,35,54,-19,44,69,-25,2,5,0,0
"3078","BUF","N.J",2016020215,17117,20162017,0,60,2,4,-2,2.81234667454959,3.5941806938572,-0.78183401930761,23,27,-4,27,36,-9,38,49,-11,3,6,0,0
"3079","BUF","T.B",2016020245,17122,20162017,1,60,1,4,-3,4.65649823971034,5.37233657405068,-0.715838334340333,33,38,-5,39,43,-4,49,55,-6,6,4,0,0
"3080","BUF","PIT",2016020263,17124,20162017,1,65,1,1,0,3.46047745755641,7.14121798847094,-3.68074053091453,33,47,-14,39,61,-22,52,76,-24,6,4,0,0
"3081","BUF","NYR",2016020346,17136,20162017,1,60,4,3,1,8.23208792431979,3.24694109757547,4.98514682674431,34,25,9,50,39,11,71,48,23,2,2,0,0
"3082","BUF","EDM",2016020382,17141,20162017,1,60.95,4,3,1,4.28547035792144,5.03245557725792,-0.746985219336483,26,37,-11,36,49,-13,43,62,-19,4,4,0,0
"3083","BUF","NYI",2016020453,17151,20162017,1,60.7,3,2,1,3.96722810927531,3.57441998188733,0.39280812738798,37,35,2,48,45,3,62,53,9,3,1,0,0
"3084","BUF","NYI",2016020505,17158,20162017,0,60,1,5,-4,1.9929066761834,4.67850521698711,-2.68559854080371,29,32,-3,36,45,-9,58,63,-5,2,2,0,0
"3085","BUF","NYR",2016020565,17169,20162017,0,60,4,1,3,3.00734567761538,4.55486873372138,-1.547523056106,19,25,-6,30,40,-10,45,52,-7,5,1,0,0
"3086","BUF","WPG",2016020591,17173,20162017,1,60,4,3,1,2.80252564407419,4.00082841213066,-1.19830276805646,36,35,1,45,43,2,52,60,-8,8,5,0,0
"3087","BUF","PHI",2016020613,17176,20162017,1,60,4,1,3,2.2120881669689,8.37620741769354,-6.16411925072464,27,40,-13,34,62,-28,45,81,-36,2,2,0,0
"3088","BUF","T.B",2016020626,17178,20162017,0,60,2,4,-2,4.0223287352419,4.27042571264246,-0.248096977400564,26,29,-3,34,37,-3,45,52,-7,4,5,0,0
"3089","BUF","DAL",2016020657,17182,20162017,1,60,4,1,3,6.43191193870734,6.40569168336095,0.0262202553463986,29,32,-3,39,46,-7,56,61,-5,3,1,0,0
"3090","BUF","TOR",2016020665,17183,20162017,0,60,3,4,-1,5.41792482760502,3.66699774179142,1.7509270858136,27,32,-5,37,44,-7,46,61,-15,1,1,0,0
"3091","BUF","MTL",2016020694,17187,20162017,0,61.8,3,2,1,6.0292122539322,5.39822323422413,0.630989019708068,38,38,0,43,47,-4,63,55,8,3,1,0,0
"3092","BUF","DAL",2016020738,17192,20162017,0,60,3,4,-1,5.03926726008618,4.72748028336881,0.311786976717366,27,38,-11,39,57,-18,52,74,-22,2,5,0,0
"3093","BUF","MTL",2016020745,17197,20162017,0,60,2,5,-3,9.17458805794013,4.53307371135452,4.64151434658561,39,35,4,49,48,1,65,69,-4,3,1,0,0
"3094","BUF","NYR",2016020758,17199,20162017,1,63.9333333333333,1,2,-1,6.21445064982219,6.73445880392728,-0.520008154105093,37,44,-7,57,61,-4,65,69,-4,4,4,0,0
"3095","BUF","N.J",2016020787,17203,20162017,0,60,1,2,-1,3.15233417655717,8.48557588041876,-5.33324170386159,23,39,-16,38,64,-26,58,76,-18,2,5,0,0
"3096","BUF","ANA",2016020803,17206,20162017,1,60,2,5,-3,5.5633724633808,5.23008980672603,0.333282656654774,26,44,-18,33,51,-18,40,67,-27,2,3,0,0
"3097","BUF","TOR",2016020821,17208,20162017,0,60,3,1,2,2.11991458450211,5.72250388000975,-3.60258929550764,23,44,-21,33,62,-29,44,82,-38,2,4,0,0
"3098","BUF","COL",2016020847,17213,20162017,1,60,2,0,2,5.28156833327375,3.92073878552037,1.36082954775338,32,23,9,40,32,8,51,46,5,3,0,0,0
"3099","BUF","COL",2016020910,17222,20162017,0,60,3,5,-2,6.49596383900501,4.1950171448152,2.30094669418981,37,30,7,50,44,6,66,53,13,5,3,0,0
"3100","BUF","T.B",2016020953,17229,20162017,1,65,1,1,0,2.27697228131001,4.83698548987741,-2.5600132085674,32,32,0,41,46,-5,50,59,-9,3,2,0,0
"3101","BUF","PIT",2016020964,17230,20162017,0,60,3,4,-1,5.60622537786276,3.11557165211707,2.49065372574569,49,45,4,55,53,2,61,65,-4,6,6,0,0
"3102","BUF","PHI",2016020973,17232,20162017,1,60,3,6,-3,0,0,0,34,30,4,44,39,5,55,56,-1,4,3,0,0
"3103","BUF","ANA",2016021052,17242,20162017,0,65,1,1,0,2.65322474029381,8.10894809136516,-5.45572335107136,31,40,-9,43,62,-19,65,76,-11,1,0,0,0
"3104","BUF","PIT",2016021076,17246,20162017,1,60,1,3,-2,3.87527002502497,3.92969989044832,-0.0544298654233479,30,35,-5,43,43,0,55,54,1,1,3,0,0
"3105","BUF","TOR",2016021107,17250,20162017,1,60,5,2,3,6.75916191336337,5.84576425458363,0.913397658779743,38,34,4,53,48,5,61,63,-2,3,4,0,0
"3106","BUF","NYI",2016021166,17258,20162017,1,60,2,4,-2,4.5148500749201,3.4986469725809,1.0162031023392,37,26,11,46,33,13,57,44,13,4,1,0,0
"3107","BUF","TOR",2016021176,17259,20162017,1,60,2,4,-2,3.51830824685749,8.49987488380759,-4.98156663695011,22,45,-23,36,57,-21,50,69,-19,3,5,0,0
"3108","BUF","MTL",2016021192,17261,20162017,1,60,2,1,1,3.41445514593215,5.25299581239233,-1.83854066646018,30,32,-2,41,48,-7,49,53,-4,0,1,0,0
"3109","BUF","T.B",2016021222,17265,20162017,0,60,2,4,-2,4.70497723622248,4.00830653004589,0.696670706176583,28,37,-9,38,45,-7,48,57,-9,1,3,0,0
"3110","BUF","MTL",2017020006,17444,20172018,1,65,2,2,0,7.80542884868919,6.82251751257502,0.982911336114171,45,40,5,61,48,13,69,63,6,5,4,0,0
"3111","BUF","NYI",2017020020,17446,20172018,0,60,3,6,-3,4.13202252103788,6.08372335827682,-1.95170083723894,29,33,-4,41,43,-2,52,54,-2,5,4,0,0
"3112","BUF","N.J",2017020034,17448,20172018,1,60,2,6,-4,0,0,0,25,31,-6,34,41,-7,47,51,-4,4,4,0,0
"3113","BUF","ANA",2017020078,17454,20172018,0,60,3,1,2,3.45755168330719,6.80355623536668,-3.34600455205949,31,26,5,41,42,-1,56,57,-1,3,4,0,0
"3114","BUF","VGK",2017020090,17456,20172018,0,63.8666666666667,4,5,-1,5.92062322725044,3.73359883284138,2.18702439440906,34,31,3,53,43,10,70,61,9,5,5,0,0
"3115","BUF","DAL",2017020207,17474,20172018,0,60,1,5,-4,2.37423026189208,3.34850028801406,-0.97427002612198,28,22,6,41,34,7,55,52,3,5,2,0,0
"3116","BUF","MTL",2017020251,17481,20172018,0,63.1333333333333,1,2,-1,4.90604845841881,3.75501864361559,1.15102981480322,35,29,6,44,41,3,50,53,-3,3,1,0,0
"3117","BUF","PIT",2017020267,17484,20172018,0,60.2666666666667,4,5,-1,3.20904244597735,8.76013014162891,-5.55108769565156,32,45,-13,41,61,-20,45,81,-36,5,7,0,0
"3118","BUF","MIN",2017020319,17492,20172018,1,60,4,5,-1,6.3344358976683,3.76970435310248,2.56473154456581,34,32,2,48,37,11,63,44,19,3,3,0,0
"3119","BUF","EDM",2017020339,17494,20172018,1,60,3,1,2,6.24920048681723,4.35873272432946,1.89046776248778,31,30,1,40,39,1,53,61,-8,3,3,0,0
"3120","BUF","MTL",2017020349,17495,20172018,0,60,0,3,-3,4.92035843139456,3.15006510462899,1.77029332676557,36,26,10,48,37,11,78,52,26,2,2,0,0
"3121","BUF","T.B",2017020367,17498,20172018,1,60,0,2,-2,3.33474257402122,5.51220924553402,-2.1774666715128,34,26,8,47,40,7,58,49,9,3,3,0,0
"3122","BUF","PIT",2017020388,17501,20172018,1,60,0,4,-4,4.12741022474725,4.09831072063918,0.0290995041080633,34,25,9,43,37,6,57,47,10,5,2,0,0
"3123","BUF","PIT",2017020400,17502,20172018,0,60,1,5,-4,3.83290436464245,7.0527771787747,-3.21987281413226,33,29,4,47,40,7,63,54,9,5,7,0,0
"3124","BUF","COL",2017020422,17505,20172018,0,60,4,2,2,3.45596820185892,4.48761896932797,-1.03165076746905,35,37,-2,48,53,-5,63,75,-12,4,7,0,0
"3125","BUF","PHI",2017020480,17514,20172018,0,60,1,2,-1,3.23331335172497,3.09206483922753,0.141248512497441,20,27,-7,29,43,-14,48,55,-7,1,2,0,0
"3126","BUF","PHI",2017020539,17522,20172018,1,60,4,2,2,5.09368758873188,3.32951365050006,1.76417393823182,37,35,2,48,44,4,58,58,0,2,5,0,0
"3127","BUF","NYI",2017020560,17527,20172018,0,61.1333333333333,2,3,-1,3.82300997411949,5.02930407038434,-1.20629409626486,37,34,3,47,45,2,62,57,5,4,2,0,0
"3128","BUF","N.J",2017020576,17529,20172018,0,62.6166666666667,4,3,1,3.83099653501995,4.73285465729714,-0.90185812227719,29,38,-9,43,45,-2,52,54,-2,3,2,0,0
"3129","BUF","NYR",2017020601,17532,20172018,1,62.7166666666667,2,3,-1,4.57792146055499,4.2153693123862,0.362552148168788,33,42,-9,48,50,-2,58,61,-3,5,3,0,0
"3130","BUF","MIN",2017020622,17535,20172018,0,60,2,6,-4,4.23619469081702,2.88842783066332,1.3477668601537,31,27,4,40,39,1,48,52,-4,3,1,0,0
"3131","BUF","WPG",2017020631,17536,20172018,0,60,3,4,-1,3.26678403757978,3.28872158235635,-0.0219375447765628,29,29,0,46,38,8,69,51,18,5,4,0,0
"3132","BUF","PHI",2017020643,17538,20172018,0,60,1,4,-3,4.81073063763324,7.32683475976228,-2.51610412212904,31,29,2,39,42,-3,50,53,-3,4,4,0,0
"3133","BUF","WPG",2017020653,17540,20172018,1,60,4,7,-3,3.7398872575418,4.24944462185522,-0.509557364313423,34,37,-3,47,47,0,56,54,2,3,4,0,0
"3134","BUF","NYR",2017020697,17549,20172018,0,60,3,4,-1,6.56952721572634,3.7903106375461,2.77921657818024,37,34,3,51,47,4,70,61,9,6,4,0,0
"3135","BUF","DAL",2017020708,17551,20172018,1,60,1,7,-6,6.53831258753897,4.26891465169383,2.26939793584514,27,32,-5,42,38,4,52,48,4,5,3,0,0
"3136","BUF","EDM",2017020739,17554,20172018,0,60,5,0,5,6.34377941605635,6.88609552331036,-0.54231610725401,34,33,1,40,50,-10,48,70,-22,4,2,0,0
"3137","BUF","N.J",2017020762,17561,20172018,1,60,1,3,-2,6.14454395824578,5.18102745262513,0.963516505620646,28,28,0,38,37,1,56,47,9,4,0,0,0
"3138","BUF","ANA",2017020812,17568,20172018,1,61.6,3,4,-1,2.48988111050545,5.80064705490913,-3.31076594440368,33,34,-1,41,48,-7,55,62,-7,3,4,0,0
"3139","BUF","NYI",2017020826,17570,20172018,1,60,4,3,1,3.16519621460361,3.98143499103026,-0.816238776426644,22,29,-7,31,42,-11,40,49,-9,2,3,0,0
"3140","BUF","COL",2017020856,17573,20172018,1,60,4,5,-1,0,0,0,33,27,6,51,40,11,58,50,8,6,6,0,0
"3141","BUF","T.B",2017020865,17575,20172018,1,60,5,3,2,6.97125203754001,5.33995789848268,1.63129413905733,33,29,4,47,40,7,59,48,11,3,5,0,0
"3142","BUF","T.B",2017020979,17590,20172018,0,61.4333333333333,2,1,1,3.86847963956825,2.48354285311871,1.38493678644954,34,22,12,49,34,15,62,50,12,4,1,0,0
"3143","BUF","TOR",2017021015,17595,20172018,1,60,5,3,2,4.12462270798278,5.89296510230633,-1.76834239432355,24,41,-17,35,52,-17,40,65,-25,2,2,0,0
"3144","BUF","VGK",2017021049,17600,20172018,1,65,1,1,0,4.83511139738201,5.86214011808852,-1.02702872070651,32,34,-2,51,43,8,58,58,0,2,2,0,0
"3145","BUF","TOR",2017021083,17605,20172018,1,60,2,5,-3,5.19399806191768,5.32550878188324,-0.131510719965566,40,39,1,51,46,5,69,55,14,5,3,0,0
"3146","BUF","MTL",2017021146,17613,20172018,1,60,0,3,-3,4.22215433428221,3.46654642875365,0.755607905528563,35,24,11,48,34,14,56,40,16,2,2,0,0
"3147","BUF","NYR",2017021159,17614,20172018,0,60,1,5,-4,6.06266118183254,4.33005463694099,1.73260654489155,44,23,21,60,37,23,67,47,20,3,3,0,0
"3148","BUF","TOR",2017021168,17616,20172018,0,60,3,2,1,3.65727547605275,3.93368103005923,-0.276405554006487,27,41,-14,33,67,-34,41,86,-45,0,1,0,0
"3149","BUF","TOR",2017021223,17623,20172018,0,60,2,5,-3,5.049936957721,5.18110418412834,-0.131167226407342,34,36,-2,53,44,9,68,56,12,4,3,0,0
"3150","BUF","T.B",2017021254,17627,20172018,0,60,5,7,-2,3.43897604935592,4.67117265013803,-1.23219660078212,32,34,-2,41,44,-3,52,55,-3,5,3,0,0
"3151","BUF","NYR",2018020017,17810,20182019,1,60,3,1,2,4.79084119089703,4.61071382071077,0.180127370186256,29,44,-15,45,55,-10,58,68,-10,6,5,0,0
"3152","BUF","VGK",2018020034,17812,20182019,1,60,4,2,2,4.69622183519095,3.71973446196492,0.976487373226037,17,37,-20,29,53,-24,35,67,-32,2,2,0,0
"3153","BUF","COL",2018020046,17815,20182019,1,60,1,6,-5,4.94534571190889,4.10542624697598,0.839919464932905,31,30,1,48,41,7,58,43,15,7,4,0,0
"3154","BUF","VGK",2018020085,17820,20182019,0,60,1,4,-3,3.32779715440455,4.49431705977622,-1.16651990537167,27,29,-2,33,35,-2,51,58,-7,6,3,0,0
"3155","BUF","ANA",2018020117,17825,20182019,0,60,4,2,2,6.8371633839585,3.81036177220847,3.02680161175003,45,28,17,60,36,24,71,43,28,4,2,0,0
"3156","BUF","MTL",2018020135,17829,20182019,1,60,4,3,1,5.63679733805475,3.19648405880434,2.4403132792504,42,22,20,57,32,25,66,45,21,4,2,0,0
"3157","BUF","NYR",2018020208,17839,20182019,0,60,1,3,-2,5.42079773626756,5.17591216659639,0.244885569671169,40,22,18,55,34,21,72,43,29,4,1,0,0
"3158","BUF","MTL",2018020230,17843,20182019,0,61.6333333333333,6,5,1,3.68915456484274,4.99600288202979,-1.30684831718705,31,37,-6,35,49,-14,50,65,-15,3,5,0,0
"3159","BUF","T.B",2018020264,17848,20182019,1,60,2,1,1,3.84640460612718,4.6146115718002,-0.768206965673016,19,30,-11,27,48,-21,36,65,-29,2,2,0,0
"3160","BUF","WPG",2018020287,17851,20182019,0,65,1,1,0,3.16731981832709,2.67124793020776,0.496071888119332,32,26,6,41,39,2,53,53,0,3,1,0,0
"3161","BUF","MIN",2018020294,17852,20182019,0,60,3,2,1,5.20949636609294,4.82854607116315,0.380950294929789,29,39,-10,45,51,-6,57,63,-6,1,3,0,0
"3162","BUF","PIT",2018020310,17854,20182019,0,60.75,5,4,1,6.29188085443489,4.41309945664761,1.87878139778728,40,40,0,50,47,3,65,54,11,3,3,0,0
"3163","BUF","PHI",2018020318,17856,20182019,1,60,5,2,3,5.74939294892829,2.97904884386662,2.77034410506167,21,25,-4,29,35,-6,39,44,-5,3,1,0,0
"3164","BUF","MTL",2018020333,17858,20182019,1,63.1,3,2,1,7.92816605698317,5.80080634790978,2.1273597090734,40,33,7,50,48,2,62,64,-2,4,2,0,0
"3165","BUF","T.B",2018020385,17864,20182019,0,60,4,5,-1,2.70754877070794,3.32343450393091,-0.615885733222967,22,37,-15,31,49,-18,39,59,-20,2,4,0,0
"3166","BUF","TOR",2018020416,17869,20182019,1,64.95,3,4,-1,4.50517130619846,4.01857717022358,0.486594135974883,41,30,11,49,41,8,60,63,-3,2,2,0,0
"3167","BUF","PHI",2018020444,17873,20182019,1,60,2,6,-4,2.94181571061228,4.30968948715919,-1.36787377654691,30,41,-11,42,48,-6,52,59,-7,2,3,0,0
"3168","BUF","ANA",2018020551,17887,20182019,1,60,3,0,3,3.02062267637666,5.24799924105749,-2.22737656468082,33,40,-7,38,50,-12,49,65,-16,4,3,0,0
"3169","BUF","NYI",2018020601,17896,20182019,1,60,1,3,-2,3.07811067361035,6.55560058983974,-3.47748991622939,40,33,7,49,45,4,65,56,9,2,2,0,0
"3170","BUF","N.J",2018020658,17904,20182019,1,60,5,1,4,5.8300636212688,5.46632056843411,0.363743052834685,33,21,12,46,34,12,65,45,20,2,5,0,0
"3171","BUF","T.B",2018020689,17908,20182019,1,60,3,5,-2,3.20862616180425,4.17751129576936,-0.968885133965117,33,30,3,45,44,1,55,51,4,4,3,0,0
"3172","BUF","EDM",2018020710,17910,20182019,0,60,2,7,-5,5.00445974757167,2.93329843395622,2.07116131361545,43,25,18,57,31,26,72,37,35,4,1,0,0
"3173","BUF","DAL",2018020777,17926,20182019,0,60,0,1,-1,4.98083057358539,2.13916942111973,2.84166115246566,30,27,3,46,38,8,65,48,17,1,1,0,0
"3174","BUF","MIN",2018020810,17932,20182019,1,65,4,4,0,7.11225122726207,8.20917196972005,-1.09692074245797,39,45,-6,45,58,-13,54,70,-16,2,3,0,0
"3175","BUF","WPG",2018020854,17937,20182019,1,60,1,3,-2,5.1376215351047,5.98372006739373,-0.846098532289034,36,29,7,49,41,8,66,51,15,5,1,0,0
"3176","BUF","NYI",2018020864,17939,20182019,1,60,3,1,2,4.85420641221572,5.34234751688189,-0.488141104666177,22,25,-3,36,37,-1,41,51,-10,1,0,0,0
"3177","BUF","NYR",2018020888,17942,20182019,1,60,2,6,-4,4.9130555234733,3.72168438544031,1.19137113803299,33,29,4,52,33,19,61,41,20,4,1,0,0
"3178","BUF","N.J",2018020906,17944,20182019,0,60,1,4,-3,2.95620983225209,3.26686888345284,-0.31065905120075,35,24,11,44,30,14,61,40,21,3,2,0,0
"3179","BUF","T.B",2018020935,17948,20182019,0,65,1,1,0,3.40055454485992,4.79414112377796,-1.39358657891805,30,40,-10,38,50,-12,49,62,-13,5,5,0,0
"3180","BUF","TOR",2018020962,17952,20182019,0,60,3,5,-2,4.07501301814045,6.52205861203674,-2.44704559389629,34,33,1,51,47,4,71,62,9,5,1,0,0
"3181","BUF","PHI",2018020970,17953,20182019,0,60,2,5,-3,4.15172164669548,5.07859836367703,-0.926876716981553,36,45,-9,45,54,-9,62,70,-8,6,5,0,0
"3182","BUF","PIT",2018020991,17956,20182019,1,64.1833333333333,4,3,1,2.77273077356363,7.40882640092387,-4.63609562736024,30,44,-14,35,54,-19,50,71,-21,3,4,0,0
"3183","BUF","TOR",2018021002,17957,20182019,0,60,2,5,-3,4.78658309167262,5.29227189915855,-0.505688807485931,37,32,5,45,44,1,58,61,-3,2,2,0,0
"3184","BUF","EDM",2018021017,17959,20182019,1,60,3,4,-1,3.87091040912492,2.98545265845314,0.885457750671776,38,27,11,50,35,15,64,47,17,3,2,0,0
"3185","BUF","COL",2018021048,17964,20182019,0,60,0,3,-3,2.90892630477902,6.47712912689894,-3.56820282211993,18,43,-25,27,54,-27,38,76,-38,3,5,0,0
"3186","BUF","DAL",2018021072,17967,20182019,1,60,0,2,-2,3.70195281822453,2.76837061847127,0.933582199753261,35,27,8,45,33,12,61,37,24,3,3,0,0
"3187","BUF","PIT",2018021083,17969,20182019,1,60,0,5,-5,4.71257849355425,2.62655036871295,2.0860281248413,26,28,-2,35,36,-1,50,54,-4,3,5,0,0
"3188","BUF","TOR",2018021132,17975,20182019,1,60,2,4,-2,4.72194439752002,4.6985687425869,0.0233756549331225,24,46,-22,37,63,-26,47,77,-30,2,3,0,0
"3189","BUF","MTL",2018021155,17978,20182019,0,60,4,7,-3,3.94903187995078,7.04157259544218,-3.0925407154914,27,44,-17,39,52,-13,48,63,-15,4,2,0,0
"3190","BUF","N.J",2018021170,17980,20182019,0,60,1,3,-2,4.70334636041571,3.16391033330001,1.5394360271157,46,21,25,52,30,22,62,34,28,3,3,0,0
"3191","BUF","NYI",2018021208,17985,20182019,0,60,1,5,-4,6.01781077357191,3.33457214317059,2.68323863040132,32,38,-6,43,51,-8,59,67,-8,2,2,0,0
"3192","CAR","FLA",2008020011,14162,20082009,1,60,6,4,2,0,0,0,24,33,-9,39,49,-10,55,73,-18,4,6,0,0
"3193","CAR","T.B",2008020023,14163,20082009,0,64.6,4,3,1,0,0,0,46,29,17,59,41,18,71,51,20,9,7,0,0
"3194","CAR","DET",2008020037,14165,20082009,1,60,1,3,-2,0,0,0,28,36,-8,36,48,-12,47,68,-21,4,6,0,0
"3195","CAR","L.A",2008020062,14169,20082009,0,63.35,3,4,-1,0,0,0,26,24,2,41,37,4,52,45,7,5,3,0,0
"3196","CAR","ANA",2008020077,14171,20082009,0,60,3,1,2,0,0,0,24,33,-9,32,55,-23,38,70,-32,4,4,0,0
"3197","CAR","PIT",2008020094,14175,20082009,0,60,1,4,-3,0,0,0,25,35,-10,33,43,-10,50,55,-5,2,3,0,0
"3198","CAR","NYI",2008020108,14177,20082009,0,60,4,3,1,0,0,0,28,60,-32,40,73,-33,58,95,-37,3,8,0,0
"3199","CAR","MTL",2008020129,14180,20082009,0,65,2,2,0,0,0,0,33,25,8,48,40,8,66,61,5,7,8,0,0
"3200","CAR","STL",2008020142,14182,20082009,0,60,1,0,1,0,0,0,29,19,10,44,38,6,61,45,16,6,3,0,0
"3201","CAR","EDM",2008020150,14184,20082009,1,60,1,3,-2,0,0,0,34,32,2,48,41,7,61,58,3,6,3,0,0
"3202","CAR","TOR",2008020163,14185,20082009,1,60,6,4,2,0,0,0,30,33,-3,52,46,6,67,58,9,6,2,0,0
"3203","CAR","TOR",2008020172,14187,20082009,0,61.8666666666667,5,4,1,0,0,0,24,42,-18,32,63,-31,57,83,-26,2,3,0,0
"3204","CAR","WSH",2008020183,14189,20082009,0,60,2,3,-1,0,0,0,34,33,1,40,42,-2,49,59,-10,3,4,0,0
"3205","CAR","OTT",2008020192,14190,20082009,1,60,2,1,1,0,0,0,30,23,7,48,36,12,75,50,25,7,6,0,0
"3206","CAR","ATL",2008020208,14192,20082009,1,60,2,5,-3,0,0,0,37,22,15,50,38,12,70,54,16,4,3,0,0
"3207","CAR","WSH",2008020223,14195,20082009,1,60,1,5,-4,0,0,0,27,37,-10,42,53,-11,60,69,-9,7,5,0,0
"3208","CAR","ATL",2008020238,14197,20082009,0,60,2,3,-1,0,0,0,29,25,4,39,35,4,55,47,8,7,8,0,0
"3209","CAR","T.B",2008020252,14199,20082009,1,65,2,2,0,0,0,0,30,28,2,46,41,5,67,57,10,5,6,0,0
"3210","CAR","MTL",2008020263,14201,20082009,1,60,2,1,1,0,0,0,48,29,19,66,42,24,91,55,36,5,6,0,0
"3211","CAR","ARI",2008020281,14204,20082009,1,60,5,2,3,0,0,0,33,28,5,53,49,4,65,68,-3,3,3,0,0
"3212","CAR","NSH",2008020297,14206,20082009,1,60,2,5,-3,0,0,0,26,30,-4,43,39,4,54,55,-1,9,6,0,0
"3213","CAR","FLA",2008020302,14207,20082009,0,60,2,3,-1,0,0,0,29,22,7,44,32,12,57,45,12,2,0,0,0
"3214","CAR","PHI",2008020312,14209,20082009,1,60,1,3,-2,0,0,0,28,27,1,43,36,7,62,52,10,6,4,0,0
"3215","CAR","PHI",2008020324,14211,20082009,0,63.8833333333333,3,2,1,0,0,0,30,26,4,46,42,4,57,54,3,4,4,0,0
"3216","CAR","ANA",2008020349,14213,20082009,1,60,1,4,-3,0,0,0,37,27,10,55,35,20,79,49,30,4,4,0,0
"3217","CAR","PIT",2008020369,14217,20082009,1,60,2,5,-3,0,0,0,36,22,14,58,31,27,82,43,39,5,3,0,0
"3218","CAR","PHI",2008020384,14219,20082009,1,63.5666666666667,1,2,-1,0,0,0,36,31,5,50,44,6,73,65,8,8,5,0,0
"3219","CAR","WSH",2008020392,14220,20082009,1,60,3,1,2,0,0,0,25,39,-14,37,54,-17,43,68,-25,4,7,0,0
"3220","CAR","PHI",2008020414,14224,20082009,0,65,5,5,0,0,0,0,31,37,-6,47,57,-10,57,66,-9,8,7,0,0
"3221","CAR","NYR",2008020435,14226,20082009,0,65,2,2,0,0,0,0,31,29,2,47,36,11,59,44,15,7,5,0,0
"3222","CAR","MTL",2008020448,14229,20082009,1,60,3,2,1,0,0,0,27,24,3,40,37,3,54,52,2,11,2,0,0
"3223","CAR","FLA",2008020462,14231,20082009,1,64.2666666666667,2,1,1,0,0,0,37,20,17,58,30,28,80,47,33,4,1,0,0
"3224","CAR","BOS",2008020474,14233,20082009,0,60,2,4,-2,0,0,0,34,36,-2,38,47,-9,43,58,-15,3,1,0,0
"3225","CAR","MTL",2008020488,14234,20082009,0,61.7166666666667,3,2,1,0,0,0,27,28,-1,48,40,8,64,57,7,4,4,0,0
"3226","CAR","MIN",2008020503,14236,20082009,0,60,2,3,-1,0,0,0,37,23,14,47,33,14,56,50,6,4,1,0,0
"3227","CAR","ATL",2008020510,14239,20082009,0,60,5,4,1,0,0,0,39,31,8,49,39,10,59,52,7,4,3,0,0
"3228","CAR","BOS",2008020518,14240,20082009,1,60,2,4,-2,0,0,0,31,22,9,52,33,19,64,54,10,4,3,0,0
"3229","CAR","ATL",2008020549,14244,20082009,1,60,3,1,2,0,0,0,28,21,7,47,34,13,66,50,16,4,4,0,0
"3230","CAR","STL",2008020560,14246,20082009,1,60,2,1,1,0,0,0,29,31,-2,46,45,1,59,60,-1,4,3,0,0
"3231","CAR","T.B",2008020570,14247,20082009,0,60,3,2,1,0,0,0,28,19,9,39,35,4,50,45,5,5,3,0,0
"3232","CAR","N.J",2008020588,14250,20082009,1,60,3,2,1,0,0,0,28,28,0,36,46,-10,51,62,-11,3,2,0,0
"3233","CAR","FLA",2008020602,14252,20082009,0,60,2,4,-2,0,0,0,33,31,2,45,39,6,55,49,6,0,2,0,0
"3234","CAR","BOS",2008020614,14254,20082009,0,60,1,5,-4,0,0,0,30,32,-2,37,47,-10,50,67,-17,3,5,0,0
"3235","CAR","OTT",2008020637,14257,20082009,0,60,1,5,-4,0,0,0,24,40,-16,39,47,-8,48,58,-10,4,4,0,0
"3236","CAR","TOR",2008020647,14259,20082009,1,60,4,6,-2,0,0,0,32,24,8,48,36,12,66,45,21,4,3,0,0
"3237","CAR","BUF",2008020663,14261,20082009,0,60,1,3,-2,0,0,0,37,26,11,49,34,15,71,43,28,5,2,0,0
"3238","CAR","TOR",2008020679,14263,20082009,0,60,2,0,2,0,0,0,34,35,-1,51,50,1,70,70,0,5,3,0,0
"3239","CAR","PIT",2008020687,14264,20082009,0,60,2,1,1,0,0,0,40,33,7,52,41,11,66,55,11,5,5,0,0
"3240","CAR","NYR",2008020702,14271,20082009,0,60,2,3,-1,0,0,0,35,31,4,48,41,7,68,50,18,4,2,0,0
"3241","CAR","T.B",2008020717,14273,20082009,1,60,3,2,1,0,0,0,31,29,2,46,38,8,57,52,5,5,4,0,0
"3242","CAR","ATL",2008020737,14275,20082009,1,60,2,0,2,0,0,0,40,19,21,53,36,17,71,54,17,2,3,0,0
"3243","CAR","VAN",2008020758,14278,20082009,0,60,3,4,-1,0,0,0,27,24,3,41,34,7,60,50,10,4,5,0,0
"3244","CAR","S.J",2008020771,14280,20082009,0,65,3,3,0,0,0,0,29,40,-11,37,56,-19,48,80,-32,4,6,0,0
"3245","CAR","ARI",2008020787,14282,20082009,0,60,7,2,5,0,0,0,41,32,9,52,43,9,61,63,-2,5,4,0,0
"3246","CAR","FLA",2008020812,14287,20082009,1,60,0,5,-5,0,0,0,42,23,19,61,35,26,81,44,37,6,6,0,0
"3247","CAR","CBJ",2008020828,14289,20082009,1,60,1,5,-4,0,0,0,27,20,7,42,31,11,71,48,23,3,4,0,0
"3248","CAR","BUF",2008020838,14290,20082009,0,60,3,0,3,0,0,0,47,36,11,60,49,11,70,64,6,5,4,0,0
"3249","CAR","BOS",2008020847,14292,20082009,1,60,1,5,-4,0,0,0,32,34,-2,41,50,-9,56,74,-18,6,5,0,0
"3250","CAR","NYI",2008020859,14294,20082009,0,60,6,2,4,0,0,0,30,24,6,43,37,6,65,54,11,3,5,0,0
"3251","CAR","T.B",2008020872,14295,20082009,1,60,4,1,3,0,0,0,41,13,28,56,26,30,73,37,36,6,3,0,0
"3252","CAR","COL",2008020888,14297,20082009,1,60,5,2,3,0,0,0,39,19,20,55,30,25,75,38,37,9,4,0,0
"3253","CAR","OTT",2008020898,14299,20082009,0,60,2,4,-2,0,0,0,43,22,21,49,31,18,68,43,25,5,3,0,0
"3254","CAR","BUF",2008020913,14301,20082009,1,65,1,1,0,0,0,0,32,37,-5,51,46,5,73,52,21,6,1,0,0
"3255","CAR","ATL",2008020930,14303,20082009,0,60,3,5,-2,0,0,0,35,32,3,42,43,-1,56,59,-3,4,3,0,0
"3256","CAR","WSH",2008020942,14306,20082009,0,60,5,2,3,0,0,0,30,41,-11,38,54,-16,46,73,-27,5,5,0,0
"3257","CAR","CGY",2008020964,14309,20082009,1,60,6,1,5,0,0,0,34,22,12,41,39,2,53,53,0,8,4,0,0
"3258","CAR","T.B",2008020977,14310,20082009,0,60,9,3,6,0,0,0,37,25,12,43,40,3,57,59,-2,6,5,0,0
"3259","CAR","NYR",2008020986,14312,20082009,1,60,3,0,3,0,0,0,36,28,8,46,35,11,59,54,5,7,5,0,0
"3260","CAR","CHI",2008021001,14314,20082009,0,65,2,2,0,0,0,0,31,41,-10,37,52,-15,42,60,-18,4,6,0,0
"3261","CAR","DAL",2008021013,14315,20082009,0,60,2,3,-1,0,0,0,31,31,0,49,39,10,62,47,15,4,3,0,0
"3262","CAR","N.J",2008021051,14321,20082009,1,60,4,2,2,0,0,0,32,43,-11,40,55,-15,61,74,-13,5,6,0,0
"3263","CAR","NYI",2008021064,14323,20082009,1,60,5,4,1,0,0,0,37,32,5,55,45,10,75,64,11,4,1,0,0
"3264","CAR","FLA",2008021086,14326,20082009,0,61.6166666666667,3,2,1,0,0,0,31,39,-8,42,51,-9,55,64,-9,1,4,0,0
"3265","CAR","OTT",2008021098,14328,20082009,1,60,2,1,1,0,0,0,30,22,8,43,29,14,59,41,18,4,2,0,0
"3266","CAR","N.J",2008021119,14331,20082009,0,60,2,1,1,0,0,0,48,32,16,56,44,12,66,53,13,5,2,0,0
"3267","CAR","NYR",2008021152,14336,20082009,1,60,4,2,2,0,0,0,23,38,-15,39,60,-21,58,85,-27,6,7,0,0
"3268","CAR","PIT",2008021169,14338,20082009,1,61.1833333333333,3,2,1,0,0,0,30,35,-5,42,46,-4,60,58,2,4,4,0,0
"3269","CAR","NYI",2008021187,14341,20082009,1,60,9,0,9,0,0,0,57,12,45,78,19,59,96,30,66,10,1,0,0
"3270","CAR","N.J",2008021214,14345,20082009,0,60,2,3,-1,0,0,0,25,35,-10,30,54,-24,38,63,-25,5,6,0,0
"3271","CAR","N.J",2008030131,14349,20082009,0,60,1,4,-3,0,0,0,19,39,-20,24,51,-27,35,63,-28,2,4,0,0
"3272","CAR","N.J",2008030132,14351,20082009,0,62.6666666666667,2,1,1,0,0,0,32,34,-2,39,43,-4,42,51,-9,4,7,0,0
"3273","CAR","N.J",2008030133,14353,20082009,1,64.9666666666667,2,3,-1,0,0,0,30,35,-5,48,52,-4,59,71,-12,6,4,0,0
"3274","CAR","N.J",2008030134,14355,20082009,1,60,4,3,1,0,0,0,46,29,17,59,38,21,72,52,20,5,4,0,0
"3275","CAR","N.J",2008030135,14357,20082009,0,60,0,1,-1,0,0,0,44,42,2,50,54,-4,72,61,11,5,4,0,0
"3276","CAR","N.J",2008030136,14360,20082009,1,60,4,0,4,0,0,0,37,28,9,50,40,10,67,54,13,6,2,0,0
"3277","CAR","N.J",2008030137,14362,20082009,0,60,4,3,1,0,0,0,31,35,-4,41,41,0,58,54,4,5,4,0,0
"3278","CAR","BOS",2008030211,14365,20082009,0,60,1,4,-3,0,0,0,27,24,3,34,33,1,50,41,9,2,4,0,0
"3279","CAR","BOS",2008030212,14367,20082009,0,60,3,0,3,0,0,0,25,36,-11,34,45,-11,51,58,-7,1,4,0,0
"3280","CAR","BOS",2008030213,14370,20082009,1,62.8,3,2,1,0,0,0,41,23,18,58,32,26,66,48,18,3,2,0,0
"3281","CAR","BOS",2008030214,14372,20082009,1,60,4,1,3,0,0,0,31,21,10,43,30,13,54,49,5,9,7,0,0
"3282","CAR","BOS",2008030215,14374,20082009,0,60,0,4,-4,0,0,0,19,40,-21,21,55,-34,30,60,-30,10,14,0,0
"3283","CAR","BOS",2008030216,14376,20082009,1,60,2,4,-2,0,0,0,33,19,14,44,29,15,56,38,18,3,2,0,0
"3284","CAR","BOS",2008030217,14378,20082009,0,78.7666666666667,3,2,1,0,0,0,37,36,1,47,52,-5,55,71,-16,2,4,0,0
"3285","CAR","PIT",2008030312,14385,20082009,0,60,4,7,-3,0,0,0,28,42,-14,36,53,-17,47,63,-16,6,6,0,0
"3286","CAR","PIT",2008030313,14387,20082009,1,60,2,6,-4,0,0,0,34,40,-6,53,50,3,75,64,11,4,5,0,0
"3287","CAR","PIT",2008030314,14390,20082009,1,60,1,4,-3,0,0,0,31,25,6,47,34,13,68,46,22,4,5,0,0
"3288","CAR","PHI",2009020005,14519,20092010,1,60,0,2,-2,0,0,0,28,27,1,48,41,7,65,49,16,10,6,0,0
"3289","CAR","BOS",2009020010,14520,20092010,0,60,2,7,-5,0,0,0,27,42,-15,38,49,-11,49,56,-7,12,12,0,0
"3290","CAR","T.B",2009020028,14523,20092010,1,65,1,1,0,0,0,0,28,30,-2,36,44,-8,52,55,-3,5,8,0,0
"3291","CAR","FLA",2009020047,14526,20092010,1,60,7,2,5,0,0,0,33,27,6,44,44,0,57,62,-5,4,7,0,0
"3292","CAR","T.B",2009020055,14527,20092010,0,60,2,5,-3,0,0,0,26,39,-13,41,48,-7,55,64,-9,6,7,0,0
"3293","CAR","N.J",2009020096,14534,20092010,0,60,0,2,-2,0,0,0,26,29,-3,33,38,-5,38,46,-8,2,4,0,0
"3294","CAR","NYI",2009020113,14538,20092010,0,65,3,3,0,0,0,0,38,29,9,53,38,15,71,42,29,4,3,0,0
"3295","CAR","COL",2009020129,14540,20092010,0,60,4,5,-1,0,0,0,36,36,0,47,44,3,64,60,4,5,6,0,0
"3296","CAR","MIN",2009020139,14541,20092010,0,61.9166666666667,2,3,-1,0,0,0,23,29,-6,41,46,-5,54,63,-9,5,9,0,0
"3297","CAR","STL",2009020157,14545,20092010,1,60,2,5,-3,0,0,0,36,18,18,60,29,31,82,37,45,6,1,0,0
"3298","CAR","PHI",2009020181,14548,20092010,0,60,1,6,-5,0,0,0,40,28,12,50,38,12,73,47,26,10,9,0,0
"3299","CAR","S.J",2009020192,14549,20092010,1,60,1,5,-4,0,0,0,26,25,1,36,41,-5,51,51,0,3,5,0,0
"3300","CAR","FLA",2009020206,14552,20092010,0,60,0,3,-3,0,0,0,32,25,7,47,33,14,56,41,15,7,8,0,0
"3301","CAR","L.A",2009020250,14559,20092010,1,60,2,5,-3,0,0,0,24,31,-7,39,44,-5,57,58,-1,2,5,0,0
"3302","CAR","NYI",2009020263,14561,20092010,1,64.75,3,4,-1,0,0,0,28,25,3,51,38,13,75,44,31,5,5,0,0
"3303","CAR","MIN",2009020280,14563,20092010,1,65,4,4,0,0,0,0,35,32,3,50,49,1,59,61,-2,6,3,0,0
"3304","CAR","MTL",2009020290,14565,20092010,0,65,2,2,0,0,0,0,32,35,-3,46,46,0,62,61,1,5,4,0,0
"3305","CAR","TOR",2009020299,14567,20092010,1,65,5,5,0,0,0,0,45,32,13,62,42,20,86,56,30,5,4,0,0
"3306","CAR","T.B",2009020318,14569,20092010,1,60,3,1,2,0,0,0,27,21,6,43,33,10,54,50,4,5,4,0,0
"3307","CAR","DAL",2009020334,14571,20092010,0,60,0,2,-2,0,0,0,22,29,-7,29,38,-9,42,57,-15,5,9,0,0
"3308","CAR","ANA",2009020351,14573,20092010,0,60,2,3,-1,0,0,0,30,33,-3,44,47,-3,53,58,-5,3,2,0,0
"3309","CAR","ATL",2009020360,14575,20092010,1,60,4,6,-2,0,0,0,36,34,2,49,44,5,70,56,14,5,2,0,0
"3310","CAR","VAN",2009020413,14583,20092010,1,60,5,3,2,0,0,0,28,36,-8,39,53,-14,51,73,-22,2,3,0,0
"3311","CAR","PIT",2009020432,14585,20092010,0,60,3,2,1,0,0,0,21,32,-11,33,47,-14,37,64,-27,5,3,0,0
"3312","CAR","N.J",2009020444,14587,20092010,0,60,2,4,-2,0,0,0,23,31,-8,28,36,-8,41,43,-2,4,5,0,0
"3313","CAR","OTT",2009020467,14590,20092010,0,60,2,4,-2,0,0,0,25,39,-14,36,50,-14,46,60,-14,2,3,0,0
"3314","CAR","DAL",2009020496,14594,20092010,1,60,5,3,2,0,0,0,29,27,2,37,38,-1,50,51,-1,5,3,0,0
"3315","CAR","FLA",2009020513,14596,20092010,0,60,3,6,-3,0,0,0,35,28,7,43,37,6,56,42,14,2,4,0,0
"3316","CAR","FLA",2009020524,14597,20092010,1,60,3,2,1,0,0,0,24,30,-6,37,38,-1,56,53,3,2,5,0,0
"3317","CAR","NYR",2009020534,14599,20092010,1,60,1,3,-2,0,0,0,33,31,2,46,44,2,64,54,10,3,1,0,0
"3318","CAR","MTL",2009020550,14601,20092010,1,60,1,5,-4,0,0,0,47,25,22,67,33,34,84,45,39,5,5,0,0
"3319","CAR","PHI",2009020561,14604,20092010,1,65,3,3,0,0,0,0,40,36,4,58,47,11,80,53,27,5,3,0,0
"3320","CAR","NYR",2009020603,14609,20092010,1,60,1,2,-1,0,0,0,18,35,-17,34,45,-11,49,62,-13,4,5,0,0
"3321","CAR","NYR",2009020611,14611,20092010,0,63.75,2,1,1,0,0,0,19,28,-9,27,47,-20,43,60,-17,4,3,0,0
"3322","CAR","NSH",2009020650,14616,20092010,0,60,2,4,-2,0,0,0,27,34,-7,37,45,-8,48,64,-16,4,7,0,0
"3323","CAR","COL",2009020656,14617,20092010,1,60,2,1,1,0,0,0,20,30,-10,34,47,-13,45,61,-16,6,8,0,0
"3324","CAR","OTT",2009020673,14619,20092010,1,60,4,1,3,0,0,0,33,32,1,48,41,7,62,55,7,3,3,0,0
"3325","CAR","TOR",2009020680,14621,20092010,0,60,4,2,2,0,0,0,18,40,-22,30,52,-22,44,64,-20,2,3,0,0
"3326","CAR","DET",2009020698,14623,20092010,0,60,1,3,-2,0,0,0,38,35,3,49,50,-1,56,69,-13,2,6,0,0
"3327","CAR","ATL",2009020715,14625,20092010,1,60,3,5,-2,0,0,0,32,37,-5,50,51,-1,72,66,6,5,3,0,0
"3328","CAR","T.B",2009020725,14627,20092010,1,60,2,3,-1,0,0,0,22,32,-10,35,47,-12,51,64,-13,4,2,0,0
"3329","CAR","ATL",2009020748,14630,20092010,0,60,5,2,3,0,0,0,22,34,-12,27,42,-15,40,61,-21,5,7,0,0
"3330","CAR","PHI",2009020761,14632,20092010,0,60,2,4,-2,0,0,0,35,30,5,46,41,5,58,52,6,6,4,0,0
"3331","CAR","BOS",2009020773,14633,20092010,1,60,5,1,4,0,0,0,20,28,-8,29,41,-12,39,66,-27,4,4,0,0
"3332","CAR","NYR",2009020787,14636,20092010,0,60,5,1,4,0,0,0,24,38,-14,29,48,-19,37,61,-24,4,5,0,0
"3333","CAR","NYI",2009020795,14637,20092010,1,60,4,1,3,0,0,0,23,27,-4,36,49,-13,47,69,-22,3,2,0,0
"3334","CAR","CHI",2009020811,14639,20092010,1,60,4,2,2,0,0,0,24,41,-17,40,60,-20,53,79,-26,2,3,0,0
"3335","CAR","EDM",2009020826,14641,20092010,0,60,2,4,-2,0,0,0,35,27,8,53,34,19,72,45,27,4,5,0,0
"3336","CAR","CGY",2009020838,14643,20092010,0,60,1,4,-3,0,0,0,28,39,-11,41,51,-10,52,62,-10,8,4,0,0
"3337","CAR","NYI",2009020860,14646,20092010,0,60,3,1,2,0,0,0,25,35,-10,35,47,-12,49,70,-21,4,5,0,0
"3338","CAR","FLA",2009020878,14649,20092010,1,60,4,1,3,0,0,0,30,20,10,44,33,11,62,44,18,4,4,0,0
"3339","CAR","N.J",2009020908,14653,20092010,1,60,5,2,3,0,0,0,31,25,6,47,35,12,67,47,20,5,4,0,0
"3340","CAR","TOR",2009020924,14670,20092010,0,60,5,1,4,0,0,0,30,33,-3,38,53,-15,53,66,-13,1,3,0,0
"3341","CAR","OTT",2009020944,14672,20092010,1,60,4,1,3,0,0,0,21,26,-5,29,44,-15,38,63,-25,3,2,0,0
"3342","CAR","FLA",2009020959,14674,20092010,0,60,1,4,-3,0,0,0,32,30,2,49,39,10,68,42,26,7,4,0,0
"3343","CAR","ATL",2009020968,14675,20092010,0,60,4,0,4,0,0,0,33,27,6,39,35,4,54,51,3,8,4,0,0
"3344","CAR","PIT",2009020993,14679,20092010,1,60.3833333333333,4,3,1,0,0,0,21,40,-19,26,59,-33,30,75,-45,4,2,0,0
"3345","CAR","BOS",2009021029,14684,20092010,1,60,2,5,-3,0,0,0,32,37,-5,45,57,-12,63,67,-4,5,5,0,0
"3346","CAR","PIT",2009021057,14688,20092010,0,64.9833333333333,3,2,1,0,0,0,29,25,4,37,43,-6,52,56,-4,5,3,0,0
"3347","CAR","T.B",2009021084,14691,20092010,0,60.4833333333333,2,3,-1,0,0,0,29,27,2,41,45,-4,56,70,-14,0,3,0,0
"3348","CAR","ATL",2009021116,14695,20092010,1,60,0,4,-4,0,0,0,34,43,-9,53,59,-6,71,71,0,4,3,0,0
"3349","CAR","ATL",2009021129,14697,20092010,0,60,4,1,3,0,0,0,22,27,-5,29,32,-3,49,51,-2,4,7,0,0
"3350","CAR","MTL",2009021143,14699,20092010,0,60,2,1,1,0,0,0,27,35,-8,38,47,-9,51,68,-17,3,4,0,0
"3351","CAR","OTT",2009021153,14700,20092010,0,65,3,3,0,0,0,0,31,35,-4,40,58,-18,59,81,-22,2,2,0,0
"3352","CAR","N.J",2009021169,14702,20092010,1,60,0,4,-4,0,0,0,26,29,-3,41,46,-5,56,61,-5,3,3,0,0
"3353","CAR","T.B",2009021187,14705,20092010,0,60,8,5,3,0,0,0,41,37,4,49,53,-4,62,68,-6,4,3,0,0
"3354","CAR","MTL",2009021199,14707,20092010,1,60,5,2,3,0,0,0,33,32,1,38,51,-13,57,67,-10,1,2,0,0
"3355","CAR","BOS",2009021212,14709,20092010,0,60,2,4,-2,0,0,0,35,42,-7,45,53,-8,56,65,-9,4,5,0,0
"3356","CAR","MIN",2010020003,14889,20102011,0,60,4,3,1,3.03147175791673,4.19284423772478,-1.16137247980805,31,29,2,40,37,3,59,56,3,5,5,0,0
"3357","CAR","MIN",2010020008,14890,20102011,1,65,1,1,0,4.51614154528943,5.5347172919719,-1.01857574668247,37,42,-5,43,58,-15,58,70,-12,7,6,0,0
"3358","CAR","OTT",2010020043,14896,20102011,0,60,2,3,-1,3.58858880069602,6.38324309294694,-2.79465429225093,24,39,-15,33,50,-17,41,62,-21,4,3,0,0
"3359","CAR","VAN",2010020068,14899,20102011,0,60,1,5,-4,5.50093855134389,3.43984165981965,2.06109689152424,33,28,5,50,44,6,65,70,-5,8,7,0,0
"3360","CAR","S.J",2010020077,14901,20102011,0,60,5,2,3,3.54089610286428,5.61098932739081,-2.07009322452653,31,43,-12,43,49,-6,58,69,-11,5,6,0,0
"3361","CAR","L.A",2010020081,14902,20102011,0,60,3,4,-1,5.36020672755694,3.81311274884501,1.54709397871193,30,27,3,42,39,3,53,45,8,3,4,0,0
"3362","CAR","NYR",2010020138,14911,20102011,0,60,4,3,1,5.79367741598981,4.46201629599909,1.33166111999071,38,43,-5,45,52,-7,67,64,3,5,7,0,0
"3363","CAR","PIT",2010020147,14912,20102011,1,60,0,3,-3,2.99430186366953,3.69868850766215,-0.704386643992621,33,31,2,49,44,5,67,61,6,8,3,0,0
"3364","CAR","PHI",2010020158,14914,20102011,0,60,2,3,-1,4.5115055176575,5.5274879657328,-1.01598244807531,28,37,-9,44,51,-7,67,67,0,3,5,0,0
"3365","CAR","NYI",2010020166,14916,20102011,1,60,7,2,5,3.36766882994561,6.15108679120951,-2.78341796126389,32,33,-1,41,52,-11,56,66,-10,4,3,0,0
"3366","CAR","FLA",2010020182,14918,20102011,0,60,4,7,-3,5.7424608732108,5.04976735120499,0.692693522005811,31,50,-19,46,61,-15,56,74,-18,7,2,0,0
"3367","CAR","FLA",2010020192,14919,20102011,1,60,3,2,1,5.42046048342308,3.88319083061651,1.53726965280657,29,20,9,40,30,10,66,49,17,5,2,0,0
"3368","CAR","EDM",2010020205,14922,20102011,1,60,7,1,6,3.32037047638736,3.686703744086,-0.366333267698643,42,22,20,55,38,17,69,54,15,7,4,0,0
"3369","CAR","PHI",2010020220,14924,20102011,1,60,1,8,-7,6.07476066073286,4.45771642611561,1.61704423461725,36,26,10,55,41,14,77,50,27,4,2,0,0
"3370","CAR","MTL",2010020236,14926,20102011,0,60,2,7,-5,3.67487731782268,4.73892871671263,-1.06405139888995,30,33,-3,43,46,-3,62,51,11,7,7,0,0
"3371","CAR","OTT",2010020261,14930,20102011,1,60,7,1,6,5.28351438755027,6.31508966023055,-1.03157527268028,28,24,4,43,42,1,47,58,-11,9,6,0,0
"3372","CAR","PIT",2010020274,14932,20102011,0,65,4,4,0,4.42368977423757,5.23795336471812,-0.81426359048055,34,36,-2,53,49,4,69,66,3,2,2,0,0
"3373","CAR","NSH",2010020288,14933,20102011,1,65,1,1,0,4.58261148398742,4.4880544293407,0.0945570546467227,22,27,-5,34,50,-16,41,60,-19,3,3,0,0
"3374","CAR","BOS",2010020321,14939,20102011,0,60,3,0,3,2.96407969298889,7.90629776462447,-4.94221807163558,21,37,-16,24,49,-25,37,65,-28,3,4,0,0
"3375","CAR","DAL",2010020349,14942,20102011,1,60,1,4,-3,4.88055200286908,4.03004588740441,0.850506115464668,28,33,-5,44,41,3,63,54,9,8,6,0,0
"3376","CAR","COL",2010020374,14946,20102011,1,61.2666666666667,2,1,1,3.86529025924392,5.29480038931797,-1.42951013007405,30,35,-5,45,50,-5,60,66,-6,2,3,0,0
"3377","CAR","NSH",2010020386,14947,20102011,0,60,2,5,-3,3.1707406406058,5.16847767920081,-1.99773703859501,30,39,-9,45,48,-3,60,58,2,4,1,0,0
"3378","CAR","DAL",2010020422,14953,20102011,0,65,1,1,0,2.20768328910572,5.71437141182124,-3.50668812271553,23,29,-6,34,49,-15,52,65,-13,5,4,0,0
"3379","CAR","STL",2010020432,14954,20102011,0,65,1,1,0,2.83374127890988,6.63777926861076,-3.80403798970087,29,39,-10,42,62,-20,48,75,-27,2,5,0,0
"3380","CAR","FLA",2010020456,14958,20102011,0,60,4,3,1,4.89752336306992,4.213001095457,0.68452226761292,34,27,7,42,40,2,63,49,14,4,3,0,0
"3381","CAR","ATL",2010020462,14959,20102011,0,65,2,2,0,3.93067153357468,4.65711003273282,-0.726438499158135,29,47,-18,40,64,-24,56,81,-25,2,4,0,0
"3382","CAR","ANA",2010020476,14961,20102011,1,60,4,2,2,6.13257894593698,8.37380899320124,-2.24123004726425,32,45,-13,47,62,-15,65,80,-15,5,8,0,0
"3383","CAR","T.B",2010020492,14963,20102011,0,60,1,5,-4,3.66706135039567,5.96289786421703,-2.29583651382136,22,34,-12,35,47,-12,58,60,-2,6,5,0,0
"3384","CAR","MTL",2010020511,14966,20102011,1,60,2,3,-1,3.79588509356836,5.43890994272078,-1.64302484915243,24,29,-5,34,43,-9,49,57,-8,3,2,0,0
"3385","CAR","TOR",2010020536,14971,20102011,0,60,4,3,1,5.3931113387704,4.2198558990541,1.17325543971629,27,37,-10,40,51,-11,59,69,-10,5,7,0,0
"3386","CAR","OTT",2010020547,14972,20102011,0,60,4,0,4,3.35666830014088,7.75540301975441,-4.39873471961353,31,37,-6,35,52,-17,46,69,-23,4,4,0,0
"3387","CAR","N.J",2010020569,14975,20102011,1,60,6,3,3,5.17367329541594,3.13254113942402,2.04113215599192,25,28,-3,30,40,-10,43,55,-12,7,2,0,0
"3388","CAR","FLA",2010020582,14977,20102011,1,61.2666666666667,3,4,-1,6.16096985188011,5.02187317106063,1.13909668081948,37,28,9,60,45,15,75,66,9,4,2,0,0
"3389","CAR","NYR",2010020591,14979,20102011,0,63.15,1,2,-1,2.98782342999766,5.53878023623363,-2.55095680623597,32,35,-3,38,57,-19,51,67,-16,3,3,0,0
"3390","CAR","FLA",2010020606,14981,20102011,0,60,5,3,2,6.82841399280005,6.99331662543597,-0.164902632635922,35,35,0,46,40,6,54,55,-1,3,3,0,0
"3391","CAR","ATL",2010020623,14983,20102011,1,62.15,4,3,1,5.66190923073153,5.28109531612427,0.38081391460727,34,28,6,46,40,6,58,55,3,4,4,0,0
"3392","CAR","CGY",2010020636,14985,20102011,1,65,5,5,0,5.23006155699841,5.41356695156628,-0.183505394567874,30,32,-2,45,50,-5,61,67,-6,6,3,0,0
"3393","CAR","T.B",2010020664,14989,20102011,1,60,6,4,2,5.20830787541229,6.0004190452164,-0.792111169804116,31,34,-3,43,60,-17,58,80,-22,6,5,0,0
"3394","CAR","BOS",2010020677,14991,20102011,0,60,0,7,-7,4.89370874011527,5.77145690105681,-0.877748160941536,31,38,-7,40,52,-12,56,72,-16,5,5,0,0
"3395","CAR","BOS",2010020686,14992,20102011,1,60,2,3,-1,6.76012527296552,5.95424143713899,0.805883835826535,45,28,17,59,41,18,87,53,34,5,6,0,0
"3396","CAR","NYR",2010020701,14994,20102011,1,60,4,1,3,4.57738816272467,8.32419645797927,-3.7468082952546,39,40,-1,46,61,-15,56,68,-12,2,2,0,0
"3397","CAR","PIT",2010020717,14996,20102011,0,60,2,3,-1,3.00735187446439,4.45491998828976,-1.44756811382537,26,31,-5,34,44,-10,52,55,-3,7,6,0,0
"3398","CAR","TOR",2010020729,14998,20102011,1,60,6,4,2,5.3106963000441,4.95838043298843,0.352315867055662,28,30,-2,50,49,1,68,64,4,10,6,0,0
"3399","CAR","NYI",2010020743,15000,20102011,0,60,4,2,2,4.16960161881434,4.13213241722673,0.0374692015876148,31,25,6,45,42,3,55,60,-5,7,5,0,0
"3400","CAR","BOS",2010020755,15006,20102011,1,60,2,3,-1,7.99039713689126,4.64848573512074,3.34191140177052,26,33,-7,49,43,6,72,56,16,4,0,0,0
"3401","CAR","TOR",2010020771,15008,20102011,0,60,0,3,-3,6.49751976761036,5.26159020722844,1.23592956038192,27,41,-14,42,56,-14,70,69,1,4,4,0,0
"3402","CAR","ATL",2010020788,15010,20102011,1,62.8,4,3,1,6.99422735335511,7.08495396950934,-0.0907266161542282,37,37,0,50,53,-3,63,68,-5,8,8,0,0
"3403","CAR","N.J",2010020802,15013,20102011,0,62.7,2,3,-1,2.63115950688371,4.58578305493575,-1.95462354805204,22,34,-12,31,47,-16,38,59,-21,3,0,0,0
"3404","CAR","PHI",2010020817,15015,20102011,0,60,1,2,-1,5.63756159199932,5.79207158366255,-0.154509991663231,32,25,7,46,35,11,63,51,12,5,6,0,0
"3405","CAR","T.B",2010020832,15017,20102011,0,61.5333333333333,3,4,-1,3.38459569876971,5.447345308683,-2.06274960991329,34,41,-7,47,50,-3,67,64,3,8,7,0,0
"3406","CAR","ATL",2010020840,15018,20102011,0,60,3,2,1,2.40424238191918,6.12335169980156,-3.71910931788238,17,43,-26,23,57,-34,45,65,-20,2,2,0,0
"3407","CAR","N.J",2010020856,15021,20102011,0,60,2,3,-1,6.6433629673616,1.96395275100076,4.67941021636084,27,22,5,35,31,4,48,40,8,3,2,0,0
"3408","CAR","PHI",2010020871,15023,20102011,1,60,3,2,1,4.29293556741322,4.48016694206726,-0.187231374654033,29,23,6,41,42,-1,58,69,-11,7,3,0,0
"3409","CAR","N.J",2010020880,15024,20102011,1,60,1,4,-3,4.17474955800571,7.66576319094747,-3.49101363294176,25,25,0,39,39,0,56,49,7,5,5,0,0
"3410","CAR","NYR",2010020896,15027,20102011,1,65,3,3,0,6.42593232130821,6.71108797049965,-0.285155649191438,33,46,-13,46,63,-17,72,87,-15,3,4,0,0
"3411","CAR","PIT",2010020916,15030,20102011,1,60,4,1,3,4.21140500280308,5.11965220452603,-0.908247201722954,21,34,-13,32,47,-15,41,63,-22,4,3,0,0
"3412","CAR","MTL",2010020928,15031,20102011,0,60,3,4,-1,3.16432717643329,3.18802518080099,-0.0236980043676982,31,27,4,42,37,5,58,53,5,3,1,0,0
"3413","CAR","FLA",2010020944,15034,20102011,1,60,2,1,1,6.23408595139335,7.14614031417295,-0.9120543627796,22,42,-20,39,60,-21,52,80,-28,2,1,0,0
"3414","CAR","CHI",2010020970,15037,20102011,0,60,2,5,-3,1.95108592030365,1.69171602322108,0.259369897082578,20,29,-9,31,41,-10,41,49,-8,2,2,0,0
"3415","CAR","ATL",2010021002,15042,20102011,1,61.6333333333333,2,3,-1,7.24768089173449,5.37440992193297,1.87327096980152,37,29,8,56,40,16,79,51,28,3,2,0,0
"3416","CAR","TOR",2010021051,15049,20102011,1,60,1,3,-2,5.76086542123812,3.46960797962782,2.2912574416103,37,19,18,52,28,24,84,36,48,5,3,0,0
"3417","CAR","NYI",2010021068,15051,20102011,1,63.9666666666667,3,2,1,5.31968284961366,5.28903857444675,0.0306442751669067,35,37,-2,50,48,2,73,65,8,2,4,0,0
"3418","CAR","OTT",2010021091,15055,20102011,1,60,4,3,1,3.85023129512774,7.33341188248687,-3.48318058735913,24,39,-15,32,59,-27,47,79,-32,4,4,0,0
"3419","CAR","T.B",2010021115,15058,20102011,0,60,4,3,1,2.40738049306104,3.76082511879304,-1.353444625732,39,21,18,50,34,16,65,47,18,7,6,0,0
"3420","CAR","T.B",2010021121,15059,20102011,1,60,2,4,-2,4.71804828060869,8.09347330058517,-3.37542501997648,35,32,3,43,41,2,67,51,16,5,4,0,0
"3421","CAR","MTL",2010021147,15063,20102011,1,60,6,2,4,7.18095712500508,7.41855467333517,-0.237597548330086,35,40,-5,51,50,1,65,73,-8,4,3,0,0
"3422","CAR","NYI",2010021170,15066,20102011,0,60,4,2,2,4.74772941480108,4.25534197269008,0.492387442111002,26,31,-5,40,39,1,58,52,6,4,5,0,0
"3423","CAR","DET",2010021196,15070,20102011,1,60,3,0,3,4.94439615801093,7.28443776210042,-2.34004160408949,32,42,-10,49,63,-14,64,79,-15,4,2,0,0
"3424","CAR","ATL",2010021208,15072,20102011,0,60,6,1,5,4.69818690681132,4.17712970206048,0.521057204750832,32,19,13,38,32,6,55,40,15,8,2,0,0
"3425","CAR","T.B",2010021219,15073,20102011,1,60,2,6,-4,5.0952278287441,7.65238684722863,-2.55715901848453,44,35,9,61,46,15,82,61,21,7,1,0,0
"3426","CAR","T.B",2011020004,15254,20112012,1,60,1,5,-4,6.56641479863687,7.47769303830137,-0.911278239664497,33,34,-1,46,43,3,69,60,9,5,6,0,0
"3427","CAR","N.J",2011020026,15257,20112012,0,60,2,4,-2,3.10565750541641,1.86914765180981,1.23650985360661,26,26,0,34,35,-1,44,39,5,7,7,0,0
"3428","CAR","BOS",2011020036,15259,20112012,1,60,3,2,1,4.29788462169377,5.98050518520176,-1.68262056350799,34,28,6,44,47,-3,62,69,-7,4,5,0,0
"3429","CAR","BOS",2011020069,15265,20112012,0,60,4,1,3,4.14946312364191,3.33440990467653,0.815053218965383,23,34,-11,35,46,-11,49,62,-13,11,6,0,0
"3430","CAR","STL",2011020093,15268,20112012,0,63.9666666666667,2,3,-1,3.51652764703613,8.08167366179987,-4.56514601476374,29,43,-14,45,55,-10,59,65,-6,2,1,0,0
"3431","CAR","WPG",2011020103,15269,20112012,0,60,3,5,-2,3.49515692148725,4.2136215762591,-0.718464654771849,24,24,0,36,40,-4,44,51,-7,7,6,0,0
"3432","CAR","OTT",2011020115,15272,20112012,1,65,2,2,0,6.76578490222164,5.65755760374418,1.10822729847746,34,28,6,50,48,2,75,67,8,4,1,0,0
"3433","CAR","CHI",2011020136,15275,20112012,1,60,3,0,3,2.85570406031911,7.69517650714261,-4.83947244682349,33,30,3,42,46,-4,57,66,-9,6,4,0,0
"3434","CAR","PHI",2011020145,15276,20112012,0,60,1,5,-4,3.83009648101033,4.8269089744968,-0.996812493486473,25,34,-9,46,44,2,58,52,6,3,5,0,0
"3435","CAR","T.B",2011020162,15279,20112012,1,60,4,2,2,3.98030728247249,5.39652967296876,-1.41622239049626,31,30,1,43,52,-9,55,72,-17,2,3,0,0
"3436","CAR","DAL",2011020195,15284,20112012,1,60,2,5,-3,3.5299780772184,3.28124139213469,0.248736685083713,32,27,5,52,36,16,72,45,27,9,4,0,0
"3437","CAR","N.J",2011020204,15286,20112012,0,60,2,3,-1,2.28454904683058,7.24071444652509,-4.95616539969451,27,36,-9,29,53,-24,34,57,-23,2,4,0,0
"3438","CAR","NYR",2011020223,15289,20112012,0,60,1,5,-4,4.88051489999956,6.71984103462273,-1.83932613462317,35,40,-5,51,47,4,68,57,11,2,3,0,0
"3439","CAR","PIT",2011020232,15290,20112012,1,60,5,3,2,4.12739296970979,7.55101485417254,-3.42362188446275,26,40,-14,34,56,-22,44,76,-32,6,7,0,0
"3440","CAR","PHI",2011020244,15292,20112012,1,60,3,5,-2,2.3561709985961,3.23642775848225,-0.880256759886151,20,28,-8,35,36,-1,56,48,8,7,8,0,0
"3441","CAR","MTL",2011020256,15294,20112012,0,60,0,4,-4,4.83451239642454,5.02934342349181,-0.194831027067266,25,36,-11,36,41,-5,57,66,-9,8,5,0,0
"3442","CAR","TOR",2011020286,15298,20112012,1,60,3,2,1,6.32117250518058,5.57690274348097,0.744269761699615,41,25,16,60,35,25,79,47,32,7,4,0,0
"3443","CAR","PHI",2011020290,15299,20112012,0,60,4,2,2,3.92511669838859,5.68964822937414,-1.76453153098555,31,32,-1,39,45,-6,50,65,-15,5,5,0,0
"3444","CAR","MTL",2011020305,15301,20112012,1,65,3,3,0,0,0,0,33,34,-1,43,54,-11,57,65,-8,4,2,0,0
"3445","CAR","WPG",2011020320,15303,20112012,1,60,1,3,-2,3.4253013265261,5.99960748522981,-2.57430615870372,21,30,-9,48,47,1,66,60,6,4,1,0,0
"3446","CAR","OTT",2011020337,15305,20112012,0,60,3,4,-1,4.30271723843543,5.14700162757587,-0.844284389140435,37,25,12,50,34,16,63,47,16,9,5,0,0
"3447","CAR","FLA",2011020348,15307,20112012,1,60,1,3,-2,3.17539927747566,4.08298431435568,-0.907585036880015,27,21,6,47,27,20,65,35,30,5,3,0,0
"3448","CAR","NYR",2011020359,15309,20112012,1,60,3,5,-2,5.94725073828886,6.4188016274129,-0.471550889124046,31,27,4,38,38,0,60,59,1,1,4,0,0
"3449","CAR","CGY",2011020398,15314,20112012,0,60,6,7,-1,4.55347758164862,7.52693364906008,-2.97345606741146,34,35,-1,47,47,0,63,64,-1,4,2,0,0
"3450","CAR","EDM",2011020404,15315,20112012,0,60,5,3,2,3.06618392919427,4.03361929004313,-0.967435360848867,33,25,8,45,37,8,62,44,18,7,5,0,0
"3451","CAR","WPG",2011020419,15317,20112012,0,60,2,4,-2,3.62445451910889,4.60630895523003,-0.981854436121139,25,37,-12,39,45,-6,60,61,-1,5,5,0,0
"3452","CAR","TOR",2011020438,15321,20112012,0,60.7333333333333,1,2,-1,2.86303106816899,4.96995320834685,-2.10692214017786,19,38,-19,30,59,-29,46,76,-30,3,3,0,0
"3453","CAR","VAN",2011020452,15323,20112012,1,60,4,3,1,5.74237734434428,8.04300912142708,-2.3006317770828,41,36,5,51,51,0,62,70,-8,8,3,0,0
"3454","CAR","FLA",2011020478,15326,20112012,0,63.1333333333333,2,3,-1,2.97591820638627,4.80091236745223,-1.82499416106596,26,25,1,37,37,0,55,50,5,3,3,0,0
"3455","CAR","OTT",2011020512,15331,20112012,1,61.6,2,1,1,8.31469846260734,4.66913407915854,3.6455643834488,38,23,15,59,40,19,83,53,30,3,1,0,0
"3456","CAR","N.J",2011020522,15334,20112012,1,60,4,2,2,0,0,0,34,25,9,45,34,11,61,50,11,3,2,0,0
"3457","CAR","TOR",2011020544,15337,20112012,1,63.15,4,3,1,5.21833765416523,3.30638919665944,1.91194845750579,34,24,10,43,42,1,54,60,-6,4,6,0,0
"3458","CAR","T.B",2011020558,15339,20112012,0,60,2,5,-3,3.70158627898491,4.49962546216542,-0.798039183180514,26,32,-6,42,47,-5,55,62,-7,6,5,0,0
"3459","CAR","NYI",2011020577,15342,20112012,1,65,3,3,0,6.09926540523884,7.57021558115957,-1.47095017592073,40,36,4,57,54,3,71,69,2,1,2,0,0
"3460","CAR","NSH",2011020607,15346,20112012,0,60,2,5,-3,1.85695497506829,4.72807879408538,-2.87112381901709,29,36,-7,34,42,-8,47,53,-6,2,5,0,0
"3461","CAR","PHI",2011020621,15349,20112012,1,60,1,2,-1,4.71625088338056,5.91368536934351,-1.19743448596295,36,37,-1,51,51,0,68,62,6,4,5,0,0
"3462","CAR","T.B",2011020634,15351,20112012,0,60,5,2,3,3.60571571340552,4.98864151474118,-1.38292580133566,32,36,-4,43,44,-1,60,57,3,1,2,0,0
"3463","CAR","BOS",2011020652,15353,20112012,1,60,4,2,2,4.91681774205063,3.9760854400738,0.940732301976823,21,35,-14,32,48,-16,47,64,-17,1,3,0,0
"3464","CAR","NYI",2011020703,15360,20112012,0,63.9666666666667,1,2,-1,2.89657869012069,5.46423248201534,-2.56765379189465,33,40,-7,44,52,-8,63,75,-12,3,2,0,0
"3465","CAR","WPG",2011020717,15362,20112012,1,60,2,1,1,2.8671919034803,7.27613289390047,-4.40894099042016,16,30,-14,24,51,-27,32,67,-35,2,3,0,0
"3466","CAR","NYI",2011020740,15370,20112012,1,60,2,5,-3,3.19900531822805,6.07076459002928,-2.87175927180124,23,26,-3,37,38,-1,60,51,9,2,4,0,0
"3467","CAR","BOS",2011020754,15372,20112012,0,60,3,0,3,4.71012757903372,5.36001858082905,-0.649891001795321,31,47,-16,43,63,-20,52,71,-19,4,2,0,0
"3468","CAR","L.A",2011020773,15374,20112012,1,60,2,1,1,4.14669009448691,6.52309862028266,-2.37640852579575,22,25,-3,31,35,-4,45,59,-14,3,2,0,0
"3469","CAR","ANA",2011020799,15378,20112012,0,62.2333333333333,2,3,-1,6.50763943366474,4.49497524476828,2.01266418889645,33,34,-1,46,46,0,63,63,0,2,1,0,0
"3470","CAR","COL",2011020814,15380,20112012,0,64.9666666666667,3,4,-1,5.52287261589663,5.18211761647763,0.340754999419005,42,33,9,60,43,17,80,55,25,3,0,0,0
"3471","CAR","MTL",2011020835,15383,20112012,0,60,5,3,2,5.94682334974021,6.73543450102443,-0.788611151284215,35,33,2,52,44,8,71,65,6,8,8,0,0
"3472","CAR","S.J",2011020859,15387,20112012,1,60,3,2,1,6.22744300447357,8.72720925181056,-2.49976624733699,25,37,-12,34,52,-18,44,70,-26,3,2,0,0
"3473","CAR","NYI",2011020868,15388,20112012,0,60,3,4,-1,4.48131550550033,2.95362610764278,1.52768939785756,36,31,5,50,39,11,71,45,26,5,4,0,0
"3474","CAR","ANA",2011020900,15393,20112012,1,65,2,2,0,4.11082726356835,9.14048341258922,-5.02965614902086,32,37,-5,47,65,-18,58,82,-24,2,5,0,0
"3475","CAR","FLA",2011020921,15395,20112012,1,65,2,2,0,5.49007003367296,8.350974181325,-2.86090414765204,28,44,-16,35,62,-27,49,81,-32,3,3,0,0
"3476","CAR","NSH",2011020940,15398,20112012,1,60,4,3,1,6.16575461528555,3.5789316106675,2.58682300461805,33,29,4,48,39,9,60,51,9,6,1,0,0
"3477","CAR","NYR",2011020953,15400,20112012,1,60,2,3,-1,4.07276628981344,7.52997937638429,-3.45721308657085,23,25,-2,35,44,-9,55,63,-8,5,4,0,0
"3478","CAR","T.B",2011020967,15402,20112012,1,62.6833333333333,3,4,-1,2.84838726866292,3.95835574575881,-1.10996847709589,28,23,5,37,34,3,50,49,1,2,4,0,0
"3479","CAR","T.B",2011021019,15409,20112012,0,60,4,2,2,4.50430377101293,4.14470729682944,0.35959647418349,26,38,-12,42,50,-8,58,63,-5,3,4,0,0
"3480","CAR","FLA",2011021026,15410,20112012,0,60,0,2,-2,3.64521223800966,3.66949148904364,-0.0242792510339731,34,33,1,46,46,0,59,59,0,4,3,0,0
"3481","CAR","NYR",2011021038,15412,20112012,0,60,2,4,-2,2.64353176471008,4.99833635403775,-2.35480458932767,29,28,1,41,46,-5,60,59,1,4,3,0,0
"3482","CAR","STL",2011021055,15414,20112012,1,60,2,0,2,3.76313136995304,3.16904159593486,0.594089774018187,30,40,-10,40,58,-18,51,72,-21,6,4,0,0
"3483","CAR","MIN",2011021067,15416,20112012,0,60,5,3,2,5.88732837329007,3.08165435181581,2.80567402147426,34,26,8,43,35,8,52,52,0,2,3,0,0
"3484","CAR","WPG",2011021081,15417,20112012,0,60,4,3,1,3.62071406216768,4.96658947308481,-1.34587541091713,35,33,2,46,48,-2,54,64,-10,5,6,0,0
"3485","CAR","FLA",2011021098,15420,20112012,1,60,3,1,2,5.60289904003412,3.79028040199134,1.81261863804278,39,31,8,52,45,7,63,63,0,7,8,0,0
"3486","CAR","CBJ",2011021113,15422,20112012,0,60,1,5,-4,6.7167746662987,4.04679003663477,2.66998462966393,40,26,14,48,33,15,58,47,11,5,3,0,0
"3487","CAR","DET",2011021123,15423,20112012,0,60,4,5,-1,4.40963612556601,7.77999217942124,-3.37035605385523,24,50,-26,31,71,-40,44,79,-35,3,3,0,0
"3488","CAR","TOR",2011021141,15426,20112012,0,60,3,0,3,1.56099169756635,2.39359215868171,-0.832600461115362,22,30,-8,34,41,-7,42,56,-14,2,2,0,0
"3489","CAR","WPG",2011021162,15429,20112012,1,60.2666666666667,3,4,-1,3.60776234847066,6.74044742526016,-3.1326850767895,33,35,-2,44,53,-9,58,68,-10,4,4,0,0
"3490","CAR","N.J",2011021173,15430,20112012,1,60,0,5,-5,5.85346275151824,3.23183806541596,2.62162468610228,22,31,-9,37,40,-3,48,50,-2,4,4,0,0
"3491","CAR","OTT",2011021193,15433,20112012,0,60,2,1,1,4.14381278791552,4.99275795911663,-0.848945171201104,31,39,-8,37,52,-15,44,69,-25,4,6,0,0
"3492","CAR","MTL",2011021206,15435,20112012,1,65,1,1,0,5.79727658160045,7.31626755748584,-1.5189909758854,29,31,-2,41,45,-4,52,60,-8,7,7,0,0
"3493","CAR","FLA",2011021225,15437,20112012,0,60,1,4,-3,4.97425539146207,3.0911819451826,1.88307344627947,35,26,9,43,34,9,57,45,12,2,2,0,0
"3494","CAR","FLA",2012020008,15724,20122013,0,60,1,5,-4,6.21305985380604,3.309533699241,2.90352615456504,42,25,17,67,29,38,81,39,42,8,7,0,0
"3495","CAR","T.B",2012020028,15727,20122013,1,60,1,4,-3,5.23819122514335,4.31248065805994,0.92571056708341,36,26,10,51,34,17,74,45,29,7,8,0,0
"3496","CAR","BOS",2012020073,15733,20122013,1,60,3,5,-2,0,0,0,32,38,-6,41,50,-9,51,61,-10,7,5,0,0
"3497","CAR","OTT",2012020102,15737,20122013,1,60,1,0,1,3.27902877944276,5.43852333803557,-2.15949455859281,35,33,2,44,48,-4,55,67,-12,4,3,0,0
"3498","CAR","PHI",2012020112,15738,20122013,0,60,3,5,-2,6.87464733480873,2.45018828638638,4.42445904842235,42,24,18,59,34,25,91,41,50,7,4,0,0
"3499","CAR","TOR",2012020123,15740,20122013,0,60,4,1,3,0,0,0,39,42,-3,48,60,-12,57,77,-20,4,5,0,0
"3500","CAR","OTT",2012020147,15743,20122013,0,62.3166666666667,3,2,1,4.47679429607524,6.21144056803314,-1.7346462719579,26,47,-21,37,64,-27,54,88,-34,2,3,0,0
"3501","CAR","PHI",2012020156,15745,20122013,0,61.7833333333333,3,4,-1,5.31227248450887,4.3029844200646,1.00928806444426,33,32,1,45,51,-6,65,62,3,5,3,0,0
"3502","CAR","NYI",2012020173,15747,20122013,0,60,6,4,2,7.61100449299556,4.53635989705799,3.07464459593757,31,28,3,41,36,5,59,57,2,4,7,0,0
"3503","CAR","N.J",2012020178,15748,20122013,0,60,4,2,2,2.9878845946223,4.68108257338167,-1.69319797875937,25,28,-3,27,41,-14,38,49,-11,5,4,0,0
"3504","CAR","TOR",2012020192,15750,20122013,1,60,3,1,2,5.11179115584151,3.25510196742835,1.85668918841317,33,23,10,50,35,15,69,51,18,3,2,0,0
"3505","CAR","MTL",2012020222,15754,20122013,0,60,0,3,-3,4.09385569389997,5.55325774871744,-1.45940205481747,19,26,-7,30,35,-5,40,50,-10,4,5,0,0
"3506","CAR","WPG",2012020240,15757,20122013,1,60,3,4,-1,4.83491423144005,5.72577870407258,-0.890864472632529,30,23,7,43,36,7,57,57,0,3,4,0,0
"3507","CAR","T.B",2012020257,15759,20122013,1,60,2,5,-3,5.00223945546895,8.24979060710757,-3.24755115163862,34,39,-5,47,49,-2,63,61,2,3,3,0,0
"3508","CAR","NYI",2012020265,15760,20122013,0,60,4,2,2,6.36938884027768,1.75958185317523,4.60980698710244,28,25,3,45,38,7,65,53,12,3,3,0,0
"3509","CAR","FLA",2012020307,15766,20122013,1,60,6,2,4,5.16692893719301,3.63972830861167,1.52720062858134,34,24,10,44,30,14,59,45,14,5,1,0,0
"3510","CAR","FLA",2012020315,15767,20122013,0,60,3,2,1,2.32102317811223,3.17559570580488,-0.854572527692653,24,36,-12,32,46,-14,43,55,-12,2,1,0,0
"3511","CAR","MTL",2012020344,15771,20122013,1,60,2,4,-2,3.8259659955952,2.11384486648603,1.71212112910916,43,28,15,56,35,21,70,47,23,7,8,0,0
"3512","CAR","N.J",2012020360,15773,20122013,1,60,6,3,3,3.26746604697109,4.14036274136743,-0.872896694396331,22,34,-12,34,45,-11,43,61,-18,3,2,0,0
"3513","CAR","T.B",2012020411,15780,20122013,0,60,1,4,-3,3.34755437285639,2.47623272700082,0.871321645855573,22,26,-4,38,35,3,59,45,14,2,1,0,0
"3514","CAR","NYR",2012020422,15782,20122013,0,65,1,1,0,4.39501200200175,5.40179604361765,-1.0067840416159,30,36,-6,45,59,-14,65,75,-10,3,3,0,0
"3515","CAR","FLA",2012020431,15783,20122013,1,60,1,4,-3,3.50765282208698,4.38004768949494,-0.872394867407962,34,44,-10,52,62,-10,71,73,-2,4,4,0,0
"3516","CAR","N.J",2012020446,15785,20122013,1,60,1,4,-3,4.20944967996184,3.32146184832709,0.887987831634746,18,23,-5,41,31,10,55,49,6,5,6,0,0
"3517","CAR","WPG",2012020482,15790,20122013,1,60,1,4,-3,4.97005820425693,5.59152209023341,-0.621463885976482,39,36,3,54,52,2,79,67,12,3,2,0,0
"3518","CAR","TOR",2012020492,15792,20122013,0,60,3,6,-3,5.8593074732089,4.91785877286271,0.941448700346193,22,36,-14,40,48,-8,57,66,-9,3,4,0,0
"3519","CAR","WPG",2012020508,15794,20122013,0,60,3,1,2,2.95178112270514,2.03604843166767,0.915732691037476,28,35,-7,42,43,-1,58,60,-2,6,3,0,0
"3520","CAR","MTL",2012020524,15796,20122013,0,60,1,4,-3,4.30880432248523,3.70312209400024,0.605682228484994,19,29,-10,39,41,-2,58,54,4,5,3,0,0
"3521","CAR","T.B",2012020546,15799,20122013,1,60,0,5,-5,9.71131664974382,6.06715522180821,3.64416142793561,45,30,15,68,44,24,89,55,34,3,1,0,0
"3522","CAR","NYR",2012020565,15801,20122013,1,60,1,4,-3,6.89088484846264,5.76824085388853,1.12264399457411,49,39,10,67,52,15,89,60,29,5,5,0,0
"3523","CAR","BOS",2012020577,15803,20122013,0,60,2,6,-4,5.12437279277401,3.15138813381054,1.97298465896347,42,36,6,56,46,10,71,59,12,1,2,0,0
"3524","CAR","BOS",2012020615,15808,20122013,1,60,4,2,2,7.89970226644073,6.61253693975953,1.2871653266812,38,30,8,57,53,4,70,70,0,3,3,0,0
"3525","CAR","OTT",2012020634,15811,20122013,0,60,2,3,-1,3.90024483801972,5.04499909393809,-1.14475425591837,34,34,0,41,41,0,60,51,9,4,4,0,0
"3526","CAR","WPG",2012020649,15813,20122013,0,61.3833333333333,3,4,-1,4.72553798567185,4.19432620727457,0.531211778397278,27,31,-4,38,46,-8,59,67,-8,1,6,0,0
"3527","CAR","PHI",2012020665,15815,20122013,1,60,3,5,-2,4.24492083285077,5.59075530959217,-1.3458344767414,29,38,-9,47,58,-11,58,68,-10,3,4,0,0
"3528","CAR","T.B",2012020669,15816,20122013,0,60,3,2,1,4.54482963813643,4.25469127728195,0.290138360854485,28,37,-9,40,53,-13,48,63,-15,4,2,0,0
"3529","CAR","NYI",2012020683,15818,20122013,1,65,3,3,0,4.89898296922911,6.61179023732439,-1.71280726809528,32,39,-7,43,64,-21,57,77,-20,0,2,0,0
"3530","CAR","NYR",2012020696,15820,20122013,1,62.9166666666667,3,4,-1,4.47905635709132,5.75066112793138,-1.27160477084006,21,38,-17,33,49,-16,53,68,-15,2,3,0,0
"3531","CAR","DET",2013020017,15982,20132014,1,63.2166666666667,2,3,-1,4.87865283372423,5.94453266127675,-1.06587982755252,25,38,-13,40,53,-13,55,76,-21,3,3,0,0
"3532","CAR","PHI",2013020032,15984,20132014,1,60,2,1,1,4.42503704797855,4.47296923449903,-0.0479321865204838,34,18,16,46,30,16,60,41,19,4,2,0,0
"3533","CAR","L.A",2013020059,15989,20132014,1,65,1,1,0,3.72554664825077,4.58535519790557,-0.859808549654804,28,37,-9,43,58,-15,66,70,-4,5,3,0,0
"3534","CAR","ARI",2013020075,15991,20132014,1,60,3,5,-2,4.97525880285411,6.68506408361037,-1.70980528075626,34,32,2,54,50,4,70,60,10,11,7,0,0
"3535","CAR","CHI",2013020086,15993,20132014,1,65,2,2,0,3.19229438726325,5.82317167166912,-2.63087728440587,34,36,-2,45,51,-6,71,64,7,4,3,0,0
"3536","CAR","TOR",2013020097,15995,20132014,0,60,3,2,1,6.54527748767782,2.59920718389459,3.94607030378323,38,26,12,54,36,18,66,42,24,4,4,0,0
"3537","CAR","NYI",2013020117,15997,20132014,0,60,4,3,1,2.30200037470672,4.72608462601056,-2.42408425130384,23,25,-2,35,33,2,48,49,-1,3,5,0,0
"3538","CAR","MIN",2013020145,16002,20132014,0,60,1,3,-2,4.16342043988334,4.51024194182946,-0.346821501946124,28,27,1,39,40,-1,53,53,0,5,5,0,0
"3539","CAR","COL",2013020154,16003,20132014,0,60,2,4,-2,4.40449157473631,3.88944405838265,0.515047516353661,30,34,-4,42,46,-4,59,59,0,3,3,0,0
"3540","CAR","T.B",2013020193,16010,20132014,1,60,0,3,-3,3.8253406936783,4.97013697313852,-1.14479627946022,31,32,-1,44,47,-3,68,62,6,5,4,0,0
"3541","CAR","NYR",2013020205,16011,20132014,0,60,1,5,-4,3.32554969389457,4.89938849885948,-1.57383880496491,28,38,-10,40,50,-10,50,65,-15,5,6,0,0
"3542","CAR","PHI",2013020222,16014,20132014,1,62.6666666666667,2,1,1,7.26661481534097,3.15788719884949,4.10872761649148,38,29,9,55,40,15,74,63,11,5,5,0,0
"3543","CAR","NYI",2013020234,16016,20132014,1,60,1,0,1,6.71369611111004,2.24999283417128,4.46370327693876,24,21,3,38,44,-6,54,57,-3,4,5,0,0
"3544","CAR","MIN",2013020249,16018,20132014,1,65,2,2,0,7.79353777954475,5.8256268027177,1.96791097682705,29,30,-1,50,42,8,64,60,4,3,4,0,0
"3545","CAR","COL",2013020267,16021,20132014,1,60,2,1,1,5.21779382950626,6.55246030641138,-1.33466647690511,28,34,-6,48,56,-8,60,72,-12,1,2,0,0
"3546","CAR","ANA",2013020287,16024,20132014,1,65,2,2,0,3.09745630226098,4.47032377233728,-1.3728674700763,23,30,-7,37,47,-10,54,53,1,3,3,0,0
"3547","CAR","STL",2013020298,16025,20132014,0,60,2,4,-2,4.57186253837903,5.24749350536149,-0.675630966982459,20,32,-12,30,48,-18,40,65,-25,4,5,0,0
"3548","CAR","BOS",2013020309,16027,20132014,1,60,1,4,-3,2.33607979514636,6.89283595542656,-4.5567561602802,24,30,-6,39,46,-7,49,66,-17,4,2,0,0
"3549","CAR","DET",2013020329,16030,20132014,0,60,3,4,-1,5.82075610554283,7.44192450241826,-1.62116839687543,27,47,-20,37,56,-19,45,67,-22,4,4,0,0
"3550","CAR","BOS",2013020341,16032,20132014,0,61.4666666666667,2,3,-1,2.34731526654286,4.757403347832,-2.41008808128913,24,38,-14,32,48,-16,43,61,-18,2,4,0,0
"3551","CAR","OTT",2013020354,16033,20132014,1,60,4,1,3,7.33687604045554,6.98675775929587,0.350118281159666,37,36,1,55,53,2,76,67,9,4,2,0,0
"3552","CAR","N.J",2013020366,16036,20132014,0,60,4,3,1,2.9731833012338,3.8309475829592,-0.857764281725395,22,22,0,27,34,-7,33,45,-12,1,1,0,0
"3553","CAR","N.J",2013020389,16038,20132014,1,60,2,5,-3,2.6764582201431,3.85486533611977,-1.17840711597666,18,31,-13,24,48,-24,38,68,-30,4,4,0,0
"3554","CAR","VAN",2013020403,16040,20132014,1,60,2,3,-1,4.49225925689097,5.40495620904185,-0.912696952150876,31,30,1,46,39,7,69,49,20,6,4,0,0
"3555","CAR","NSH",2013020429,16044,20132014,0,60,5,2,3,6.09520075356022,3.47319165658996,2.62200909697026,23,22,1,40,31,9,65,39,26,6,5,0,0
"3556","CAR","S.J",2013020433,16045,20132014,1,60,5,3,2,7.84762456287493,3.22575286461506,4.62187169825987,35,25,10,47,36,11,67,59,8,1,2,0,0
"3557","CAR","VAN",2013020456,16048,20132014,0,60,0,2,-2,3.40176794753643,3.00451869856624,0.397249248970184,31,26,5,45,37,8,59,51,8,4,4,0,0
"3558","CAR","EDM",2013020468,16049,20132014,0,61.8,4,5,-1,6.05728707091475,3.82598569511902,2.23130137579574,28,29,-1,40,43,-3,57,57,0,2,3,0,0
"3559","CAR","CGY",2013020480,16051,20132014,0,64.9333333333333,1,2,-1,5.13342839902907,4.62057391594863,0.512854483080446,30,30,0,47,38,9,69,51,18,4,2,0,0
"3560","CAR","ARI",2013020496,16053,20132014,0,60,3,1,2,5.65441321583057,4.59029014628158,1.06412306954899,33,38,-5,41,46,-5,62,60,2,7,5,0,0
"3561","CAR","T.B",2013020543,16060,20132014,0,62.2666666666667,2,3,-1,5.63373979390599,4.48271083034342,1.15102896356257,27,50,-23,39,58,-19,53,72,-19,2,5,0,0
"3562","CAR","CBJ",2013020556,16062,20132014,1,60,3,4,-1,6.01020385127049,3.27096461688305,2.73923923438744,33,25,8,46,38,8,67,53,14,6,5,0,0
"3563","CAR","TOR",2013020590,16068,20132014,0,60,2,5,-3,4.2733202959875,5.48489183561469,-1.21157153962719,43,27,16,61,38,23,75,49,26,3,3,0,0
"3564","CAR","MTL",2013020603,16070,20132014,1,63.45,5,4,1,7.35215530422213,2.67876156994816,4.67339373427396,42,25,17,66,36,30,100,45,55,10,7,0,0
"3565","CAR","NYI",2013020632,16074,20132014,0,60,3,2,1,3.1304614704859,4.20256664508997,-1.07210517460408,30,40,-10,43,49,-6,63,68,-5,2,2,0,0
"3566","CAR","NSH",2013020639,16075,20132014,1,60,2,1,1,0,0,0,25,32,-7,36,55,-19,55,68,-13,2,2,0,0
"3567","CAR","TOR",2013020662,16079,20132014,1,60,6,1,5,6.74491010204747,6.45059257316825,0.294317528879219,36,26,10,51,41,10,63,61,2,6,2,0,0
"3568","CAR","CBJ",2013020671,16080,20132014,0,60,0,3,-3,7.12747984658927,4.46439422864933,2.66308561793994,36,24,12,46,35,11,52,46,6,3,2,0,0
"3569","CAR","CGY",2013020692,16083,20132014,1,60,0,2,-2,3.1107023145305,5.46668751898687,-2.35598520445637,23,29,-6,36,44,-8,54,56,-2,2,4,0,0
"3570","CAR","FLA",2013020730,16088,20132014,1,60,3,2,1,8.76315887386761,6.97192202376367,1.79123685010394,39,39,0,54,51,3,73,63,10,2,4,0,0
"3571","CAR","T.B",2013020737,16089,20132014,1,60,3,5,-2,7.99065484080529,4.05235255963635,3.93830228116894,51,24,27,69,29,40,97,40,57,5,2,0,0
"3572","CAR","PHI",2013020749,16092,20132014,0,60,3,2,1,6.18555079793798,3.72766167574446,2.45788912219352,32,24,8,46,36,10,65,48,17,3,3,0,0
"3573","CAR","OTT",2013020770,16095,20132014,1,60,6,3,3,6.73150997989183,6.20284711373036,0.528662866161469,32,26,6,44,45,-1,51,59,-8,4,3,0,0
"3574","CAR","CBJ",2013020790,16097,20132014,1,60,3,2,1,5.1673467750079,5.6783579613284,-0.511011186320502,35,24,11,46,37,9,61,52,9,2,0,0,0
"3575","CAR","MTL",2013020800,16098,20132014,0,60,0,3,-3,8.41127479415811,3.30609034224317,5.10518445191494,36,30,6,48,38,10,75,48,27,3,2,0,0
"3576","CAR","STL",2013020820,16101,20132014,1,60,3,1,2,5.46367893768239,5.8161437260278,-0.352464788345412,31,28,3,46,47,-1,71,53,18,4,4,0,0
"3577","CAR","WPG",2013020846,16105,20132014,1,60,1,2,-1,3.65157126286067,3.49513784531155,0.156433417549124,29,27,2,44,40,4,58,47,11,4,1,0,0
"3578","CAR","FLA",2013020869,16108,20132014,1,60,5,1,4,5.35936573171057,7.22301396304758,-1.86364823133701,32,35,-3,47,57,-10,61,81,-20,3,4,0,0
"3579","CAR","MTL",2013020876,16109,20132014,1,60,1,4,-3,5.34503764181864,2.57202826847788,2.77300937334076,32,24,8,50,32,18,70,42,28,2,1,0,0
"3580","CAR","DAL",2013020895,16128,20132014,0,60,1,4,-3,2.86316793739616,3.73361325592123,-0.870445318525071,30,34,-4,39,46,-7,57,60,-3,5,9,0,0
"3581","CAR","L.A",2013020908,16130,20132014,0,60,1,3,-2,4.15934206204838,7.07286157651137,-2.91351951446299,25,31,-6,38,53,-15,41,62,-21,4,7,0,0
"3582","CAR","ANA",2013020919,16131,20132014,0,60,3,5,-2,4.76212726515712,5.26331714571596,-0.501189880558844,52,34,18,71,46,25,85,61,24,7,4,0,0
"3583","CAR","S.J",2013020933,16133,20132014,0,64.3,3,2,1,4.76957367546856,8.88821319054364,-4.11863951507507,35,37,-2,48,56,-8,63,73,-10,2,1,0,0
"3584","CAR","NYR",2013020948,16136,20132014,1,60,2,4,-2,2.95762843298144,9.46814436446556,-6.51051593148412,24,44,-20,37,60,-23,48,75,-27,6,5,0,0
"3585","CAR","N.J",2013020957,16137,20132014,0,60,4,5,-1,7.19977241482798,4.00842026316322,3.19135215166476,33,31,2,42,38,4,52,51,1,2,2,0,0
"3586","CAR","NYR",2013020978,16140,20132014,1,60,3,1,2,5.30547839439913,4.68689004587155,0.618588348527581,35,25,10,49,38,11,66,54,12,5,4,0,0
"3587","CAR","BOS",2013021004,16144,20132014,0,60,1,5,-4,5.14188533709967,6.40479837013118,-1.26291303303151,30,41,-11,40,51,-11,56,63,-7,4,3,0,0
"3588","CAR","EDM",2013021015,16145,20132014,1,60,1,2,-1,4.07642997259973,6.64457217635754,-2.56814220375782,30,33,-3,47,46,1,67,55,12,5,6,0,0
"3589","CAR","CBJ",2013021029,16147,20132014,0,60,3,1,2,3.21776555412928,5.85734067653539,-2.63957512240611,20,47,-27,28,62,-34,37,79,-42,5,3,0,0
"3590","CAR","CHI",2013021052,16150,20132014,0,60,2,3,-1,3.92726901754384,2.31943167119975,1.60783734634409,28,25,3,30,31,-1,42,42,0,6,5,0,0
"3591","CAR","WPG",2013021062,16151,20132014,0,60,3,2,1,5.3350025381169,5.59393100984744,-0.258928471730542,32,36,-4,48,43,5,66,65,1,3,2,0,0
"3592","CAR","NYI",2013021082,16154,20132014,1,60,4,5,-1,0,0,0,28,32,-4,44,43,1,60,52,8,4,3,0,0
"3593","CAR","FLA",2013021097,16156,20132014,0,60,3,0,3,3.98106038224638,4.48945864563575,-0.508398263389367,32,35,-3,36,49,-13,46,56,-10,2,2,0,0
"3594","CAR","CBJ",2013021114,16158,20132014,1,62.6666666666667,2,3,-1,5.77273404839798,3.93746142775538,1.8352726206426,27,32,-5,38,45,-7,54,58,-4,4,2,0,0
"3595","CAR","OTT",2013021125,16160,20132014,0,65,1,1,0,4.32891085801285,9.60228536358521,-5.27337450557236,31,29,2,48,52,-4,57,70,-13,4,3,0,0
"3596","CAR","DAL",2013021146,16163,20132014,1,60,4,1,3,3.73405266230111,4.89185149427794,-1.15779883197683,32,34,-2,41,45,-4,54,60,-6,5,3,0,0
"3597","CAR","N.J",2013021167,16165,20132014,1,60,1,3,-2,5.45042886664299,3.52588491782066,1.92454394882233,27,23,4,37,41,-4,58,54,4,4,1,0,0
"3598","CAR","NYR",2013021182,16168,20132014,0,60,1,4,-3,3.67580368986819,5.65125326591078,-1.97544957604259,28,36,-8,36,46,-10,52,70,-18,0,3,0,0
"3599","CAR","DET",2013021206,16171,20132014,0,60,2,1,1,3.29782089384994,2.26078051200602,1.03704038184392,19,29,-10,24,38,-14,32,46,-14,3,3,0,0
"3600","CAR","PHI",2013021222,16173,20132014,0,65,5,5,0,6.60376725941023,9.2900727981731,-2.68630553876287,38,44,-6,47,59,-12,66,76,-10,2,3,0,0
"3601","CAR","NYI",2014020017,16353,20142015,1,60,3,5,-2,3.9175991367083,5.58216732987421,-1.66456819316591,24,26,-2,44,38,6,57,52,5,5,3,0,0
"3602","CAR","NYI",2014020023,16354,20142015,0,60,3,4,-1,4.21921415295219,3.64989754377166,0.569316609180532,24,31,-7,30,44,-14,45,54,-9,6,7,0,0
"3603","CAR","NYR",2014020057,16359,20142015,0,65,1,1,0,4.57270581130535,4.52836304134689,0.0443427699584582,30,34,-4,39,44,-5,47,66,-19,4,6,0,0
"3604","CAR","WPG",2014020084,16364,20142015,0,60,1,3,-2,5.63317402719986,5.02998355700793,0.603190470191926,22,26,-4,31,42,-11,44,55,-11,5,5,0,0
"3605","CAR","CGY",2014020098,16366,20142015,0,60,0,5,-5,1.82672380085569,2.75735544918408,-0.930631648328394,16,24,-8,22,35,-13,38,47,-9,2,2,0,0
"3606","CAR","EDM",2014020104,16367,20142015,0,60,3,6,-3,2.81937068660045,5.2546881631838,-2.43531747658335,30,29,1,38,46,-8,52,63,-11,1,4,0,0
"3607","CAR","VAN",2014020135,16371,20142015,0,60,1,4,-3,2.57734504924156,3.87979185347831,-1.30244680423675,30,25,5,35,37,-2,51,46,5,3,3,0,0
"3608","CAR","ARI",2014020160,16375,20142015,1,60,3,0,3,7.04428074309106,4.40169816391426,2.6425825791768,35,25,10,45,39,6,56,53,3,4,5,0,0
"3609","CAR","L.A",2014020165,16376,20142015,1,60,3,2,1,5.53350014503337,4.52143249567598,1.01206764935739,32,32,0,45,40,5,59,51,8,4,3,0,0
"3610","CAR","CBJ",2014020176,16378,20142015,0,60,4,2,2,5.253337113405,3.50198213223382,1.75135498117118,37,19,18,47,28,19,58,42,16,6,3,0,0
"3611","CAR","CBJ",2014020198,16381,20142015,1,64.3666666666667,3,2,1,7.21917309498531,2.86067859494835,4.35849450003695,35,31,4,53,39,14,76,58,18,8,5,0,0
"3612","CAR","CGY",2014020219,16384,20142015,1,60,4,1,3,6.81467698866618,5.44684434699593,1.36783264167025,31,23,8,47,42,5,65,55,10,3,1,0,0
"3613","CAR","WPG",2014020234,16387,20142015,1,60,1,3,-2,6.1305257276108,6.17833315653843,-0.0478074289276265,23,37,-14,43,54,-11,62,71,-9,3,2,0,0
"3614","CAR","BOS",2014020248,16389,20142015,0,60,1,2,-1,4.14221463026479,3.05873738478113,1.08347724548366,34,25,9,41,37,4,55,47,8,3,2,0,0
"3615","CAR","S.J",2014020260,16390,20142015,1,60,0,2,-2,8.45274934651388,3.32952445122444,5.12322489528944,45,19,26,67,32,35,89,46,43,2,1,0,0
"3616","CAR","DAL",2014020274,16392,20142015,0,60,6,4,2,4.04691822769337,3.49628132586031,0.550636901833059,25,27,-2,42,44,-2,54,55,-1,4,3,0,0
"3617","CAR","L.A",2014020289,16394,20142015,0,60,2,3,-1,6.58839898288716,4.72073878077208,1.86766020211508,27,39,-12,39,49,-10,51,62,-11,4,3,0,0
"3618","CAR","COL",2014020304,16396,20142015,0,60,3,4,-1,4.32817492317353,3.31060807505855,1.01756684811498,27,35,-8,38,44,-6,57,61,-4,0,4,0,0
"3619","CAR","FLA",2014020327,16400,20142015,0,60,0,1,-1,6.90945404907688,3.29645811527735,3.61299593379954,33,28,5,39,37,2,49,51,-2,3,1,0,0
"3620","CAR","DET",2014020403,16411,20142015,1,60,1,3,-2,6.05420639662816,2.16431671107537,3.88988968555279,35,22,13,47,30,17,65,38,27,4,2,0,0
"3621","CAR","N.J",2014020407,16412,20142015,1,60,1,2,-1,5.05621542946938,2.84958312341769,2.20663230605169,40,16,24,61,29,32,94,42,52,4,2,0,0
"3622","CAR","T.B",2014020426,16415,20142015,0,60,1,2,-1,3.96999502560357,1.87929892213764,2.09069610346593,30,27,3,41,43,-2,50,57,-7,5,3,0,0
"3623","CAR","PHI",2014020436,16417,20142015,0,60,1,5,-4,6.47807587007992,4.05605471132003,2.42202115875989,26,23,3,42,36,6,66,48,18,4,2,0,0
"3624","CAR","MTL",2014020455,16420,20142015,0,60,1,4,-3,6.26252280399649,4.47945861137123,1.78306419262526,26,29,-3,44,42,2,61,53,8,4,5,0,0
"3625","CAR","TOR",2014020469,16422,20142015,1,60,4,1,3,6.26954164530616,3.18329374976747,3.08624789553869,37,26,11,45,37,8,60,44,16,3,3,0,0
"3626","CAR","NYR",2014020486,16424,20142015,1,65,2,2,0,4.14230154520192,9.73539975238037,-5.59309820717845,20,34,-14,34,56,-22,46,75,-29,4,2,0,0
"3627","CAR","NYR",2014020494,16425,20142015,0,60,0,1,-1,2.24848892039154,2.55317530306638,-0.304686382674845,18,31,-13,22,40,-18,29,56,-27,1,3,0,0
"3628","CAR","N.J",2014020504,16427,20142015,0,65,1,1,0,2.54898309597775,4.81252646193025,-2.2635433659525,33,19,14,42,27,15,53,41,12,2,3,0,0
"3629","CAR","T.B",2014020516,16431,20142015,0,60,1,2,-1,3.28594177193008,6.54813118162565,-3.26218940969557,26,38,-12,34,57,-23,40,74,-34,4,7,0,0
"3630","CAR","MTL",2014020532,16433,20142015,1,60,1,3,-2,3.7702172991232,2.94490392284933,0.825313376273868,29,19,10,38,27,11,55,35,20,2,1,0,0
"3631","CAR","PHI",2014020561,16437,20142015,1,60,2,1,1,1.68212856369883,2.80531872506253,-1.12319016136371,26,24,2,39,40,-1,50,50,0,2,3,0,0
"3632","CAR","BOS",2014020576,16439,20142015,1,65,1,1,0,7.37441536133156,4.70100464880306,2.67341071252849,36,20,16,52,41,11,67,56,11,3,2,0,0
"3633","CAR","COL",2014020634,16448,20142015,1,65,2,2,0,7.12186093417404,6.19211536558578,0.92974556858826,46,30,16,68,42,26,95,60,35,1,1,0,0
"3634","CAR","VAN",2014020655,16451,20142015,1,60,0,3,-3,2.89508115212084,4.5386234323858,-1.64354228026497,28,17,11,42,28,14,56,40,16,3,2,0,0
"3635","CAR","OTT",2014020663,16452,20142015,0,60,3,2,1,6.05546843488212,4.08437608588554,1.97109234899659,28,32,-4,43,48,-5,53,68,-15,4,2,0,0
"3636","CAR","TOR",2014020677,16454,20142015,0,60,4,1,3,5.40341006463859,3.66435875114985,1.73905131348874,32,35,-3,41,50,-9,46,62,-16,4,5,0,0
"3637","CAR","T.B",2014020700,16462,20142015,1,60,4,2,2,1.41755857067619,5.02204622328281,-3.60448765260662,22,30,-8,30,42,-12,41,57,-16,3,3,0,0
"3638","CAR","NYR",2014020732,16466,20142015,0,60,1,4,-3,4.6353120241547,5.80838031847088,-1.17306829431618,32,37,-5,44,49,-5,62,64,-2,3,2,0,0
"3639","CAR","ANA",2014020755,16469,20142015,0,60.75,4,5,-1,4.1742737951041,3.8181095818145,0.356164213289599,32,31,1,42,42,0,47,51,-4,5,4,0,0
"3640","CAR","ARI",2014020766,16471,20142015,0,65,1,1,0,7.46668370826228,3.68893764608574,3.77774606217654,41,29,12,51,40,11,68,56,12,3,0,0,0
"3641","CAR","S.J",2014020783,16473,20142015,0,60,5,4,1,6.21790052604047,3.38799282677937,2.8299076992611,30,27,3,46,42,4,62,51,11,4,1,0,0
"3642","CAR","ANA",2014020810,16478,20142015,1,60,1,2,-1,6.00842379909591,1.33914399062087,4.66927980847504,36,17,19,52,26,26,71,37,34,3,1,0,0
"3643","CAR","MIN",2014020828,16480,20142015,0,60,3,6,-3,2.97645782429026,5.46232179435901,-2.48586397006875,27,24,3,45,33,12,71,39,32,3,3,0,0
"3644","CAR","OTT",2014020839,16482,20142015,0,60,6,3,3,4.60662178971688,4.28171950438263,0.324902285334251,36,32,4,43,49,-6,56,66,-10,5,3,0,0
"3645","CAR","NYI",2014020849,16483,20142015,1,60,1,4,-3,4.43256995072105,7.19052422074614,-2.75795427002509,38,30,8,58,48,10,81,63,18,2,2,0,0
"3646","CAR","TOR",2014020868,16486,20142015,1,60,2,1,1,4.08188458378817,3.03183240065073,1.05005218313744,26,24,2,36,36,0,52,55,-3,2,4,0,0
"3647","CAR","N.J",2014020878,16487,20142015,0,60,1,3,-2,2.84913967429497,1.85983560566092,0.989304068634056,32,19,13,41,26,15,51,30,21,3,4,0,0
"3648","CAR","PHI",2014020897,16490,20142015,1,60,4,1,3,7.99300395185128,3.42807965996076,4.56492429189052,35,24,11,51,37,14,69,52,17,4,2,0,0
"3649","CAR","NYI",2014020925,16494,20142015,0,60,5,3,2,5.51710105876191,2.69088997330982,2.82621108545209,41,24,17,47,33,14,70,46,24,5,2,0,0
"3650","CAR","CHI",2014020940,16496,20142015,0,60,2,5,-3,3.86470384721179,2.49607091715734,1.36863293005445,29,26,3,38,34,4,53,53,0,3,0,0,0
"3651","CAR","MIN",2014020965,16500,20142015,1,60,1,3,-2,5.02545901019766,2.70623689219065,2.31922211800702,38,19,19,48,29,19,73,35,38,2,2,0,0
"3652","CAR","EDM",2014020980,16502,20142015,1,60,7,4,3,5.86165655487275,2.77937983925244,3.08227671562031,35,20,15,51,25,26,71,36,35,6,4,0,0
"3653","CAR","CBJ",2014020993,16504,20142015,1,65,3,3,0,5.21092237001802,8.2418943089433,-3.03097193892528,32,32,0,48,50,-2,64,65,-1,4,5,0,0
"3654","CAR","DAL",2014021004,16506,20142015,1,60,3,5,-2,3.807041998356,5.83115052868379,-2.02410853032779,18,32,-14,30,44,-14,48,58,-10,3,2,0,0
"3655","CAR","CBJ",2014021031,16509,20142015,0,60,3,2,1,3.15263720143412,3.05475616498734,0.097881036446779,27,24,3,36,34,2,44,46,-2,6,4,0,0
"3656","CAR","OTT",2014021043,16511,20142015,1,64.7666666666667,1,2,-1,6.14194278931245,5.50221075562877,0.639732033683686,36,33,3,52,48,4,67,64,3,4,5,0,0
"3657","CAR","MTL",2014021054,16513,20142015,0,60,0,4,-4,6.55973389233009,3.81325870798901,2.74647518434109,31,22,9,44,27,17,63,47,16,2,2,0,0
"3658","CAR","NYR",2014021073,16515,20142015,1,65,2,2,0,5.88098824373446,4.49021490787459,1.39077333585988,30,29,1,46,44,2,70,54,16,2,2,0,0
"3659","CAR","CHI",2014021084,16517,20142015,1,60,1,3,-2,6.19295781070832,5.23894416220719,0.954013648501132,44,25,19,57,37,20,82,46,36,1,0,0,0
"3660","CAR","N.J",2014021123,16522,20142015,1,60,3,1,2,5.53416327515151,4.44838269763352,1.08578057751799,32,22,10,47,37,10,64,53,11,3,1,0,0
"3661","CAR","BOS",2014021131,16523,20142015,1,64.3833333333333,1,2,-1,8.03940575922934,4.22634156157437,3.81306419765497,31,30,1,61,40,21,73,47,26,3,3,0,0
"3662","CAR","PHI",2014021167,16529,20142015,1,65,2,2,0,2.90422050047709,3.78213281498756,-0.877912314510468,26,23,3,37,35,2,55,51,4,3,2,0,0
"3663","CAR","DET",2014021193,16532,20142015,0,60,2,3,-1,5.53176931085181,5.01389972712786,0.51786958372395,32,25,7,43,30,13,54,40,14,1,1,0,0
"3664","CAR","PHI",2014021204,16534,20142015,0,60,3,1,2,6.2116297488966,3.19357157003424,3.01805817886236,27,28,-1,41,41,0,56,53,3,5,2,0,0
"3665","CAR","DET",2014021224,16536,20142015,1,60,0,2,-2,5.76594072215812,5.75936202595767,0.00657869620044949,35,29,6,54,37,17,66,58,8,2,1,0,0
"3666","CAR","DET",2015020023,16718,20152016,1,60,3,4,-1,10.9689701202587,4.21634613536298,6.75262398489576,47,19,28,74,25,49,89,35,54,7,2,0,0
"3667","CAR","DET",2015020060,16724,20152016,0,60,5,3,2,4.00800054822906,2.96301113197114,1.04498941625792,36,20,16,50,27,23,56,38,18,3,2,0,0
"3668","CAR","COL",2015020091,16729,20152016,0,61.8166666666667,1,0,1,4.02252056889756,4.58754771507407,-0.565027146176504,19,26,-7,32,35,-3,47,52,-5,5,4,0,0
"3669","CAR","L.A",2015020105,16731,20152016,0,60,0,3,-3,4.40406286513186,3.4780936489001,0.925969216231758,40,28,12,51,38,13,63,50,13,5,3,0,0
"3670","CAR","S.J",2015020117,16732,20152016,0,60,2,5,-3,4.07955038012005,3.92398417537333,0.155566204746719,34,21,13,41,32,9,65,38,27,3,1,0,0
"3671","CAR","DET",2015020127,16735,20152016,0,60,3,1,2,3.5725294159638,1.6949011630004,1.8776282529634,21,26,-5,27,33,-6,39,39,0,4,3,0,0
"3672","CAR","NYI",2015020137,16737,20152016,0,62.35,3,2,1,1.85861462380853,1.49867552224896,0.359939101559576,29,19,10,39,29,10,50,39,11,2,2,0,0
"3673","CAR","COL",2015020148,16738,20152016,1,60,3,2,1,4.95056079668575,5.41846472062984,-0.467903923944094,26,32,-6,39,45,-6,61,51,10,4,3,0,0
"3674","CAR","T.B",2015020165,16740,20152016,1,60,3,4,-1,6.8626283070771,6.14613615952726,0.716492147549843,35,31,4,50,48,2,62,57,5,2,4,0,0
"3675","CAR","DAL",2015020196,16745,20152016,1,60,1,4,-3,4.28481551434379,3.37275362515356,0.912061889190227,31,29,2,47,50,-3,58,63,-5,0,1,0,0
"3676","CAR","OTT",2015020204,16746,20152016,1,62.85,3,2,1,5.98259134809632,5.28267382055902,0.6999175275373,46,21,25,67,32,35,85,44,41,3,2,0,0
"3677","CAR","NYR",2015020217,16749,20152016,0,60,0,3,-3,4.13124204758155,2.4243485619106,1.70689348567095,33,23,10,48,28,20,67,37,30,6,2,0,0
"3678","CAR","MIN",2015020233,16751,20152016,1,63.8333333333333,2,3,-1,7.69434860650654,3.84612359356834,3.8482250129382,39,21,18,63,36,27,84,45,39,3,0,0,0
"3679","CAR","PHI",2015020253,16753,20152016,1,60.6166666666667,2,3,-1,3.46474953798679,8.08888280028123,-4.62413326229444,21,19,2,32,43,-11,45,65,-20,4,2,0,0
"3680","CAR","ANA",2015020262,16755,20152016,1,60,1,4,-3,5.55283787322696,5.65499315538909,-0.10215528216213,25,20,5,35,28,7,54,41,13,3,0,0,0
"3681","CAR","TOR",2015020287,16759,20152016,1,65,1,1,0,7.5335078844073,4.76818330278911,2.76532458161819,34,25,9,49,45,4,64,56,8,4,6,0,0
"3682","CAR","L.A",2015020304,16761,20152016,1,60,4,3,1,3.10574946005363,7.07481459947303,-3.9690651394194,29,29,0,38,51,-13,54,67,-13,6,4,0,0
"3683","CAR","PHI",2015020310,16762,20152016,0,60.4,2,3,-1,7.03935170173645,3.66072004105126,3.37863166068519,33,36,-3,43,48,-5,64,64,0,5,5,0,0
"3684","CAR","EDM",2015020323,16764,20152016,1,60,4,1,3,6.12982880443451,5.45127237699762,0.678556427436888,27,31,-4,44,42,2,57,54,3,1,4,0,0
"3685","CAR","NYR",2015020356,16769,20152016,0,60,3,4,-1,7.31098783863126,2.60677868072298,4.70420915790828,36,22,14,50,28,22,75,37,38,4,5,0,0
"3686","CAR","N.J",2015020374,16772,20152016,1,60,1,5,-4,5.00056528283886,3.75848410848994,1.24208117434893,31,27,4,46,34,12,62,50,12,4,5,0,0
"3687","CAR","MTL",2015020392,16774,20152016,1,60,3,2,1,6.89876551180214,8.5886805082082,-1.68991499640606,29,38,-9,52,55,-3,65,68,-3,4,4,0,0
"3688","CAR","ARI",2015020398,16775,20152016,1,60,5,4,1,2.65669436922257,1.74285505826265,0.913839310959919,18,23,-5,32,30,2,45,42,3,4,4,0,0
"3689","CAR","DAL",2015020415,16777,20152016,0,60,5,6,-1,5.12897660414819,2.93934164359234,2.18963496055585,30,20,10,49,30,19,68,40,28,3,3,0,0
"3690","CAR","ANA",2015020434,16780,20152016,0,60,5,1,4,4.51903411376406,7.90750888888579,-3.38847477512172,24,32,-8,32,56,-24,44,73,-29,1,2,0,0
"3691","CAR","ARI",2015020442,16781,20152016,0,60.8833333333333,5,4,1,2.91934620220127,4.20442429254763,-1.28507809034636,33,29,4,50,43,7,59,56,3,3,2,0,0
"3692","CAR","PHI",2015020456,16784,20152016,0,61.7,3,4,-1,4.48658783818246,3.78032398177311,0.70626385640935,32,31,1,46,41,5,62,59,3,5,3,0,0
"3693","CAR","PIT",2015020487,16788,20152016,0,60,2,1,1,2.51218704125495,2.96756392144236,-0.455376880187416,26,38,-12,35,44,-9,38,55,-17,4,2,0,0
"3694","CAR","N.J",2015020520,16795,20152016,1,60,3,1,2,4.36446228485147,0.840536815056112,3.52392546979536,25,20,5,39,30,9,50,39,11,1,1,0,0
"3695","CAR","CHI",2015020530,16796,20152016,0,60,2,1,1,5.80380344379228,7.34116139146499,-1.53735794767272,27,36,-9,35,49,-14,44,70,-26,2,3,0,0
"3696","CAR","N.J",2015020543,16798,20152016,0,60,2,3,-1,5.68789707610267,3.14977423403376,2.53812284206891,28,24,4,44,34,10,57,40,17,1,2,0,0
"3697","CAR","EDM",2015020586,16804,20152016,0,62.7833333333333,0,1,-1,2.83092710811616,7.36006918949715,-4.529142081381,29,27,2,42,38,4,64,49,15,1,2,0,0
"3698","CAR","VAN",2015020599,16806,20152016,0,60,2,3,-1,3.26227823255573,2.87721385259647,0.385064379959262,28,21,7,43,34,9,50,39,11,2,5,0,0
"3699","CAR","CBJ",2015020609,16808,20152016,1,60,4,1,3,4.28238407156948,4.94725205728901,-0.664867985719525,29,36,-7,41,46,-5,61,61,0,4,5,0,0
"3700","CAR","CBJ",2015020618,16809,20152016,0,62.75,4,3,1,4.04168577794508,4.41525745082117,-0.373571672876098,30,24,6,37,33,4,57,53,4,4,2,0,0
"3701","CAR","PIT",2015020635,16812,20152016,1,63.0333333333333,3,2,1,2.83734857826494,5.18729684507707,-2.34994826681213,21,25,-4,28,42,-14,45,55,-10,4,3,0,0
"3702","CAR","VAN",2015020656,16815,20152016,1,63.4166666666667,2,3,-1,4.94649522998952,4.65527524289791,0.291219987091608,40,22,18,53,28,25,72,39,33,2,0,0,0
"3703","CAR","PIT",2015020670,16817,20152016,0,60,0,5,-5,2.14903396027512,3.86229661109974,-1.71326265082462,22,32,-10,35,39,-4,44,50,-6,4,4,0,0
"3704","CAR","TOR",2015020697,16821,20152016,0,62.9,1,0,1,4.70952088136508,3.42141760226036,1.28810327910472,41,32,9,49,51,-2,61,57,4,5,3,0,0
"3705","CAR","NYR",2015020705,16822,20152016,1,60,1,4,-3,4.50623573578196,4.51172901266546,-0.00549327688349877,31,32,-1,43,49,-6,56,57,-1,1,1,0,0
"3706","CAR","CHI",2015020733,16826,20152016,1,60,5,0,5,9.67011183996874,2.13230701982275,7.53780482014599,40,26,14,57,36,21,65,48,17,2,4,0,0
"3707","CAR","WPG",2015020772,16836,20152016,0,60,5,3,2,3.27135763580009,6.49444514399956,-3.22308750819948,29,36,-7,36,51,-15,48,67,-19,4,2,0,0
"3708","CAR","MTL",2015020788,16838,20152016,0,65,1,1,0,6.28108374839343,4.76948635501321,1.51159739338021,35,34,1,45,39,6,61,52,9,2,2,0,0
"3709","CAR","PIT",2015020820,16843,20152016,1,65,1,1,0,6.24118786495819,3.24791103148164,2.99327683347656,30,26,4,57,39,18,76,56,20,3,1,0,0
"3710","CAR","NYI",2015020828,16844,20152016,1,60,6,3,3,7.08091386500746,3.71722651956952,3.36368734543794,31,26,5,40,43,-3,50,55,-5,3,3,0,0
"3711","CAR","WPG",2015020849,16847,20152016,1,60,2,1,1,2.55446202741894,2.06566479430494,0.488797233113992,29,21,8,41,31,10,57,44,13,5,4,0,0
"3712","CAR","OTT",2015020861,16849,20152016,0,60,2,4,-2,4.47501387400553,8.1370346340118,-3.66202076000627,32,22,10,40,33,7,61,44,17,2,4,0,0
"3713","CAR","S.J",2015020870,16850,20152016,1,60,5,2,3,4.81633049289667,2.59038395711832,2.22594653577835,37,24,13,46,35,11,60,43,17,4,2,0,0
"3714","CAR","T.B",2015020886,16852,20152016,1,60,2,4,-2,5.33374878708129,4.08298169308546,1.25076709399583,31,18,13,43,28,15,57,45,12,3,5,0,0
"3715","CAR","PHI",2015020894,16854,20152016,1,60,3,1,2,2.4081779245656,6.77964262220485,-4.37146469763924,18,37,-19,27,56,-29,37,66,-29,3,3,0,0
"3716","CAR","TOR",2015020908,16856,20152016,0,60,1,3,-2,5.12400912798489,4.93785356714909,0.1861555608358,31,29,2,46,40,6,56,60,-4,6,6,0,0
"3717","CAR","BOS",2015020918,16857,20152016,1,60,1,4,-3,6.96305276381327,3.61982018167027,3.343232582143,40,22,18,59,29,30,80,42,38,4,2,0,0
"3718","CAR","N.J",2015020945,16861,20152016,0,60,3,1,2,2.37490019004326,5.23241000947869,-2.85750981943543,19,30,-11,20,43,-23,29,46,-17,3,3,0,0
"3719","CAR","T.B",2015020975,16865,20152016,0,64.2833333333333,3,4,-1,3.28117302436646,4.19239802742959,-0.911225003063131,27,30,-3,36,44,-8,49,56,-7,3,4,0,0
"3720","CAR","OTT",2015020995,16868,20152016,1,65,3,3,0,5.93840996840299,3.89947297569597,2.03893699270702,37,24,13,53,46,7,73,57,16,4,3,0,0
"3721","CAR","BOS",2015021007,16870,20152016,0,61.5,3,2,1,2.64456555034849,3.53393472557946,-0.889369175230968,28,32,-4,40,43,-3,58,53,5,3,2,0,0
"3722","CAR","PIT",2015021054,16877,20152016,0,60,2,4,-2,4.16417681018356,4.68840119713488,-0.524224386951317,33,48,-15,38,55,-17,45,69,-24,7,5,0,0
"3723","CAR","MIN",2015021068,16879,20152016,0,65,2,2,0,4.02589490186074,2.9692685901509,1.05662631170983,33,32,1,39,41,-2,47,53,-6,2,2,0,0
"3724","CAR","CBJ",2015021103,16884,20152016,0,60,3,2,1,2.17865892024713,6.7363456262392,-4.55768670599207,24,44,-20,35,62,-27,46,81,-35,3,4,0,0
"3725","CAR","NYI",2015021124,16886,20152016,1,64.7666666666667,3,4,-1,8.44469671832485,4.26061187366879,4.18408484465606,36,31,5,50,53,-3,73,62,11,1,2,0,0
"3726","CAR","N.J",2015021129,16887,20152016,1,60,3,2,1,2.85847399767954,4.01260239819283,-1.15412840051329,23,25,-2,31,36,-5,39,50,-11,5,2,0,0
"3727","CAR","NYI",2015021141,16889,20152016,0,65,1,1,0,3.82185945427045,4.54221811867319,-0.720358664402738,27,31,-4,33,44,-11,46,61,-15,1,3,0,0
"3728","CAR","NYR",2015021155,16891,20152016,1,60,4,3,1,3.51296961211483,4.91546094359364,-1.40249133147881,28,27,1,41,38,3,51,50,1,2,3,0,0
"3729","CAR","CBJ",2015021174,16893,20152016,1,60,1,5,-4,4.51342656509951,4.44990920199761,0.0635173631018944,27,27,0,39,38,1,53,46,7,3,5,0,0
"3730","CAR","BOS",2015021188,16896,20152016,0,65,1,1,0,4.59817502618674,5.8704419561617,-1.27226692997495,28,36,-8,43,49,-6,49,69,-20,4,4,0,0
"3731","CAR","MTL",2015021207,16898,20152016,1,60,2,4,-2,5.86805662441475,6.11567342534545,-0.2476168009307,28,31,-3,41,43,-2,49,57,-8,1,0,0,0
"3732","CAR","WPG",2016020012,17087,20162017,0,62.6833333333333,4,5,-1,3.34292374561941,3.30966634288779,0.0332574027316115,27,26,1,44,36,8,56,46,10,5,5,0,0
"3733","CAR","VAN",2016020032,17090,20162017,0,60.5333333333333,3,4,-1,2.90579112542917,1.72692232386908,1.1788688015601,22,31,-9,28,38,-10,43,50,-7,2,2,0,0
"3734","CAR","EDM",2016020047,17092,20162017,0,60,2,3,-1,4.0730273501251,4.2565429593359,-0.183515609210801,33,28,5,49,41,8,64,57,7,2,3,0,0
"3735","CAR","PHI",2016020070,17096,20162017,0,60,3,6,-3,5.33893491068739,4.30232125176661,1.03661365892077,30,27,3,42,42,0,65,52,13,6,5,0,0
"3736","CAR","DET",2016020088,17099,20162017,0,60,2,4,-2,2.91283197726443,2.68401788339428,0.228814093870155,31,25,6,38,29,9,51,36,15,4,3,0,0
"3737","CAR","NYR",2016020108,17102,20162017,1,60,3,2,1,2.96974159191359,4.91276690707309,-1.9430253151595,21,30,-9,32,43,-11,46,55,-9,1,2,0,0
"3738","CAR","PHI",2016020125,17104,20162017,1,60,3,4,-1,6.38629499768285,4.19608447884366,2.19021051883919,29,28,1,45,46,-1,63,55,8,2,3,0,0
"3739","CAR","OTT",2016020135,17106,20162017,0,63.15,1,2,-1,3.89237793524489,7.76813234086148,-3.87575440561659,33,32,1,51,39,12,63,48,15,5,4,0,0
"3740","CAR","N.J",2016020176,17111,20162017,1,60,1,4,-3,5.43718196550981,5.06650683982298,0.37067512568683,34,21,13,52,32,20,72,46,26,4,3,0,0
"3741","CAR","N.J",2016020183,17113,20162017,0,65,2,2,0,3.75940735332773,4.41714525089628,-0.657737897568552,33,41,-8,43,53,-10,47,65,-18,1,3,0,0
"3742","CAR","ANA",2016020198,17115,20162017,1,60,2,4,-2,4.00529493531212,4.76681620317686,-0.761521267864737,30,27,3,39,35,4,59,44,15,2,3,0,0
"3743","CAR","S.J",2016020231,17120,20162017,1,60,1,0,1,5.33298454934993,2.97716420079814,2.35582034855179,33,22,11,45,37,8,62,50,12,1,1,0,0
"3744","CAR","MTL",2016020258,17123,20162017,1,60,3,2,1,4.25535903027048,8.36272960207134,-4.10737057180086,18,33,-15,31,50,-19,47,64,-17,3,1,0,0
"3745","CAR","WPG",2016020273,17125,20162017,1,60,3,1,2,5.61256472172681,2.77272577083204,2.83983895089477,40,29,11,52,39,13,70,49,21,9,5,0,0
"3746","CAR","TOR",2016020284,17127,20162017,0,60,2,1,1,2.81260105447821,2.56632575067116,0.246275303807053,29,26,3,38,40,-2,56,55,1,1,3,0,0
"3747","CAR","MTL",2016020300,17129,20162017,0,60,1,2,-1,4.53699127002619,2.04968147241743,2.48730979760876,32,22,10,45,30,15,65,42,23,3,2,0,0
"3748","CAR","NYR",2016020330,17134,20162017,0,60,2,3,-1,3.34324220840335,2.44027676883661,0.902965439566742,28,21,7,38,32,6,60,47,13,3,4,0,0
"3749","CAR","BOS",2016020345,17136,20162017,0,65,1,1,0,1.79786510240046,4.78300603313255,-2.98514093073209,30,35,-5,37,58,-21,50,80,-30,2,4,0,0
"3750","CAR","NYR",2016020360,17138,20162017,0,60,2,4,-2,3.83405630156631,3.55807560409482,0.275980697471482,28,23,5,36,31,5,57,46,11,3,2,0,0
"3751","CAR","T.B",2016020371,17139,20162017,1,61.4333333333333,1,0,1,4.18848439373596,6.89772097712607,-2.7092365833901,30,30,0,46,43,3,64,55,9,4,5,0,0
"3752","CAR","ANA",2016020393,17142,20162017,0,65,5,5,0,5.96473338315263,6.06006486492697,-0.0953314817743376,34,38,-4,53,49,4,61,69,-8,5,3,0,0
"3753","CAR","L.A",2016020404,17143,20162017,0,60,3,1,2,2.73891764552407,4.85647037997842,-2.11755273445435,18,22,-4,25,38,-13,36,58,-22,0,3,0,0
"3754","CAR","S.J",2016020420,17145,20162017,0,60,3,4,-1,3.49918986583361,3.59002066135872,-0.0908307955251075,33,20,13,44,34,10,68,44,24,3,2,0,0
"3755","CAR","VAN",2016020434,17148,20162017,1,60,8,6,2,6.86558730239631,6.79930843463808,0.0662788677582284,36,34,2,51,45,6,66,58,8,3,2,0,0
"3756","CAR","DET",2016020477,17252,20162017,1,61.9833333333333,3,4,-1,4.21341417351505,5.32405041004677,-1.11063623653172,42,27,15,56,38,18,75,50,25,3,3,0,0
"3757","CAR","BOS",2016020511,17158,20162017,1,63.0166666666667,3,2,1,4.2983076168457,6.93268727799841,-2.63437966115271,23,33,-10,31,46,-15,49,64,-15,2,3,0,0
"3758","CAR","PIT",2016020528,17163,20162017,0,60,2,3,-1,3.83976327165146,3.3848568313515,0.454906440299965,46,26,20,61,32,29,90,43,47,0,0,0,0
"3759","CAR","CHI",2016020544,17165,20162017,1,60,3,2,1,2.96731047868053,8.25446719268803,-5.28715671400749,28,29,-1,36,44,-8,46,61,-15,1,1,0,0
"3760","CAR","T.B",2016020551,17166,20162017,0,60,1,3,-2,2.80683565320214,3.26486362286596,-0.458027969663817,27,25,2,37,35,2,52,47,5,4,3,0,0
"3761","CAR","N.J",2016020567,17169,20162017,1,60,1,3,-2,5.23970241654752,5.63668259984115,-0.396980183293635,30,18,12,41,24,17,65,37,28,4,2,0,0
"3762","CAR","CHI",2016020587,17172,20162017,0,60,1,2,-1,8.06821550471068,3.49488252011361,4.57333298459707,40,24,16,48,31,17,67,43,24,3,3,0,0
"3763","CAR","BOS",2016020604,17174,20162017,1,61.5666666666667,4,3,1,6.4423534989917,3.4592114352603,2.9831420637314,30,35,-5,42,45,-3,60,62,-2,1,1,0,0
"3764","CAR","CBJ",2016020614,17176,20162017,1,60,5,3,2,6.7955520057792,5.90028834395343,0.895263661825766,28,27,1,42,42,0,53,60,-7,2,4,0,0
"3765","CAR","NYI",2016020646,17180,20162017,1,60,7,4,3,11.6862180796452,6.9051930840069,4.78102499563829,45,32,13,62,47,15,79,62,17,0,0,0,0
"3766","CAR","CBJ",2016020664,17183,20162017,0,60,1,4,-3,4.23314104114115,4.07511165377218,0.15802938736897,25,36,-11,36,44,-8,51,55,-4,2,4,0,0
"3767","CAR","PIT",2016020687,17186,20162017,1,60,1,7,-6,4.4536492177067,7.52632245128916,-3.07267323358246,28,41,-13,45,52,-7,62,61,1,3,3,0,0
"3768","CAR","CBJ",2016020692,17187,20162017,0,60,2,3,-1,3.79541238358144,1.66961014736444,2.125802236217,37,20,17,46,28,18,58,40,18,6,2,0,0
"3769","CAR","L.A",2016020732,17192,20162017,1,60,0,3,-3,3.18284630757262,4.32402086375041,-1.14117455617779,22,29,-7,35,41,-6,53,52,1,5,2,0,0
"3770","CAR","PHI",2016020744,17197,20162017,1,60,5,1,4,5.14502236258704,2.77223807265182,2.37278428993523,28,16,12,44,28,16,64,37,27,7,5,0,0
"3771","CAR","EDM",2016020770,17200,20162017,1,60,2,1,1,2.72486766427755,4.39119131618645,-1.6663236519089,23,25,-2,42,38,4,59,49,10,1,3,0,0
"3772","CAR","NYI",2016020777,17201,20162017,0,62.8666666666667,5,4,1,4.46370047586854,2.25715230201604,2.2065481738525,25,37,-12,34,47,-13,48,71,-23,3,4,0,0
"3773","CAR","DAL",2016020819,17208,20162017,0,60,2,5,-3,2.69223053629685,4.39179537145537,-1.69956483515853,24,27,-3,39,38,1,54,50,4,2,4,0,0
"3774","CAR","COL",2016020856,17214,20162017,1,64.3833333333333,1,2,-1,5.77386062599001,3.41279056831263,2.36107005767738,29,37,-8,47,46,1,56,58,-2,2,3,0,0
"3775","CAR","TOR",2016020875,17216,20162017,1,60,0,4,-4,4.24188915499326,7.0858719884418,-2.84398283344854,37,31,6,53,44,9,70,57,13,3,2,0,0
"3776","CAR","PIT",2016020884,17218,20162017,1,60,1,3,-2,3.89015510406419,3.20148172510826,0.688673378955924,30,22,8,47,30,17,72,40,32,5,4,0,0
"3777","CAR","T.B",2016020934,17226,20162017,0,60.7666666666667,3,4,-1,1.76217477450166,4.03261364405625,-2.2704388695546,31,16,15,43,39,4,56,51,5,2,4,0,0
"3778","CAR","ARI",2016020947,17228,20162017,1,60,2,4,-2,3.69287307634659,3.64252902266253,0.0503440536840571,34,22,12,47,32,15,57,39,18,3,3,0,0
"3779","CAR","ARI",2016020968,17230,20162017,0,60,2,1,1,4.55485916583348,6.48433371301508,-1.9294745471816,35,26,9,52,42,10,62,58,4,3,4,0,0
"3780","CAR","COL",2016020978,17232,20162017,0,60,1,3,-2,3.10570234778466,4.98753154945643,-1.88182920167177,26,25,1,35,38,-3,45,47,-2,2,1,0,0
"3781","CAR","NYR",2016020985,17234,20162017,1,60,4,3,1,4.04665104934247,11.1865821151277,-7.13993106578528,30,43,-13,38,57,-19,50,71,-21,4,5,0,0
"3782","CAR","TOR",2016021004,17236,20162017,1,62.2166666666667,2,3,-1,7.67617168393917,5.38923467553104,2.28693700840813,38,26,12,56,40,16,74,50,24,2,2,0,0
"3783","CAR","NYI",2016021016,17238,20162017,0,60,8,4,4,4.9227381271071,2.45660812812315,2.46612999898394,33,27,6,47,37,10,59,46,13,4,3,0,0
"3784","CAR","NYI",2016021026,17239,20162017,1,60.5666666666667,2,3,-1,7.49857003398586,5.43885077266168,2.05971926132418,32,34,-2,54,50,4,69,66,3,3,1,0,0
"3785","CAR","MIN",2016021040,17241,20162017,1,60,3,1,2,7.28838730230927,3.88608481953218,3.4023024827771,24,31,-7,41,43,-2,59,61,-2,4,1,0,0
"3786","CAR","PHI",2016021066,17244,20162017,0,60.6333333333333,3,4,-1,4.42363964579999,8.07211054011714,-3.64847089431714,22,44,-22,32,53,-21,44,69,-25,2,3,0,0
"3787","CAR","MTL",2016021092,17248,20162017,0,60,4,1,3,4.03464637446268,6.86064845288638,-2.8260020784237,23,22,1,34,37,-3,55,48,7,2,1,0,0
"3788","CAR","N.J",2016021110,17250,20162017,0,60,3,1,2,3.4715188533155,5.8589976040239,-2.3874787507084,28,27,1,33,44,-11,44,51,-7,3,3,0,0
"3789","CAR","DET",2016021129,17253,20162017,1,60,4,1,3,4.99911695721676,5.64637137480895,-0.647254417592194,32,22,10,44,37,7,59,50,9,3,2,0,0
"3790","CAR","CBJ",2016021143,17255,20162017,1,62.2666666666667,2,1,1,6.58143034169916,2.74410770353279,3.83732263816637,31,24,7,49,36,13,68,49,19,3,2,0,0
"3791","CAR","DAL",2016021162,17257,20162017,1,60,0,3,-3,4.64536612475058,6.6059015567145,-1.96053543196392,25,24,1,35,32,3,51,38,13,1,0,0,0
"3792","CAR","PIT",2016021167,17258,20162017,0,60,2,3,-1,5.03816367080435,3.65388877352234,1.38427489728201,35,26,9,49,38,11,61,46,15,2,2,0,0
"3793","CAR","MIN",2016021186,17260,20162017,0,60,3,5,-2,4.59527250119618,4.26310506975278,0.332167431443397,30,36,-6,42,46,-4,51,61,-10,4,1,0,0
"3794","CAR","NYI",2016021196,17262,20162017,1,60,0,3,-3,4.00063268712467,4.76797399832867,-0.767341311204,29,23,6,40,35,5,61,45,16,3,3,0,0
"3795","CAR","PHI",2016021227,17265,20162017,0,65,3,3,0,8.55334273027256,4.63752247032152,3.91582025995104,35,44,-9,46,56,-10,61,77,-16,3,1,0,0
"3796","CAR","MIN",2017020023,17446,20172018,1,65,4,4,0,5.44155166251585,3.84848287515342,1.59306878736243,42,27,15,63,39,24,79,56,23,5,3,0,0
"3797","CAR","CBJ",2017020040,17449,20172018,1,64.5166666666667,1,2,-1,6.25638376631816,5.33488938989501,0.921494376423148,38,27,11,48,40,8,65,54,11,3,3,0,0
"3798","CAR","WPG",2017020068,17453,20172018,0,60,1,2,-1,2.76781193968145,2.45837671010452,0.30943522957693,29,21,8,42,30,12,61,44,17,4,2,0,0
"3799","CAR","EDM",2017020089,17456,20172018,0,60,5,3,2,3.94843286221476,4.90951627601376,-0.961083413799003,21,51,-30,25,63,-38,40,82,-42,5,7,0,0
"3800","CAR","DAL",2017020118,17460,20172018,0,60,3,4,-1,6.07461248447046,2.49804119962209,3.57657128484837,39,26,13,51,38,13,72,46,26,3,2,0,0
"3801","CAR","T.B",2017020129,17463,20172018,1,60,1,5,-4,3.10766128241085,6.43926158500835,-3.33160030259751,32,29,3,55,40,15,77,46,31,5,2,0,0
"3802","CAR","TOR",2017020139,17465,20172018,0,60,6,3,3,4.75634864065614,6.80129191682499,-2.04494327616885,38,34,4,55,50,5,71,64,7,2,3,0,0
"3803","CAR","ANA",2017020167,17468,20172018,1,65,3,3,0,7.47489720255544,3.75886036861472,3.71603683394072,37,25,12,61,38,23,82,47,35,3,0,0,0
"3804","CAR","COL",2017020194,17472,20172018,0,60,3,5,-2,9.72296018654015,3.5560629205138,6.16689726602635,60,27,33,73,32,41,90,42,48,2,2,0,0
"3805","CAR","ARI",2017020209,17474,20172018,0,65,1,1,0,0,0,0,37,24,13,51,36,15,74,47,27,4,2,0,0
"3806","CAR","CBJ",2017020245,17480,20172018,0,60,3,1,2,5.58917684358312,2.72202988129982,2.8671469622833,29,26,3,36,38,-2,55,49,6,1,2,0,0
"3807","CAR","CHI",2017020256,17481,20172018,1,61.7333333333333,3,4,-1,4.55178490826983,4.64817576563667,-0.0963908573668331,38,30,8,46,46,0,61,71,-10,3,5,0,0
"3808","CAR","DAL",2017020265,17483,20172018,1,60,5,1,4,5.46438696467521,7.99797186949329,-2.53358490481807,28,26,2,42,37,5,58,56,2,4,3,0,0
"3809","CAR","NYI",2017020279,17486,20172018,0,60,4,6,-2,3.87755210138857,7.88058687461307,-4.0030347732245,32,36,-4,40,48,-8,57,60,-3,3,3,0,0
"3810","CAR","NYI",2017020305,17489,20172018,1,60,4,2,2,4.34848006185348,3.87383095438804,0.474649107465439,32,29,3,47,39,8,56,61,-5,5,7,0,0
"3811","CAR","NYR",2017020326,17492,20172018,1,60,1,6,-5,2.58261299399601,6.18067962917848,-3.59806663518248,33,27,6,49,42,7,67,48,19,5,2,0,0
"3812","CAR","TOR",2017020343,17494,20172018,1,60,4,5,-1,5.49626434306265,3.62808714729119,1.86817719577146,47,25,22,69,32,37,91,39,52,2,2,0,0
"3813","CAR","CBJ",2017020371,17498,20172018,0,65,2,2,0,1.97976417792961,6.09791434438375,-4.11815016645414,31,38,-7,38,46,-8,54,54,0,1,1,0,0
"3814","CAR","NYR",2017020390,17501,20172018,0,60,1,5,-4,4.17154715846203,6.05701453883376,-1.88546738037172,33,26,7,45,37,8,60,54,6,3,7,0,0
"3815","CAR","VAN",2017020423,17505,20172018,0,60,0,3,-3,4.07045151472994,3.68449864571448,0.385952869015455,30,22,8,45,32,13,60,42,18,2,2,0,0
"3816","CAR","S.J",2017020438,17507,20172018,0,60.3666666666667,4,5,-1,3.44110747496597,7.10753410006873,-3.66642662510276,25,33,-8,36,47,-11,48,63,-15,3,3,0,0
"3817","CAR","L.A",2017020455,17509,20172018,0,64.6666666666667,2,3,-1,4.09944284794619,5.19974898526561,-1.10030613731942,34,21,13,48,32,16,68,43,25,3,1,0,0
"3818","CAR","ANA",2017020465,17511,20172018,0,60,2,3,-1,3.41109679787769,3.70476572180633,-0.293668923928635,30,23,7,48,39,9,67,52,15,3,2,0,0
"3819","CAR","VGK",2017020474,17512,20172018,0,65,2,2,0,4.53729045779619,2.28425552805675,2.25303492973944,37,24,13,44,30,14,59,43,16,4,3,0,0
"3820","CAR","CBJ",2017020503,17516,20172018,1,60,2,1,1,6.00329547461661,4.61273882315118,1.39055665146543,24,36,-12,35,52,-17,41,68,-27,2,4,0,0
"3821","CAR","TOR",2017020516,17519,20172018,0,60,1,8,-7,0,0,0,33,36,-3,51,50,1,72,60,12,5,4,0,0
"3822","CAR","MTL",2017020563,17527,20172018,1,60,3,1,2,7.80342094832304,4.33676294360339,3.46665800471965,36,24,12,50,32,18,65,44,21,3,2,0,0
"3823","CAR","PIT",2017020580,17529,20172018,1,60,2,1,1,4.59109038099268,3.90726626239484,0.68382411859784,33,28,5,48,37,11,65,47,18,2,2,0,0
"3824","CAR","PIT",2017020619,17535,20172018,0,60,4,0,4,4.02631768688298,2.37070213323022,1.65561555365275,33,21,12,41,29,12,49,51,-2,1,2,0,0
"3825","CAR","BOS",2017020636,17537,20172018,0,60,1,7,-6,3.6826247218778,2.37190712797928,1.31071759389852,28,30,-2,38,37,1,52,51,1,3,2,0,0
"3826","CAR","T.B",2017020656,17540,20172018,0,60,4,5,-1,2.94616099225823,3.2494326356973,-0.303271643439075,32,34,-2,40,44,-4,59,58,1,4,0,0,0
"3827","CAR","DET",2017020714,17551,20172018,0,60,3,1,2,5.28208628666471,3.10337102477206,2.17871526189265,30,24,6,42,41,1,57,52,5,3,2,0,0
"3828","CAR","VGK",2017020722,17552,20172018,1,60,1,5,-4,5.12777399492946,6.79976506857201,-1.67199107364255,28,33,-5,44,47,-3,58,53,5,5,5,0,0
"3829","CAR","PIT",2017020733,17554,20172018,0,60,1,3,-2,3.79388662870362,4.06908825837309,-0.275201629669463,35,33,2,53,42,11,71,55,16,4,3,0,0
"3830","CAR","MTL",2017020749,17556,20172018,0,60,6,5,1,4.43573195157251,4.6020041559641,-0.166272204391589,29,31,-2,37,39,-2,61,53,8,2,3,0,0
"3831","CAR","MTL",2017020780,17563,20172018,1,60,2,0,2,6.60181154725797,7.0576772322529,-0.455865684994933,30,27,3,49,42,7,64,55,9,3,1,0,0
"3832","CAR","DET",2017020789,17564,20172018,1,60,1,4,-3,4.45853566310836,6.39363601640798,-1.93510035329962,37,38,-1,50,50,0,68,62,6,2,3,0,0
"3833","CAR","S.J",2017020807,17566,20172018,1,60,1,3,-2,4.09677044310592,3.35990871556825,0.736861727537676,30,26,4,43,38,5,58,51,7,1,0,0,0
"3834","CAR","PHI",2017020814,17568,20172018,1,64.9333333333333,1,2,-1,5.58842061860412,3.56076161821693,2.02765900038719,28,30,-2,44,41,3,72,54,18,3,5,0,0
"3835","CAR","VAN",2017020839,17571,20172018,1,60,4,1,3,6.41520288755419,4.51453438173485,1.90066850581934,33,22,11,48,32,16,72,37,35,4,3,0,0
"3836","CAR","COL",2017020847,17572,20172018,1,60,3,1,2,5.42582457076406,4.30268934884225,1.12313522192181,35,30,5,58,43,15,68,54,14,3,4,0,0
"3837","CAR","L.A",2017020869,17575,20172018,1,60,7,3,4,6.31377895049809,4.61561609006138,1.69816286043671,41,30,11,52,39,13,66,51,15,5,2,0,0
"3838","CAR","N.J",2017020879,17577,20172018,0,60,2,5,-3,7.21107718417446,4.84331627305073,2.36776091112372,29,22,7,36,31,5,53,37,16,3,2,0,0
"3839","CAR","NYI",2017020891,17578,20172018,1,60,0,3,-3,8.68638634408126,4.29676916901371,4.38961717506754,45,23,22,65,30,35,92,43,49,3,1,0,0
"3840","CAR","N.J",2017020907,17580,20172018,1,64.6166666666667,2,3,-1,5.11030501947019,4.70934720871264,0.400957810757552,42,21,21,61,31,30,79,41,38,4,4,0,0
"3841","CAR","PIT",2017020942,17585,20172018,1,60,1,6,-5,6.02512120780739,3.97243434902339,2.052686858784,28,39,-11,48,51,-3,61,72,-11,3,2,0,0
"3842","CAR","DET",2017020950,17586,20172018,0,60,1,3,-2,3.78390051554015,1.9524155932015,1.83148492233865,29,22,7,39,34,5,70,43,27,4,4,0,0
"3843","CAR","BOS",2017020969,17589,20172018,0,61.1333333333333,3,4,-1,3.96905006777223,3.35664124089408,0.612408826878152,32,32,0,47,48,-1,57,56,1,2,2,0,0
"3844","CAR","PHI",2017020984,17591,20172018,0,60,4,1,3,4.81856800183596,2.29908852674998,2.51947947508597,35,22,13,42,33,9,53,43,10,2,3,0,0
"3845","CAR","N.J",2017020993,17592,20172018,1,60,3,1,2,4.99299344077008,4.21662279323209,0.776370647537988,30,26,4,42,34,8,54,46,8,1,3,0,0
"3846","CAR","WPG",2017021012,17594,20172018,1,60,2,3,-1,6.68295344081707,5.22718455738504,1.45576888343203,35,23,12,54,40,14,68,46,22,3,2,0,0
"3847","CAR","MIN",2017021026,17596,20172018,0,60,2,6,-4,5.04888182791183,4.62145944710937,0.427422380802454,31,31,0,43,47,-4,60,58,2,3,2,0,0
"3848","CAR","CHI",2017021040,17598,20172018,0,60,3,2,1,6.43942657617496,2.40412918840313,4.03529738777183,40,24,16,51,35,16,73,45,28,2,2,0,0
"3849","CAR","NYR",2017021063,17602,20172018,0,60,3,6,-3,4.58160226499604,4.57944844319718,0.00215382179885637,44,23,21,56,34,22,86,41,45,3,3,0,0
"3850","CAR","BOS",2017021071,17603,20172018,1,60,4,6,-2,6.74143782112515,5.04246174888976,1.69897607223538,33,34,-1,51,39,12,69,52,17,5,4,0,0
"3851","CAR","PHI",2017021103,17607,20172018,1,60,2,4,-2,4.73972621539751,5.13671782816527,-0.396991612767765,25,27,-2,40,38,2,64,55,9,2,2,0,0
"3852","CAR","NYI",2017021111,17608,20172018,0,60,4,3,1,5.35888985860431,4.9683019705778,0.390587888026515,39,29,10,49,38,11,62,50,12,4,4,0,0
"3853","CAR","EDM",2017021124,17610,20172018,1,60,3,7,-4,6.48926130434847,2.43626200520157,4.0529992991469,34,30,4,46,38,8,55,46,9,2,1,0,0
"3854","CAR","ARI",2017021138,17612,20172018,1,60,6,5,1,4.32345228779013,5.02912189537892,-0.705669607588788,30,33,-3,44,46,-2,65,60,5,2,4,0,0
"3855","CAR","N.J",2017021177,17617,20172018,0,60,3,4,-1,3.91713982564397,6.15009612877412,-2.23295630313015,34,45,-11,43,57,-14,51,63,-12,3,4,0,0
"3856","CAR","NYR",2017021212,17621,20172018,1,60,1,2,-1,7.28083954239992,2.17197300947737,5.10886653292255,41,20,21,64,28,36,84,38,46,3,1,0,0
"3857","CAR","PHI",2017021243,17626,20172018,0,60,3,4,-1,5.69133831148793,2.39405411076586,3.29728420072206,22,34,-12,39,44,-5,57,56,1,3,2,0,0
"3858","CAR","T.B",2017021263,17628,20172018,1,60.8166666666667,3,2,1,7.29572038480546,4.20238333740417,3.09333704740129,42,34,8,53,38,15,71,47,24,2,1,0,0
"3859","CAR","NYI",2018020008,17808,20182019,1,60.7166666666667,1,2,-1,5.88316154016872,1.59367106161699,4.28949047855173,46,20,26,67,31,36,89,39,50,3,3,0,0
"3860","CAR","CBJ",2018020015,17809,20182019,0,60,3,1,2,4.01685760397812,3.5837261202123,0.433131483765813,35,32,3,46,44,2,60,54,6,1,3,0,0
"3861","CAR","NYR",2018020029,17811,20182019,1,60,8,5,3,5.67288996950083,3.04815547388197,2.62473449561886,40,24,16,61,35,26,74,51,23,6,5,0,0
"3862","CAR","VAN",2018020037,17813,20182019,1,60,5,3,2,5.75227307754483,3.93485218147115,1.81742089607368,33,25,8,44,38,6,60,49,11,3,5,0,0
"3863","CAR","MIN",2018020060,17817,20182019,0,62.95,5,4,1,7.23095873533748,4.02061546001237,3.21034327532511,57,23,34,65,26,39,83,34,49,11,7,0,0
"3864","CAR","WPG",2018020073,17818,20182019,0,60,1,3,-2,7.27614681258274,3.5864369951596,3.68970981742314,43,26,17,58,36,22,79,48,31,2,2,0,0
"3865","CAR","T.B",2018020082,17820,20182019,0,60,2,4,-2,3.99102057539858,6.67220709958002,-2.68118652418144,40,27,13,50,37,13,70,50,20,4,1,0,0
"3866","CAR","COL",2018020103,17824,20182019,1,60,1,3,-2,3.90351325759913,1.43212609450088,2.47138716309825,43,22,21,58,31,27,81,44,37,6,5,0,0
"3867","CAR","DET",2018020119,17826,20182019,0,60,3,1,2,4.96092634258093,3.71823045272322,1.24269588985771,39,21,18,51,30,21,69,42,27,3,4,0,0
"3868","CAR","S.J",2018020146,17830,20182019,1,65,3,3,0,6.85973631994693,4.03373788257886,2.82599843736807,41,23,18,64,39,25,80,51,29,2,3,0,0
"3869","CAR","NYI",2018020161,17832,20182019,1,60,1,2,-1,4.20679601065012,3.52069379857699,0.686102212073137,39,20,19,54,27,27,74,39,35,3,4,0,0
"3870","CAR","BOS",2018020169,17834,20182019,1,60,2,3,-1,6.66314006580446,5.44820655859525,1.21493350720921,44,31,13,64,46,18,76,63,13,4,5,0,0
"3871","CAR","ARI",2018020194,17837,20182019,0,61.2833333333333,3,4,-1,8.30029665885377,5.04697252360977,3.253324135244,51,25,26,66,33,33,92,41,51,6,3,0,0
"3872","CAR","VGK",2018020204,17838,20182019,0,60,0,3,-3,2.74461966415519,4.94192437968104,-2.19730471552585,34,25,9,45,42,3,73,57,16,3,4,0,0
"3873","CAR","CHI",2018020233,17843,20182019,0,60,4,3,1,6.25511714351207,6.0459853713437,0.209131772168362,34,38,-4,37,55,-18,50,71,-21,2,2,0,0
"3874","CAR","DET",2018020250,17845,20182019,1,65,3,3,0,7.85341386368964,6.15577985128039,1.69763401240925,52,32,20,72,42,30,92,54,38,5,2,0,0
"3875","CAR","CHI",2018020261,17847,20182019,1,61.2666666666667,3,2,1,6.88955488131614,5.65179944837928,1.23775543293686,40,35,5,58,48,10,71,60,11,3,1,0,0
"3876","CAR","CBJ",2018020297,17852,20182019,1,60,1,4,-3,4.33914691599293,3.26619248779805,1.07295442819488,31,24,7,48,32,16,67,41,26,3,5,0,0
"3877","CAR","N.J",2018020304,17853,20182019,1,60,2,1,1,4.64559759755525,6.3734715991086,-1.72787400155335,25,34,-9,41,48,-7,61,62,-1,3,3,0,0
"3878","CAR","TOR",2018020323,17856,20182019,1,60,5,2,3,9.53164649184328,6.24319232237758,3.28845416946569,45,32,13,65,54,11,77,69,8,2,3,0,0
"3879","CAR","NYI",2018020352,17859,20182019,0,60,1,4,-3,5.57069679338019,2.95381723331229,2.6168795600679,27,19,8,46,27,19,66,34,32,3,1,0,0
"3880","CAR","MTL",2018020369,17862,20182019,0,60,2,1,1,4.91301460636896,7.81268414234,-2.89966953597104,22,49,-27,32,67,-35,47,93,-46,1,3,0,0
"3881","CAR","ANA",2018020392,17865,20182019,1,61.25,1,2,-1,4.37101507525949,2.46491011240741,1.90610496285208,34,29,5,47,42,5,64,46,18,6,3,0,0
"3882","CAR","L.A",2018020412,17867,20182019,0,60,0,2,-2,4.54649426104152,4.58365817968479,-0.0371639186432731,34,35,-1,49,46,3,69,56,13,3,4,0,0
"3883","CAR","S.J",2018020428,17870,20182019,0,60,1,5,-4,6.21968105793349,4.65898542748801,1.56069563044548,40,23,17,57,31,26,77,41,36,4,3,0,0
"3884","CAR","ANA",2018020443,17872,20182019,0,60,4,1,3,4.72009867689943,3.26167694522451,1.45842173167492,36,19,17,55,33,22,67,45,22,6,7,0,0
"3885","CAR","TOR",2018020468,17876,20182019,1,60,1,4,-3,6.70221112726722,5.51856834797945,1.18364277928777,30,29,1,49,45,4,68,62,6,4,4,0,0
"3886","CAR","MTL",2018020481,17878,20182019,0,60,4,6,-2,6.21376163257943,7.81014237926865,-1.59638074668922,31,40,-9,44,53,-9,55,70,-15,3,7,0,0
"3887","CAR","ARI",2018020506,17881,20182019,1,60,3,0,3,4.4647076533917,2.67238413177755,1.79232352161415,27,23,4,43,33,10,53,44,9,6,4,0,0
"3888","CAR","DET",2018020534,17885,20182019,1,60,1,4,-3,6.30713029635081,7.49189844632929,-1.18476814997848,39,24,15,63,33,30,80,38,42,2,1,0,0
"3889","CAR","PIT",2018020554,17887,20182019,1,60,0,3,-3,5.80173997234272,3.69463355917,2.10710641317272,39,32,7,60,41,19,76,56,20,4,2,0,0
"3890","CAR","BOS",2018020560,17888,20182019,1,60,5,3,2,7.54577375343536,4.1051911940533,3.44058255938205,37,30,7,52,46,6,68,60,8,3,5,0,0
"3891","CAR","N.J",2018020583,17894,20182019,0,60,0,2,-2,2.58131033776027,5.49137927084496,-2.91006893308468,37,30,7,46,44,2,59,60,-1,6,4,0,0
"3892","CAR","PHI",2018020602,17896,20182019,1,60,3,1,2,4.80550234905331,2.74878688069962,2.05671546835369,33,23,10,48,37,11,65,58,7,2,2,0,0
"3893","CAR","PHI",2018020625,17899,20182019,0,60,5,3,2,2.59938299592944,4.40206227080462,-1.80267927487517,28,37,-9,34,54,-20,44,74,-30,5,6,0,0
"3894","CAR","CBJ",2018020631,17900,20182019,1,60,4,2,2,4.53312742087292,4.50347195440281,0.0296554664701034,31,24,7,48,35,13,65,49,16,2,1,0,0
"3895","CAR","NYI",2018020659,17904,20182019,0,60,4,3,1,3.49353007748766,4.06346353740082,-0.569933459913159,24,31,-7,32,41,-9,43,54,-11,2,3,0,0
"3896","CAR","T.B",2018020676,17906,20182019,0,60,1,3,-2,2.39907365114277,5.33481047677105,-2.93573682562828,27,30,-3,34,39,-5,47,51,-4,4,6,0,0
"3897","CAR","NYR",2018020712,17911,20182019,0,60,2,6,-4,5.33460286751506,6.34655211858291,-1.01194925106785,36,28,8,50,40,10,71,53,18,4,4,0,0
"3898","CAR","EDM",2018020755,17916,20182019,0,60,7,4,3,6.06165356820566,3.28603197907796,2.7756215891277,34,21,13,44,32,12,56,48,8,2,5,0,0
"3899","CAR","CGY",2018020763,17918,20182019,0,60.25,2,3,-1,4.63295794886653,4.77679295261623,-0.1438350037497,35,25,10,52,35,17,70,47,23,2,4,0,0
"3900","CAR","VAN",2018020770,17919,20182019,0,60,5,2,3,3.05249439945328,2.96132818023784,0.0911662192154381,34,26,8,49,39,10,64,50,14,7,3,0,0
"3901","CAR","VGK",2018020787,17928,20182019,1,60,5,2,3,8.45361224802036,3.89461785997496,4.55899438804541,32,25,7,46,33,13,63,49,14,3,2,0,0
"3902","CAR","CGY",2018020804,17930,20182019,1,60,3,4,-1,3.87401978716662,6.14588822406222,-2.2718684368956,37,32,5,47,49,-2,68,57,11,4,5,0,0
"3903","CAR","PIT",2018020813,17932,20182019,0,60,4,0,4,7.78430211138857,3.13130354241002,4.65299856897855,32,23,9,44,28,16,62,44,18,2,2,0,0
"3904","CAR","NYR",2018020837,17935,20182019,0,60,3,0,3,6.71613832676667,4.07138143922202,2.64475688754464,33,27,6,47,40,7,59,50,9,3,3,0,0
"3905","CAR","N.J",2018020855,17937,20182019,0,60,2,3,-1,6.47853396252322,3.09521714023262,3.3833168222906,35,21,14,54,27,27,69,36,33,6,5,0,0
"3906","CAR","EDM",2018020889,17942,20182019,1,60,3,1,2,3.11002542090137,4.23885781536956,-1.12883239446819,27,41,-14,33,46,-13,45,63,-18,3,4,0,0
"3907","CAR","DAL",2018020899,17943,20182019,1,60,3,0,3,7.28820860596898,5.00293724745279,2.28527135851618,27,33,-6,42,48,-6,50,73,-23,1,2,0,0
"3908","CAR","NYR",2018020919,17946,20182019,1,60,1,2,-1,7.93011348396976,2.52513622466358,5.40497725930618,44,26,18,70,42,28,93,50,43,2,4,0,0
"3909","CAR","DAL",2018020950,17950,20182019,0,60,3,0,3,6.93717848258336,5.27149392483989,1.66568455774348,31,24,7,48,40,8,63,53,10,3,3,0,0
"3910","CAR","L.A",2018020972,17953,20182019,1,60,6,1,5,5.19807973271236,3.19096144230571,2.00711829040665,34,23,11,61,32,29,80,45,35,2,1,0,0
"3911","CAR","BOS",2018021019,17960,20182019,0,61.7666666666667,3,4,-1,3.14016551629175,5.62714145949995,-2.4869759432082,37,38,-1,46,49,-3,60,58,2,5,2,0,0
"3912","CAR","WPG",2018021046,17963,20182019,1,60,1,8,-7,5.29518335170633,3.550247017949,1.74493633375732,29,29,0,48,42,6,71,50,21,5,3,0,0
"3913","CAR","COL",2018021070,17966,20182019,0,60,3,0,3,3.8524495919502,4.18831115344074,-0.335861561490537,33,38,-5,45,46,-1,60,56,4,1,3,0,0
"3914","CAR","CBJ",2018021094,17970,20182019,0,60,0,3,-3,5.53596442616254,2.55197258235421,2.98399184380833,46,20,26,65,23,42,83,29,54,2,1,0,0
"3915","CAR","PIT",2018021126,17974,20182019,1,65,2,2,0,8.59152133179487,9.69352974027977,-1.10200840848491,39,38,1,61,49,12,76,60,16,4,3,0,0
"3916","CAR","T.B",2018021138,17976,20182019,1,60,3,6,-3,3.44695633441734,7.43970123765757,-3.99274490324024,28,32,-4,41,44,-3,55,61,-6,3,7,0,0
"3917","CAR","MIN",2018021157,17978,20182019,1,60,5,1,4,3.81443014873424,2.51287538503811,1.30155476369612,33,25,8,48,39,9,61,56,5,3,5,0,0
"3918","CAR","MTL",2018021166,17979,20182019,1,63.25,2,1,1,5.86736604204634,3.68416467802217,2.18320136402417,40,29,11,72,41,31,91,53,38,3,1,0,0
"3919","CAR","PHI",2018021203,17985,20182019,1,60,5,2,3,5.99180493406493,5.03690162950352,0.954903304561412,32,32,0,52,44,8,66,58,8,2,3,0,0
"3920","CAR","PIT",2018021216,17986,20182019,0,60,1,3,-2,5.60107785824221,3.57379010540899,2.02728775283322,38,28,10,54,34,20,77,44,33,4,3,0,0
"3921","CAR","TOR",2018021231,17988,20182019,0,60,4,1,3,6.8353580777366,5.93415388953872,0.90120418819788,37,24,13,56,40,16,71,56,15,3,5,0,0
"3922","CAR","N.J",2018021247,17990,20182019,1,60,3,1,2,4.73095169694716,6.70882649549914,-1.97787479855198,25,37,-12,41,46,-5,49,63,-14,2,3,0,0
"3923","CAR","PHI",2018021263,17992,20182019,0,60,4,3,1,3.11474209353537,2.50384684983629,0.610895243699076,28,31,-3,36,40,-4,52,57,-5,2,2,0,0
"3924","CAR","NYI",2018030221,18012,20182019,0,64.0666666666667,1,0,1,5.35929723960795,2.26880242804594,3.09049481156201,32,31,1,41,39,2,60,57,3,3,5,0,0
"3925","CAR","NYI",2018030222,18014,20182019,0,60,2,1,1,2.74289220949868,6.46367272653151,-3.72078051703284,18,27,-9,35,43,-8,51,56,-5,3,2,0,0
"3926","CAR","NYI",2018030223,18017,20182019,1,60,5,2,3,7.8484043045221,4.84583991059714,3.00256439392495,38,30,8,60,39,21,76,56,20,2,3,0,0
"3927","CAR","NYI",2018030224,18019,20182019,1,60,5,2,3,2.98083346686326,6.78529755929799,-3.80446409243473,21,28,-7,32,42,-10,43,62,-19,5,4,0,0
"3928","CAR","BOS",2018030311,18025,20182019,0,60,2,5,-3,2.53695415921506,4.92556510458235,-2.38861094536729,31,28,3,42,38,4,53,48,5,3,5,0,0
"3929","CAR","BOS",2018030312,18028,20182019,0,60,2,6,-4,3.20999250776139,4.0861225446497,-0.876130036888306,23,25,-2,31,31,0,41,38,3,4,2,0,0
"3930","CAR","BOS",2018030313,18030,20182019,1,60,1,2,-1,4.64714517196337,4.54465541484538,0.102489757117992,36,31,5,54,42,12,70,55,15,7,7,0,0
"3931","CAR","BOS",2018030314,18032,20182019,1,60,0,4,-4,5.06195599923376,5.15333502408711,-0.0913790248533468,24,23,1,39,37,2,62,53,9,2,3,0,0
"3932","CBJ","DAL",2008020015,14162,20082009,0,64.65,5,4,1,0,0,0,27,31,-4,34,45,-11,42,61,-19,4,8,0,0
"3933","CBJ","ARI",2008020027,14163,20082009,0,60,1,3,-2,0,0,0,29,30,-1,45,36,9,69,51,18,6,9,0,0
"3934","CBJ","S.J",2008020043,14166,20082009,0,60,2,5,-3,0,0,0,33,25,8,41,33,8,58,51,7,7,3,0,0
"3935","CBJ","NSH",2008020058,14169,20082009,1,60,5,3,2,0,0,0,28,30,-2,33,42,-9,44,57,-13,5,6,0,0
"3936","CBJ","NSH",2008020072,14170,20082009,0,60,3,6,-3,0,0,0,26,30,-4,35,38,-3,51,47,4,5,5,0,0
"3937","CBJ","VAN",2008020084,14173,20082009,1,60,4,2,2,0,0,0,33,25,8,41,31,10,52,40,12,4,4,0,0
"3938","CBJ","NYR",2008020101,14176,20082009,1,60,1,3,-2,0,0,0,26,32,-6,39,44,-5,50,58,-8,7,8,0,0
"3939","CBJ","MIN",2008020113,14177,20082009,0,60,1,2,-1,0,0,0,26,23,3,36,32,4,50,51,-1,2,4,0,0
"3940","CBJ","ANA",2008020122,14179,20082009,1,60,2,3,-1,0,0,0,32,24,8,46,34,12,57,39,18,7,6,0,0
"3941","CBJ","COL",2008020143,14182,20082009,0,60,4,2,2,0,0,0,17,32,-15,24,41,-17,40,56,-16,0,4,0,0
"3942","CBJ","CHI",2008020156,14184,20082009,1,65,3,3,0,0,0,0,51,24,27,66,36,30,84,42,42,10,4,0,0
"3943","CBJ","NYI",2008020169,14186,20082009,0,63.2166666666667,3,4,-1,0,0,0,34,29,5,48,41,7,66,59,7,7,2,0,0
"3944","CBJ","EDM",2008020179,14188,20082009,1,60,5,4,1,0,0,0,38,26,12,48,40,8,65,54,11,7,6,0,0
"3945","CBJ","MTL",2008020193,14190,20082009,1,65,3,3,0,0,0,0,28,37,-9,40,45,-5,52,62,-10,8,7,0,0
"3946","CBJ","CGY",2008020202,14191,20082009,1,60,3,1,2,0,0,0,28,23,5,39,35,4,46,46,0,10,9,0,0
"3947","CBJ","ARI",2008020224,14195,20082009,1,60,2,5,-3,0,0,0,33,30,3,47,45,2,66,58,8,5,5,0,0
"3948","CBJ","BUF",2008020237,14197,20082009,0,60,6,1,5,0,0,0,25,37,-12,31,43,-12,39,57,-18,3,8,0,0
"3949","CBJ","MIN",2008020248,14198,20082009,0,65,2,2,0,0,0,0,26,30,-4,30,41,-11,37,46,-9,1,3,0,0
"3950","CBJ","EDM",2008020264,14201,20082009,1,60,2,7,-5,0,0,0,39,19,20,52,25,27,70,38,32,7,3,0,0
"3951","CBJ","ATL",2008020291,14205,20082009,0,60,2,0,2,0,0,0,31,15,16,40,25,15,50,41,9,4,3,0,0
"3952","CBJ","ARI",2008020313,14209,20082009,1,60,2,3,-1,0,0,0,40,25,15,52,30,22,73,33,40,8,6,0,0
"3953","CBJ","DET",2008020332,14211,20082009,0,60,3,5,-2,0,0,0,16,35,-19,24,47,-23,31,60,-29,8,7,0,0
"3954","CBJ","WSH",2008020340,14212,20082009,1,60,3,0,3,0,0,0,31,26,5,40,38,2,50,53,-3,3,5,0,0
"3955","CBJ","VAN",2008020351,14214,20082009,1,60,3,2,1,0,0,0,29,32,-3,37,42,-5,43,50,-7,8,4,0,0
"3956","CBJ","S.J",2008020375,14217,20082009,0,60,2,3,-1,0,0,0,31,22,9,39,38,1,54,56,-2,2,6,0,0
"3957","CBJ","L.A",2008020391,14219,20082009,0,60,0,3,-3,0,0,0,23,18,5,34,37,-3,50,51,-1,4,2,0,0
"3958","CBJ","ANA",2008020396,14220,20082009,0,60,3,5,-2,0,0,0,32,34,-2,47,41,6,52,49,3,6,4,0,0
"3959","CBJ","NSH",2008020415,14224,20082009,1,65,1,1,0,0,0,0,36,26,10,48,36,12,63,45,18,5,4,0,0
"3960","CBJ","NYI",2008020436,14226,20082009,1,60,3,1,2,0,0,0,35,25,10,51,30,21,69,39,30,3,4,0,0
"3961","CBJ","CHI",2008020441,14227,20082009,0,60,1,3,-2,0,0,0,32,31,1,42,39,3,54,49,5,1,3,0,0
"3962","CBJ","S.J",2008020456,14230,20082009,1,62.9166666666667,2,1,1,0,0,0,32,48,-16,39,60,-21,46,77,-31,3,5,0,0
"3963","CBJ","DAL",2008020467,14231,20082009,0,65,5,5,0,0,0,0,28,17,11,46,28,18,67,39,28,5,5,0,0
"3964","CBJ","ARI",2008020483,14233,20082009,0,60,0,2,-2,0,0,0,33,24,9,44,32,12,62,44,18,2,3,0,0
"3965","CBJ","L.A",2008020498,14236,20082009,1,60,0,3,-3,0,0,0,24,42,-18,37,51,-14,55,61,-6,5,3,0,0
"3966","CBJ","PHI",2008020519,14240,20082009,1,60,3,0,3,0,0,0,33,20,13,46,25,21,61,35,26,8,5,0,0
"3967","CBJ","L.A",2008020538,14242,20082009,0,60,2,0,2,0,0,0,25,24,1,35,38,-3,46,54,-8,3,4,0,0
"3968","CBJ","ANA",2008020552,14244,20082009,0,60,2,0,2,0,0,0,29,27,2,38,36,2,46,46,0,5,6,0,0
"3969","CBJ","COL",2008020562,14246,20082009,0,60,6,1,5,0,0,0,30,24,6,35,36,-1,46,50,-4,6,7,0,0
"3970","CBJ","STL",2008020572,14247,20082009,0,60,2,5,-3,0,0,0,22,27,-5,31,39,-8,45,49,-4,5,11,0,0
"3971","CBJ","DET",2008020591,14250,20082009,0,60,0,3,-3,0,0,0,23,40,-17,37,52,-15,42,70,-28,6,7,0,0
"3972","CBJ","WSH",2008020609,14253,20082009,0,60,3,0,3,0,0,0,23,45,-22,32,59,-27,43,75,-32,7,6,0,0
"3973","CBJ","MIN",2008020621,14254,20082009,1,60,4,2,2,0,0,0,32,23,9,42,32,10,48,37,11,2,3,0,0
"3974","CBJ","COL",2008020635,14257,20082009,1,60,4,3,1,0,0,0,27,26,1,38,32,6,53,36,17,5,5,0,0
"3975","CBJ","N.J",2008020656,14260,20082009,1,60,1,2,-1,0,0,0,27,28,-1,35,34,1,48,47,1,3,1,0,0
"3976","CBJ","VAN",2008020676,14262,20082009,0,65,5,5,0,0,0,0,28,30,-2,40,38,2,52,52,0,5,7,0,0
"3977","CBJ","EDM",2008020689,14264,20082009,0,60,3,4,-1,0,0,0,23,22,1,34,32,2,52,42,10,3,3,0,0
"3978","CBJ","CGY",2008020700,14265,20082009,0,65,4,4,0,0,0,0,33,31,2,44,47,-3,50,69,-19,6,9,0,0
"3979","CBJ","DET",2008020703,14271,20082009,1,63.45,3,2,1,0,0,0,23,23,0,30,33,-3,41,42,-1,4,3,0,0
"3980","CBJ","OTT",2008020726,14274,20082009,1,60,1,0,1,0,0,0,26,17,9,38,19,19,56,32,24,7,6,0,0
"3981","CBJ","DAL",2008020736,14275,20082009,1,60,3,7,-4,0,0,0,38,31,7,53,40,13,65,45,20,5,4,0,0
"3982","CBJ","STL",2008020751,14278,20082009,1,60,2,4,-2,0,0,0,35,22,13,51,30,21,65,34,31,6,4,0,0
"3983","CBJ","PIT",2008020773,14281,20082009,0,60,1,4,-3,0,0,0,34,25,9,47,34,13,62,47,15,5,1,0,0
"3984","CBJ","S.J",2008020784,14282,20082009,1,61.55,3,2,1,0,0,0,20,30,-10,27,45,-18,35,62,-27,1,5,0,0
"3985","CBJ","COL",2008020797,14285,20082009,1,60,3,0,3,0,0,0,30,31,-1,50,42,8,70,50,20,2,3,0,0
"3986","CBJ","DET",2008020819,14288,20082009,1,60,3,2,1,0,0,0,25,34,-9,36,42,-6,43,60,-17,5,5,0,0
"3987","CBJ","CAR",2008020828,14289,20082009,0,60,5,1,4,0,0,0,20,27,-7,31,42,-11,48,71,-23,4,3,0,0
"3988","CBJ","DAL",2008020842,14291,20082009,1,65,2,2,0,0,0,0,43,22,21,55,37,18,63,44,19,6,3,0,0
"3989","CBJ","STL",2008020855,14293,20082009,1,60,4,3,1,0,0,0,21,24,-3,29,34,-5,40,50,-10,3,5,0,0
"3990","CBJ","TOR",2008020862,14294,20082009,0,65,3,3,0,0,0,0,34,35,-1,42,52,-10,53,77,-24,2,5,0,0
"3991","CBJ","ANA",2008020883,14296,20082009,1,60,2,5,-3,0,0,0,28,13,15,39,20,19,54,27,27,9,4,0,0
"3992","CBJ","CGY",2008020902,14299,20082009,0,60,1,4,-3,0,0,0,29,28,1,47,37,10,53,51,2,5,3,0,0
"3993","CBJ","EDM",2008020917,14301,20082009,0,60,1,0,1,0,0,0,32,19,13,48,25,23,64,32,32,5,3,0,0
"3994","CBJ","VAN",2008020939,14304,20082009,0,60,1,3,-2,0,0,0,20,30,-10,36,38,-2,47,52,-5,5,5,0,0
"3995","CBJ","L.A",2008020944,14306,20082009,1,60,5,4,1,0,0,0,25,26,-1,31,34,-3,42,50,-8,1,3,0,0
"3996","CBJ","NSH",2008020961,14308,20082009,0,60,2,4,-2,0,0,0,33,23,10,38,40,-2,47,53,-6,3,2,0,0
"3997","CBJ","PIT",2008021007,14315,20082009,1,65,3,3,0,0,0,0,28,41,-13,38,53,-15,48,65,-17,6,4,0,0
"3998","CBJ","FLA",2008021075,14324,20082009,0,60,3,1,2,0,0,0,37,23,14,51,39,12,63,53,10,1,3,0,0
"3999","CBJ","T.B",2008021091,14327,20082009,0,63.0666666666667,1,2,-1,0,0,0,34,17,17,44,24,20,52,41,11,3,1,0,0
"4000","CBJ","STL",2008021124,14331,20082009,0,65,3,3,0,0,0,0,27,28,-1,34,40,-6,41,51,-10,5,7,0,0
"4001","CBJ","STL",2008021128,14332,20082009,1,60,2,5,-3,0,0,0,28,27,1,41,33,8,60,39,21,5,7,0,0
"4002","CBJ","STL",2008021211,14344,20082009,0,60,1,3,-2,0,0,0,17,25,-8,23,37,-14,33,41,-8,1,7,0,0
"4003","CBJ","MIN",2008021224,14345,20082009,1,60,3,6,-3,0,0,0,28,28,0,36,38,-2,47,45,2,3,6,0,0
"4004","CBJ","DET",2008030161,14350,20082009,0,60,1,4,-3,0,0,0,21,34,-13,29,42,-13,46,58,-12,5,4,0,0
"4005","CBJ","DET",2008030162,14352,20082009,0,60,0,4,-4,0,0,0,25,39,-14,36,56,-20,48,76,-28,4,12,0,0
"4006","CBJ","DET",2008030163,14355,20082009,1,60,1,4,-3,0,0,0,32,26,6,46,35,11,58,43,15,4,2,0,0
"4007","CBJ","DET",2008030164,14357,20082009,1,60,5,6,-1,0,0,0,32,41,-9,46,52,-6,55,65,-10,3,7,0,0
"4008","CBJ","MIN",2009020018,14520,20092010,1,60,2,1,1,0,0,0,39,33,6,47,38,9,57,46,11,2,4,0,0
"4009","CBJ","EDM",2009020124,14539,20092010,0,60,4,6,-2,0,0,0,32,32,0,44,42,2,64,55,9,5,8,0,0
"4010","CBJ","ANA",2009020144,14541,20092010,0,60,6,4,2,0,0,0,37,36,1,47,49,-2,53,58,-5,3,3,0,0
"4011","CBJ","PIT",2009020173,14547,20092010,1,65,3,3,0,0,0,0,32,32,0,39,38,1,55,52,3,8,6,0,0
"4012","CBJ","ANA",2009020264,14561,20092010,1,65,2,2,0,0,0,0,29,34,-5,42,45,-3,56,60,-4,5,6,0,0
"4013","CBJ","EDM",2009020285,14564,20092010,1,65,2,2,0,0,0,0,32,25,7,44,37,7,55,48,7,6,7,0,0
"4014","CBJ","DAL",2009020304,14567,20092010,0,60,4,1,3,0,0,0,28,26,2,41,33,8,53,45,8,7,7,0,0
"4015","CBJ","NYR",2009020330,14571,20092010,0,60,4,7,-3,0,0,0,30,33,-3,37,40,-3,49,53,-4,1,4,0,0
"4016","CBJ","MTL",2009020338,14572,20092010,0,60,3,5,-2,0,0,0,36,29,7,46,39,7,71,58,13,4,3,0,0
"4017","CBJ","OTT",2009020353,14574,20092010,0,60,1,2,-1,0,0,0,33,36,-3,41,48,-7,58,59,-1,6,4,0,0
"4018","CBJ","STL",2009020386,14578,20092010,1,60,5,2,3,0,0,0,27,29,-2,34,36,-2,44,47,-3,4,4,0,0
"4019","CBJ","TOR",2009020402,14581,20092010,1,60,3,6,-3,0,0,0,36,25,11,45,33,12,56,38,18,6,4,0,0
"4020","CBJ","COL",2009020421,14583,20092010,1,60,2,3,-1,0,0,0,31,19,12,45,25,20,63,36,27,5,3,0,0
"4021","CBJ","FLA",2009020445,14587,20092010,1,60,3,0,3,0,0,0,32,32,0,43,42,1,63,48,15,2,3,0,0
"4022","CBJ","ANA",2009020472,14590,20092010,1,60,1,3,-2,0,0,0,36,25,11,43,29,14,58,40,18,5,3,0,0
"4023","CBJ","MIN",2009020491,14593,20092010,0,60,1,2,-1,0,0,0,22,23,-1,33,38,-5,41,48,-7,1,1,0,0
"4024","CBJ","COL",2009020527,14597,20092010,0,60,2,5,-3,0,0,0,30,31,-1,47,40,7,67,48,19,3,5,0,0
"4025","CBJ","DAL",2009020554,14601,20092010,0,60,1,3,-2,0,0,0,34,28,6,54,41,13,78,59,19,6,6,0,0
"4026","CBJ","NYI",2009020585,14607,20092010,0,65,1,1,0,0,0,0,42,25,17,51,40,11,79,56,23,3,4,0,0
"4027","CBJ","COL",2009020616,14611,20092010,1,60,2,3,-1,0,0,0,28,37,-9,33,44,-11,48,52,-4,4,6,0,0
"4028","CBJ","EDM",2009020651,14616,20092010,0,60,4,2,2,0,0,0,29,26,3,35,46,-11,41,65,-24,3,4,0,0
"4029","CBJ","DAL",2009020674,14619,20092010,1,60,2,0,2,0,0,0,41,26,15,54,33,21,65,43,22,5,5,0,0
"4030","CBJ","STL",2009020686,14621,20092010,0,60,1,4,-3,0,0,0,27,23,4,32,33,-1,42,44,-2,6,4,0,0
"4031","CBJ","STL",2009020726,14627,20092010,1,60,4,2,2,0,0,0,30,32,-2,40,42,-2,59,56,3,4,4,0,0
"4032","CBJ","PHI",2009020734,14628,20092010,0,60,3,5,-2,0,0,0,28,37,-9,38,53,-15,53,62,-9,3,4,0,0
"4033","CBJ","MIN",2009020769,14632,20092010,0,60,2,4,-2,0,0,0,24,28,-4,36,38,-2,47,50,-3,3,6,0,0
"4034","CBJ","STL",2009020812,14639,20092010,0,61.5333333333333,3,2,1,0,0,0,19,27,-8,26,44,-18,35,59,-24,6,5,0,0
"4035","CBJ","COL",2009020833,14642,20092010,0,60,1,5,-4,0,0,0,21,26,-5,31,43,-12,37,54,-17,5,3,0,0
"4036","CBJ","DAL",2009020843,14644,20092010,1,60,2,1,1,0,0,0,26,23,3,34,30,4,43,43,0,0,3,0,0
"4037","CBJ","ANA",2009020984,14677,20092010,0,60,5,2,3,0,0,0,29,38,-9,44,52,-8,53,64,-11,9,9,0,0
"4038","CBJ","STL",2009021012,14681,20092010,1,60,1,5,-4,0,0,0,25,36,-11,34,45,-11,41,54,-13,7,6,0,0
"4039","CBJ","EDM",2009021026,14683,20092010,1,60,5,3,2,0,0,0,29,32,-3,38,42,-4,50,61,-11,3,4,0,0
"4040","CBJ","MIN",2009021053,14687,20092010,1,60,4,2,2,0,0,0,32,20,12,38,29,9,59,39,20,5,3,0,0
"4041","CBJ","N.J",2009021081,14691,20092010,0,60,3,6,-3,0,0,0,22,30,-8,30,38,-8,34,48,-14,4,7,0,0
"4042","CBJ","NYI",2009021117,14695,20092010,1,62.9666666666667,3,4,-1,0,0,0,37,28,9,48,45,3,62,52,10,4,0,0,0
"4043","CBJ","T.B",2009021137,14698,20092010,1,60,3,2,1,0,0,0,25,18,7,33,26,7,49,34,15,6,4,0,0
"4044","CBJ","STL",2009021180,14704,20092010,0,63.9833333333333,1,2,-1,0,0,0,28,34,-6,35,49,-14,47,61,-14,7,7,0,0
"4045","CBJ","MIN",2010020061,14898,20102011,0,60,3,2,1,3.53011315481854,2.91392295464175,0.616190200176788,25,23,2,37,33,4,46,51,-5,4,5,0,0
"4046","CBJ","ANA",2010020079,14902,20102011,1,60,3,1,2,5.15826043288689,2.79928801419737,2.35897241868952,22,32,-10,28,42,-14,35,62,-27,3,5,0,0
"4047","CBJ","PHI",2010020114,14907,20102011,1,60,2,1,1,0,0,0,25,29,-4,38,36,2,52,48,4,6,3,0,0
"4048","CBJ","EDM",2010020131,14910,20102011,1,65,2,2,0,6.89991332222384,3.52333427480778,3.37657904741606,41,27,14,52,35,17,61,54,7,8,6,0,0
"4049","CBJ","COL",2010020152,14912,20102011,0,60,1,5,-4,6.20271953371163,4.18849016816239,2.01422936554924,34,31,3,54,43,11,64,50,14,5,8,0,0
"4050","CBJ","MTL",2010020161,14915,20102011,1,60,3,0,3,5.1420250593219,4.07398175312846,1.06804330619343,24,29,-5,32,41,-9,40,65,-25,3,3,0,0
"4051","CBJ","MIN",2010020194,14919,20102011,1,60,2,3,-1,5.30300880649065,4.83425307487721,0.468755731613442,37,24,13,48,32,16,65,47,18,4,4,0,0
"4052","CBJ","STL",2010020213,14923,20102011,1,60,8,1,7,5.76712572356448,6.13166553794872,-0.364539814384237,35,30,5,45,39,6,53,57,-4,8,7,0,0
"4053","CBJ","COL",2010020229,14925,20102011,1,60,1,5,-4,4.63319359983947,4.12599859910551,0.507195000733958,29,29,0,39,38,1,56,44,12,4,1,0,0
"4054","CBJ","ANA",2010020282,14932,20102011,0,60,4,3,1,7.28810842998791,4.91539114297484,2.37271728701307,29,50,-21,42,59,-17,52,71,-19,4,5,0,0
"4055","CBJ","NYI",2010020308,14937,20102011,0,62.5166666666667,4,3,1,4.66762845973245,6.15868960649095,-1.4910611467585,38,24,14,48,36,12,64,48,16,6,4,0,0
"4056","CBJ","PIT",2010020384,14947,20102011,1,60,2,7,-5,1.89931618027185,4.5275708159696,-2.62825463569774,23,35,-12,28,45,-17,36,55,-19,6,5,0,0
"4057","CBJ","DAL",2010020400,14949,20102011,1,65,2,2,0,5.5611014708993,2.97715496303863,2.58394650786067,29,18,11,40,35,5,49,53,-4,3,4,0,0
"4058","CBJ","STL",2010020416,14952,20102011,0,60,1,4,-3,2.78949454553367,3.74897411376229,-0.959479568228616,28,24,4,38,32,6,56,43,13,9,4,0,0
"4059","CBJ","NYR",2010020431,14954,20102011,1,60,3,1,2,4.58465014956892,2.51221096219626,2.07243918737265,23,33,-10,27,43,-16,35,55,-20,2,5,0,0
"4060","CBJ","EDM",2010020468,14959,20102011,0,60,3,6,-3,4.15764195435622,2.96316644159003,1.19447551276619,40,36,4,55,47,8,77,60,17,4,5,0,0
"4061","CBJ","DAL",2010020478,14961,20102011,1,60,1,2,-1,6.42140101705445,5.07393576902922,1.34746524802523,36,23,13,46,41,5,58,49,9,9,10,0,0
"4062","CBJ","MIN",2010020531,14970,20102011,1,65,3,3,0,2.61363825846638,5.03252404893283,-2.41888579046645,22,40,-18,32,52,-20,40,69,-29,4,8,0,0
"4063","CBJ","TOR",2010020551,14973,20102011,0,60,3,2,1,6.1206838535727,4.57854421321139,1.54213964036131,32,22,10,49,37,12,74,47,27,2,1,0,0
"4064","CBJ","OTT",2010020561,14974,20102011,1,62.1,4,3,1,5.35364881587157,6.38336564773635,-1.02971683186479,23,38,-15,41,45,-4,57,55,2,5,4,0,0
"4065","CBJ","ANA",2010020611,14981,20102011,0,60,0,6,-6,4.29464727305458,5.31442892478663,-1.01978165173205,27,29,-2,39,35,4,46,41,5,7,8,0,0
"4066","CBJ","T.B",2010020688,14992,20102011,0,65,2,2,0,3.16919429882546,6.49958749493817,-3.33039319611271,30,22,8,45,37,8,63,52,11,4,4,0,0
"4067","CBJ","FLA",2010020694,14993,20102011,0,64.1,3,2,1,5.88559700710846,2.60623555567872,3.27936145142974,38,31,7,53,37,16,66,50,16,3,4,0,0
"4068","CBJ","STL",2010020719,14996,20102011,0,60,5,2,3,4.16345231374726,3.48412569961511,0.679326614132151,30,21,9,41,33,8,54,52,2,7,5,0,0
"4069","CBJ","ANA",2010020737,14999,20102011,1,60,2,3,-1,3.90514315496346,1.49686539033428,2.40827776462919,37,22,15,48,27,21,67,33,34,5,0,0,0
"4070","CBJ","EDM",2010020789,15010,20102011,1,60,4,3,1,2.96052630539634,3.15714109793271,-0.196614792536366,34,26,8,44,40,4,54,52,2,4,6,0,0
"4071","CBJ","PIT",2010020804,15013,20102011,0,60,4,1,3,5.16520031169057,3.68381481497833,1.48138549671224,25,33,-8,36,38,-2,47,48,-1,1,3,0,0
"4072","CBJ","COL",2010020824,15016,20102011,1,60,3,1,2,4.24401536647565,2.62080943070089,1.62320593577476,32,32,0,44,43,1,60,52,8,2,1,0,0
"4073","CBJ","DAL",2010020839,15018,20102011,0,60,2,1,1,5.79209874181574,2.95617266307818,2.83592607873756,39,30,9,47,39,8,60,54,6,2,6,0,0
"4074","CBJ","EDM",2010020964,15036,20102011,0,60,2,4,-2,2.41356224237825,3.24827675242204,-0.834714510043796,28,38,-10,47,40,7,73,53,20,7,5,0,0
"4075","CBJ","STL",2010020990,15040,20102011,0,65,4,4,0,3.51621228514705,5.31561716677772,-1.79940488163067,28,36,-8,35,46,-11,53,66,-13,4,3,0,0
"4076","CBJ","STL",2010021004,15042,20102011,1,60.9,3,4,-1,3.68113694202475,3.10954766327268,0.571589278752072,22,26,-4,33,30,3,49,39,10,4,2,0,0
"4077","CBJ","MIN",2010021070,15052,20102011,0,64.4333333333333,5,4,1,4.87049731666684,5.43140003544977,-0.560902718782927,33,36,-3,41,46,-5,56,64,-8,3,4,0,0
"4078","CBJ","N.J",2010021082,15053,20102011,1,60,0,3,-3,2.9837063485611,5.52539641677868,-2.54169006821758,13,31,-18,25,43,-18,38,57,-19,1,4,0,0
"4079","CBJ","COL",2010021096,15055,20102011,0,65,4,4,0,3.33598570949643,3.66420824164088,-0.328222532144445,33,32,1,45,41,4,59,57,2,2,4,0,0
"4080","CBJ","FLA",2010021138,15062,20102011,1,65,2,2,0,6.5122243370372,8.30873029064969,-1.7965059536125,32,31,1,42,43,-1,58,55,3,3,3,0,0
"4081","CBJ","STL",2010021178,15067,20102011,1,60,1,6,-5,4.60508090084477,6.68160833569709,-2.07652743485232,24,33,-9,35,43,-8,53,51,2,3,3,0,0
"4082","CBJ","DAL",2010021191,15069,20102011,0,60,0,3,-3,5.24048164737317,6.42474954598583,-1.18426789861266,23,30,-7,38,48,-10,50,65,-15,3,6,0,0
"4083","CBJ","MIN",2011020016,15255,20112012,0,60,2,4,-2,2.32766405045186,3.93503578178439,-1.60737173133254,31,26,5,42,41,1,61,51,10,5,4,0,0
"4084","CBJ","COL",2011020034,15259,20112012,1,65,2,2,0,5.71882367381477,5.99465383567735,-0.275830161862586,33,32,1,42,49,-7,53,68,-15,5,5,0,0
"4085","CBJ","DAL",2011020059,15262,20112012,0,60,2,4,-2,1.5618496017162,2.04099578152056,-0.479146179804369,15,33,-18,24,44,-20,41,58,-17,6,5,0,0
"4086","CBJ","DAL",2011020071,15265,20112012,1,60,2,3,-1,3.96741323731158,4.74963992967969,-0.782226692368113,40,18,22,52,26,26,59,27,32,5,2,0,0
"4087","CBJ","OTT",2011020099,15269,20112012,0,60,3,4,-1,5.02752659632824,6.21234717480728,-1.18482057847904,21,27,-6,28,36,-8,39,48,-9,4,2,0,0
"4088","CBJ","ANA",2011020153,15277,20112012,1,60,3,1,2,3.48267431397107,1.52170726103941,1.96096705293166,21,20,1,31,25,6,38,43,-5,4,4,0,0
"4089","CBJ","TOR",2011020171,15281,20112012,1,60,1,4,-3,10.2556968700992,3.39163151546381,6.86406535463539,39,18,21,52,24,28,70,33,37,4,2,0,0
"4090","CBJ","PHI",2011020189,15283,20112012,0,60,2,9,-7,7.44568624571548,6.16662605125748,1.279060194458,35,33,2,47,49,-2,61,60,1,4,6,0,0
"4091","CBJ","WPG",2011020234,15290,20112012,1,60,2,1,1,3.86308222384832,3.37516594028397,0.487916283564349,27,36,-9,38,43,-5,53,59,-6,4,5,0,0
"4092","CBJ","MIN",2011020251,15293,20112012,1,60,2,4,-2,4.39834704103805,3.52919437550008,0.869152665537968,45,24,21,52,26,26,66,37,29,3,5,0,0
"4093","CBJ","N.J",2011020301,15301,20112012,0,65,1,1,0,3.69427171568555,3.36493281364345,0.329338902042096,36,24,12,45,30,15,50,38,12,6,3,0,0
"4094","CBJ","STL",2011020338,15305,20112012,1,60,1,2,-1,2.48689572521334,2.99140813987469,-0.504512414661349,24,29,-5,31,37,-6,43,44,-1,5,5,0,0
"4095","CBJ","EDM",2011020370,15310,20112012,0,60,3,6,-3,4.15059353304969,4.2011781247711,-0.0505845917214174,39,34,5,46,42,4,68,48,20,5,2,0,0
"4096","CBJ","MTL",2011020394,15314,20112012,0,65,2,2,0,3.09136542581837,3.06104099645745,0.0303244293609168,28,20,8,45,34,11,60,46,14,4,3,0,0
"4097","CBJ","VAN",2011020442,15321,20112012,1,65,1,1,0,2.39620000972172,5.50373148371,-3.10753147398827,30,32,-2,39,43,-4,50,62,-12,4,5,0,0
"4098","CBJ","L.A",2011020453,15323,20112012,1,60,1,2,-1,5.18015251244651,6.67854596266989,-1.49839345022338,25,41,-16,32,46,-14,44,60,-16,4,3,0,0
"4099","CBJ","T.B",2011020472,15325,20112012,1,60,2,3,-1,0,0,0,28,28,0,44,38,6,56,38,18,5,3,0,0
"4100","CBJ","STL",2011020480,15326,20112012,0,60,4,6,-2,5.05255720307468,6.04351485355437,-0.990957650479686,32,34,-2,51,42,9,58,49,9,5,3,0,0
"4101","CBJ","NSH",2011020503,15330,20112012,0,60,5,6,-1,5.81957975763362,5.79950176319107,0.0200779944425449,31,38,-7,43,46,-3,54,54,0,3,4,0,0
"4102","CBJ","CHI",2011020525,15334,20112012,0,60,1,4,-3,5.56656526654826,2.98970489469934,2.57686037184892,38,22,16,48,26,22,56,36,20,2,3,0,0
"4103","CBJ","CGY",2011020530,15335,20112012,1,65,1,1,0,5.70264692780944,2.936490990833,2.76615593697644,28,26,2,41,31,10,52,38,14,5,3,0,0
"4104","CBJ","DAL",2011020548,15337,20112012,0,60,4,1,3,4.22354009181413,3.42506061134918,0.798479480464948,29,37,-8,37,48,-11,56,61,-5,3,4,0,0
"4105","CBJ","S.J",2011020592,15344,20112012,0,60,1,2,-1,2.99256489467685,3.49683125002775,-0.504266355350907,24,39,-15,33,54,-21,45,66,-21,1,5,0,0
"4106","CBJ","L.A",2011020601,15346,20112012,0,60,1,0,1,2.31426276707771,5.4761021562349,-3.16183938915719,18,31,-13,30,47,-17,38,67,-29,7,9,0,0
"4107","CBJ","ANA",2011020613,15347,20112012,0,60,4,7,-3,2.49707384440331,5.51086734381603,-3.01379349941272,18,27,-9,32,39,-7,46,56,-10,2,5,0,0
"4108","CBJ","CHI",2011020625,15349,20112012,0,60,2,5,-3,2.8979071698035,2.8000135916518,0.0978935781516945,34,25,9,40,35,5,48,47,1,6,5,0,0
"4109","CBJ","S.J",2011020654,15353,20112012,1,60,1,2,-1,2.74762039693209,3.98230036951645,-1.23467997258436,26,33,-7,32,43,-11,45,56,-11,3,3,0,0
"4110","CBJ","EDM",2011020676,15356,20112012,1,60,4,2,2,4.34717316518072,4.59299766839831,-0.245824503217591,25,23,2,33,34,-1,48,50,-2,2,3,0,0
"4111","CBJ","NSH",2011020689,15358,20112012,1,60,0,3,-3,6.9495301230927,5.20876889699139,1.74076122610131,38,25,13,51,29,22,64,38,26,3,2,0,0
"4112","CBJ","DET",2011020704,15360,20112012,0,65,2,2,0,3.12018090251513,3.45371170339058,-0.333530800875451,19,31,-12,31,40,-9,49,57,-8,2,4,0,0
"4113","CBJ","NSH",2011020719,15362,20112012,0,60,1,4,-3,5.57242594003765,2.43098788143834,3.14143805859931,26,29,-3,36,36,0,51,48,3,2,5,0,0
"4114","CBJ","T.B",2011020726,15363,20112012,0,60,2,4,-2,3.42154982856545,4.38064608478453,-0.959096256219084,24,31,-7,40,41,-1,54,53,1,2,4,0,0
"4115","CBJ","S.J",2011020748,15370,20112012,0,60,0,6,-6,3.65869733448199,2.86964549939148,0.789051835090504,30,43,-13,45,54,-9,59,70,-11,2,4,0,0
"4116","CBJ","L.A",2011020753,15371,20112012,0,60,2,3,-1,3.3856058466481,4.15927649952937,-0.773670652881265,22,33,-11,28,53,-25,34,66,-32,3,3,0,0
"4117","CBJ","ANA",2011020766,15373,20112012,0,63.9166666666667,3,2,1,4.23077838906693,3.87071868491572,0.360059704151205,21,35,-14,36,49,-13,53,70,-17,4,5,0,0
"4118","CBJ","MIN",2011020789,15377,20112012,1,60,3,1,2,4.49822643450352,3.76916131209873,0.729065122404791,37,29,8,45,35,10,57,41,16,7,2,0,0
"4119","CBJ","DAL",2011020806,15379,20112012,1,60,2,4,-2,3.4668828958529,6.87960729093174,-3.41272439507884,28,35,-7,36,41,-5,47,60,-13,3,3,0,0
"4120","CBJ","MIN",2011020824,15381,20112012,0,60,3,1,2,4.44014443084598,6.24511194123477,-1.80496751038879,19,35,-16,28,55,-27,35,65,-30,5,2,0,0
"4121","CBJ","ANA",2011020830,15382,20112012,1,60,3,5,-2,2.99213697842788,6.02043695357861,-3.02829997515073,27,35,-8,34,40,-6,50,50,0,5,4,0,0
"4122","CBJ","STL",2011020839,15384,20112012,1,60,2,1,1,5.44623134625726,4.92802173570303,0.518209610554234,33,32,1,47,43,4,57,59,-2,5,2,0,0
"4123","CBJ","CHI",2011020866,15388,20112012,1,60,1,6,-5,0,0,0,34,28,6,42,40,2,54,50,4,1,2,0,0
"4124","CBJ","NYR",2011020879,15389,20112012,0,60.3666666666667,2,3,-1,3.49647607907536,4.34144521910079,-0.84496914002543,23,35,-12,28,46,-18,38,66,-28,4,2,0,0
"4125","CBJ","S.J",2011020888,15391,20112012,1,60,6,3,3,4.7234535800817,3.73611410713056,0.987339472951135,35,41,-6,42,50,-8,52,60,-8,7,4,0,0
"4126","CBJ","COL",2011020911,15394,20112012,1,60,0,5,-5,3.02722880401416,3.00821221986553,0.0190165841486305,28,25,3,37,26,11,55,36,19,4,1,0,0
"4127","CBJ","DET",2011020941,15398,20112012,1,60,2,5,-3,4.40284852459677,4.08437686807883,0.318471656517939,30,25,5,37,39,-2,52,50,2,5,6,0,0
"4128","CBJ","COL",2011020955,15400,20112012,0,60,2,0,2,3.08228139173245,6.04596619660151,-2.96368480486906,28,33,-5,37,41,-4,50,58,-8,3,3,0,0
"4129","CBJ","ARI",2011020969,15402,20112012,0,60,5,2,3,5.17267677140899,3.00068919364526,2.17198757776373,26,32,-6,36,38,-2,47,54,-7,3,4,0,0
"4130","CBJ","ARI",2011020988,15405,20112012,1,60,3,2,1,5.16641704438027,4.39533670702711,0.771080337353162,32,40,-8,39,45,-6,45,61,-16,4,6,0,0
"4131","CBJ","L.A",2011021002,15407,20112012,1,60,3,1,2,4.29048540419899,5.93516342267264,-1.64467801847366,36,30,6,47,46,1,60,69,-9,6,2,0,0
"4132","CBJ","STL",2011021020,15409,20112012,0,60,1,4,-3,4.14596135129045,7.83940329243342,-3.69344194114296,22,29,-7,32,46,-14,44,55,-11,6,8,0,0
"4133","CBJ","STL",2011021027,15410,20112012,1,60,1,2,-1,5.52294907720284,5.7977899306983,-0.274840853495466,34,26,8,43,34,9,65,43,22,9,5,0,0
"4134","CBJ","EDM",2011021049,15413,20112012,0,60,0,3,-3,2.82506308906795,5.37847441108184,-2.55341132201389,22,27,-5,33,40,-7,51,51,0,3,4,0,0
"4135","CBJ","VAN",2011021073,15416,20112012,0,60,3,4,-1,4.66974182400951,5.0095805938472,-0.339838769837696,36,38,-2,49,46,3,62,80,-18,2,3,0,0
"4136","CBJ","CGY",2011021078,15417,20112012,0,65,1,1,0,1.55954396421657,3.29681423900183,-1.73727027478526,18,31,-13,26,56,-30,38,84,-46,3,5,0,0
"4137","CBJ","CHI",2011021091,15419,20112012,1,60,1,5,-4,3.52925467293244,5.14652041411318,-1.61726574118074,25,27,-2,37,38,-1,55,49,6,2,2,0,0
"4138","CBJ","CAR",2011021113,15422,20112012,1,60,5,1,4,4.04679003663477,6.7167746662987,-2.66998462966393,26,40,-14,33,48,-15,47,58,-11,3,5,0,0
"4139","CBJ","EDM",2011021127,15424,20112012,1,60,3,6,-3,3.38848506113573,4.47758850505488,-1.08910344391916,32,38,-6,45,45,0,52,50,2,9,6,0,0
"4140","CBJ","DET",2011021135,15425,20112012,0,60,2,7,-5,5.14508760084823,2.77475887734909,2.37032872349914,26,39,-13,34,46,-12,41,64,-23,4,6,0,0
"4141","CBJ","DET",2011021149,15427,20112012,1,60,4,2,2,4.7925027099541,6.85783975791128,-2.06533704795718,31,31,0,46,40,6,60,62,-2,4,5,0,0
"4142","CBJ","FLA",2011021163,15429,20112012,1,60,4,1,3,5.07596323231701,3.76289786101552,1.31306537130149,29,31,-2,41,36,5,49,50,-1,6,4,0,0
"4143","CBJ","STL",2011021175,15430,20112012,0,60,5,2,3,4.60594782174667,3.57966576497238,1.02628205677428,33,36,-3,39,53,-14,50,69,-19,12,9,0,0
"4144","CBJ","ARI",2011021198,15433,20112012,0,60,0,2,-2,7.18618035520194,3.07740356405627,4.10877679114567,54,22,32,69,35,34,82,51,31,7,1,0,0
"4145","CBJ","COL",2011021211,15435,20112012,0,60,5,2,3,4.07664769521216,4.20881604247552,-0.132168347263359,28,37,-9,37,52,-15,48,68,-20,5,4,0,0
"4146","CBJ","NYI",2011021224,15437,20112012,1,60,7,3,4,7.24192640049362,4.11209179225261,3.129834608241,37,38,-1,42,47,-5,51,55,-4,3,2,0,0
"4147","CBJ","NSH",2012020010,15724,20122013,0,65,2,2,0,5.76422181216185,5.28930123167811,0.47492058048374,28,34,-6,39,46,-7,48,58,-10,4,2,0,0
"4148","CBJ","DET",2012020025,15726,20122013,1,65,3,3,0,3.92554560376448,4.10316229831369,-0.177616694549215,33,42,-9,38,57,-19,45,72,-27,9,9,0,0
"4149","CBJ","ARI",2012020039,15728,20122013,0,60,1,5,-4,3.67326235375367,8.38383057212923,-4.71056821837556,26,42,-16,39,55,-16,57,68,-11,4,6,0,0
"4150","CBJ","COL",2012020047,15729,20122013,0,60,0,4,-4,3.4795750673652,2.8291047857856,0.650470281579601,33,28,5,49,37,12,75,44,31,9,7,0,0
"4151","CBJ","CHI",2012020059,15731,20122013,1,60,2,3,-1,3.27191964701126,3.21679874372785,0.0551209032834095,26,24,2,37,29,8,50,40,10,6,5,0,0
"4152","CBJ","DAL",2012020074,15733,20122013,1,60,2,1,1,4.58553477082023,2.85252300187275,1.73301176894748,27,25,2,32,34,-2,46,44,2,8,5,0,0
"4153","CBJ","MIN",2012020086,15734,20122013,0,60,2,3,-1,3.43391915913253,3.02564205264207,0.408277106490459,19,26,-7,33,33,0,51,41,10,4,3,0,0
"4154","CBJ","STL",2012020096,15736,20122013,1,60,1,4,-3,6.27263402065061,4.07453624851769,2.19809777213292,25,25,0,35,38,-3,49,42,7,4,5,0,0
"4155","CBJ","DET",2012020114,15738,20122013,1,60,4,2,2,4.52941606498393,5.84635766754792,-1.31694160256399,28,34,-6,37,44,-7,42,60,-18,3,5,0,0
"4156","CBJ","L.A",2012020131,15741,20122013,1,60,2,4,-2,1.82684350203331,4.24213204917032,-2.41528854713701,20,31,-11,25,43,-18,37,54,-17,4,2,0,0
"4157","CBJ","CGY",2012020146,15743,20122013,1,61.1166666666667,3,4,-1,3.20043983160576,6.09499251220859,-2.89455268060283,29,30,-1,35,41,-6,42,54,-12,4,4,0,0
"4158","CBJ","EDM",2012020167,15746,20122013,1,60,1,3,-2,2.74575759846732,2.35449728276672,0.391260315700606,40,14,26,49,20,29,62,25,37,7,4,0,0
"4159","CBJ","S.J",2012020174,15747,20122013,1,60,6,2,4,5.0220081589398,3.35496455116663,1.66704360777317,36,27,9,46,33,13,56,45,11,4,3,0,0
"4160","CBJ","L.A",2012020204,15751,20122013,0,60,1,2,-1,1.44327936181799,3.33141281032295,-1.88813344850496,13,22,-9,19,33,-14,31,41,-10,4,5,0,0
"4161","CBJ","ARI",2012020210,15752,20122013,0,60,3,5,-2,2.18199276455562,5.83057943744042,-3.6485866728848,20,35,-15,27,43,-16,50,58,-8,3,7,0,0
"4162","CBJ","ANA",2012020225,15754,20122013,0,60,2,3,-1,2.42572282705805,2.7512662060908,-0.325543379032752,27,29,-2,41,39,2,70,49,21,3,3,0,0
"4163","CBJ","DET",2012020244,15757,20122013,0,60,3,2,1,4.10239650971926,4.07003606902435,0.0323604406949016,24,30,-6,34,37,-3,47,46,1,4,5,0,0
"4164","CBJ","STL",2012020259,15759,20122013,0,60,1,2,-1,2.91136986047786,3.00976781453937,-0.098397954061511,20,23,-3,29,31,-2,52,40,12,6,4,0,0
"4165","CBJ","CHI",2012020266,15760,20122013,0,60,0,1,-1,3.13046717771795,5.54500233623548,-2.41453515851754,28,27,1,34,39,-5,50,50,0,7,5,0,0
"4166","CBJ","DAL",2012020277,15762,20122013,1,63.05,4,5,-1,4.28351818607189,8.13057509076316,-3.84705690469127,20,39,-19,24,50,-26,30,62,-32,2,2,0,0
"4167","CBJ","CHI",2012020300,15765,20122013,0,63.3833333333333,3,4,-1,5.07856342883315,7.08812585682608,-2.00956242799293,22,35,-13,34,49,-15,48,68,-20,1,2,0,0
"4168","CBJ","COL",2012020313,15767,20122013,1,62.4333333333333,2,1,1,4.25401987446821,3.17655539222443,1.07746448224378,34,19,15,42,27,15,62,39,23,6,3,0,0
"4169","CBJ","EDM",2012020328,15769,20122013,1,65,3,3,0,5.40778102908202,3.04700443852926,2.36077659055276,38,29,9,50,35,15,63,46,17,4,3,0,0
"4170","CBJ","VAN",2012020345,15771,20122013,1,64.05,2,1,1,4.94781265812344,2.81068543144829,2.13712722667515,27,35,-8,35,47,-12,50,59,-9,3,1,0,0
"4171","CBJ","DET",2012020357,15773,20122013,1,60,3,0,3,2.59070993582645,5.26659482121475,-2.6758848853883,24,30,-6,34,41,-7,46,51,-5,7,4,0,0
"4172","CBJ","DET",2012020366,15774,20122013,0,65,2,2,0,4.83802228270179,3.11505198079072,1.72297030191106,21,23,-2,29,34,-5,42,51,-9,5,6,0,0
"4173","CBJ","VAN",2012020379,15776,20122013,1,65,1,1,0,5.25897461111842,4.77872342177068,0.48025118934774,27,38,-11,38,45,-7,48,72,-24,2,2,0,0
"4174","CBJ","CHI",2012020394,15778,20122013,1,65,1,1,0,8.42737521799783,5.642534245766,2.78484097223183,30,40,-10,43,49,-6,58,66,-8,2,1,0,0
"4175","CBJ","ARI",2012020412,15780,20122013,1,65,0,0,0,5.20427372069389,7.96628871536374,-2.76201499466985,23,39,-16,37,51,-14,50,74,-24,2,2,0,0
"4176","CBJ","NSH",2012020432,15783,20122013,1,60,4,3,1,2.85959048895165,4.70221927927923,-1.84262879032758,31,35,-4,33,43,-10,46,50,-4,3,1,0,0
"4177","CBJ","CGY",2012020453,15786,20122013,1,60,5,1,4,5.14765385130886,3.32284137795068,1.82481247335818,28,25,3,38,34,4,49,46,3,4,2,0,0
"4178","CBJ","NSH",2012020462,15787,20122013,0,60,2,5,-3,3.44786624638073,3.78550795831688,-0.337641711936158,23,24,-1,30,31,-1,44,42,2,2,2,0,0
"4179","CBJ","VAN",2012020487,15790,20122013,0,65,0,0,0,2.52261745923897,6.10668729351892,-3.58406983427994,17,34,-17,22,48,-26,38,75,-37,2,3,0,0
"4180","CBJ","EDM",2012020499,15792,20122013,0,60,4,6,-2,5.8813568209298,7.21302775902222,-1.33167093809243,30,25,5,39,33,6,56,49,7,2,2,0,0
"4181","CBJ","CGY",2012020505,15793,20122013,0,60,6,4,2,4.43356397928483,4.26674021120016,0.166823768084669,25,33,-8,36,43,-7,47,63,-16,1,4,0,0
"4182","CBJ","ANA",2012020518,15795,20122013,1,64,2,1,1,4.1134211360029,5.25798873527674,-1.14456759927384,18,30,-12,27,40,-13,34,54,-20,1,2,0,0
"4183","CBJ","NSH",2012020548,15799,20122013,0,60,3,1,2,4.19388369788601,4.06232281589473,0.131560881991277,38,39,-1,50,45,5,68,58,10,3,3,0,0
"4184","CBJ","STL",2012020555,15800,20122013,0,60,1,3,-2,4.09463462612558,2.37822367856279,1.71641094756279,27,19,8,37,30,7,50,40,10,5,7,0,0
"4185","CBJ","MIN",2012020572,15802,20122013,1,60,0,3,-3,1.05442711568321,4.83302154942066,-3.77859443373745,24,24,0,25,31,-6,43,41,2,4,3,0,0
"4186","CBJ","S.J",2012020584,15804,20122013,1,60,4,0,4,4.45282894952106,5.16618089465192,-0.713351945130853,30,30,0,43,45,-2,53,59,-6,3,2,0,0
"4187","CBJ","STL",2012020606,15807,20122013,1,60,4,1,3,3.78997319802875,6.70432253135368,-2.91434933332494,19,32,-13,30,48,-18,40,60,-20,2,5,0,0
"4188","CBJ","MIN",2012020617,15808,20122013,0,65,2,2,0,3.65406207140768,6.25033456855454,-2.59627249714686,22,41,-19,30,48,-18,46,60,-14,1,5,0,0
"4189","CBJ","COL",2012020629,15810,20122013,0,64.5166666666667,4,3,1,4.5358883705938,2.89206504391041,1.64382332668339,30,32,-2,43,53,-10,64,73,-9,1,2,0,0
"4190","CBJ","ANA",2012020643,15812,20122013,0,62.3166666666667,3,2,1,2.09790930460986,2.58343699836489,-0.485527693755031,28,28,0,41,36,5,59,43,16,5,5,0,0
"4191","CBJ","L.A",2012020652,15813,20122013,0,60,1,2,-1,3.55742206785362,3.47479630704038,0.0826257608132437,21,23,-2,30,36,-6,47,45,2,4,4,0,0
"4192","CBJ","S.J",2012020674,15816,20122013,0,60,4,3,1,3.29364484822145,5.56285190861672,-2.26920706039527,22,35,-13,34,51,-17,52,71,-19,2,3,0,0
"4193","CBJ","DAL",2012020702,15820,20122013,0,60,3,1,2,4.43456540067439,4.81344383506359,-0.378878434389208,35,32,3,43,48,-5,50,73,-23,5,4,0,0
"4194","CBJ","NSH",2012020713,15822,20122013,1,60,3,1,2,8.1798214110313,3.87124017995666,4.30858123107464,47,20,27,61,29,32,73,38,35,3,1,0,0
"4195","CBJ","CGY",2013020018,15982,20132014,1,60,3,4,-1,3.07561348042509,4.6017524773095,-1.52613899688441,32,30,2,40,43,-3,63,51,12,4,4,0,0
"4196","CBJ","NYI",2013020024,15983,20132014,0,65,2,2,0,3.96100707244477,3.04284639825346,0.918160674191313,29,30,-1,40,38,2,61,51,10,2,2,0,0
"4197","CBJ","BOS",2013020068,15990,20132014,1,60,1,3,-2,5.69054490650888,4.49213778377543,1.19840712273344,27,36,-9,34,45,-11,52,58,-6,4,3,0,0
"4198","CBJ","DET",2013020087,15993,20132014,0,60,1,2,-1,4.25719826840213,2.97812688574777,1.27907138265437,37,32,5,42,45,-3,52,56,-4,3,4,0,0
"4199","CBJ","MTL",2013020100,15995,20132014,0,60,3,5,-2,4.44556635257322,5.17004569031269,-0.724479337739467,33,36,-3,44,44,0,60,57,3,6,4,0,0
"4200","CBJ","VAN",2013020123,15998,20132014,1,60,3,1,2,5.80461321855546,8.4720695768433,-2.66745635828784,29,38,-9,41,49,-8,49,64,-15,6,4,0,0
"4201","CBJ","N.J",2013020131,16000,20132014,1,60,4,1,3,3.51645974392886,3.24760472035268,0.26885502357618,24,25,-1,33,37,-4,46,51,-5,3,4,0,0
"4202","CBJ","TOR",2013020150,16003,20132014,1,60,5,2,3,6.66459352942184,4.48501839861274,2.1795751308091,36,25,11,47,31,16,56,39,17,8,5,0,0
"4203","CBJ","ANA",2013020168,16005,20132014,1,60,3,4,-1,3.30477449197861,8.40486858785152,-5.10009409587292,21,32,-11,30,42,-12,42,58,-16,1,3,0,0
"4204","CBJ","OTT",2013020219,16014,20132014,1,60,1,4,-3,4.2290069540586,3.31447759067123,0.914529363387373,33,24,9,48,39,9,60,51,9,4,4,0,0
"4205","CBJ","NYR",2013020235,16016,20132014,1,60,2,4,-2,5.03947121358317,5.3049049268011,-0.265433713217931,34,34,0,43,40,3,58,54,4,3,4,0,0
"4206","CBJ","NYI",2013020250,16018,20132014,1,60,5,2,3,3.13811398109829,6.01994908379856,-2.88183510270028,29,26,3,40,35,5,53,44,9,5,2,0,0
"4207","CBJ","BOS",2013020277,16023,20132014,0,64.1833333333333,2,3,-1,5.99420656336588,2.64211441179214,3.35209215157374,34,31,3,41,40,1,52,60,-8,4,1,0,0
"4208","CBJ","MTL",2013020288,16024,20132014,1,65,2,2,0,5.94500898409751,6.40966583182308,-0.464656847725564,25,40,-15,38,52,-14,52,67,-15,4,5,0,0
"4209","CBJ","OTT",2013020303,16026,20132014,0,60,4,1,3,4.9546275796686,5.28750629918068,-0.332878719512081,22,30,-8,34,43,-9,46,65,-19,4,7,0,0
"4210","CBJ","EDM",2013020319,16028,20132014,0,60,0,7,-7,3.59197914111428,3.15781822526696,0.434160915847315,14,32,-18,26,43,-17,41,54,-13,2,5,0,0
"4211","CBJ","CGY",2013020324,16029,20132014,0,62.4166666666667,2,1,1,3.00228525027342,3.27581312065013,-0.273527870376711,18,24,-6,27,34,-7,48,46,2,3,0,0,0
"4212","CBJ","VAN",2013020339,16031,20132014,0,60,2,6,-4,2.55979094649229,4.81697964477172,-2.25718869827944,16,35,-19,24,45,-21,43,62,-19,6,6,0,0
"4213","CBJ","TOR",2013020356,16034,20132014,0,60,6,0,6,6.26198628224665,3.35969427169766,2.90229201054899,22,18,4,37,34,3,52,54,-2,4,1,0,0
"4214","CBJ","NSH",2013020369,16036,20132014,1,60,0,4,-4,1.42204208404291,2.07061567764049,-0.648573593597575,19,29,-10,26,33,-7,40,43,-3,2,3,0,0
"4215","CBJ","EDM",2013020390,16038,20132014,1,60,4,2,2,3.65270306684621,4.56923256794107,-0.916529501094857,28,27,1,33,34,-1,50,42,8,5,7,0,0
"4216","CBJ","BOS",2013020393,16039,20132014,0,60,1,3,-2,2.29192477605898,5.11555511239567,-2.82363033633669,14,36,-22,24,50,-26,42,67,-25,3,7,0,0
"4217","CBJ","T.B",2013020413,16042,20132014,1,60,1,0,1,5.05203204571444,5.90222338623425,-0.850191340519814,21,26,-5,34,33,1,44,42,2,1,2,0,0
"4218","CBJ","MIN",2013020434,16045,20132014,1,60,4,0,4,4.860113714563,2.33210386932404,2.52800984523896,41,20,21,48,28,20,57,40,17,5,5,0,0
"4219","CBJ","N.J",2013020460,16049,20132014,1,60,5,4,1,1.4478123546578,6.51933613058645,-5.07152377592865,23,34,-11,25,42,-17,27,53,-26,1,2,0,0
"4220","CBJ","NYR",2013020473,16051,20132014,0,60,4,2,2,4.64721419199486,3.85921649674128,0.78799769525358,27,34,-7,38,50,-12,48,69,-21,4,6,0,0
"4221","CBJ","STL",2013020494,16053,20132014,1,60.3666666666667,3,4,-1,4.6468763660057,5.44192864899234,-0.795052282986644,33,31,2,46,38,8,61,54,7,8,4,0,0
"4222","CBJ","WPG",2013020506,16055,20132014,1,60,2,3,-1,6.32419006712735,4.10840415532584,2.2157859118015,24,32,-8,31,41,-10,47,49,-2,3,4,0,0
"4223","CBJ","PHI",2013020525,16058,20132014,0,60,4,5,-1,3.90380405348917,7.24635754997446,-3.34255349648529,29,39,-10,37,55,-18,46,75,-29,2,4,0,0
"4224","CBJ","PHI",2013020547,16060,20132014,1,60,6,3,3,4.80186879725077,6.42630060572064,-1.62443180846988,29,36,-7,38,42,-4,49,54,-5,4,5,0,0
"4225","CBJ","CAR",2013020556,16062,20132014,0,60,4,3,1,3.27096461688305,6.01020385127049,-2.73923923438744,25,33,-8,38,46,-8,53,67,-14,5,6,0,0
"4226","CBJ","N.J",2013020569,16066,20132014,0,65,1,1,0,4.46148146844826,2.53411029109213,1.92737117735612,30,17,13,40,27,13,44,34,10,6,4,0,0
"4227","CBJ","COL",2013020606,16070,20132014,0,60,3,5,-2,6.30563718658264,2.99208217786509,3.31355500871756,38,23,15,46,28,18,57,40,17,3,3,0,0
"4228","CBJ","ARI",2013020620,16072,20132014,0,60,2,0,2,4.34736590887121,6.23645536723465,-1.88908945836344,31,34,-3,45,43,2,55,56,-1,4,5,0,0
"4229","CBJ","STL",2013020633,16074,20132014,0,60,2,6,-4,3.04325555224204,6.14833244527108,-3.10507689302904,24,37,-13,31,51,-20,44,67,-23,2,2,0,0
"4230","CBJ","NYR",2013020644,16076,20132014,0,65,3,3,0,4.90193969697723,8.38171759809484,-3.47977790111761,39,43,-4,51,59,-8,68,70,-2,2,7,0,0
"4231","CBJ","CAR",2013020671,16080,20132014,1,60,3,0,3,4.46439422864933,7.12747984658927,-2.66308561793994,24,36,-12,35,46,-11,46,52,-6,2,3,0,0
"4232","CBJ","WPG",2013020679,16081,20132014,0,60,6,3,3,5.94391565964906,4.61161161271002,1.33230404693904,26,31,-5,42,43,-1,50,57,-7,5,5,0,0
"4233","CBJ","T.B",2013020693,16083,20132014,1,60,3,2,1,2.56137095637874,6.0282243287561,-3.46685337237735,28,28,0,45,35,10,61,44,17,6,4,0,0
"4234","CBJ","L.A",2013020751,16091,20132014,1,60,5,3,2,3.12697331166999,2.89943378207501,0.227539529594971,34,29,5,44,36,8,53,54,-1,3,3,0,0
"4235","CBJ","PHI",2013020761,16093,20132014,1,60,5,2,3,5.64705454300256,2.67182772987871,2.97522681312385,39,28,11,54,33,21,65,42,23,7,6,0,0
"4236","CBJ","CAR",2013020790,16097,20132014,0,60,2,3,-1,5.6783579613284,5.1673467750079,0.511011186320502,24,35,-11,37,46,-9,52,61,-9,0,2,0,0
"4237","CBJ","OTT",2013020798,16098,20132014,1,60,2,3,-1,5.24701280620008,2.53261177925742,2.71440102694265,36,28,8,48,37,11,60,62,-2,7,6,0,0
"4238","CBJ","FLA",2013020829,16102,20132014,1,60,4,1,3,5.47263026647852,6.52085567396716,-1.04822540748864,30,36,-6,37,48,-11,47,64,-17,2,4,0,0
"4239","CBJ","ANA",2013020841,16104,20132014,0,60,4,2,2,5.05924427893478,4.03483550406963,1.02440877486515,33,36,-3,40,49,-9,56,68,-12,5,2,0,0
"4240","CBJ","L.A",2013020866,16107,20132014,0,62.55,1,2,-1,2.19462808117012,3.9148683451549,-1.72024026398478,25,20,5,41,40,1,50,54,-4,6,6,0,0
"4241","CBJ","S.J",2013020871,16108,20132014,0,60,2,3,-1,2.79745594477845,7.50562000807258,-4.70816406329413,21,47,-26,33,61,-28,50,74,-24,4,5,0,0
"4242","CBJ","N.J",2013020886,16128,20132014,0,60,2,5,-3,2.93014253673027,5.43903568344189,-2.50889314671162,19,35,-16,31,49,-18,45,53,-8,5,6,0,0
"4243","CBJ","FLA",2013020905,16130,20132014,1,60,6,3,3,8.38278027924022,3.72868444614362,4.65409583309659,37,20,17,44,30,14,53,47,6,4,4,0,0
"4244","CBJ","TOR",2013020920,16132,20132014,0,60,2,1,1,0,0,0,33,29,4,45,45,0,63,60,3,1,2,0,0
"4245","CBJ","DAL",2013020926,16133,20132014,1,60,4,2,2,5.15881048439769,4.58769883355126,0.571111650846433,20,33,-13,29,42,-13,38,57,-19,3,4,0,0
"4246","CBJ","CHI",2013020942,16135,20132014,0,60,1,6,-5,3.10085551859811,5.42921149772883,-2.32835597913072,23,33,-10,31,40,-9,37,52,-15,4,4,0,0
"4247","CBJ","NSH",2013020959,16137,20132014,0,60,1,0,1,4.13184443654609,5.13503018894698,-1.0031857524009,36,28,8,48,38,10,59,56,3,4,1,0,0
"4248","CBJ","DAL",2013020971,16169,20132014,0,60,2,1,1,3.44532095783507,3.77694735630968,-0.331626398474619,25,34,-9,33,53,-20,45,76,-31,3,4,0,0
"4249","CBJ","DET",2013020979,16140,20132014,1,60,4,1,3,5.05690371931996,5.97253356131114,-0.915629841991176,37,40,-3,42,48,-6,55,60,-5,4,5,0,0
"4250","CBJ","S.J",2013020991,16142,20132014,1,65,3,3,0,6.46824029480594,4.37838731508236,2.08985297972358,38,27,11,53,33,20,71,45,26,3,3,0,0
"4251","CBJ","MIN",2013021010,16144,20132014,0,65,1,1,0,5.48341823159899,4.42057796480367,1.06284026679532,29,33,-4,41,44,-3,51,54,-3,0,1,0,0
"4252","CBJ","CAR",2013021029,16147,20132014,1,60,1,3,-2,5.85734067653539,3.21776555412928,2.63957512240611,47,20,27,62,28,34,79,37,42,3,5,0,0
"4253","CBJ","MTL",2013021044,16149,20132014,0,60,3,2,1,6.6824725985813,2.34113103931438,4.34134155926692,40,27,13,60,35,25,83,53,30,7,4,0,0
"4254","CBJ","NYR",2013021051,16150,20132014,1,60,1,3,-2,5.36129244797554,8.00963238699478,-2.64833993901924,26,32,-6,35,42,-7,50,57,-7,5,6,0,0
"4255","CBJ","NYI",2013021066,16152,20132014,0,60,0,2,-2,4.11147078115594,4.09316577054602,0.0183050106099216,41,32,9,51,45,6,63,47,16,7,5,0,0
"4256","CBJ","DET",2013021085,16154,20132014,1,60,4,2,2,4.22434861784495,3.4230406247807,0.801307993064256,28,33,-5,37,41,-4,49,53,-4,4,3,0,0
"4257","CBJ","CAR",2013021114,16158,20132014,0,62.6666666666667,3,2,1,3.93746142775538,5.77273404839798,-1.8352726206426,32,27,5,45,38,7,58,54,4,2,4,0,0
"4258","CBJ","COL",2013021134,16161,20132014,1,64.45,2,3,-1,5.76533249262138,7.1364448198583,-1.37111232723692,26,28,-2,41,35,6,54,46,8,2,1,0,0
"4259","CBJ","PHI",2013021145,16163,20132014,0,60,2,0,2,4.75711737339795,4.00146555064682,0.75565182275113,27,37,-10,44,46,-2,64,68,-4,4,4,0,0
"4260","CBJ","CHI",2013021154,16164,20132014,1,60,3,4,-1,3.12806503944033,5.57798891694735,-2.44992387750702,27,38,-11,32,46,-14,48,56,-8,3,2,0,0
"4261","CBJ","NYI",2013021172,16166,20132014,1,60,4,0,4,4.24025965165492,1.68334648865858,2.55691316299635,33,31,2,42,37,5,48,50,-2,9,5,0,0
"4262","CBJ","ARI",2013021183,16168,20132014,1,63.55,4,3,1,7.19880208914401,7.036957084405,0.161845004739007,30,32,-2,39,42,-3,59,57,2,1,2,0,0
"4263","CBJ","T.B",2013021207,16171,20132014,0,60,2,3,-1,4.08058044559814,5.05816312341267,-0.977582677814524,38,22,16,49,38,11,68,45,23,4,4,0,0
"4264","CBJ","FLA",2013021216,16172,20132014,0,60,3,2,1,5.40644720338009,3.41479182032812,1.99165538305198,38,35,3,50,42,8,61,50,11,4,4,0,0
"4265","CBJ","PIT",2013030131,16176,20132014,0,60,3,4,-1,5.27471920958487,4.40082705581153,0.87389215377334,34,32,2,45,42,3,57,59,-2,4,3,0,0
"4266","CBJ","PIT",2013030132,16179,20132014,0,80,3,3,0,6.70509453907655,5.29010291613163,1.41499162294493,41,42,-1,57,62,-5,78,84,-6,6,8,0,0
"4267","CBJ","PIT",2013030133,16181,20132014,1,60,3,4,-1,1.99100214184728,8.17693082383994,-6.18592868199266,20,41,-21,29,53,-24,42,73,-31,4,6,0,0
"4268","CBJ","PIT",2013030134,16183,20132014,1,62.8166666666667,4,3,1,5.08069737942607,3.25306243328806,1.82763494613801,46,25,21,56,36,20,76,47,29,6,5,0,0
"4269","CBJ","PIT",2013030135,16186,20132014,0,60,1,3,-2,4.61351359274704,9.94252574388764,-5.3290121511406,24,51,-27,34,67,-33,45,82,-37,3,6,0,0
"4270","CBJ","PIT",2013030136,16188,20132014,1,60,3,4,-1,3.52356108679669,2.54193834317266,0.98162274362403,27,28,-1,35,36,-1,52,44,8,5,4,0,0
"4271","CBJ","NYR",2014020025,16354,20142015,1,60,5,2,3,3.23175487280241,4.6914787517411,-1.45972387893869,24,26,-2,35,34,1,48,44,4,5,4,0,0
"4272","CBJ","DAL",2014020042,16357,20142015,1,60,2,4,-2,6.00603767918983,9.72857578557571,-3.72253810638588,35,35,0,45,48,-3,56,61,-5,4,1,0,0
"4273","CBJ","CGY",2014020058,16360,20142015,1,60,3,2,1,4.34383295178884,1.72911787360495,2.61471507818389,26,31,-5,36,38,-2,51,54,-3,5,4,0,0
"4274","CBJ","OTT",2014020065,16361,20142015,0,60,2,3,-1,4.36094820812286,5.95448143051135,-1.59353322238849,40,35,5,54,45,9,68,56,12,5,5,0,0
"4275","CBJ","S.J",2014020100,16366,20142015,0,60,5,4,1,3.30814013179085,4.42400921432233,-1.11586908253147,28,37,-9,39,46,-7,51,57,-6,4,5,0,0
"4276","CBJ","ANA",2014020105,16367,20142015,0,60,1,4,-3,1.99225873920022,4.92830374869973,-2.93604500949951,17,34,-17,32,49,-17,39,58,-19,4,4,0,0
"4277","CBJ","L.A",2014020118,16369,20142015,0,60,2,5,-3,3.79241962166401,3.7141531004745,0.0782665211895051,24,27,-3,38,43,-5,47,57,-10,3,4,0,0
"4278","CBJ","OTT",2014020128,16371,20142015,1,60,2,5,-3,5.69456365844235,5.58387738412148,0.110686274320869,38,34,4,54,46,8,63,58,5,4,3,0,0
"4279","CBJ","TOR",2014020148,16374,20142015,1,60,1,4,-3,5.47318748678663,2.25053602067055,3.22265146611608,29,27,2,37,34,3,51,43,8,4,2,0,0
"4280","CBJ","N.J",2014020157,16375,20142015,0,60,2,3,-1,3.4185386847239,3.36641878087539,0.0521199038485065,34,29,5,37,33,4,40,46,-6,5,8,0,0
"4281","CBJ","CAR",2014020176,16378,20142015,1,60,2,4,-2,3.50198213223382,5.253337113405,-1.75135498117118,19,37,-18,28,47,-19,42,58,-16,3,6,0,0
"4282","CBJ","CAR",2014020198,16381,20142015,0,64.3666666666667,2,3,-1,2.86067859494835,7.21917309498531,-4.35849450003695,31,35,-4,39,53,-14,58,76,-18,5,8,0,0
"4283","CBJ","T.B",2014020208,16382,20142015,1,60,4,7,-3,6.25553985612351,5.27060000749771,0.9849398486258,32,38,-6,42,52,-10,63,61,2,6,5,0,0
"4284","CBJ","PHI",2014020242,16388,20142015,0,60,4,3,1,7.34278410160914,3.29758043815673,4.04520366345241,38,27,11,51,35,16,67,51,16,4,3,0,0
"4285","CBJ","S.J",2014020256,16389,20142015,1,60,2,1,1,4.35596312302025,5.52476945973467,-1.16880633671442,28,37,-9,30,53,-23,39,72,-33,3,2,0,0
"4286","CBJ","DET",2014020270,16392,20142015,1,60,0,5,-5,3.57693505141424,7.04944413473928,-3.47250908332504,28,40,-12,38,50,-12,54,63,-9,3,5,0,0
"4287","CBJ","BOS",2014020293,16395,20142015,1,65,3,3,0,5.81474870810052,7.71770943736055,-1.90296072926003,28,41,-13,48,52,-4,60,70,-10,3,2,0,0
"4288","CBJ","PHI",2014020300,16396,20142015,0,60,2,4,-2,6.9419529621955,7.13164674254949,-0.189693780353991,22,37,-15,30,46,-16,47,60,-13,4,5,0,0
"4289","CBJ","WPG",2014020316,16399,20142015,1,60,2,4,-2,7.02773532797852,5.95255056281046,1.07518476516806,34,32,2,46,41,5,54,53,1,6,4,0,0
"4290","CBJ","VAN",2014020340,16402,20142015,1,60,0,5,-5,4.39200765153146,4.65534588682259,-0.263338235291132,31,30,1,43,37,6,53,44,9,3,2,0,0
"4291","CBJ","NSH",2014020350,16403,20142015,0,60,1,2,-1,3.45969849731773,4.78241909820645,-1.32272060088872,22,42,-20,31,52,-21,41,73,-32,4,4,0,0
"4292","CBJ","FLA",2014020358,16405,20142015,1,60,2,1,1,6.16587346663437,1.65665349756091,4.50921996907346,23,25,-2,40,35,5,46,55,-9,2,3,0,0
"4293","CBJ","FLA",2014020382,16408,20142015,0,65,3,3,0,2.53699274999235,6.14354231572361,-3.60654956573126,20,55,-35,27,72,-45,35,99,-64,2,6,0,0
"4294","CBJ","T.B",2014020394,16410,20142015,0,60,3,1,2,2.10616769711487,2.96828527521575,-0.862117578100879,20,34,-14,27,45,-18,38,58,-20,7,5,0,0
"4295","CBJ","PHI",2014020411,16413,20142015,1,61.9666666666667,3,2,1,3.71192811935907,3.15912199264492,0.552806126714152,24,21,3,33,34,-1,48,46,2,4,4,0,0
"4296","CBJ","DET",2014020456,16420,20142015,0,65,0,0,0,5.35285683799884,6.85687480584238,-1.50401796784354,29,30,-1,37,39,-2,48,48,0,3,1,0,0
"4297","CBJ","CHI",2014020487,16424,20142015,1,65,2,2,0,5.40072382218204,6.0516649815836,-0.650941159401555,19,41,-22,28,59,-31,42,65,-23,4,6,0,0
"4298","CBJ","NSH",2014020498,16426,20142015,1,60,1,5,-4,3.89423664246715,3.53735764100108,0.356879001466069,31,35,-4,38,43,-5,49,55,-6,2,4,0,0
"4299","CBJ","BOS",2014020519,16431,20142015,1,60,6,2,4,3.74685353941459,2.97972842736635,0.767125112048234,30,28,2,37,40,-3,43,54,-11,3,4,0,0
"4300","CBJ","MIN",2014020549,16435,20142015,1,60,3,1,2,4.47670974442735,4.90112474763737,-0.424415003210015,26,29,-3,31,42,-11,41,51,-10,2,4,0,0
"4301","CBJ","ARI",2014020573,16438,20142015,0,60,3,6,-3,2.79245684080805,4.30943689026753,-1.51698004945949,26,34,-8,30,50,-20,45,63,-18,3,4,0,0
"4302","CBJ","COL",2014020580,16439,20142015,0,60,4,3,1,4.32019049118348,4.17845194524853,0.141738545934958,27,29,-2,43,43,0,56,55,1,3,4,0,0
"4303","CBJ","DAL",2014020590,16441,20142015,0,60,4,2,2,3.02479296951788,3.74706736971712,-0.72227440019924,20,26,-6,32,38,-6,38,53,-15,5,5,0,0
"4304","CBJ","TOR",2014020609,16444,20142015,0,60,2,5,-3,5.03158160086852,8.11548917833716,-3.08390757746864,20,32,-12,41,45,-4,53,58,-5,2,4,0,0
"4305","CBJ","NYI",2014020618,16445,20142015,1,60,2,5,-3,2.34293492999814,7.16747101473256,-4.82453608473442,18,40,-22,27,53,-26,43,62,-19,4,7,0,0
"4306","CBJ","MTL",2014020640,16449,20142015,1,60,2,3,-1,3.78476920376329,3.40727658598917,0.377492617774124,16,31,-15,29,44,-15,36,61,-25,3,8,0,0
"4307","CBJ","NYR",2014020656,16451,20142015,1,60,1,2,-1,4.2853846832586,2.3604685455324,1.9249161377262,36,26,10,45,28,17,65,40,25,4,2,0,0
"4308","CBJ","BOS",2014020660,16452,20142015,0,60,3,1,2,4.93097372935154,5.27229352817812,-0.341319798826589,31,35,-4,40,44,-4,53,59,-6,3,2,0,0
"4309","CBJ","MIN",2014020680,16454,20142015,0,60,3,1,2,3.10192635725252,4.02091959211975,-0.91899323486723,23,26,-3,29,49,-20,41,61,-20,2,3,0,0
"4310","CBJ","WPG",2014020693,16456,20142015,0,60,0,4,-4,4.26115874804236,3.55018329706218,0.710975450980186,29,29,0,37,44,-7,53,56,-3,4,4,0,0
"4311","CBJ","T.B",2014020735,16466,20142015,0,60,1,3,-2,0,0,0,35,34,1,46,45,1,55,63,-8,5,6,0,0
"4312","CBJ","ARI",2014020748,16469,20142015,1,60,1,4,-3,3.47245475701882,3.70891108925571,-0.236456332236884,31,29,2,45,36,9,59,51,8,3,3,0,0
"4313","CBJ","OTT",2014020779,16473,20142015,0,60,4,1,3,4.62126580922755,2.9511611078342,1.67010470139336,33,35,-2,39,50,-11,51,65,-14,1,3,0,0
"4314","CBJ","L.A",2014020793,16475,20142015,1,60,3,4,-1,3.67955156617609,2.47502864393755,1.20452292223854,26,44,-18,34,53,-19,46,62,-16,1,1,0,0
"4315","CBJ","PHI",2014020818,16479,20142015,1,62.2833333333333,4,3,1,7.03472328117578,4.9862750605389,2.04844822063687,33,25,8,45,35,10,65,47,18,1,3,0,0
"4316","CBJ","NYI",2014020826,16480,20142015,0,60,3,6,-3,5.33988318536012,2.87670284004798,2.46318034531214,37,46,-9,51,54,-3,71,72,-1,5,5,0,0
"4317","CBJ","PHI",2014020847,16483,20142015,0,60,5,2,3,5.87784012750468,6.99600825746893,-1.11816812996425,25,44,-19,33,63,-30,38,85,-47,1,2,0,0
"4318","CBJ","MTL",2014020876,16487,20142015,0,60,1,3,-2,5.27396916765429,7.58232577255694,-2.30835660490266,32,24,8,39,31,8,69,50,19,4,3,0,0
"4319","CBJ","NYR",2014020890,16488,20142015,0,65,3,3,0,4.37539616245442,5.53307225327859,-1.15767609082417,30,37,-7,38,49,-11,54,62,-8,3,4,0,0
"4320","CBJ","MTL",2014020910,16492,20142015,1,60,2,5,-3,3.21636461479284,3.4583034091338,-0.241938794340967,27,27,0,36,34,2,48,46,2,2,2,0,0
"4321","CBJ","N.J",2014020926,16494,20142015,1,60,0,2,-2,2.53380707431143,1.98381443563267,0.549992638678759,33,19,14,45,28,17,60,44,16,3,4,0,0
"4322","CBJ","N.J",2014020964,16500,20142015,0,60,3,2,1,5.2436807849125,5.43100471893558,-0.187323934023087,24,23,1,36,42,-6,45,59,-14,2,5,0,0
"4323","CBJ","COL",2014020975,16501,20142015,1,60,0,4,-4,3.97642351474497,4.50497791840462,-0.528554403659655,44,33,11,52,36,16,66,41,25,2,6,0,0
"4324","CBJ","CAR",2014020993,16504,20142015,0,65,3,3,0,8.2418943089433,5.21092237001802,3.03097193892528,32,32,0,50,48,2,65,64,1,5,4,0,0
"4325","CBJ","DET",2014021006,16506,20142015,0,60,3,1,2,2.02868969144814,4.42403485160321,-2.39534516015507,26,42,-16,34,57,-23,46,72,-26,3,5,0,0
"4326","CBJ","EDM",2014021015,16507,20142015,1,65,4,4,0,2.62769445173922,5.05824251030572,-2.4305480585665,31,35,-4,44,42,2,59,52,7,3,5,0,0
"4327","CBJ","CAR",2014021031,16509,20142015,1,60,2,3,-1,3.05475616498734,3.15263720143412,-0.097881036446779,24,27,-3,34,36,-2,46,44,2,4,6,0,0
"4328","CBJ","EDM",2014021051,16512,20142015,0,65,3,3,0,3.17097559747344,8.65580005581432,-5.48482445834088,20,47,-27,29,63,-34,38,76,-38,2,7,0,0
"4329","CBJ","VAN",2014021061,16513,20142015,0,60,6,2,4,3.74919902987597,10.0042988494824,-6.25509981960647,33,40,-7,40,54,-14,54,72,-18,1,2,0,0
"4330","CBJ","CGY",2014021067,16515,20142015,0,64.0166666666667,3,2,1,3.12706947954939,4.17200107251119,-1.0449315929618,26,40,-14,37,56,-19,52,73,-21,3,8,0,0
"4331","CBJ","ANA",2014021093,16518,20142015,1,60,5,3,2,3.44809000650962,6.11306327092461,-2.66497326441499,27,40,-13,29,61,-32,34,73,-39,4,6,0,0
"4332","CBJ","CHI",2014021113,16521,20142015,0,60,5,2,3,3.31588043062948,4.08233780460432,-0.766457373974845,27,33,-6,30,41,-11,39,58,-19,1,5,0,0
"4333","CBJ","N.J",2014021144,16525,20142015,1,60.9333333333333,3,2,1,4.79894438358908,3.35068278562835,1.44826159796073,31,26,5,41,33,8,52,37,15,5,2,0,0
"4334","CBJ","NYI",2014021153,16527,20142015,1,65,3,3,0,5.48453950393014,2.2743772836111,3.21016222031903,39,28,11,50,38,12,67,47,20,2,2,0,0
"4335","CBJ","NYR",2014021186,16531,20142015,0,64.1666666666667,3,4,-1,4.21582671100623,5.27898230070872,-1.06315558970249,32,42,-10,45,50,-5,60,67,-7,3,3,0,0
"4336","CBJ","TOR",2014021200,16533,20142015,1,60,5,0,5,3.09148708455541,3.41119324096495,-0.319706156409538,33,35,-2,41,44,-3,47,56,-9,2,4,0,0
"4337","CBJ","NYI",2014021223,16536,20142015,0,65,4,4,0,5.75478956854204,4.55685127989744,1.1979382886446,37,52,-15,51,69,-18,66,90,-24,6,6,0,0
"4338","CBJ","NYR",2015020013,16717,20152016,1,60,2,4,-2,2.49571046751856,3.47417394833079,-0.978463480812231,33,25,8,41,30,11,53,38,15,6,3,0,0
"4339","CBJ","NYR",2015020021,16718,20152016,0,60,2,5,-3,5.59996317258629,3.25817655317951,2.34178661940678,39,29,10,55,36,19,68,41,27,6,4,0,0
"4340","CBJ","OTT",2015020046,16722,20152016,1,60,3,7,-4,5.58485141309211,3.60355533599795,1.98129607709416,41,27,14,53,38,15,66,46,20,5,4,0,0
"4341","CBJ","TOR",2015020059,16724,20152016,1,60,3,6,-3,3.35968127049273,4.02933854312319,-0.669657272630463,27,34,-7,38,47,-9,51,59,-8,5,2,0,0
"4342","CBJ","CHI",2015020072,16725,20152016,0,60,1,4,-3,4.2741706355373,5.28961867434555,-1.01544803880824,23,30,-7,29,40,-11,39,60,-21,4,7,0,0
"4343","CBJ","NYI",2015020084,16728,20152016,1,60,0,4,-4,0,0,0,37,29,8,51,39,12,79,47,32,8,3,0,0
"4344","CBJ","MIN",2015020096,16730,20152016,0,60,2,3,-1,5.55923207021472,2.48182477863156,3.07740729158315,29,23,6,44,34,10,55,49,6,2,2,0,0
"4345","CBJ","COL",2015020115,16732,20152016,0,60,4,3,1,4.79723422136885,5.82937227399993,-1.03213805263108,36,34,2,48,50,-2,60,61,-1,5,6,0,0
"4346","CBJ","N.J",2015020125,16735,20152016,0,60,3,1,2,0,0,0,14,24,-10,20,35,-15,25,40,-15,4,5,0,0
"4347","CBJ","WPG",2015020161,16739,20152016,1,60,2,3,-1,3.59237733582268,3.07489454793682,0.517482787885855,21,27,-6,30,36,-6,42,50,-8,4,3,0,0
"4348","CBJ","S.J",2015020180,16742,20152016,0,60,5,2,3,4.18268678720415,5.10634986338869,-0.923663076184539,24,43,-19,31,61,-30,49,78,-29,2,4,0,0
"4349","CBJ","L.A",2015020192,16744,20152016,0,60,3,2,1,4.87872365439325,3.91506135840518,0.963662295988065,25,33,-8,36,49,-13,46,62,-16,8,8,0,0
"4350","CBJ","ANA",2015020199,16745,20152016,0,60,2,4,-2,5.29393769038143,6.05139306512198,-0.757455374740555,36,34,2,44,49,-5,50,61,-11,4,5,0,0
"4351","CBJ","VAN",2015020219,16749,20152016,1,60,3,5,-2,4.99877587637366,3.55272837350276,1.4460475028709,45,30,15,52,33,19,70,46,24,4,4,0,0
"4352","CBJ","ARI",2015020254,16753,20152016,1,60,5,2,3,3.61472662806804,5.29981204192154,-1.6850854138535,21,29,-8,27,41,-14,29,56,-27,9,10,0,0
"4353","CBJ","OTT",2015020283,16758,20152016,0,60,0,3,-3,4.13331529387376,5.38937772344798,-1.25606242957422,25,29,-4,38,43,-5,55,62,-7,6,7,0,0
"4354","CBJ","NSH",2015020288,16759,20152016,1,60,4,0,4,3.84449149173201,6.07795726468612,-2.2334657729541,18,39,-21,24,58,-34,32,84,-52,1,3,0,0
"4355","CBJ","S.J",2015020305,16761,20152016,1,60,3,5,-2,3.98880083564177,6.72197424176557,-2.7331734061238,31,29,2,35,43,-8,50,64,-14,3,5,0,0
"4356","CBJ","N.J",2015020318,16764,20152016,0,60,2,1,1,3.17581492571662,2.7213173485361,0.454497577180518,25,28,-3,27,38,-11,32,41,-9,3,5,0,0
"4357","CBJ","MTL",2015020360,16770,20152016,0,60,1,2,-1,3.0569739936509,5.19457247858225,-2.13759848493135,23,26,-3,33,39,-6,50,54,-4,0,4,0,0
"4358","CBJ","PHI",2015020394,16774,20152016,0,60,4,1,3,3.45355240273057,3.43112821463205,0.0224241880985119,34,28,6,47,35,12,64,50,14,3,2,0,0
"4359","CBJ","L.A",2015020410,16777,20152016,1,64.55,2,3,-1,3.69839178658972,7.23706575327827,-3.53867396668856,23,41,-18,31,58,-27,40,84,-44,2,3,0,0
"4360","CBJ","WPG",2015020426,16779,20152016,0,60,4,6,-2,2.99019133768161,5.03444561979268,-2.04425428211107,29,35,-6,39,44,-5,49,53,-4,5,4,0,0
"4361","CBJ","NYI",2015020439,16781,20152016,1,62.2666666666667,2,3,-1,3.75449582550209,2.88259008951718,0.87190573598491,30,19,11,45,30,15,58,46,12,0,3,0,0
"4362","CBJ","T.B",2015020450,16783,20152016,1,60,1,2,-1,0,0,0,26,29,-3,40,36,4,57,54,3,2,2,0,0
"4363","CBJ","DAL",2015020463,16784,20152016,0,60,1,5,-4,4.62528575316537,5.76015971253219,-1.13487395936681,35,34,1,45,54,-9,58,60,-2,3,4,0,0
"4364","CBJ","ARI",2015020476,16786,20152016,0,60,7,5,2,0,0,0,21,32,-11,30,48,-18,37,70,-33,1,3,0,0
"4365","CBJ","PHI",2015020488,16788,20152016,1,65,2,2,0,6.58138160072414,5.54240410780039,1.03897749292375,37,32,5,50,45,5,59,67,-8,7,4,0,0
"4366","CBJ","PIT",2015020501,16790,20152016,0,60,2,5,-3,4.61716467339643,5.82235257775574,-1.20518790435931,24,35,-11,29,49,-20,41,61,-20,3,4,0,0
"4367","CBJ","T.B",2015020518,16795,20152016,0,60,2,5,-3,2.38274456536805,5.77970272316452,-3.39695815779647,32,25,7,40,36,4,51,53,-2,4,6,0,0
"4368","CBJ","DAL",2015020544,16798,20152016,1,60,6,3,3,6.36991986662906,3.59639922215206,2.773520644477,33,43,-10,45,57,-12,61,72,-11,3,4,0,0
"4369","CBJ","MIN",2015020593,16805,20152016,1,60,2,4,-2,7.16990931349574,4.79026223750952,2.37964707598621,31,33,-2,44,44,0,67,58,9,2,3,0,0
"4370","CBJ","CAR",2015020609,16808,20152016,0,60,1,4,-3,4.94725205728901,4.28238407156948,0.664867985719525,36,29,7,46,41,5,61,61,0,5,4,0,0
"4371","CBJ","CAR",2015020618,16809,20152016,1,62.75,3,4,-1,4.41525745082117,4.04168577794508,0.373571672876098,24,30,-6,33,37,-4,53,57,-4,2,4,0,0
"4372","CBJ","NYI",2015020634,16812,20152016,0,60,2,5,-3,5.20490782184061,3.970714646141,1.23419317569961,20,33,-13,31,40,-9,53,55,-2,8,6,0,0
"4373","CBJ","TOR",2015020642,16813,20152016,0,60,3,1,2,4.39498260487744,5.8657603824031,-1.47077777752565,22,42,-20,42,72,-30,50,94,-44,2,3,0,0
"4374","CBJ","COL",2015020664,16816,20152016,1,60,2,1,1,3.47932494672568,1.88700385189577,1.59232109482991,21,30,-9,39,41,-2,48,51,-3,3,3,0,0
"4375","CBJ","CGY",2015020696,16821,20152016,1,60,2,4,-2,4.88229289615265,3.43626148485532,1.44603141129733,29,27,2,45,40,5,62,55,7,2,1,0,0
"4376","CBJ","BOS",2015020711,16823,20152016,0,65,2,2,0,3.91493287660435,2.03498698544286,1.87994589116149,33,34,-1,44,41,3,59,57,2,4,5,0,0
"4377","CBJ","MTL",2015020728,16825,20152016,1,60,5,2,3,3.60518930212129,6.1831858609803,-2.57799655885901,25,34,-9,38,44,-6,50,61,-11,2,3,0,0
"4378","CBJ","MTL",2015020734,16826,20152016,0,60,5,2,3,4.47629011813638,4.48612350409495,-0.00983338595857308,26,30,-4,32,41,-9,46,68,-22,3,6,0,0
"4379","CBJ","EDM",2015020753,16833,20152016,0,60,1,5,-4,6.99118632393947,5.6271585778244,1.36402774611507,37,35,2,50,47,3,66,59,7,7,5,0,0
"4380","CBJ","VAN",2015020769,16835,20152016,0,65,1,1,0,2.86801457998808,2.92702291544992,-0.05900833546184,28,38,-10,40,50,-10,54,69,-15,3,3,0,0
"4381","CBJ","CGY",2015020773,16836,20152016,0,60,2,1,1,4.29596520506311,6.00121202127775,-1.70524681621464,18,31,-13,25,45,-20,34,75,-41,1,2,0,0
"4382","CBJ","NYI",2015020798,16840,20152016,1,65,2,2,0,5.39735545017174,5.36945815128274,0.0278972988890018,31,46,-15,40,54,-14,62,80,-18,1,2,0,0
"4383","CBJ","ANA",2015020811,16842,20152016,1,65,3,3,0,5.16626064202865,4.73485210079891,0.431408541229736,34,27,7,42,36,6,66,48,18,4,2,0,0
"4384","CBJ","OTT",2015020829,16844,20152016,1,60,4,2,2,7.61451868936895,4.01878411079724,3.59573457857171,40,35,5,55,46,9,70,67,3,4,5,0,0
"4385","CBJ","BOS",2015020850,16847,20152016,1,60.55,1,2,-1,5.72862199303563,6.17962949155481,-0.451007498519175,29,30,-1,42,46,-4,55,60,-5,4,4,0,0
"4386","CBJ","BOS",2015020889,16853,20152016,0,60,6,4,2,8.85519217226367,4.27900674920033,4.57618542306333,35,30,5,51,43,8,64,56,8,3,2,0,0
"4387","CBJ","DET",2015020896,16854,20152016,0,65,1,1,0,5.51653907822993,5.81648847404608,-0.299949395816157,29,28,1,38,43,-5,45,52,-7,3,1,0,0
"4388","CBJ","N.J",2015020907,16856,20152016,1,60,6,1,5,1.94461680069799,5.54804042922569,-3.60342362852771,24,26,-2,34,34,0,42,52,-10,2,4,0,0
"4389","CBJ","NYR",2015020937,16860,20152016,0,60,1,2,-1,2.11546392389573,5.40485251130303,-3.2893885874073,27,23,4,37,34,3,59,50,9,1,1,0,0
"4390","CBJ","EDM",2015020967,16864,20152016,1,60,6,3,3,4.04310029132519,6.10695532438103,-2.06385503305584,27,36,-9,42,52,-10,49,77,-28,3,3,0,0
"4391","CBJ","PHI",2015020976,16865,20152016,0,60,0,6,-6,1.79446052813,4.97296206120518,-3.17850153307518,19,36,-17,27,47,-20,44,65,-21,4,7,0,0
"4392","CBJ","DET",2015020996,16868,20152016,1,60,5,3,2,4.3687023638704,8.58749353112307,-4.21879116725268,32,35,-3,38,54,-16,51,74,-23,7,7,0,0
"4393","CBJ","PIT",2015021013,16871,20152016,1,60,2,3,-1,4.37987657648046,5.09757737291511,-0.717700796434656,27,31,-4,32,50,-18,45,64,-19,4,5,0,0
"4394","CBJ","T.B",2015021031,16873,20152016,1,60,0,4,-4,4.50851855036308,3.14483226749554,1.36368628286754,37,37,0,51,40,11,60,51,9,6,6,0,0
"4395","CBJ","DET",2015021055,16877,20152016,1,60,1,3,-2,3.01647710657539,2.09043622022728,0.926040886348119,28,22,6,36,31,5,54,46,8,3,3,0,0
"4396","CBJ","N.J",2015021073,16879,20152016,1,60,6,3,3,6.66256148060347,3.71951728823478,2.94304419236869,34,30,4,52,39,13,68,53,15,3,4,0,0
"4397","CBJ","N.J",2015021079,16880,20152016,0,60,1,2,-1,5.31472818469202,2.25037653117418,3.06435165351784,28,22,6,38,34,4,47,45,2,3,3,0,0
"4398","CBJ","PHI",2015021090,16882,20152016,1,65,2,2,0,7.76365927316496,5.82979893946619,1.93386033369877,53,33,20,64,48,16,82,64,18,5,4,0,0
"4399","CBJ","CAR",2015021103,16884,20152016,1,60,2,3,-1,6.7363456262392,2.17865892024713,4.55768670599207,44,24,20,62,35,27,81,46,35,4,3,0,0
"4400","CBJ","NSH",2015021125,16886,20152016,0,60,1,5,-4,4.41119976568734,5.75200931751169,-1.34080955182435,19,48,-29,27,62,-35,35,75,-40,2,4,0,0
"4401","CBJ","NYI",2015021153,16891,20152016,0,60,3,4,-1,3.5350139712682,4.0655737532943,-0.530559782026103,24,27,-3,35,37,-2,61,49,12,4,3,0,0
"4402","CBJ","CAR",2015021174,16893,20152016,0,60,5,1,4,4.44990920199761,4.51342656509951,-0.0635173631018944,27,27,0,38,39,-1,46,53,-7,5,3,0,0
"4403","CBJ","NYR",2015021184,16895,20152016,1,60,2,4,-2,0,0,0,29,30,-1,43,47,-4,63,64,-1,4,1,0,0
"4404","CBJ","TOR",2015021199,16897,20152016,0,60,5,1,4,3.74784337176243,2.54834454028193,1.1994988314805,32,27,5,46,41,5,59,62,-3,2,2,0,0
"4405","CBJ","CHI",2015021223,16900,20152016,1,62.4666666666667,5,4,1,3.00660067725704,1.88811266608536,1.11848801117168,25,26,-1,32,34,-2,39,46,-7,2,5,0,0
"4406","CBJ","BOS",2016020008,17087,20162017,1,60,3,6,-3,5.04826402281186,6.07162114185849,-1.02335711904662,31,37,-6,40,45,-5,63,60,3,4,3,0,0
"4407","CBJ","S.J",2016020023,17089,20162017,1,60,2,3,-1,3.45500787087392,5.8867414432407,-2.43173357236677,28,38,-10,41,43,-2,58,55,3,2,4,0,0
"4408","CBJ","CHI",2016020063,17095,20162017,1,60,3,2,1,5.27292153512826,6.72111797546313,-1.44819644033487,28,34,-6,41,51,-10,50,71,-21,2,4,0,0
"4409","CBJ","DAL",2016020074,17096,20162017,0,60,3,0,3,6.01356397117706,5.6721664413999,0.341397529777169,26,32,-6,47,52,-5,65,64,1,3,5,0,0
"4410","CBJ","L.A",2016020092,17099,20162017,0,61.2333333333333,2,3,-1,3.7178745107376,3.9888792863203,-0.271004775582696,21,30,-9,32,44,-12,41,64,-23,1,1,0,0
"4411","CBJ","S.J",2016020106,17101,20162017,0,60,1,3,-2,2.76690686168149,6.04759408672544,-3.28068722504395,25,29,-4,35,47,-12,56,65,-9,3,2,0,0
"4412","CBJ","ANA",2016020112,17102,20162017,0,60,4,0,4,5.16118272827917,4.10168669409867,1.0594960341805,37,35,2,52,53,-1,62,61,1,6,5,0,0
"4413","CBJ","DAL",2016020133,17106,20162017,1,60.7666666666667,3,2,1,3.58334173240291,6.13792026125157,-2.55457852884865,28,38,-10,39,55,-16,55,73,-18,2,4,0,0
"4414","CBJ","MTL",2016020158,17109,20162017,1,60,10,0,10,7.93220669205766,3.57361126149004,4.35859543056762,40,30,10,50,43,7,59,60,-1,5,2,0,0
"4415","CBJ","ANA",2016020193,17114,20162017,1,61.35,3,2,1,2.46297101924439,3.34608964294603,-0.883118623701634,18,32,-14,25,41,-16,40,56,-16,3,3,0,0
"4416","CBJ","BOS",2016020196,17115,20162017,0,60,2,5,-3,1.74151909074862,2.9804929694219,-1.23897387867328,18,32,-14,33,43,-10,44,54,-10,3,2,0,0
"4417","CBJ","NYR",2016020257,17123,20162017,1,60,4,2,2,3.20410818095388,3.44383162329905,-0.239723442345166,24,27,-3,38,38,0,52,50,2,2,2,0,0
"4418","CBJ","COL",2016020278,17126,20162017,1,61.8166666666667,2,3,-1,6.50890878279563,5.92719804419903,0.581710738596598,42,27,15,64,38,26,92,52,40,1,1,0,0
"4419","CBJ","CGY",2016020292,17128,20162017,1,60,0,2,-2,3.98465573851718,2.96974715071235,1.01490858780483,34,20,14,41,32,9,59,44,15,3,3,0,0
"4420","CBJ","T.B",2016020309,17130,20162017,0,60,5,3,2,8.44442206982058,4.95202908208012,3.49239298774046,38,28,10,49,44,5,63,54,9,4,3,0,0
"4421","CBJ","T.B",2016020332,17134,20162017,1,60,5,1,4,7.44907993235191,4.69676208472811,2.7523178476238,38,27,11,51,40,11,60,55,5,1,1,0,0
"4422","CBJ","COL",2016020354,17136,20162017,0,60,3,2,1,5.40145959419897,5.2399437688,0.161515825398965,37,20,17,51,30,21,60,46,14,5,4,0,0
"4423","CBJ","ARI",2016020368,17138,20162017,0,65,2,2,0,7.9870190803581,3.67076397122582,4.31625510913227,60,34,26,75,41,34,93,60,33,8,7,0,0
"4424","CBJ","ARI",2016020381,17140,20162017,1,60,4,1,3,7.23309371605865,1.90124076008942,5.33185295596923,34,18,16,48,28,20,59,35,24,8,3,0,0
"4425","CBJ","DET",2016020406,17144,20162017,0,60,4,1,3,4.24211304585333,3.74380351553555,0.498309530317783,25,33,-8,33,46,-13,43,66,-23,0,3,0,0
"4426","CBJ","NYI",2016020417,17145,20162017,1,60,6,2,4,4.38862534789951,5.37534166558703,-0.986716317687519,39,30,9,49,40,9,64,51,13,4,3,0,0
"4427","CBJ","EDM",2016020440,17148,20162017,0,60,3,1,2,3.44093550945763,4.13846153082392,-0.697526021366286,31,34,-3,38,42,-4,54,55,-1,5,3,0,0
"4428","CBJ","CGY",2016020458,17151,20162017,0,60,4,1,3,3.4848545328714,3.38298190940986,0.101872623461531,29,23,6,36,30,6,47,53,-6,4,5,0,0
"4429","CBJ","VAN",2016020472,17153,20162017,0,60.7666666666667,4,3,1,6.89930458614253,2.96893371274928,3.93037087339326,25,17,8,33,31,2,41,47,-6,2,4,0,0
"4430","CBJ","L.A",2016020484,17155,20162017,1,65,2,2,0,3.77667645044858,5.20707232499262,-1.43039587454405,27,46,-19,43,58,-15,56,72,-16,2,2,0,0
"4431","CBJ","PIT",2016020497,17157,20162017,1,60,7,1,6,5.67999655078611,3.5283350917307,2.15166145905542,28,26,2,39,35,4,53,49,4,5,5,0,0
"4432","CBJ","MTL",2016020509,17158,20162017,1,60,2,1,1,3.30211506361957,3.10621744230144,0.195897621318124,24,37,-13,33,52,-19,41,67,-26,4,2,0,0
"4433","CBJ","BOS",2016020520,17162,20162017,1,60,4,3,1,3.72167035554594,5.74858338919512,-2.02691303364918,22,40,-18,38,54,-16,51,74,-23,4,4,0,0
"4434","CBJ","WPG",2016020539,17164,20162017,0,60,5,3,2,3.98813862395764,3.50396841934932,0.484170204608318,35,34,1,44,48,-4,58,58,0,6,6,0,0
"4435","CBJ","MIN",2016020550,17166,20162017,0,60,4,2,2,3.26022972341161,7.53039886194892,-4.27016913853731,25,31,-6,36,42,-6,44,53,-9,3,4,0,0
"4436","CBJ","EDM",2016020568,17169,20162017,1,60,3,1,2,3.82155549925164,2.22139568947023,1.60015980978142,35,22,13,41,29,12,52,39,13,4,3,0,0
"4437","CBJ","NYR",2016020598,17173,20162017,1,60,4,5,-1,6.24597368198738,6.5642722878838,-0.318298605896416,37,34,3,50,43,7,63,60,3,4,3,0,0
"4438","CBJ","PHI",2016020605,17174,20162017,1,62.55,2,1,1,4.74938491458306,6.64613593025749,-1.89675101567443,25,26,-1,33,42,-9,55,59,-4,2,1,0,0
"4439","CBJ","CAR",2016020614,17176,20162017,0,60,3,5,-2,5.90028834395343,6.7955520057792,-0.895263661825766,27,28,-1,42,42,0,60,53,7,4,2,0,0
"4440","CBJ","T.B",2016020635,17179,20162017,0,60,3,1,2,7.08219391657622,3.34422657372005,3.73796734285616,31,32,-1,41,45,-4,50,63,-13,4,3,0,0
"4441","CBJ","CAR",2016020664,17183,20162017,1,60,4,1,3,4.07511165377218,4.23314104114115,-0.15802938736897,36,25,11,44,36,8,55,51,4,4,2,0,0
"4442","CBJ","CAR",2016020692,17187,20162017,1,60,3,2,1,1.66961014736444,3.79541238358144,-2.125802236217,20,37,-17,28,46,-18,40,58,-18,2,6,0,0
"4443","CBJ","NYI",2016020716,17190,20162017,0,60,2,4,-2,4.73542377683043,2.90255086851539,1.83287290831504,23,29,-6,34,36,-2,50,49,1,0,1,0,0
"4444","CBJ","NSH",2016020735,17192,20162017,0,60,3,4,-1,4.7328662807995,5.33674741519644,-0.603881134396943,33,32,1,42,44,-2,53,59,-6,3,4,0,0
"4445","CBJ","NYR",2016020742,17197,20162017,0,60,6,4,2,3.65298747445922,6.91898995939846,-3.26600248493924,26,37,-11,29,59,-30,42,70,-28,2,3,0,0
"4446","CBJ","PIT",2016020766,17200,20162017,0,63.25,3,4,-1,3.28637226100545,4.3275459202996,-1.04117365929415,31,33,-2,33,42,-9,55,59,-4,1,2,0,0
"4447","CBJ","N.J",2016020778,17201,20162017,1,60,1,5,-4,2.69650229311083,6.13055624079976,-3.43405394768894,32,30,2,45,39,6,60,45,15,3,3,0,0
"4448","CBJ","DET",2016020796,17204,20162017,0,63.3666666666667,3,2,1,3.78629832930164,4.6546230243371,-0.868324695035461,27,26,1,42,36,6,53,41,12,4,4,0,0
"4449","CBJ","VAN",2016020807,17206,20162017,1,60,0,3,-3,5.30150480719749,4.56940509592278,0.732099711274714,33,24,9,42,34,8,57,51,6,4,4,0,0
"4450","CBJ","DET",2016020820,17208,20162017,1,60,2,1,1,5.06536980927922,6.26504350580217,-1.19967369652295,39,36,3,54,52,2,68,65,3,2,3,0,0
"4451","CBJ","NYR",2016020834,17210,20162017,1,60,2,3,-1,3.48595944989584,3.27926948532231,0.206689964573534,32,23,9,41,36,5,58,50,8,4,5,0,0
"4452","CBJ","TOR",2016020843,17212,20162017,1,60,5,2,3,3.94955044763628,4.66404610190693,-0.71449565427065,35,33,2,39,45,-6,49,64,-15,5,3,0,0
"4453","CBJ","PIT",2016020855,17214,20162017,1,61.0666666666667,2,1,1,4.71952629166481,7.04258395088602,-2.32305765922121,39,39,0,53,52,1,73,67,6,3,1,0,0
"4454","CBJ","NSH",2016020874,17216,20162017,1,60,3,4,-1,5.15756067784969,4.19439871050417,0.963161967345513,38,32,6,53,42,11,72,55,17,2,0,0,0
"4455","CBJ","NYI",2016020909,17222,20162017,1,60,7,0,7,6.4859998524189,4.24590440289467,2.24009544952423,45,24,21,55,33,22,71,44,27,2,0,0,0
"4456","CBJ","NYR",2016020914,17223,20162017,0,60,5,2,3,3.32431997053166,3.82546846960048,-0.501148499068822,26,30,-4,34,45,-11,49,65,-16,3,2,0,0
"4457","CBJ","MTL",2016020926,17225,20162017,0,63.8833333333333,0,1,-1,4.57963538714275,6.54872209766472,-1.96908671052197,26,30,-4,41,42,-1,58,65,-7,2,4,0,0
"4458","CBJ","MIN",2016020940,17227,20162017,1,60,1,0,1,4.17627715457638,4.9824600481079,-0.806182893531513,40,38,2,49,50,-1,57,65,-8,4,4,0,0
"4459","CBJ","N.J",2016020963,17230,20162017,0,60,3,0,3,4.43542521464406,2.69608132646681,1.73934388817725,22,20,2,31,35,-4,35,42,-7,1,3,0,0
"4460","CBJ","N.J",2016020974,17232,20162017,1,60,2,0,2,4.65285655419575,4.64519086945802,0.00766568473773077,25,33,-8,38,42,-4,53,53,0,2,1,0,0
"4461","CBJ","PHI",2016021018,17238,20162017,0,60,5,3,2,5.07649899197202,4.04278117761714,1.03371781435487,29,26,3,35,41,-6,46,61,-15,4,9,0,0
"4462","CBJ","NYI",2016021054,17243,20162017,0,61.3166666666667,3,2,1,0,0,0,38,22,16,46,37,9,54,56,-2,1,2,0,0
"4463","CBJ","N.J",2016021063,17244,20162017,0,60,4,1,3,3.39667329450822,8.32945646267035,-4.93278316816213,27,36,-9,40,48,-8,46,64,-18,3,3,0,0
"4464","CBJ","TOR",2016021086,17247,20162017,1,60,2,5,-3,4.74684236637404,5.83896114263916,-1.09211877626512,34,32,2,44,44,0,65,55,10,0,3,0,0
"4465","CBJ","PHI",2016021105,17250,20162017,1,60,1,0,1,2.86716230980528,3.69751619671297,-0.830353886907687,21,36,-15,28,44,-16,42,58,-16,4,5,0,0
"4466","CBJ","CAR",2016021143,17255,20162017,0,62.2666666666667,1,2,-1,2.74410770353279,6.58143034169916,-3.83732263816637,24,31,-7,36,49,-13,49,68,-19,2,3,0,0
"4467","CBJ","CHI",2016021152,17256,20162017,0,60,1,3,-2,4.96133079433457,3.97190088336356,0.989429910971012,33,24,9,42,27,15,61,40,21,5,4,0,0
"4468","CBJ","PIT",2016021181,17260,20162017,0,60,1,4,-3,4.72666166414274,2.85729354352225,1.86936812062049,39,27,12,51,32,19,70,43,27,2,4,0,0
"4469","CBJ","WPG",2016021197,17262,20162017,1,60,4,5,-1,5.85278954243703,7.16530376698938,-1.31251422455235,39,32,7,50,42,8,71,54,17,0,2,0,0
"4470","CBJ","PHI",2016021208,17264,20162017,0,60,2,4,-2,1.76686955842888,4.02694785047788,-2.260078292049,22,24,-2,29,34,-5,54,49,5,3,4,0,0
"4471","CBJ","TOR",2016021224,17265,20162017,0,60,3,2,1,5.9192567768862,4.63546749369135,1.28378928319485,32,32,0,44,55,-11,49,71,-22,2,3,0,0
"4472","CBJ","PIT",2016030141,17268,20162017,0,60,1,3,-2,3.94673830414831,4.79484002565732,-0.848101721509011,32,29,3,38,35,3,60,47,13,2,3,0,0
"4473","CBJ","PIT",2016030142,17270,20162017,0,60,1,4,-3,4.15216711721539,6.43026995693799,-2.2781028397226,40,32,8,56,42,14,79,55,24,3,4,0,0
"4474","CBJ","PIT",2016030143,17272,20162017,1,73.1666666666667,4,5,-1,6.89849470561603,8.37802754077711,-1.47953283516108,37,47,-10,47,65,-18,67,94,-27,2,3,0,0
"4475","CBJ","PIT",2016030144,17274,20162017,1,60,5,4,1,5.23718866685074,4.9382494497404,0.298939217110339,34,31,3,52,43,9,65,62,3,3,3,0,0
"4476","CBJ","PIT",2016030145,17276,20162017,0,60,2,5,-3,6.61277328709548,3.10721020424529,3.50556308285019,51,32,19,56,41,15,72,51,21,3,4,0,0
"4477","CBJ","NYI",2017020013,17445,20172018,1,60,5,0,5,5.94902724123676,4.83938417674744,1.10964306448932,37,29,8,52,43,9,67,61,6,3,2,0,0
"4478","CBJ","CHI",2017020025,17446,20172018,0,60,1,5,-4,5.18358779459959,4.42381870092052,0.759769093679074,33,29,4,42,31,11,54,44,10,3,3,0,0
"4479","CBJ","CAR",2017020040,17449,20172018,0,64.5166666666667,2,1,1,5.33488938989501,6.25638376631816,-0.921494376423148,27,38,-11,40,48,-8,54,65,-11,3,3,0,0
"4480","CBJ","NYR",2017020059,17452,20172018,1,60,3,1,2,4.02309452676005,4.14369640917019,-0.120601882410139,43,38,5,56,43,13,70,56,14,4,5,0,0
"4481","CBJ","MIN",2017020070,17453,20172018,0,60.7833333333333,5,4,1,4.11095551182017,1.8530894239957,2.25786608782447,35,21,14,43,28,15,56,39,17,3,3,0,0
"4482","CBJ","WPG",2017020087,17456,20172018,0,60,5,2,3,6.29491692269221,3.32140798795186,2.97350893474035,39,26,13,49,34,15,66,51,15,3,1,0,0
"4483","CBJ","T.B",2017020098,17458,20172018,1,60,0,2,-2,4.87237060408417,2.71674658741755,2.15562401666662,43,21,22,52,41,11,64,50,14,3,2,0,0
"4484","CBJ","L.A",2017020117,17460,20172018,1,60,4,6,-2,6.42666813195683,4.18614714348587,2.24052098847096,36,32,4,47,41,6,70,56,14,3,2,0,0
"4485","CBJ","WPG",2017020151,17466,20172018,1,62.6333333333333,2,1,1,5.91101937641542,4.67921677149846,1.23180260491696,37,30,7,56,44,12,71,53,18,4,6,0,0
"4486","CBJ","BOS",2017020172,17469,20172018,1,65,3,3,0,3.45855750204646,3.91499688611475,-0.45643938406829,32,30,2,40,44,-4,57,63,-6,6,3,0,0
"4487","CBJ","T.B",2017020202,17474,20172018,0,65,4,4,0,3.14858410342276,2.81178443604434,0.336799667378427,34,36,-2,45,49,-4,57,68,-11,4,3,0,0
"4488","CBJ","NYR",2017020219,17476,20172018,0,60,3,5,-2,3.35316374138215,4.00465496444667,-0.651491223064522,25,26,-1,37,36,1,53,48,5,1,5,0,0
"4489","CBJ","NSH",2017020228,17477,20172018,1,60,1,3,-2,3.10623407336585,4.01272303470633,-0.906488961340482,36,29,7,52,39,13,63,56,7,4,4,0,0
"4490","CBJ","CAR",2017020245,17480,20172018,1,60,1,3,-2,2.72202988129982,5.58917684358312,-2.8671469622833,26,29,-3,38,36,2,49,55,-6,2,1,0,0
"4491","CBJ","DET",2017020253,17481,20172018,0,65,1,1,0,7.59477303780659,3.54835677022788,4.04641626757871,32,33,-1,46,40,6,56,53,3,3,0,0,0
"4492","CBJ","MTL",2017020268,17484,20172018,0,61.15,2,1,1,4.630169524331,3.42509915103346,1.20507037329753,25,29,-4,36,41,-5,58,67,-9,2,2,0,0
"4493","CBJ","NYR",2017020290,17487,20172018,1,60,2,0,2,6.16645902216416,5.46422555290337,0.70223346926079,42,36,6,52,49,3,63,64,-1,3,3,0,0
"4494","CBJ","CGY",2017020327,17492,20172018,1,62.0333333333333,1,0,1,4.85171490984794,2.11466617330734,2.7370487365406,41,22,19,55,37,18,70,54,16,2,1,0,0
"4495","CBJ","MTL",2017020364,17497,20172018,0,60,1,3,-2,4.14220345861395,4.22486953629414,-0.0826660776801873,38,28,10,50,37,13,72,52,20,5,3,0,0
"4496","CBJ","CAR",2017020371,17498,20172018,1,65,2,2,0,6.09791434438375,1.97976417792961,4.11815016645414,38,31,7,46,38,8,54,54,0,1,1,0,0
"4497","CBJ","ANA",2017020391,17501,20172018,1,60,4,2,2,4.36940742757177,2.75147285890969,1.61793456866208,31,27,4,44,33,11,53,46,7,9,4,0,0
"4498","CBJ","N.J",2017020417,17505,20172018,1,60,1,4,-3,4.19251134089427,4.7204131112403,-0.527901770346034,42,36,6,54,46,8,70,60,10,6,1,0,0
"4499","CBJ","N.J",2017020439,17508,20172018,0,60,5,3,2,2.96802465481935,3.87608897480823,-0.908064319988881,28,24,4,38,34,4,47,44,3,2,3,0,0
"4500","CBJ","ARI",2017020451,17509,20172018,1,60,1,0,1,4.65511216842771,2.41918974440409,2.23592242402361,34,35,-1,40,43,-3,55,55,0,2,4,0,0
"4501","CBJ","EDM",2017020470,17512,20172018,1,60,2,7,-5,4.51985090605922,5.11570744793426,-0.595856541875037,29,38,-9,40,47,-7,54,58,-4,2,4,0,0
"4502","CBJ","NYI",2017020481,17514,20172018,1,60,6,4,2,0,0,0,35,25,10,47,45,2,64,67,-3,2,4,0,0
"4503","CBJ","CAR",2017020503,17516,20172018,0,60,1,2,-1,4.61273882315118,6.00329547461661,-1.39055665146543,36,24,12,52,35,17,68,41,27,4,2,0,0
"4504","CBJ","BOS",2017020511,17518,20172018,0,60,2,7,-5,2.77699114626358,4.07077926424114,-1.29378811797756,18,45,-27,28,58,-30,42,77,-35,7,7,0,0
"4505","CBJ","TOR",2017020526,17520,20172018,1,60,4,2,2,4.56683040020289,4.06979751723793,0.497032882964959,37,41,-4,47,54,-7,55,67,-12,3,2,0,0
"4506","CBJ","PIT",2017020532,17521,20172018,0,65,2,2,0,5.69520070319046,6.00639552889068,-0.31119482570022,32,41,-9,44,62,-18,54,76,-22,8,6,0,0
"4507","CBJ","PHI",2017020551,17523,20172018,1,65,1,1,0,3.86645676265352,5.62254784417843,-1.75609108152491,36,31,5,50,46,4,64,61,3,3,3,0,0
"4508","CBJ","PIT",2017020562,17527,20172018,0,65,4,4,0,4.33789191102258,4.67964789098187,-0.341755979959288,33,37,-4,48,50,-2,64,67,-3,3,4,0,0
"4509","CBJ","T.B",2017020594,17531,20172018,1,60,0,5,-5,2.63764310526858,4.48169139740639,-1.84404829213781,21,35,-14,34,45,-11,43,62,-19,4,5,0,0
"4510","CBJ","DAL",2017020609,17533,20172018,0,60,2,1,1,3.86532590372371,3.65535075360603,0.209975150117682,26,22,4,37,26,11,50,43,7,1,0,0,0
"4511","CBJ","COL",2017020624,17535,20172018,0,60,0,2,-2,3.42198132281192,2.88245825318154,0.539523069630377,34,32,2,46,38,8,59,52,7,4,4,0,0
"4512","CBJ","TOR",2017020652,17539,20172018,0,63.1833333333333,3,2,1,4.52838475586395,5.66383318445878,-1.13544842859483,33,37,-4,49,47,2,63,62,1,3,2,0,0
"4513","CBJ","VAN",2017020665,17543,20172018,1,60,2,5,-3,4.79066345016849,7.92554279760225,-3.13487934743375,29,29,0,44,43,1,63,61,2,2,3,0,0
"4514","CBJ","DAL",2017020699,17549,20172018,1,65,1,1,0,3.05935962722882,3.29495693183068,-0.235597304601859,26,36,-10,39,52,-13,48,73,-25,3,5,0,0
"4515","CBJ","VGK",2017020741,17554,20172018,0,60,3,6,-3,4.70931646075504,5.30599912197795,-0.596682661222911,32,38,-6,47,48,-1,60,64,-4,4,4,0,0
"4516","CBJ","ARI",2017020756,17556,20172018,0,60,2,1,1,3.16122027224446,4.44687272207557,-1.2856524498311,27,39,-12,36,50,-14,48,73,-25,2,2,0,0
"4517","CBJ","MIN",2017020766,17561,20172018,1,65,2,2,0,3.95574176721857,5.6002776618836,-1.64453589466503,30,43,-13,48,56,-8,57,66,-9,3,2,0,0
"4518","CBJ","S.J",2017020790,17564,20172018,1,60,1,3,-2,3.52087766460681,4.19147107226308,-0.67059340765627,29,28,1,44,42,2,63,56,7,2,4,0,0
"4519","CBJ","NYI",2017020798,17565,20172018,0,60,3,4,-1,5.31766274343681,4.3008532114327,1.01680953200412,49,38,11,71,49,22,88,65,23,4,3,0,0
"4520","CBJ","N.J",2017020848,17572,20172018,1,60,6,1,5,7.86394636466333,7.94657617650228,-0.0826298118389417,50,36,14,62,57,5,84,75,9,6,2,0,0
"4521","CBJ","NYI",2017020866,17575,20172018,0,60,4,1,3,6.43414612715424,4.5982319641624,1.83591416299183,51,30,21,67,38,29,86,56,30,5,4,0,0
"4522","CBJ","TOR",2017020876,17576,20172018,0,60,3,6,-3,6.02325430774363,3.18481062659339,2.83844368115024,57,28,29,77,41,36,91,56,35,2,3,0,0
"4523","CBJ","PHI",2017020890,17578,20172018,1,61.8666666666667,1,2,-1,4.43717708601616,3.46592803874228,0.971249047273886,36,25,11,49,30,19,68,47,21,1,2,0,0
"4524","CBJ","PIT",2017020908,17580,20172018,1,60,2,5,-3,7.1078427509201,6.02373048055347,1.08411227036663,37,23,14,51,36,15,62,42,20,2,0,0,0
"4525","CBJ","N.J",2017020919,17582,20172018,0,60,2,1,1,2.42534133760739,3.55678200808325,-1.13144067047585,19,31,-12,29,43,-14,39,54,-15,3,2,0,0
"4526","CBJ","PHI",2017020932,17584,20172018,0,60,1,2,-1,1.38294978837826,2.9590527794935,-1.57610299111525,20,20,0,31,31,0,45,42,3,2,5,0,0
"4527","CBJ","CHI",2017020954,17586,20172018,1,60,3,2,1,3.70712155704814,3.01466906243149,0.692452494616646,29,33,-4,35,45,-10,45,62,-17,1,3,0,0
"4528","CBJ","L.A",2017020989,17591,20172018,0,60,2,5,-3,3.61881409331181,4.78483347033034,-1.16601937701853,32,34,-2,50,42,8,64,57,7,3,2,0,0
"4529","CBJ","ANA",2017020999,17592,20172018,0,60,2,4,-2,2.76022005259531,3.95091921499443,-1.19069916239912,36,35,1,54,51,3,63,62,1,6,4,0,0
"4530","CBJ","S.J",2017021014,17594,20172018,0,60,4,2,2,7.16046584605647,3.6215591035143,3.53890674254217,28,35,-7,38,49,-11,55,60,-5,2,4,0,0
"4531","CBJ","VGK",2017021023,17596,20172018,1,60,4,1,3,5.48503027828632,6.53466657023321,-1.0496362919469,21,38,-17,39,46,-7,47,62,-15,3,3,0,0
"4532","CBJ","COL",2017021034,17598,20172018,1,60.9833333333333,5,4,1,3.70314828473158,3.40432391827926,0.298824366452322,44,27,17,58,35,23,67,48,19,5,3,0,0
"4533","CBJ","DET",2017021044,17599,20172018,1,60,3,2,1,5.44771572438185,2.83088213101323,2.61683359336862,36,24,12,46,34,12,60,47,13,2,2,0,0
"4534","CBJ","MTL",2017021066,17602,20172018,1,60,5,2,3,3.88712412982568,6.12143871454828,-2.2343145847226,25,40,-15,35,54,-19,45,74,-29,3,2,0,0
"4535","CBJ","PHI",2017021085,17605,20172018,0,60,5,3,2,6.32744657287995,5.30291108973324,1.02453548314671,29,30,-1,43,49,-6,65,70,-5,1,3,0,0
"4536","CBJ","BOS",2017021116,17609,20172018,0,62.9166666666667,5,4,1,2.38460519307353,5.85133774625137,-3.46673255317785,25,38,-13,30,55,-25,41,68,-27,2,4,0,0
"4537","CBJ","NYR",2017021122,17610,20172018,0,60,5,3,2,5.41095128975576,2.85876600611805,2.55218528363771,31,32,-1,51,43,8,63,67,-4,2,4,0,0
"4538","CBJ","EDM",2017021184,17617,20172018,0,60,7,3,4,4.91181958059158,4.63837626783182,0.273443312759765,27,25,2,43,33,10,63,45,18,3,3,0,0
"4539","CBJ","CGY",2017021197,17619,20172018,0,60,5,1,4,2.61747735585959,5.704150630394,-3.08667327453441,28,38,-10,37,57,-20,48,73,-25,3,2,0,0
"4540","CBJ","VAN",2017021208,17621,20172018,0,61.35,4,5,-1,5.03183550347603,3.32097022990177,1.71086527357426,30,29,1,43,38,5,63,45,18,3,1,0,0
"4541","CBJ","DET",2017021231,17624,20172018,1,62.9166666666667,5,4,1,5.74777529538551,3.97541752621109,1.77235776917442,41,27,14,56,35,21,70,48,22,5,3,0,0
"4542","CBJ","PIT",2017021245,17626,20172018,1,61.1,4,5,-1,3.79700596781913,5.65722915259539,-1.86022318477626,30,43,-13,35,52,-17,44,69,-25,3,3,0,0
"4543","CBJ","NSH",2017021265,17628,20172018,0,60,2,4,-2,6.63434577233798,6.44788449544467,0.186461276893311,31,27,4,41,41,0,51,56,-5,2,6,0,0
"4544","CBJ","DET",2018020010,17808,20182019,0,62.1833333333333,3,2,1,5.15744251082651,2.95568564834684,2.20175686247967,39,20,19,56,28,28,76,45,31,6,3,0,0
"4545","CBJ","CAR",2018020015,17809,20182019,1,60,1,3,-2,3.5837261202123,4.01685760397812,-0.433131483765813,32,35,-3,44,46,-2,54,60,-6,3,1,0,0
"4546","CBJ","COL",2018020038,17813,20182019,1,60,5,2,3,6.34592532309152,5.07690234437373,1.26902297871779,35,27,8,45,34,11,54,45,9,6,4,0,0
"4547","CBJ","T.B",2018020063,17817,20182019,0,60,2,8,-6,3.2153039043842,5.57169399398572,-2.35639008960152,32,31,1,45,39,6,57,56,1,6,8,0,0
"4548","CBJ","PHI",2018020092,17822,20182019,1,60,6,3,3,3.34863578600925,5.69225777202519,-2.34362198601593,28,35,-7,42,45,-3,49,56,-7,2,2,0,0
"4549","CBJ","CHI",2018020109,17824,20182019,1,60,1,4,-3,4.11221500861077,2.8742170407204,1.23799796789037,38,26,12,62,36,26,77,47,30,4,3,0,0
"4550","CBJ","ARI",2018020123,17827,20182019,1,60,1,4,-3,4.53695684602258,5.19591670285445,-0.658959856831871,36,26,10,53,37,16,65,50,15,5,5,0,0
"4551","CBJ","DET",2018020170,17834,20182019,1,60,3,5,-2,3.50298331215099,5.42793233297584,-1.92494902082485,37,32,5,56,47,9,74,55,19,5,2,0,0
"4552","CBJ","S.J",2018020191,17836,20182019,0,60,4,1,3,7.72054803948413,6.85292152772308,0.867626511761046,27,45,-18,38,56,-18,42,86,-44,2,4,0,0
"4553","CBJ","L.A",2018020205,17838,20182019,0,60,1,4,-3,4.21322855429787,4.35179949878907,-0.1385709444912,27,29,-2,45,47,-2,53,55,-2,5,5,0,0
"4554","CBJ","ANA",2018020209,17839,20182019,0,60.6,2,3,-1,4.86286734979866,2.74528634597285,2.11758100382582,26,30,-4,43,44,-1,53,58,-5,6,5,0,0
"4555","CBJ","DAL",2018020217,17841,20182019,1,60,4,1,3,4.97655493607454,6.07548198409495,-1.09892704802041,34,28,6,40,40,0,54,53,1,3,2,0,0
"4556","CBJ","NYR",2018020251,17845,20182019,1,65,4,4,0,4.62614279609988,0.829962076502852,3.79618071959703,38,19,19,49,28,21,65,41,24,2,2,0,0
"4557","CBJ","DAL",2018020262,17847,20182019,0,60,2,1,1,3.56529947879318,1.98751327187347,1.57778620691971,28,27,1,34,39,-5,58,63,-5,4,5,0,0
"4558","CBJ","CAR",2018020297,17852,20182019,0,60,4,1,3,3.26619248779805,4.33914691599293,-1.07295442819488,24,31,-7,32,48,-16,41,67,-26,5,3,0,0
"4559","CBJ","TOR",2018020308,17854,20182019,0,60,2,4,-2,7.01941550843912,5.6567826657556,1.36263284268352,39,26,13,52,41,11,60,56,4,0,0,0,0
"4560","CBJ","TOR",2018020339,17858,20182019,1,60,4,2,2,2.98319396866688,6.40157436841333,-3.41838039974645,24,34,-10,35,51,-16,43,66,-23,2,3,0,0
"4561","CBJ","PIT",2018020353,17859,20182019,0,60,2,4,-2,3.77406636874975,4.42812103679739,-0.654054668047641,39,36,3,50,50,0,63,64,-1,1,1,0,0
"4562","CBJ","DET",2018020366,17861,20182019,0,60,7,5,2,4.6728768358004,3.92680592248622,0.746070913314184,32,32,0,42,40,2,48,45,3,4,3,0,0
"4563","CBJ","MIN",2018020383,17864,20182019,1,60,4,2,2,2.22966057479951,4.42478691006545,-2.19512633526594,29,25,4,49,37,12,64,49,15,2,1,0,0
"4564","CBJ","NYI",2018020401,17866,20182019,0,60,2,3,-1,4.62765119657171,2.81178913696203,1.81586205960968,30,29,1,41,33,8,54,46,8,3,4,0,0
"4565","CBJ","CGY",2018020420,17869,20182019,1,60,6,9,-3,4.7244335338728,5.27626497792517,-0.551831444052368,30,28,2,39,35,4,49,44,5,3,4,0,0
"4566","CBJ","PHI",2018020431,17871,20182019,0,60.1666666666667,4,3,1,3.49131250074272,4.50434465636499,-1.01303215562227,30,26,4,37,39,-2,48,57,-9,5,3,0,0
"4567","CBJ","VAN",2018020469,17876,20182019,1,60,2,3,-1,3.56427301757617,1.65331503292316,1.91095798465301,36,25,11,42,28,14,54,45,9,2,1,0,0
"4568","CBJ","L.A",2018020480,17878,20182019,1,60,4,1,3,3.92913911461847,4.15072186157809,-0.221582746959626,41,30,11,48,45,3,59,60,-1,3,3,0,0
"4569","CBJ","ANA",2018020501,17880,20182019,1,61.3166666666667,1,2,-1,6.14366417957353,3.52859085996897,2.61507331960456,37,22,15,57,29,28,69,42,27,4,2,0,0
"4570","CBJ","VGK",2018020513,17882,20182019,1,60,1,0,1,2.92432406567423,3.28617150557693,-0.361847439902704,31,28,3,40,36,4,45,51,-6,2,1,0,0
"4571","CBJ","N.J",2018020535,17885,20182019,1,60,2,1,1,2.72762652941017,3.0117601341598,-0.284133604749631,38,30,8,48,36,12,63,45,18,5,2,0,0
"4572","CBJ","PHI",2018020546,17887,20182019,0,60,4,3,1,2.51967594073483,4.69296703330696,-2.17329109257213,19,37,-18,23,50,-27,30,67,-37,3,5,0,0
"4573","CBJ","N.J",2018020559,17888,20182019,0,60,3,0,3,3.19116630761891,5.35387727220268,-2.16271096458377,20,39,-19,35,55,-20,42,68,-26,5,4,0,0
"4574","CBJ","NYR",2018020568,17892,20182019,0,60.5166666666667,4,3,1,3.06725231016753,3.62315456563374,-0.555902255466208,29,22,7,37,27,10,53,41,12,1,1,0,0
"4575","CBJ","TOR",2018020582,17893,20182019,1,60,2,4,-2,3.50894036961108,3.53838764282489,-0.0294472732138078,29,29,0,48,39,9,65,51,14,3,3,0,0
"4576","CBJ","CAR",2018020631,17900,20182019,0,60,2,4,-2,4.50347195440281,4.53312742087292,-0.0296554664701034,24,31,-7,35,48,-13,49,65,-16,1,2,0,0
"4577","CBJ","T.B",2018020663,17904,20182019,0,60,0,4,-4,3.17346775546457,2.82784629439567,0.345621461068902,31,22,9,41,33,8,63,41,22,1,1,0,0
"4578","CBJ","NSH",2018020675,17906,20182019,1,61.3666666666667,4,3,1,4.6840262174519,3.28692551818676,1.39710069926514,33,35,-2,44,46,-2,56,67,-11,2,2,0,0
"4579","CBJ","NYR",2018020700,17909,20182019,1,60,7,5,2,7.04724499491158,2.64650427096058,4.400740723951,40,27,13,54,38,16,69,50,19,5,3,0,0
"4580","CBJ","N.J",2018020713,17911,20182019,1,60,4,1,3,5.10959186954523,3.80679666726154,1.30279520228369,34,30,4,43,37,6,52,56,-4,3,2,0,0
"4581","CBJ","MTL",2018020734,17914,20182019,1,60,1,4,-3,2.33050278317203,5.91900803669341,-3.58850525352138,35,26,9,46,37,9,53,48,5,2,3,0,0
"4582","CBJ","MIN",2018020748,17915,20182019,0,60,1,2,-1,4.19214413340706,4.3040816022677,-0.111937468860646,20,31,-11,36,43,-7,51,53,-2,4,4,0,0
"4583","CBJ","WPG",2018020780,17927,20182019,0,60,3,4,-1,2.63502846669578,2.86972134454845,-0.234692877852673,31,26,5,40,41,-1,55,54,1,3,4,0,0
"4584","CBJ","COL",2018020819,17932,20182019,0,60,6,3,3,8.54001533754717,4.53121629563248,4.0087990419147,37,30,7,45,36,9,59,50,9,2,4,0,0
"4585","CBJ","ARI",2018020836,17934,20182019,0,60,4,2,2,3.62185030045025,7.89430380195336,-4.27245350150311,33,31,2,47,54,-7,56,66,-10,2,3,0,0
"4586","CBJ","VGK",2018020851,17936,20182019,0,60,4,3,1,4.85165948991198,2.33153764248709,2.52012184742489,33,23,10,43,29,14,57,42,15,3,2,0,0
"4587","CBJ","NYI",2018020878,17941,20182019,1,60,0,3,-3,3.43498234499452,2.99499658169225,0.439985763302275,31,27,4,44,36,8,65,48,17,1,2,0,0
"4588","CBJ","CHI",2018020900,17943,20182019,0,60,5,2,3,4.03658840153366,4.08114056382328,-0.0445521622896194,30,41,-11,38,49,-11,50,61,-11,1,1,0,0
"4589","CBJ","T.B",2018020911,17945,20182019,1,60,1,5,-4,2.81632421569794,1.99678401096025,0.819540204737681,40,20,20,47,23,24,58,31,27,4,4,0,0
"4590","CBJ","MTL",2018020920,17946,20182019,0,60,2,3,-1,4.48825592549501,4.05550371285062,0.432752212644388,33,32,1,44,49,-5,56,69,-13,2,3,0,0
"4591","CBJ","S.J",2018020949,17950,20182019,1,60,4,0,4,2.93403152798383,2.41868887925952,0.515342648724315,26,26,0,33,34,-1,44,40,4,2,2,0,0
"4592","CBJ","PIT",2018020973,17953,20182019,1,60,2,5,-3,2.96838714081878,3.87380308989009,-0.905415949071312,23,27,-4,30,33,-3,49,48,1,3,2,0,0
"4593","CBJ","PHI",2018020986,17955,20182019,1,64.45,4,3,1,6.54664496549685,5.90744793326303,0.639197032233824,40,31,9,49,45,4,69,57,12,3,2,0,0
"4594","CBJ","EDM",2018020999,17957,20182019,1,60,0,4,-4,2.24495402054163,5.23120124920206,-2.98624722866043,30,24,6,40,30,10,57,37,20,1,1,0,0
"4595","CBJ","WPG",2018021014,17958,20182019,1,60,2,5,-3,4.78975351996237,6.85785624697564,-2.06810272701327,42,26,16,54,39,15,67,49,18,4,3,0,0
"4596","CBJ","N.J",2018021020,17960,20182019,0,65,1,1,0,6.75555942405481,4.4762667089235,2.27929271513131,18,30,-12,35,47,-12,49,59,-10,2,2,0,0
"4597","CBJ","PIT",2018021034,17962,20182019,0,60,0,3,-3,3.36206438047364,4.49466886134613,-1.13260448087249,25,31,-6,35,41,-6,59,53,6,4,5,0,0
"4598","CBJ","PIT",2018021054,17964,20182019,1,60,4,1,3,3.72688075505721,3.88566774884929,-0.158786993792079,33,29,4,42,41,1,52,53,-1,5,4,0,0
"4599","CBJ","NYI",2018021066,17966,20182019,0,60,0,2,-2,4.18886926405685,2.80220530077349,1.38666396328335,31,20,11,46,29,17,62,33,29,2,3,0,0
"4600","CBJ","BOS",2018021074,17967,20182019,1,60,7,4,3,4.33422036409195,2.65035470666228,1.68386565742966,35,31,4,44,43,1,52,56,-4,4,3,0,0
"4601","CBJ","CAR",2018021094,17970,20182019,1,60,3,0,3,2.55197258235421,5.53596442616254,-2.98399184380833,20,46,-26,23,65,-42,29,83,-54,1,2,0,0
"4602","CBJ","BOS",2018021102,17971,20182019,0,63.5,1,2,-1,3.74065316000997,5.73506831686973,-1.99441515685976,25,33,-8,39,45,-6,46,65,-19,1,2,0,0
"4603","CBJ","CGY",2018021131,17974,20182019,0,60,2,4,-2,3.41759287098648,3.49874244484818,-0.0811495738616941,33,31,2,52,43,9,66,53,13,3,1,0,0
"4604","CBJ","EDM",2018021145,17976,20182019,0,60,1,4,-3,4.32079039269593,5.44172386243008,-1.12093346973415,20,22,-2,28,38,-10,42,59,-17,0,1,0,0
"4605","CBJ","VAN",2018021168,17979,20182019,0,60,5,0,5,3.31518364890871,3.01402858108637,0.301155067822346,33,21,12,42,34,8,54,47,7,2,4,0,0
"4606","CBJ","NYI",2018021179,17981,20182019,1,60,4,0,4,4.65012750332244,2.46139358776857,2.18873391555387,33,26,7,46,36,10,55,50,5,2,1,0,0
"4607","CBJ","MTL",2018021191,17983,20182019,1,60,6,2,4,6.11679389676442,5.74053298766376,0.376260909100665,30,28,2,41,40,1,52,53,-1,2,2,0,0
"4608","CBJ","NSH",2018021210,17985,20182019,0,60,5,2,3,5.29678604646324,2.96129773889697,2.33548830756627,32,25,7,47,32,15,58,42,16,6,2,0,0
"4609","CBJ","BOS",2018021230,17988,20182019,1,60,2,6,-4,5.1537960297137,4.89334725070512,0.260448779008584,34,28,6,48,36,12,65,41,24,3,1,0,0
"4610","CBJ","NYR",2018021254,17991,20182019,0,65,2,2,0,5.71575614856556,4.37130480734049,1.34445134122507,41,27,14,59,35,24,74,44,30,2,0,0,0
"4611","CBJ","T.B",2018030111,17996,20182019,0,60,4,3,1,4.07007492409321,2.95102594181662,1.11904898227658,26,29,-3,33,36,-3,49,50,-1,3,3,0,0
"4612","CBJ","T.B",2018030112,17998,20182019,0,60,5,1,4,2.33475900412304,3.99536594449544,-1.6606069403724,27,24,3,34,36,-2,43,52,-9,4,3,0,0
"4613","CBJ","T.B",2018030113,18000,20182019,1,60,3,1,2,4.93354145635385,2.92651426943485,2.007027186919,30,31,-1,35,37,-2,50,54,-4,4,2,0,0
"4614","CBJ","T.B",2018030114,18002,20182019,1,60,7,3,4,5.08423815155038,5.22133644571295,-0.13709829416257,25,33,-8,36,43,-7,45,58,-13,2,1,0,0
"4615","CBJ","BOS",2018030211,18011,20182019,0,65.25,2,3,-1,4.25030914641684,6.57152246597832,-2.32121331956148,22,37,-15,31,56,-25,38,75,-37,4,4,0,0
"4616","CBJ","BOS",2018030212,18013,20182019,0,80,2,2,0,5.17034253924876,7.44682473921082,-2.27648219996207,36,31,5,49,48,1,65,69,-4,3,3,0,0
"4617","CBJ","BOS",2018030213,18016,20182019,1,60,2,1,1,5.23453388062087,3.63838475655302,1.59614912406784,34,37,-3,44,50,-6,61,72,-11,3,2,0,0
"4618","CBJ","BOS",2018030214,18018,20182019,1,60,1,4,-3,5.04473645681646,5.69714843365364,-0.652411976837175,40,46,-6,52,54,-2,65,69,-4,5,6,0,0
"4619","CBJ","BOS",2018030215,18020,20182019,0,60,3,4,-1,5.73741059529129,8.36068056587828,-2.62326997058699,36,36,0,45,49,-4,60,67,-7,2,2,0,0
"4620","CBJ","BOS",2018030216,18022,20182019,1,60,0,3,-3,4.08142852066973,2.25224665363479,1.82918186703494,39,29,10,55,39,16,70,50,20,4,1,0,0
"4621","CGY","VAN",2008020007,14161,20082009,0,60,0,6,-6,0,0,0,25,23,2,38,36,2,53,47,6,7,10,0,0
"4622","CGY","VAN",2008020026,14163,20082009,1,63.9,4,5,-1,0,0,0,29,34,-5,44,43,1,58,53,5,8,7,0,0
"4623","CGY","COL",2008020041,14166,20082009,1,60,5,4,1,0,0,0,35,29,6,46,36,10,59,43,16,7,6,0,0
"4624","CGY","EDM",2008020060,14169,20082009,1,60,3,4,-1,0,0,0,29,35,-6,43,46,-3,52,61,-9,4,7,0,0
"4625","CGY","EDM",2008020074,14170,20082009,0,60,2,3,-1,0,0,0,33,27,6,49,38,11,76,48,28,8,5,0,0
"4626","CGY","WSH",2008020086,14173,20082009,1,60,2,1,1,0,0,0,28,31,-3,41,45,-4,51,54,-3,10,4,0,0
"4627","CGY","NSH",2008020095,14175,20082009,0,60,5,3,2,0,0,0,27,38,-11,39,50,-11,57,59,-2,5,8,0,0
"4628","CGY","ARI",2008020119,14177,20082009,0,60,4,1,3,0,0,0,36,24,12,48,32,16,64,40,24,4,4,0,0
"4629","CGY","COL",2008020130,14180,20082009,1,60,3,0,3,0,0,0,30,22,8,45,33,12,66,37,29,2,3,0,0
"4630","CGY","BOS",2008020144,14182,20082009,1,60,3,2,1,0,0,0,38,31,7,51,52,-1,65,56,9,5,3,0,0
"4631","CGY","L.A",2008020161,14184,20082009,0,60,3,2,1,0,0,0,21,36,-15,31,49,-18,38,59,-21,5,7,0,0
"4632","CGY","ANA",2008020166,14185,20082009,0,60,2,3,-1,0,0,0,36,37,-1,49,53,-4,55,59,-4,6,1,0,0
"4633","CGY","ARI",2008020174,14187,20082009,1,60,2,4,-2,0,0,0,29,22,7,42,28,14,65,36,29,3,3,0,0
"4634","CGY","NSH",2008020188,14189,20082009,1,60,7,6,1,0,0,0,29,29,0,38,42,-4,52,47,5,7,9,0,0
"4635","CGY","CBJ",2008020202,14191,20082009,0,60,1,3,-2,0,0,0,23,28,-5,35,39,-4,46,46,0,9,10,0,0
"4636","CGY","CHI",2008020210,14192,20082009,0,60,1,6,-5,0,0,0,23,27,-4,26,37,-11,35,43,-8,8,8,0,0
"4637","CGY","TOR",2008020218,14194,20082009,1,60,4,3,1,0,0,0,32,32,0,48,43,5,65,57,8,1,4,0,0
"4638","CGY","S.J",2008020235,14196,20082009,0,60,1,6,-5,0,0,0,24,46,-22,34,55,-21,45,66,-21,6,11,0,0
"4639","CGY","COL",2008020267,14201,20082009,1,60,4,1,3,0,0,0,51,23,28,66,28,38,91,33,58,8,2,0,0
"4640","CGY","COL",2008020276,14203,20082009,0,60,1,0,1,0,0,0,33,18,15,44,24,20,65,36,29,8,3,0,0
"4641","CGY","DET",2008020294,14205,20082009,1,60,2,5,-3,0,0,0,33,37,-4,47,42,5,59,56,3,5,4,0,0
"4642","CGY","L.A",2008020308,14208,20082009,1,60,6,2,4,0,0,0,35,25,10,50,32,18,62,43,19,13,5,0,0
"4643","CGY","VAN",2008020322,14210,20082009,0,60,4,3,1,0,0,0,33,30,3,39,43,-4,49,52,-3,2,4,0,0
"4644","CGY","VAN",2008020345,14212,20082009,1,60,3,1,2,0,0,0,31,18,13,48,26,22,65,41,24,5,3,0,0
"4645","CGY","DAL",2008020358,14215,20082009,1,60,1,3,-2,0,0,0,37,23,14,49,29,20,64,36,28,1,3,0,0
"4646","CGY","STL",2008020377,14218,20082009,0,62.35,4,3,1,0,0,0,30,25,5,44,38,6,55,45,10,5,5,0,0
"4647","CGY","NYR",2008020393,14220,20082009,0,60,3,0,3,0,0,0,20,31,-11,36,47,-11,43,56,-13,2,4,0,0
"4648","CGY","MTL",2008020403,14222,20082009,0,60,1,4,-3,0,0,0,33,31,2,45,44,1,58,58,0,6,5,0,0
"4649","CGY","FLA",2008020428,14225,20082009,1,65,2,2,0,0,0,0,37,29,8,49,42,7,68,52,16,5,4,0,0
"4650","CGY","STL",2008020451,14229,20082009,0,60,6,3,3,0,0,0,31,31,0,42,42,0,52,53,-1,6,8,0,0
"4651","CGY","MIN",2008020457,14230,20082009,0,63.8,3,2,1,0,0,0,30,27,3,40,43,-3,55,57,-2,3,3,0,0
"4652","CGY","CHI",2008020472,14232,20082009,1,60.3833333333333,2,3,-1,0,0,0,34,31,3,45,39,6,54,51,3,4,3,0,0
"4653","CGY","ANA",2008020505,14236,20082009,1,60,4,3,1,0,0,0,32,33,-1,49,45,4,67,53,14,4,1,0,0
"4654","CGY","OTT",2008020526,14240,20082009,1,60,6,3,3,0,0,0,42,30,12,54,41,13,69,44,25,6,6,0,0
"4655","CGY","MIN",2008020537,14242,20082009,1,60,2,1,1,0,0,0,29,24,5,42,42,0,57,53,4,2,4,0,0
"4656","CGY","EDM",2008020553,14244,20082009,1,60,6,4,2,0,0,0,37,32,5,50,45,5,69,55,14,5,5,0,0
"4657","CGY","NSH",2008020567,14247,20082009,0,60,3,2,1,0,0,0,26,26,0,42,42,0,55,54,1,5,4,0,0
"4658","CGY","CHI",2008020579,14248,20082009,0,60,2,5,-3,0,0,0,36,36,0,40,46,-6,53,54,-1,4,6,0,0
"4659","CGY","S.J",2008020593,14250,20082009,1,60,5,2,3,0,0,0,28,28,0,34,44,-10,50,53,-3,5,6,0,0
"4660","CGY","NYI",2008020606,14252,20082009,1,60,5,2,3,0,0,0,41,26,15,59,40,19,75,53,22,4,6,0,0
"4661","CGY","STL",2008020639,14257,20082009,1,60,3,1,2,0,0,0,34,28,6,43,40,3,58,50,8,7,5,0,0
"4662","CGY","S.J",2008020655,14259,20082009,0,60,3,2,1,0,0,0,31,35,-4,44,44,0,64,56,8,6,6,0,0
"4663","CGY","ARI",2008020671,14261,20082009,1,60,3,4,-1,0,0,0,32,26,6,49,38,11,70,45,25,2,2,0,0
"4664","CGY","COL",2008020674,14262,20082009,0,60,2,6,-4,0,0,0,41,39,2,55,53,2,74,61,13,5,6,0,0
"4665","CGY","CBJ",2008020700,14265,20082009,1,65,4,4,0,0,0,0,31,33,-2,47,44,3,69,50,19,9,6,0,0
"4666","CGY","BUF",2008020713,14272,20082009,1,60,5,2,3,0,0,0,43,27,16,61,38,23,68,50,18,5,5,0,0
"4667","CGY","NSH",2008020728,14274,20082009,1,60,3,1,2,0,0,0,32,29,3,43,37,6,54,48,6,8,5,0,0
"4668","CGY","COL",2008020746,14277,20082009,0,60,3,4,-1,0,0,0,39,42,-3,53,50,3,80,61,19,2,4,0,0
"4669","CGY","DAL",2008020756,14278,20082009,0,60,1,3,-2,0,0,0,25,32,-7,39,41,-2,52,49,3,3,5,0,0
"4670","CGY","CHI",2008020770,14280,20082009,1,60,2,5,-3,0,0,0,31,33,-2,45,47,-2,58,60,-2,6,7,0,0
"4671","CGY","ANA",2008020779,14282,20082009,1,60,1,2,-1,0,0,0,27,25,2,34,38,-4,44,50,-6,4,2,0,0
"4672","CGY","MTL",2008020794,14284,20082009,1,60,6,2,4,0,0,0,41,24,17,51,28,23,69,38,31,7,6,0,0
"4673","CGY","ANA",2008020810,14286,20082009,0,60.9166666666667,2,3,-1,0,0,0,23,40,-17,36,52,-16,41,65,-24,5,6,0,0
"4674","CGY","L.A",2008020817,14287,20082009,0,60,2,0,2,0,0,0,20,36,-16,28,54,-26,39,64,-25,5,7,0,0
"4675","CGY","ARI",2008020833,14289,20082009,0,60,7,5,2,0,0,0,45,37,8,57,54,3,68,62,6,2,6,0,0
"4676","CGY","VAN",2008020852,14292,20082009,1,65,3,3,0,0,0,0,41,43,-2,56,55,1,68,68,0,8,7,0,0
"4677","CGY","MIN",2008020867,14294,20082009,0,63.8333333333333,3,2,1,0,0,0,22,27,-5,34,41,-7,41,56,-15,2,1,0,0
"4678","CGY","EDM",2008020886,14296,20082009,0,65,2,2,0,0,0,0,32,28,4,45,33,12,64,38,26,4,6,0,0
"4679","CGY","CBJ",2008020902,14299,20082009,1,60,4,1,3,0,0,0,28,29,-1,37,47,-10,51,53,-2,3,5,0,0
"4680","CGY","MIN",2008020921,14302,20082009,1,60,4,1,3,0,0,0,29,16,13,37,25,12,51,32,19,6,6,0,0
"4681","CGY","T.B",2008020938,14304,20082009,1,60,6,8,-2,0,0,0,39,32,7,54,44,10,65,58,7,3,4,0,0
"4682","CGY","OTT",2008020946,14306,20082009,0,60,6,3,3,0,0,0,23,25,-2,32,37,-5,46,45,1,5,6,0,0
"4683","CGY","PHI",2008020957,14308,20082009,0,60,5,1,4,0,0,0,41,36,5,56,52,4,65,67,-2,4,6,0,0
"4684","CGY","CAR",2008020964,14309,20082009,0,60,1,6,-5,0,0,0,22,34,-12,39,41,-2,53,53,0,4,8,0,0
"4685","CGY","ATL",2008020982,14311,20082009,0,60,2,5,-3,0,0,0,29,20,9,42,31,11,58,38,20,7,10,0,0
"4686","CGY","N.J",2008020989,14313,20082009,0,60,2,3,-1,0,0,0,37,31,6,46,39,7,53,42,11,7,4,0,0
"4687","CGY","DET",2008021010,14315,20082009,0,65,5,5,0,0,0,0,33,45,-12,46,63,-17,53,75,-22,7,9,0,0
"4688","CGY","TOR",2008021023,14317,20082009,0,60,6,8,-2,0,0,0,35,30,5,56,43,13,77,52,25,6,6,0,0
"4689","CGY","DAL",2008021053,14321,20082009,1,60,2,1,1,0,0,0,31,19,12,43,29,14,66,34,32,5,3,0,0
"4690","CGY","STL",2008021069,14323,20082009,1,60,2,3,-1,0,0,0,35,28,7,51,43,8,75,49,26,5,3,0,0
"4691","CGY","DET",2008021087,14326,20082009,1,60,5,3,2,0,0,0,27,33,-6,39,49,-10,48,58,-10,4,1,0,0
"4692","CGY","PIT",2008021099,14328,20082009,0,60,0,2,-2,0,0,0,31,28,3,46,37,9,64,55,9,5,3,0,0
"4693","CGY","MIN",2008021125,14331,20082009,1,60,3,2,1,0,0,0,40,15,25,53,24,29,68,35,33,4,2,0,0
"4694","CGY","S.J",2008021135,14333,20082009,1,60,1,2,-1,0,0,0,29,17,12,38,26,12,57,36,21,3,3,0,0
"4695","CGY","DAL",2008021154,14336,20082009,0,60,2,1,1,0,0,0,24,30,-6,38,41,-3,46,53,-7,2,3,0,0
"4696","CGY","MIN",2008021162,14337,20082009,0,60,0,4,-4,0,0,0,27,28,-1,41,38,3,51,47,4,5,4,0,0
"4697","CGY","L.A",2008021183,14340,20082009,1,60,4,1,3,0,0,0,38,24,14,48,37,11,64,45,19,8,5,0,0
"4698","CGY","VAN",2008021194,14341,20082009,0,60,1,4,-3,0,0,0,47,25,22,57,39,18,75,50,25,7,6,0,0
"4699","CGY","EDM",2008021212,14344,20082009,0,60,1,5,-4,0,0,0,32,36,-4,61,44,17,80,52,28,4,4,0,0
"4700","CGY","EDM",2008021226,14345,20082009,1,60,4,1,3,0,0,0,45,36,9,61,48,13,82,56,26,2,1,0,0
"4701","CGY","CHI",2008030181,14350,20082009,0,60.2,2,3,-1,0,0,0,25,28,-3,29,40,-11,34,50,-16,2,3,0,0
"4702","CGY","CHI",2008030182,14352,20082009,0,60,2,3,-1,0,0,0,32,33,-1,35,42,-7,46,51,-5,5,4,0,0
"4703","CGY","CHI",2008030183,14354,20082009,1,60,4,2,2,0,0,0,28,38,-10,38,55,-17,51,70,-19,7,11,0,0
"4704","CGY","CHI",2008030184,14356,20082009,1,60,6,4,2,0,0,0,27,32,-5,37,42,-5,50,46,4,1,4,0,0
"4705","CGY","CHI",2008030185,14359,20082009,0,60,1,5,-4,0,0,0,20,28,-8,28,38,-10,40,44,-4,4,5,0,0
"4706","CGY","CHI",2008030186,14361,20082009,1,60,1,4,-3,0,0,0,44,16,28,53,27,26,70,33,37,3,2,0,0
"4707","CGY","VAN",2009020004,14518,20092010,1,60,5,3,2,0,0,0,23,42,-19,37,54,-17,50,69,-19,5,6,0,0
"4708","CGY","EDM",2009020021,14520,20092010,0,60,4,3,1,0,0,0,21,34,-13,36,43,-7,50,60,-10,4,5,0,0
"4709","CGY","MTL",2009020030,14523,20092010,1,60,4,3,1,0,0,0,28,30,-2,44,34,10,56,51,5,1,0,0,0
"4710","CGY","EDM",2009020044,14525,20092010,0,65,3,3,0,0,0,0,28,28,0,42,38,4,61,57,4,4,4,0,0
"4711","CGY","DAL",2009020048,14526,20092010,1,60,2,5,-3,0,0,0,23,30,-7,38,43,-5,48,53,-5,5,3,0,0
"4712","CGY","CHI",2009020071,14529,20092010,0,60.4333333333333,5,6,-1,0,0,0,20,39,-19,27,56,-29,28,72,-44,1,4,0,0
"4713","CGY","VAN",2009020091,14533,20092010,1,60,5,3,2,0,0,0,24,29,-5,39,42,-3,56,55,1,6,5,0,0
"4714","CGY","EDM",2009020143,14541,20092010,1,60,5,2,3,0,0,0,38,25,13,42,41,1,53,50,3,6,9,0,0
"4715","CGY","COL",2009020163,14545,20092010,1,60,2,3,-1,0,0,0,32,14,18,48,17,31,67,30,37,3,2,0,0
"4716","CGY","DET",2009020190,14548,20092010,1,60,1,3,-2,0,0,0,21,30,-9,35,38,-3,43,55,-12,2,4,0,0
"4717","CGY","DAL",2009020207,14552,20092010,0,61.4166666666667,3,2,1,0,0,0,23,40,-17,34,52,-18,55,67,-12,4,6,0,0
"4718","CGY","STL",2009020213,14553,20092010,0,62.8333333333333,2,1,1,0,0,0,32,31,1,44,42,2,54,63,-9,6,5,0,0
"4719","CGY","NYR",2009020235,14555,20092010,1,60,3,1,2,0,0,0,22,33,-11,39,46,-7,55,57,-2,4,4,0,0
"4720","CGY","MTL",2009020243,14558,20092010,0,60,1,0,1,0,0,0,31,25,6,50,34,16,63,44,19,8,5,0,0
"4721","CGY","TOR",2009020268,14562,20092010,0,60,5,2,3,0,0,0,22,40,-18,44,62,-18,67,81,-14,2,5,0,0
"4722","CGY","COL",2009020293,14565,20092010,1,60,2,3,-1,0,0,0,36,24,12,43,35,8,67,41,26,4,5,0,0
"4723","CGY","CHI",2009020305,14567,20092010,1,60,1,7,-6,0,0,0,28,26,2,36,36,0,54,45,9,5,5,0,0
"4724","CGY","L.A",2009020313,14569,20092010,0,60,5,2,3,0,0,0,32,25,7,45,31,14,56,40,16,8,4,0,0
"4725","CGY","ANA",2009020337,14571,20092010,0,65,2,2,0,0,0,0,43,31,12,55,47,8,66,51,15,5,4,0,0
"4726","CGY","DET",2009020363,14575,20092010,0,60,3,0,3,0,0,0,17,40,-23,24,58,-34,31,75,-44,2,6,0,0
"4727","CGY","NSH",2009020389,14578,20092010,0,60,5,0,5,0,0,0,30,22,8,40,41,-1,53,57,-4,2,3,0,0
"4728","CGY","S.J",2009020426,14583,20092010,0,60,2,1,1,0,0,0,36,36,0,50,49,1,69,63,6,6,4,0,0
"4729","CGY","L.A",2009020437,14585,20092010,0,60,1,2,-1,0,0,0,27,16,11,39,32,7,54,44,10,5,4,0,0
"4730","CGY","ATL",2009020450,14587,20092010,1,60,3,1,2,0,0,0,32,25,7,47,38,9,61,47,14,5,4,0,0
"4731","CGY","MIN",2009020464,14589,20092010,1,63.25,1,2,-1,0,0,0,23,46,-23,29,59,-30,46,72,-26,4,6,0,0
"4732","CGY","COL",2009020479,14591,20092010,0,60,2,3,-1,0,0,0,21,35,-14,37,44,-7,54,54,0,5,5,0,0
"4733","CGY","STL",2009020489,14593,20092010,0,60,3,4,-1,0,0,0,23,34,-11,31,48,-17,46,61,-15,4,5,0,0
"4734","CGY","L.A",2009020508,14595,20092010,1,60,2,1,1,0,0,0,24,35,-11,32,46,-14,48,60,-12,5,4,0,0
"4735","CGY","NSH",2009020526,14597,20092010,1,60,3,5,-2,0,0,0,32,20,12,40,30,10,50,39,11,3,4,0,0
"4736","CGY","STL",2009020556,14601,20092010,1,65,1,1,0,0,0,0,24,27,-3,36,37,-1,58,48,10,2,2,0,0
"4737","CGY","VAN",2009020575,14605,20092010,1,60,1,5,-4,0,0,0,30,29,1,44,45,-1,60,55,5,6,9,0,0
"4738","CGY","EDM",2009020581,14606,20092010,0,60,4,1,3,0,0,0,23,35,-12,41,52,-11,64,63,1,5,5,0,0
"4739","CGY","L.A",2009020595,14608,20092010,1,60,2,1,1,0,0,0,21,24,-3,34,38,-4,50,57,-7,9,5,0,0
"4740","CGY","EDM",2009020608,14609,20092010,1,60,2,1,1,0,0,0,39,22,17,52,34,18,64,52,12,2,3,0,0
"4741","CGY","TOR",2009020617,14611,20092010,1,60,3,1,2,0,0,0,35,25,10,46,36,10,61,51,10,4,5,0,0
"4742","CGY","NSH",2009020634,14614,20092010,0,60,3,1,2,0,0,0,34,28,6,48,42,6,64,59,5,2,3,0,0
"4743","CGY","MIN",2009020642,14615,20092010,0,60,1,4,-3,0,0,0,26,35,-9,38,50,-12,49,65,-16,2,5,0,0
"4744","CGY","VAN",2009020670,14618,20092010,0,65,2,2,0,0,0,0,40,21,19,53,32,21,72,50,22,4,3,0,0
"4745","CGY","COL",2009020677,14620,20092010,1,65,2,2,0,0,0,0,46,21,25,57,33,24,84,41,43,4,4,0,0
"4746","CGY","PIT",2009020691,14622,20092010,1,60,1,3,-2,0,0,0,38,27,11,59,33,26,72,45,27,5,5,0,0
"4747","CGY","NSH",2009020706,14624,20092010,1,60,0,1,-1,0,0,0,22,21,1,32,36,-4,42,48,-6,3,3,0,0
"4748","CGY","ANA",2009020722,14626,20092010,0,60,4,5,-1,0,0,0,37,26,11,49,41,8,61,55,6,4,4,0,0
"4749","CGY","S.J",2009020732,14627,20092010,0,60,1,9,-8,0,0,0,22,46,-24,30,56,-26,39,69,-30,3,4,0,0
"4750","CGY","CHI",2009020753,14630,20092010,1,60,1,3,-2,0,0,0,20,28,-8,34,38,-4,51,49,2,2,3,0,0
"4751","CGY","STL",2009020776,14634,20092010,1,60,0,2,-2,0,0,0,34,29,5,52,42,10,72,51,21,3,3,0,0
"4752","CGY","DAL",2009020791,14636,20092010,0,65,3,3,0,0,0,0,26,36,-10,50,50,0,70,70,0,1,6,0,0
"4753","CGY","EDM",2009020815,14639,20092010,1,60,6,1,5,0,0,0,30,28,2,45,36,9,59,54,5,3,5,0,0
"4754","CGY","PHI",2009020825,14641,20092010,1,60,0,3,-3,0,0,0,18,27,-9,38,40,-2,53,48,5,2,4,0,0
"4755","CGY","CAR",2009020838,14643,20092010,1,60,4,1,3,0,0,0,39,28,11,51,41,10,62,52,10,4,8,0,0
"4756","CGY","FLA",2009020853,14645,20092010,0,60,2,1,1,0,0,0,40,13,27,47,20,27,60,38,22,3,4,0,0
"4757","CGY","T.B",2009020863,14646,20092010,0,61.9666666666667,1,2,-1,0,0,0,26,23,3,36,36,0,52,46,6,5,6,0,0
"4758","CGY","OTT",2009020879,14649,20092010,0,60,2,3,-1,0,0,0,29,31,-2,38,51,-13,58,66,-8,3,5,0,0
"4759","CGY","DAL",2009020896,14651,20092010,1,60,1,3,-2,0,0,0,34,23,11,46,33,13,66,40,26,5,5,0,0
"4760","CGY","ANA",2009020914,14653,20092010,1,60,3,1,2,0,0,0,38,27,11,57,35,22,69,47,22,2,2,0,0
"4761","CGY","MIN",2009020939,14671,20092010,1,60,0,4,-4,0,0,0,29,21,8,43,29,14,59,33,26,2,0,0,0
"4762","CGY","N.J",2009020953,14673,20092010,1,60,5,3,2,0,0,0,25,25,0,35,39,-4,52,52,0,1,4,0,0
"4763","CGY","MIN",2009020967,14675,20092010,0,60,5,2,3,0,0,0,24,29,-5,37,40,-3,44,58,-14,5,4,0,0
"4764","CGY","DET",2009020980,14677,20092010,0,60,4,2,2,0,0,0,32,30,2,41,38,3,57,53,4,2,5,0,0
"4765","CGY","OTT",2009020998,14679,20092010,1,60,2,0,2,0,0,0,25,33,-8,36,45,-9,46,75,-29,3,6,0,0
"4766","CGY","VAN",2009021024,14682,20092010,0,60,1,3,-2,0,0,0,33,28,5,52,34,18,70,46,24,7,8,0,0
"4767","CGY","DET",2009021027,14683,20092010,1,60,1,2,-1,0,0,0,23,28,-5,32,40,-8,45,45,0,5,3,0,0
"4768","CGY","COL",2009021040,14685,20092010,0,60,3,2,1,0,0,0,34,34,0,41,43,-2,52,55,-3,5,4,0,0
"4769","CGY","S.J",2009021054,14687,20092010,1,60,4,3,1,0,0,0,24,28,-4,36,36,0,42,53,-11,3,3,0,0
"4770","CGY","MIN",2009021069,14689,20092010,0,60,3,4,-1,0,0,0,32,21,11,40,28,12,57,35,22,1,2,0,0
"4771","CGY","ANA",2009021088,14691,20092010,1,60,3,1,2,0,0,0,28,23,5,41,39,2,58,54,4,2,0,0,0
"4772","CGY","NYI",2009021098,14693,20092010,0,60,2,3,-1,0,0,0,23,22,1,33,33,0,52,50,2,5,2,0,0
"4773","CGY","BOS",2009021110,14695,20092010,0,60,0,5,-5,0,0,0,31,35,-4,40,46,-6,54,51,3,3,5,0,0
"4774","CGY","COL",2009021162,14701,20092010,0,60,2,1,1,0,0,0,27,36,-9,36,40,-4,55,55,0,3,1,0,0
"4775","CGY","CHI",2009021176,14703,20092010,0,60,1,4,-3,0,0,0,26,31,-5,34,41,-7,50,55,-5,1,3,0,0
"4776","CGY","S.J",2009021190,14705,20092010,1,60,1,2,-1,0,0,0,39,26,13,49,38,11,66,47,19,4,2,0,0
"4777","CGY","MIN",2009021204,14707,20092010,1,65,1,1,0,0,0,0,33,24,9,41,27,14,58,35,23,6,6,0,0
"4778","CGY","VAN",2009021221,14709,20092010,0,60,3,7,-4,0,0,0,41,29,12,52,38,14,63,50,13,3,5,0,0
"4779","CGY","EDM",2010020005,14889,20102011,0,60,0,4,-4,3.93053800398872,4.70715631263874,-0.776618308650029,37,33,4,59,44,15,79,61,18,4,6,0,0
"4780","CGY","L.A",2010020025,14892,20102011,1,60,3,1,2,3.0944018913433,4.25359736986249,-1.15919547851919,32,22,10,38,31,7,50,50,0,5,3,0,0
"4781","CGY","FLA",2010020047,14896,20102011,1,60,0,3,-3,3.63582841063271,2.42788384779124,1.20794456284148,27,18,9,43,27,16,62,42,20,4,3,0,0
"4782","CGY","EDM",2010020065,14898,20102011,1,60,5,3,2,4.96260869112552,4.75660010678314,0.206008584342385,46,30,16,60,39,21,74,47,27,5,5,0,0
"4783","CGY","NSH",2010020075,14901,20102011,0,62.1666666666667,1,0,1,5.04094354630797,4.17994136400177,0.861002182306207,35,34,1,47,46,1,61,57,4,2,5,0,0
"4784","CGY","DET",2010020085,14903,20102011,0,60,2,4,-2,4.1934158090844,3.83719484333924,0.356220965745155,36,30,6,46,40,6,62,55,7,6,5,0,0
"4785","CGY","S.J",2010020113,14906,20102011,1,60,4,0,4,4.53289634510293,2.38433986201349,2.14855648308944,30,27,3,46,37,9,56,55,1,6,2,0,0
"4786","CGY","EDM",2010020120,14908,20102011,1,65,4,4,0,5.92213473311281,7.15179133875322,-1.22965660564041,39,32,7,52,38,14,68,51,17,6,4,0,0
"4787","CGY","COL",2010020136,14910,20102011,1,60,5,6,-1,1.72310181836807,7.43278615529925,-5.70968433693118,19,36,-17,35,51,-16,47,61,-14,3,6,0,0
"4788","CGY","DET",2010020170,14916,20102011,1,60,1,2,-1,2.91073587490246,3.99442794439532,-1.08369206949286,17,33,-16,28,50,-22,34,67,-33,7,7,0,0
"4789","CGY","MIN",2010020183,14918,20102011,0,60,1,2,-1,3.69296465214186,2.03192481108937,1.6610398410525,34,23,11,48,27,21,71,36,35,4,3,0,0
"4790","CGY","COL",2010020209,14922,20102011,0,60,4,2,2,4.48000336217228,4.6015096496476,-0.121506287475313,25,31,-6,41,41,0,57,53,4,6,8,0,0
"4791","CGY","S.J",2010020242,14926,20102011,0,60,3,4,-1,3.31120374514238,4.95885140277096,-1.64764765762858,31,35,-4,46,52,-6,67,62,5,7,4,0,0
"4792","CGY","CHI",2010020280,14932,20102011,1,60,7,2,5,5.93492763389528,7.97817922318416,-2.04325158928888,36,33,3,45,60,-15,58,80,-22,5,2,0,0
"4793","CGY","DET",2010020295,14934,20102011,0,61.6333333333333,4,5,-1,3.48761312199572,3.75704074237728,-0.26942762038157,27,38,-11,33,52,-19,42,72,-30,5,10,0,0
"4794","CGY","NYR",2010020300,14935,20102011,0,60,1,2,-1,7.79507146769902,3.45646648824913,4.33860497944988,32,24,8,46,34,12,63,45,18,3,3,0,0
"4795","CGY","N.J",2010020313,14937,20102011,0,65,1,1,0,2.38375568483744,1.56472160399426,0.819034080843181,26,21,5,37,28,9,51,42,9,3,3,0,0
"4796","CGY","PHI",2010020323,14939,20102011,0,65,2,2,0,4.40204152734077,7.28033228060758,-2.87829075326681,30,36,-6,40,52,-12,57,73,-16,3,6,0,0
"4797","CGY","PIT",2010020335,14940,20102011,0,60,1,4,-3,4.34038462206081,5.63217784295921,-1.2917932208984,31,43,-12,47,56,-9,63,73,-10,5,5,0,0
"4798","CGY","MIN",2010020351,14942,20102011,1,60,3,0,3,4.89403022512325,5.17860772545868,-0.28457750033543,31,32,-1,47,43,4,57,51,6,3,3,0,0
"4799","CGY","VAN",2010020363,14944,20102011,1,60,2,7,-5,3.32884148253945,4.07101731299184,-0.742175830452395,20,36,-16,31,52,-21,43,59,-16,4,8,0,0
"4800","CGY","MIN",2010020376,14946,20102011,0,65,2,2,0,4.81914272414906,2.39929233116709,2.41985039298197,32,22,10,44,31,13,50,46,4,4,4,0,0
"4801","CGY","CHI",2010020393,14948,20102011,0,60,2,4,-2,4.57269675452096,3.56298930566118,1.00970744885979,26,32,-6,37,48,-11,50,61,-11,8,9,0,0
"4802","CGY","T.B",2010020404,14950,20102011,1,60,4,2,2,2.73691951433728,2.92481042845712,-0.187890914119843,19,24,-5,31,41,-10,40,54,-14,4,2,0,0
"4803","CGY","L.A",2010020418,14952,20102011,0,60,1,2,-1,3.81814868122675,8.01519055698412,-4.19704187575738,27,32,-5,38,53,-15,46,70,-24,3,6,0,0
"4804","CGY","ANA",2010020424,14953,20102011,0,65,2,2,0,7.00384960963856,5.323861280858,1.67998832878056,39,25,14,57,39,18,67,51,16,6,5,0,0
"4805","CGY","TOR",2010020467,14959,20102011,1,60,5,2,3,4.59948633913882,5.50175139028579,-0.902265051146969,33,19,14,50,32,18,70,53,17,5,2,0,0
"4806","CGY","MIN",2010020482,14961,20102011,1,60,1,3,-2,5.32018341867729,2.73779872519663,2.58238469348066,29,16,13,43,26,17,62,42,20,1,2,0,0
"4807","CGY","MIN",2010020494,14963,20102011,0,60,1,4,-3,4.91466010318254,3.06478116557992,1.84987893760263,35,23,12,47,30,17,56,38,18,4,3,0,0
"4808","CGY","DAL",2010020515,14966,20102011,0,65,2,2,0,3.44236692640698,3.99365121712123,-0.55128429071425,33,16,17,43,29,14,55,44,11,4,3,0,0
"4809","CGY","COL",2010020565,14974,20102011,1,60,3,2,1,3.80470340969623,3.10468074463523,0.700022665061006,23,21,2,36,26,10,47,41,6,4,2,0,0
"4810","CGY","EDM",2010020572,14975,20102011,0,60,2,1,1,5.13763617064978,3.25385407917202,1.88378209147777,30,17,13,48,23,25,76,46,30,4,2,0,0
"4811","CGY","NYI",2010020583,14977,20102011,1,60,2,5,-3,5.71692307498597,5.43853276276059,0.278390312225383,43,26,17,61,34,27,79,52,27,2,2,0,0
"4812","CGY","VAN",2010020595,14979,20102011,0,60,1,3,-2,5.77639488918066,4.3449420905672,1.43145279861346,44,21,23,51,24,27,67,34,33,3,2,0,0
"4813","CGY","DET",2010020609,14981,20102011,1,65,4,4,0,3.63096622258968,7.41942862484094,-3.78846240225126,39,27,12,58,37,21,66,53,13,5,6,0,0
"4814","CGY","CAR",2010020636,14985,20102011,0,65,5,5,0,5.41356695156628,5.23006155699841,0.183505394567874,32,30,2,50,45,5,67,61,6,3,6,0,0
"4815","CGY","OTT",2010020656,14988,20102011,0,60,3,2,1,3.73085131508014,5.33329052547924,-1.6024392103991,26,35,-9,34,44,-10,43,59,-16,7,7,0,0
"4816","CGY","TOR",2010020661,14989,20102011,0,65,1,1,0,3.54929571659886,3.86897476528065,-0.319679048681792,33,33,0,54,50,4,66,72,-6,3,3,0,0
"4817","CGY","MTL",2010020680,14991,20102011,0,61.1,4,5,-1,5.73450490786753,6.56271530786034,-0.828210399992816,28,29,-1,45,39,6,64,58,6,4,3,0,0
"4818","CGY","MIN",2010020695,14993,20102011,1,60,0,6,-6,4.61207259108119,4.01221062972763,0.599861961353554,37,24,13,53,30,23,71,36,35,2,2,0,0
"4819","CGY","DAL",2010020711,14995,20102011,1,60,7,4,3,4.93129055102378,4.59488765889546,0.336402892128319,19,21,-2,29,35,-6,41,41,0,3,3,0,0
"4820","CGY","VAN",2010020721,14996,20102011,0,65,3,3,0,4.20507680321546,6.69100839726161,-2.48593159404616,33,44,-11,39,58,-19,56,77,-21,6,5,0,0
"4821","CGY","NSH",2010020730,14998,20102011,1,60,3,1,2,4.30323771201074,4.42924804541981,-0.12601033340907,27,24,3,42,33,9,57,45,12,6,5,0,0
"4822","CGY","STL",2010020748,15000,20102011,1,60,4,1,3,4.70672447513789,6.07740196052356,-1.37067748538567,21,29,-8,33,43,-10,44,60,-16,3,2,0,0
"4823","CGY","NSH",2010020760,15006,20102011,0,65,2,2,0,5.9646173218498,4.00668624997832,1.95793107187149,28,27,1,36,39,-3,47,55,-8,5,4,0,0
"4824","CGY","ATL",2010020774,15008,20102011,0,60,4,2,2,4.87478972971439,3.85744426083905,1.01734546887535,24,24,0,36,36,0,53,56,-3,2,2,0,0
"4825","CGY","L.A",2010020792,15010,20102011,1,65,3,3,0,3.22228882473428,5.41369499213761,-2.19140616740333,35,33,2,42,44,-2,58,62,-4,4,4,0,0
"4826","CGY","CHI",2010020799,15012,20102011,1,60,3,1,2,3.74839135897128,5.61461482020147,-1.8662234612302,28,23,5,36,42,-6,56,62,-6,4,4,0,0
"4827","CGY","OTT",2010020813,15014,20102011,1,60,5,2,3,6.8464010124444,4.03464529720077,2.81175571524363,35,26,9,49,38,11,71,50,21,6,4,0,0
"4828","CGY","ANA",2010020828,15016,20102011,1,64.6833333333333,4,5,-1,0,0,0,25,30,-5,44,37,7,70,52,18,4,1,0,0
"4829","CGY","VAN",2010020836,15017,20102011,0,60,2,4,-2,2.31877229473321,5.73532975477985,-3.41655746004665,26,33,-7,33,36,-3,43,53,-10,3,3,0,0
"4830","CGY","COL",2010020846,15019,20102011,0,60,9,1,8,3.92617342370468,2.89949169888702,1.02668172481766,33,23,10,48,30,18,55,42,13,3,3,0,0
"4831","CGY","DAL",2010020861,15021,20102011,1,60,4,2,2,3.55621000609244,4.18532634659277,-0.629116340500332,31,24,7,44,42,2,60,60,0,3,2,0,0
"4832","CGY","MTL",2010020890,15025,20102011,1,60,4,0,4,7.36606220110224,7.92771795105485,-0.56165574995261,37,39,-2,50,51,-1,63,68,-5,4,1,0,0
"4833","CGY","BOS",2010020906,15027,20102011,1,60,1,3,-2,6.29243991731737,5.93111479151412,0.361325125803253,29,29,0,47,40,7,67,56,11,2,1,0,0
"4834","CGY","S.J",2010020921,15030,20102011,1,65,3,3,0,3.87734069075533,7.06104178579762,-3.18370109504229,24,33,-9,35,49,-14,52,63,-11,3,2,0,0
"4835","CGY","STL",2010020937,15032,20102011,1,60,1,0,1,2.25638400134631,9.06146509082464,-6.80508108947834,20,27,-7,31,39,-8,55,51,4,3,3,0,0
"4836","CGY","STL",2010020947,15034,20102011,0,60,6,0,6,4.3277362419467,4.34929956806409,-0.0215633261173949,29,25,4,33,43,-10,41,67,-26,4,2,0,0
"4837","CGY","CHI",2010020955,15035,20102011,0,60,4,6,-2,3.77975288718881,2.99646195324021,0.783290933948592,25,30,-5,31,35,-4,38,46,-8,3,4,0,0
"4838","CGY","NSH",2010020987,15039,20102011,1,60,3,2,1,5.89425776485587,3.09448985027848,2.79976791457739,36,23,13,46,31,15,53,52,1,3,3,0,0
"4839","CGY","DAL",2010021006,15042,20102011,0,65,3,3,0,6.13329681174332,5.34053438669753,0.792762425045794,34,34,0,46,48,-2,57,63,-6,1,3,0,0
"4840","CGY","VAN",2010021031,15045,20102011,1,60,3,4,-1,5.60510001934017,3.23806382089808,2.36703619844209,23,32,-9,34,40,-6,50,62,-12,2,2,0,0
"4841","CGY","COL",2010021062,15050,20102011,1,60,5,2,3,4.08196735950378,3.16907121145618,0.912896148047594,28,29,-1,38,38,0,56,52,4,5,6,0,0
"4842","CGY","ANA",2010021085,15053,20102011,0,62.6333333333333,4,5,-1,5.03186944723711,4.24327261147499,0.788596835762121,41,33,8,56,44,12,76,51,25,4,4,0,0
"4843","CGY","L.A",2010021087,15054,20102011,0,65,1,1,0,5.08431576429211,4.24458325409796,0.839732510194153,28,27,1,46,44,2,58,61,-3,7,5,0,0
"4844","CGY","S.J",2010021101,15056,20102011,0,60,3,6,-3,5.58774624473881,4.48839483284974,1.09935141188907,25,38,-13,35,49,-14,51,67,-16,1,2,0,0
"4845","CGY","EDM",2010021127,15059,20102011,0,65,4,4,0,2.62309497974275,4.12537829391658,-1.50228331417384,31,21,10,42,29,13,58,44,14,4,2,0,0
"4846","CGY","ANA",2010021149,15063,20102011,1,60,2,4,-2,2.79274338964622,4.19425838180847,-1.40151499216225,25,22,3,42,26,16,71,35,36,7,6,0,0
"4847","CGY","STL",2010021162,15065,20102011,0,60,3,2,1,4.59224560336635,2.21819411580162,2.37405148756472,25,27,-2,37,41,-4,44,54,-10,7,5,0,0
"4848","CGY","COL",2010021180,15067,20102011,0,60,2,1,1,3.56385279691312,3.53059744497295,0.0332553519401699,36,35,1,46,47,-1,56,61,-5,1,3,0,0
"4849","CGY","EDM",2010021198,15070,20102011,1,60,6,1,5,6.3317788798912,4.18184909457341,2.14992978531779,47,23,24,62,29,33,80,40,40,7,4,0,0
"4850","CGY","VAN",2010021223,15073,20102011,1,62.6833333333333,2,3,-1,3.82947541028261,7.14309355754864,-3.31361814726603,36,39,-3,46,57,-11,57,78,-21,10,6,0,0
"4851","CGY","PIT",2011020019,15255,20112012,1,60,3,5,-2,2.89572308208958,4.60073177330196,-1.70500869121238,20,37,-17,31,54,-23,47,75,-28,7,9,0,0
"4852","CGY","STL",2011020028,15257,20112012,0,60,2,5,-3,2.23458415525965,4.36869343782956,-2.13410928256991,17,35,-18,26,40,-14,44,56,-12,4,5,0,0
"4853","CGY","MTL",2011020040,15260,20112012,0,60,4,1,3,2.10109337756148,5.59079994716693,-3.48970656960544,21,36,-15,28,45,-17,46,69,-23,4,4,0,0
"4854","CGY","TOR",2011020049,15262,20112012,0,60,2,3,-1,2.5532397224066,2.75401636391316,-0.200776641506561,32,25,7,45,37,8,65,60,5,4,4,0,0
"4855","CGY","EDM",2011020075,15265,20112012,1,60,2,1,1,3.76063422725415,3.97366776975105,-0.213033542496895,28,25,3,43,37,6,51,44,7,3,6,0,0
"4856","CGY","NYR",2011020087,15267,20112012,1,64.9666666666667,2,3,-1,6.87145631219028,5.7929527662161,1.07850354597418,35,29,6,49,36,13,65,45,20,6,3,0,0
"4857","CGY","NSH",2011020095,15269,20112012,1,60,0,2,-2,5.63177782432467,3.84144701319747,1.79033081112721,33,14,19,50,26,24,69,36,33,4,3,0,0
"4858","CGY","COL",2011020123,15273,20112012,1,60,4,2,2,0,0,0,35,36,-1,44,51,-7,51,66,-15,3,2,0,0
"4859","CGY","STL",2011020139,15275,20112012,1,60,3,1,2,4.7057018629053,5.47383531482774,-0.768133451922438,18,29,-11,27,45,-18,41,61,-20,3,3,0,0
"4860","CGY","VAN",2011020164,15279,20112012,1,60,1,5,-4,3.06279869583942,2.19916678237496,0.863631913464459,29,21,8,44,33,11,53,44,9,5,6,0,0
"4861","CGY","DET",2011020173,15281,20112012,0,60,4,1,3,2.58000202197582,4.12740819186001,-1.5474061698842,22,29,-7,32,36,-4,42,56,-14,4,3,0,0
"4862","CGY","COL",2011020199,15284,20112012,0,60,2,1,1,5.6969880592078,9.73325347715581,-4.03626541794802,23,33,-10,29,52,-23,44,79,-35,1,2,0,0
"4863","CGY","MIN",2011020209,15286,20112012,1,60,0,3,-3,5.10879008127877,6.89272274418738,-1.78393266290861,41,26,15,55,33,22,82,40,42,6,2,0,0
"4864","CGY","CHI",2011020227,15289,20112012,0,60,1,4,-3,4.06885739068425,4.20500630304014,-0.136148912355889,25,31,-6,36,46,-10,49,62,-13,1,4,0,0
"4865","CGY","COL",2011020237,15290,20112012,0,60,4,3,1,3.49458799768854,3.5179150231137,-0.0233270254251607,20,39,-19,23,45,-22,32,59,-27,3,5,0,0
"4866","CGY","OTT",2011020255,15293,20112012,1,60,1,3,-2,3.36994311459932,4.3536831696245,-0.98374005502518,39,32,7,47,51,-4,61,62,-1,6,4,0,0
"4867","CGY","CHI",2011020273,15296,20112012,1,60,5,2,3,4.75542788894381,4.94417660869536,-0.188748719751551,26,32,-6,36,41,-5,46,58,-12,4,6,0,0
"4868","CGY","DET",2011020306,15301,20112012,0,60,3,5,-2,4.29678633585741,5.7113968724244,-1.41461053656699,22,30,-8,29,44,-15,37,55,-18,5,5,0,0
"4869","CGY","STL",2011020323,15303,20112012,0,60,0,2,-2,2.65860081179881,4.51411264516202,-1.85551183336321,24,24,0,36,43,-7,53,60,-7,4,1,0,0
"4870","CGY","MIN",2011020339,15305,20112012,0,60,5,2,3,7.22557722969214,4.49158075632295,2.73399647336919,35,21,14,46,38,8,53,47,6,4,6,0,0
"4871","CGY","NSH",2011020351,15307,20112012,1,60,1,0,1,1.86147861368954,2.70693107723491,-0.845452463545371,29,26,3,37,39,-2,53,51,2,2,3,0,0
"4872","CGY","EDM",2011020382,15311,20112012,0,60,5,3,2,4.28612902804161,2.63813437319845,1.64799465484316,32,29,3,39,41,-2,51,56,-5,3,6,0,0
"4873","CGY","VAN",2011020386,15312,20112012,0,60,1,5,-4,2.64962364407256,4.69792384564187,-2.0483002015693,22,36,-14,25,53,-28,34,65,-31,5,7,0,0
"4874","CGY","CAR",2011020398,15314,20112012,1,60,7,6,1,7.52693364906008,4.55347758164862,2.97345606741146,35,34,1,47,47,0,64,63,1,2,4,0,0
"4875","CGY","COL",2011020414,15316,20112012,1,60,3,2,1,4.86303039187624,5.06396986947584,-0.200939477599604,35,18,17,41,28,13,55,33,22,6,2,0,0
"4876","CGY","EDM",2011020431,15318,20112012,1,60,3,0,3,4.61864467492842,3.75755772116671,0.861086953761713,34,21,13,44,30,14,57,37,20,7,3,0,0
"4877","CGY","NSH",2011020445,15321,20112012,0,60,1,2,-1,5.83466259785928,5.25237490822474,0.582287689634541,36,45,-9,46,51,-5,60,63,-3,1,3,0,0
"4878","CGY","T.B",2011020455,15323,20112012,0,60.5,4,5,-1,3.12352532821961,4.14975108962972,-1.0262257614101,27,34,-7,45,41,4,63,50,13,4,2,0,0
"4879","CGY","FLA",2011020464,15324,20112012,0,65,2,2,0,2.63873295110579,5.35990018122902,-2.72116723012323,26,41,-15,34,57,-23,48,69,-21,5,6,0,0
"4880","CGY","CHI",2011020479,15326,20112012,0,60,2,4,-2,3.34974474416231,4.66103235300712,-1.31128760884482,24,25,-1,36,37,-1,47,49,-2,7,6,0,0
"4881","CGY","MIN",2011020493,15328,20112012,1,60,2,1,1,3.86588583169214,4.94590335366365,-1.08001752197151,30,30,0,37,39,-2,54,47,7,2,3,0,0
"4882","CGY","DET",2011020505,15330,20112012,1,60,3,2,1,4.45822009840049,3.83678404046441,0.62143605793608,27,31,-4,36,38,-2,47,56,-9,3,2,0,0
"4883","CGY","VAN",2011020517,15331,20112012,0,60,3,1,2,5.6206202080939,5.10541490878677,0.515205299307127,31,30,1,35,38,-3,45,55,-10,1,2,0,0
"4884","CGY","CBJ",2011020530,15335,20112012,0,65,1,1,0,2.936490990833,5.70264692780944,-2.76615593697644,26,28,-2,31,41,-10,38,52,-14,3,5,0,0
"4885","CGY","NYI",2011020542,15337,20112012,0,60,1,3,-2,4.61260691017378,9.29661697199145,-4.68401006181767,30,34,-4,40,52,-12,59,69,-10,3,2,0,0
"4886","CGY","OTT",2011020552,15338,20112012,0,63.5166666666667,3,4,-1,4.2228944100134,10.998962102772,-6.7760676927586,32,49,-17,34,73,-39,47,93,-46,4,4,0,0
"4887","CGY","NSH",2011020568,15340,20112012,0,60,3,5,-2,3.46216831612401,4.68374746956397,-1.22157915343996,20,27,-7,30,34,-4,41,43,-2,2,3,0,0
"4888","CGY","BOS",2011020584,15344,20112012,0,60,0,9,-9,3.05434665107168,5.1999507463297,-2.14560409525802,25,42,-17,34,46,-12,48,54,-6,2,2,0,0
"4889","CGY","MIN",2011020609,15346,20112012,1,60,3,1,2,5.29837270698222,4.52062765819574,0.777745048786485,36,28,8,48,47,1,60,61,-1,3,3,0,0
"4890","CGY","N.J",2011020627,15349,20112012,1,60,6,3,3,1.93588784720632,8.04564661826214,-6.10975877105582,14,38,-24,17,54,-37,26,67,-41,5,4,0,0
"4891","CGY","ANA",2011020640,15351,20112012,1,61.85,1,0,1,1.38733415160095,3.77333326026564,-2.38599910866469,19,23,-4,31,33,-2,39,45,-6,2,1,0,0
"4892","CGY","L.A",2011020657,15353,20112012,1,60,1,4,-3,4.78598779303138,5.866013644958,-1.08002585192662,30,24,6,41,33,8,51,48,3,3,4,0,0
"4893","CGY","S.J",2011020680,15356,20112012,0,65,1,1,0,6.15219477505889,3.96392734169785,2.18826743336103,28,31,-3,42,49,-7,68,69,-1,1,3,0,0
"4894","CGY","L.A",2011020693,15358,20112012,0,65,1,1,0,6.00381861126516,5.81044537739217,0.19337323387299,25,32,-7,36,51,-15,47,64,-17,3,2,0,0
"4895","CGY","EDM",2011020711,15360,20112012,0,60,6,2,4,4.32868181167578,2.02898901858134,2.29969279309444,23,23,0,31,31,0,49,50,-1,5,2,0,0
"4896","CGY","S.J",2011020732,15363,20112012,1,60,0,1,-1,2.65914128993791,4.54029856645502,-1.88115727651711,25,27,-2,35,41,-6,57,48,9,2,3,0,0
"4897","CGY","DET",2011020744,15370,20112012,1,60,1,3,-2,5.82867421132671,4.31341166315415,1.51526254817256,29,25,4,43,32,11,59,50,9,4,5,0,0
"4898","CGY","CHI",2011020765,15373,20112012,1,60,3,1,2,5.47959191849804,2.4756263284944,3.00396559000365,32,27,5,42,32,10,56,42,14,4,2,0,0
"4899","CGY","ANA",2011020785,15376,20112012,0,65,2,2,0,4.30921659697538,3.96425988259448,0.344956714380892,26,33,-7,38,48,-10,52,71,-19,3,6,0,0
"4900","CGY","S.J",2011020800,15378,20112012,0,60,4,3,1,4.84954839481452,5.35412206896581,-0.504573674151288,36,37,-1,50,58,-8,61,71,-10,4,2,0,0
"4901","CGY","VAN",2011020826,15381,20112012,1,65,2,2,0,0.922450753998419,4.81461788569629,-3.89216713169787,18,31,-13,27,50,-23,36,69,-33,6,4,0,0
"4902","CGY","TOR",2011020845,15384,20112012,1,60,5,1,4,4.46089912323805,5.16960818789455,-0.708709064656503,34,42,-8,44,56,-12,49,71,-22,3,3,0,0
"4903","CGY","DAL",2011020856,15386,20112012,0,62.0166666666667,2,3,-1,3.35993614025756,5.25060681845401,-1.89067067819645,27,32,-5,35,49,-14,48,70,-22,5,3,0,0
"4904","CGY","L.A",2011020872,15388,20112012,0,60,1,0,1,1.54344974120613,3.65530175564345,-2.11185201443732,18,28,-10,25,45,-20,35,62,-27,1,3,0,0
"4905","CGY","EDM",2011020894,15391,20112012,1,60,1,6,-5,3.03697162349363,2.91931147443952,0.117660149054111,22,42,-20,28,49,-21,37,64,-27,1,3,0,0
"4906","CGY","ARI",2011020906,15393,20112012,1,65,3,3,0,4.48402412490395,5.98143526652393,-1.49741114161998,24,29,-5,34,44,-10,42,58,-16,3,2,0,0
"4907","CGY","PHI",2011020924,15395,20112012,1,65,4,4,0,4.48420389214199,8.29549687680948,-3.81129298466749,21,45,-24,34,63,-29,54,82,-28,4,7,0,0
"4908","CGY","STL",2011020936,15397,20112012,1,60,1,3,-2,2.85412405570969,4.51370960002939,-1.6595855443197,21,24,-3,28,35,-7,43,43,0,4,4,0,0
"4909","CGY","ARI",2011020956,15400,20112012,0,60,4,2,2,4.53086004382021,4.82978417408003,-0.298924130259818,31,31,0,41,41,0,57,63,-6,3,6,0,0
"4910","CGY","ANA",2011020964,15401,20112012,0,60,2,3,-1,5.46817335218657,6.61715389971505,-1.14898054752848,29,38,-9,36,52,-16,51,65,-14,5,4,0,0
"4911","CGY","DAL",2011020978,15403,20112012,1,65,2,2,0,4.53369647826185,6.99615500433326,-2.46245852607142,38,40,-2,49,50,-1,59,62,-3,4,4,0,0
"4912","CGY","MTL",2011020993,15405,20112012,1,60,5,4,1,4.07101252263828,4.73684451275039,-0.66583199011211,34,28,6,42,37,5,52,51,1,3,3,0,0
"4913","CGY","WPG",2011021013,15408,20112012,1,60,5,3,2,4.52918042970123,7.5926052935574,-3.06342486385617,27,45,-18,39,67,-28,52,76,-24,4,3,0,0
"4914","CGY","MIN",2011021028,15410,20112012,0,60,4,3,1,4.82979476056062,4.08991048031021,0.739884280250408,25,27,-2,39,40,-1,50,58,-8,0,1,0,0
"4915","CGY","S.J",2011021044,15412,20112012,1,64.3333333333333,3,2,1,3.99778274311029,5.92325117585574,-1.92546843274545,22,31,-9,31,49,-18,39,67,-28,3,4,0,0
"4916","CGY","ARI",2011021058,15414,20112012,1,60,4,1,3,2.72676371062516,2.96020826915628,-0.233444558531119,19,28,-9,27,35,-8,35,54,-19,2,3,0,0
"4917","CGY","EDM",2011021063,15415,20112012,0,60,1,3,-2,2.23281996582227,1.85661822632125,0.376201739501028,19,25,-6,33,32,1,47,47,0,4,9,0,0
"4918","CGY","CBJ",2011021078,15417,20112012,1,65,1,1,0,3.29681423900183,1.55954396421657,1.73727027478526,31,18,13,56,26,30,84,38,46,5,3,0,0
"4919","CGY","COL",2011021095,15419,20112012,0,63.85,1,2,-1,1.86104970870656,3.2074479946736,-1.34639828596704,32,33,-1,41,40,1,57,56,1,3,0,0,0
"4920","CGY","MIN",2011021105,15421,20112012,0,65,2,2,0,7.04252315822714,6.40180652434356,0.640716633883585,29,30,-1,46,46,0,59,67,-8,5,6,0,0
"4921","CGY","DAL",2011021116,15423,20112012,0,60,1,4,-3,6.8723625500279,3.31634872424013,3.55601382578777,36,20,16,57,36,21,70,50,20,7,6,0,0
"4922","CGY","DAL",2011021137,15425,20112012,1,60,5,4,1,3.17430450096128,4.44460089795728,-1.27029639699599,35,39,-4,48,49,-1,66,59,7,8,6,0,0
"4923","CGY","L.A",2011021150,15427,20112012,1,60,0,3,-3,1.55115559324622,3.81545872716379,-2.26430313391756,19,30,-11,23,42,-19,44,55,-11,5,5,0,0
"4924","CGY","COL",2011021166,15429,20112012,1,60,1,4,-3,6.24650933886005,6.8752751062849,-0.628765767424852,39,25,14,55,44,11,85,55,30,4,0,0,0
"4925","CGY","VAN",2011021179,15430,20112012,0,63.9666666666667,2,3,-1,4.15563023671712,7.12849586092771,-2.9728656242106,33,34,-1,39,52,-13,50,74,-24,3,3,0,0
"4926","CGY","VAN",2011021212,15435,20112012,1,60,3,2,1,3.70189491365454,5.63085957811927,-1.92896466446473,28,34,-6,31,46,-15,40,57,-17,6,8,0,0
"4927","CGY","ANA",2011021221,15437,20112012,1,60,5,2,3,2.93269842089808,5.45092812849907,-2.51822970760099,23,25,-2,33,40,-7,47,49,-2,3,5,0,0
"4928","CGY","S.J",2012020016,15725,20122013,1,60,1,4,-3,3.15030155286618,3.7944311046158,-0.644129551749617,32,29,3,46,37,9,58,52,6,3,6,0,0
"4929","CGY","ANA",2012020026,15726,20122013,1,60,4,5,-1,3.38918119031587,5.25751840826706,-1.86833721795119,25,24,1,41,33,8,58,44,14,3,2,0,0
"4930","CGY","VAN",2012020038,15728,20122013,0,65,2,2,0,6.10564248417359,4.84008692900534,1.26555555516825,36,36,0,46,52,-6,61,69,-8,5,4,0,0
"4931","CGY","EDM",2012020063,15731,20122013,1,60,4,3,1,5.05700760887703,2.92493166934582,2.13207593953121,35,20,15,45,31,14,55,38,17,7,5,0,0
"4932","CGY","COL",2012020098,15736,20122013,1,60,3,6,-3,3.08203699917067,3.18159272555931,-0.099555726388644,28,22,6,45,32,13,63,39,24,3,2,0,0
"4933","CGY","CHI",2012020116,15738,20122013,1,65,2,2,0,4.87913717021002,4.5458281128092,0.333309057400811,47,19,28,61,30,31,87,46,41,5,1,0,0
"4934","CGY","DET",2012020134,15741,20122013,0,60,4,1,3,3.48726889188401,2.8945844352711,0.592684456612915,23,26,-3,30,41,-11,44,61,-17,6,4,0,0
"4935","CGY","CBJ",2012020146,15743,20122013,0,61.1166666666667,4,3,1,6.09499251220859,3.20043983160576,2.89455268060283,30,29,1,41,35,6,54,42,12,4,4,0,0
"4936","CGY","VAN",2012020165,15745,20122013,0,60,1,5,-4,4.27570787299555,5.53229743299744,-1.25658956000188,34,31,3,41,45,-4,50,59,-9,2,5,0,0
"4937","CGY","MIN",2012020177,15747,20122013,1,65,1,1,0,4.1333959197309,3.59849062905414,0.534905290676761,24,24,0,34,28,6,48,48,0,2,4,0,0
"4938","CGY","DAL",2012020190,15749,20122013,1,60,7,4,3,4.49160180689069,5.2566217663134,-0.765019959422716,23,34,-11,36,46,-10,42,60,-18,3,5,0,0
"4939","CGY","STL",2012020202,15751,20122013,1,60,2,5,-3,4.58113556322087,3.7402338096872,0.840901753533672,32,25,7,38,34,4,55,46,9,5,5,0,0
"4940","CGY","DAL",2012020215,15753,20122013,0,60,4,3,1,6.28470722906059,4.15389022878064,2.13081700027995,26,30,-4,42,43,-1,51,58,-7,5,3,0,0
"4941","CGY","ARI",2012020224,15754,20122013,0,60,0,4,-4,4.03654322322109,8.64871226490504,-4.61216904168396,30,37,-7,43,55,-12,54,73,-19,1,1,0,0
"4942","CGY","L.A",2012020236,15756,20122013,1,60,1,3,-2,3.00762056748499,2.70295696475659,0.304663602728397,27,33,-6,39,43,-4,49,61,-12,6,3,0,0
"4943","CGY","MIN",2012020261,15759,20122013,1,60,3,1,2,4.70906253147405,3.3267535741179,1.38230895735614,27,31,-4,36,38,-2,47,52,-5,2,2,0,0
"4944","CGY","ARI",2012020268,15760,20122013,1,60,5,4,1,4.32803009507984,4.99986833252478,-0.671838237444945,31,28,3,41,34,7,55,44,11,3,6,0,0
"4945","CGY","MIN",2012020281,15762,20122013,0,60.45,1,2,-1,2.579850859315,4.72366996797484,-2.14381910865984,21,30,-9,22,47,-25,29,65,-36,6,8,0,0
"4946","CGY","COL",2012020296,15764,20122013,0,60,4,5,-1,2.62011823481134,5.33255415471724,-2.7124359199059,23,36,-13,36,47,-11,56,63,-7,5,5,0,0
"4947","CGY","VAN",2012020319,15767,20122013,1,60,4,2,2,3.88711256948591,7.31154851730858,-3.42443594782267,25,31,-6,39,38,1,51,54,-3,4,2,0,0
"4948","CGY","S.J",2012020337,15770,20122013,1,60,4,1,3,4.11943174147746,4.96841810370927,-0.848986362231813,26,33,-7,39,48,-9,47,62,-15,3,4,0,0
"4949","CGY","ANA",2012020354,15772,20122013,0,60,0,4,-4,2.9764484486077,2.39068875687939,0.585759691728304,29,24,5,46,33,13,65,44,21,2,0,0,0
"4950","CGY","L.A",2012020364,15773,20122013,0,60,2,6,-4,2.64326206393889,6.05272403791605,-3.40946197397716,19,24,-5,31,39,-8,41,53,-12,4,1,0,0
"4951","CGY","L.A",2012020376,15775,20122013,0,60,1,3,-2,2.67679062479874,7.14433244569227,-4.46754182089353,24,22,2,39,33,6,54,41,13,4,1,0,0
"4952","CGY","DET",2012020390,15777,20122013,1,60,5,2,3,3.22914774466393,3.55438710372255,-0.325239359058614,22,38,-16,32,55,-23,38,73,-35,2,2,0,0
"4953","CGY","NSH",2012020403,15779,20122013,1,60,6,3,3,3.49547463061754,3.5630258298479,-0.0675511992303655,22,20,2,36,31,5,52,44,8,3,2,0,0
"4954","CGY","DAL",2012020424,15782,20122013,0,60,3,4,-1,4.47926200967049,2.77336906918208,1.70589294048841,19,24,-5,33,38,-5,53,52,1,5,5,0,0
"4955","CGY","NSH",2012020449,15785,20122013,0,60,3,5,-2,3.5640790415855,4.17504635191062,-0.610967310325123,22,23,-1,34,35,-1,54,49,5,4,4,0,0
"4956","CGY","CBJ",2012020453,15786,20122013,0,60,1,5,-4,3.32284137795068,5.14765385130886,-1.82481247335818,25,28,-3,34,38,-4,46,49,-3,2,4,0,0
"4957","CGY","STL",2012020470,15788,20122013,1,60,3,2,1,2.70152976398822,5.73120203282451,-3.02967226883629,17,38,-21,25,50,-25,39,70,-31,4,5,0,0
"4958","CGY","CHI",2012020486,15790,20122013,0,60,0,2,-2,1.69426399233635,2.49660892439915,-0.802344932062807,16,35,-19,24,42,-18,40,54,-14,4,4,0,0
"4959","CGY","COL",2012020490,15791,20122013,1,60,4,3,1,3.66409110341821,5.0165791651234,-1.35248806170519,27,30,-3,35,40,-5,47,59,-12,3,5,0,0
"4960","CGY","CBJ",2012020505,15793,20122013,1,60,4,6,-2,4.26674021120016,4.43356397928483,-0.166823768084669,33,25,8,43,36,7,63,47,16,4,1,0,0
"4961","CGY","EDM",2012020529,15796,20122013,0,60,1,4,-3,7.76175805965613,3.27968009813992,4.48207796151621,34,20,14,50,31,19,62,46,16,4,3,0,0
"4962","CGY","EDM",2012020540,15798,20122013,1,60,2,8,-6,5.91202073359741,4.17945940076709,1.73256133283032,21,39,-18,33,47,-14,44,60,-16,2,6,0,0
"4963","CGY","S.J",2012020558,15800,20122013,0,60,1,2,-1,3.62510242930148,4.48034136157398,-0.855238932272501,24,41,-17,32,57,-25,45,79,-34,2,3,0,0
"4964","CGY","VAN",2012020568,15801,20122013,0,60,2,5,-3,4.67079355198075,6.6871480854461,-2.01635453346535,38,22,16,47,28,19,62,37,25,5,2,0,0
"4965","CGY","COL",2012020579,15803,20122013,0,60,3,1,2,5.7391979561653,5.58770721386173,0.15149074230357,34,40,-6,43,49,-6,56,63,-7,7,5,0,0
"4966","CGY","VAN",2012020593,15805,20122013,1,60,1,4,-3,2.53090928709809,3.26781395825674,-0.736904671158653,41,29,12,53,43,10,65,61,4,5,5,0,0
"4967","CGY","ARI",2012020609,15807,20122013,1,64.6,3,2,1,4.4765714103064,5.83373529804851,-1.35716388774211,25,31,-6,36,50,-14,46,63,-17,1,2,0,0
"4968","CGY","EDM",2012020619,15808,20122013,0,60,4,1,3,4.33059547323501,4.25180040183477,0.0787950714002363,38,29,9,53,39,14,71,46,25,5,3,0,0
"4969","CGY","MIN",2012020630,15810,20122013,1,60,3,4,-1,2.67336268513463,3.1460257723229,-0.472663087188266,23,27,-4,29,38,-9,33,54,-21,2,1,0,0
"4970","CGY","DET",2012020642,15812,20122013,1,60,3,2,1,2.53628735022023,5.47499217167206,-2.93870482145182,17,38,-21,25,56,-31,33,70,-37,1,5,0,0
"4971","CGY","ANA",2012020659,15814,20122013,1,60,3,1,2,6.2780302550982,5.25144417727722,1.02658607782098,31,33,-2,38,47,-9,53,69,-16,4,3,0,0
"4972","CGY","MIN",2012020670,15816,20122013,0,60,4,1,3,3.54168573685456,6.18619077945186,-2.6445050425973,24,35,-11,32,49,-17,46,66,-20,3,3,0,0
"4973","CGY","NSH",2012020687,15818,20122013,0,60,3,4,-1,2.43128055028501,3.87877329144249,-1.44749274115748,18,32,-14,29,51,-22,35,69,-34,2,4,0,0
"4974","CGY","STL",2012020701,15820,20122013,0,60,1,4,-3,1.19787363906653,3.53024309198372,-2.33236945291719,19,20,-1,28,33,-5,43,46,-3,4,5,0,0
"4975","CGY","CHI",2012020706,15821,20122013,0,60,1,3,-2,1.5357231306516,7.00286331860116,-5.46714018794955,26,38,-12,30,54,-24,40,78,-38,0,2,0,0
"4976","CGY","CBJ",2013020018,15982,20132014,0,60,4,3,1,4.6017524773095,3.07561348042509,1.52613899688441,30,32,-2,43,40,3,51,63,-12,4,4,0,0
"4977","CGY","VAN",2013020034,15984,20132014,1,63.2833333333333,4,5,-1,4.39334553078515,6.21065941755421,-1.81731388676906,36,28,8,46,41,5,65,59,6,3,1,0,0
"4978","CGY","MTL",2013020046,15987,20132014,1,60,3,2,1,4.63440088473726,6.53893977947882,-1.90453889474156,25,35,-10,34,49,-15,50,63,-13,3,3,0,0
"4979","CGY","N.J",2013020063,15989,20132014,1,60,3,2,1,7.01517196395071,4.73649498153827,2.27867698241243,29,21,8,44,32,12,55,49,6,4,2,0,0
"4980","CGY","ANA",2013020095,15994,20132014,0,60,2,3,-1,4.62712859884778,2.0715149525435,2.55561364630428,35,22,13,45,31,14,57,47,10,4,1,0,0
"4981","CGY","S.J",2013020121,15997,20132014,0,60,3,6,-3,3.68696719130139,5.99067227735213,-2.30370508605074,19,36,-17,27,52,-25,48,75,-27,7,11,0,0
"4982","CGY","L.A",2013020128,15999,20132014,0,60,3,2,1,4.52101380609383,5.12709606949487,-0.606082263401039,25,29,-4,38,41,-3,47,58,-11,6,3,0,0
"4983","CGY","ARI",2013020136,16000,20132014,0,60,2,4,-2,3.98503680247018,7.95324803457015,-3.96821123209997,24,33,-9,39,45,-6,54,59,-5,3,3,0,0
"4984","CGY","DAL",2013020146,16002,20132014,0,60,1,5,-4,4.46056734999914,5.78971537978214,-1.329148029783,29,34,-5,41,58,-17,62,68,-6,2,4,0,0
"4985","CGY","TOR",2013020185,16008,20132014,1,60,2,4,-2,7.96073425232316,2.98376036096306,4.9769738913601,43,22,21,56,30,26,74,43,31,6,2,0,0
"4986","CGY","DET",2013020198,16010,20132014,1,60,3,4,-1,4.28365570434835,3.85340526981388,0.430250434534463,25,22,3,39,33,6,53,47,6,5,3,0,0
"4987","CGY","CHI",2013020213,16012,20132014,0,61.5333333333333,3,2,1,3.95925725742742,4.38367252156604,-0.424415264138624,30,44,-14,36,59,-23,43,85,-42,1,3,0,0
"4988","CGY","MIN",2013020223,16014,20132014,0,60,1,5,-4,3.28091747638345,4.52203222798518,-1.24111475160173,25,24,1,37,28,9,46,43,3,5,4,0,0
"4989","CGY","STL",2013020238,16016,20132014,0,60,2,3,-1,1.59010771627072,2.87768579048105,-1.28757807421033,20,27,-7,31,37,-6,49,47,2,7,4,0,0
"4990","CGY","COL",2013020243,16017,20132014,0,60,2,4,-2,5.61172131762305,5.58993009143533,0.0217912261877204,32,27,5,53,36,17,69,54,15,2,3,0,0
"4991","CGY","S.J",2013020273,16021,20132014,1,61.2166666666667,2,3,-1,3.4586591363186,5.09009154420346,-1.63143240788486,13,35,-22,18,50,-32,32,73,-41,2,2,0,0
"4992","CGY","DAL",2013020282,16023,20132014,1,60,3,7,-4,3.97175829477707,4.52611563458777,-0.554357339810696,28,32,-4,45,47,-2,59,66,-7,3,3,0,0
"4993","CGY","EDM",2013020302,16025,20132014,1,60,2,4,-2,0,0,0,35,24,11,48,32,16,62,40,22,3,2,0,0
"4994","CGY","WPG",2013020311,16027,20132014,0,65,4,4,0,5.65772418425769,5.06992676735354,0.587797416904152,33,47,-14,43,56,-13,57,92,-35,7,5,0,0
"4995","CGY","CBJ",2013020324,16029,20132014,1,62.4166666666667,1,2,-1,3.27581312065013,3.00228525027342,0.273527870376711,24,18,6,34,27,7,46,48,-2,0,3,0,0
"4996","CGY","FLA",2013020338,16031,20132014,1,65,3,3,0,0,0,0,24,26,-2,30,38,-8,40,64,-24,2,4,0,0
"4997","CGY","CHI",2013020376,16036,20132014,1,60,2,3,-1,3.24248168180929,5.06895163477748,-1.82646995296818,22,30,-8,28,46,-18,35,75,-40,1,2,0,0
"4998","CGY","ANA",2013020384,16038,20132014,0,60,2,5,-3,4.71889878285151,6.70360074924247,-1.98470196639096,21,42,-21,36,60,-24,46,73,-27,0,4,0,0
"4999","CGY","L.A",2013020401,16039,20132014,0,60,2,1,1,8.45769949466921,2.56502232548075,5.89267716918846,20,22,-2,35,37,-2,43,56,-13,7,4,0,0
"5000","CGY","ARI",2013020421,16043,20132014,1,60,4,1,3,4.01327876687398,2.39776017295662,1.61551859391736,18,30,-12,29,42,-13,42,63,-21,3,5,0,0
"5001","CGY","COL",2013020436,16045,20132014,1,60,2,3,-1,5.16521700814337,4.09079576935619,1.07442123878718,28,25,3,39,43,-4,54,62,-8,5,5,0,0
"5002","CGY","EDM",2013020447,16046,20132014,0,63.2333333333333,2,1,1,3.31425789848083,3.4820483601361,-0.167790461655272,27,31,-4,38,47,-9,46,71,-25,2,6,0,0
"5003","CGY","BOS",2013020467,16049,20132014,1,60,1,2,-1,3.04960646067047,6.21637959386499,-3.16677313319451,27,24,3,33,41,-8,44,59,-15,2,3,0,0
"5004","CGY","CAR",2013020480,16051,20132014,1,64.9333333333333,2,1,1,4.62057391594863,5.13342839902907,-0.512854483080446,30,30,0,38,47,-9,51,69,-18,2,4,0,0
"5005","CGY","NYR",2013020502,16054,20132014,0,65,3,3,0,3.54691272873409,3.87478616152657,-0.327873432792479,21,32,-11,30,47,-17,43,76,-33,5,5,0,0
"5006","CGY","BOS",2013020509,16056,20132014,0,60,0,2,-2,2.777115753619,4.45360047035683,-1.67648471673783,21,31,-10,30,44,-14,39,53,-14,3,2,0,0
"5007","CGY","DET",2013020528,16058,20132014,0,61.05,2,3,-1,1.64285891488797,6.11391913497937,-4.47106022009139,22,38,-16,25,52,-27,36,67,-31,5,4,0,0
"5008","CGY","STL",2013020563,16062,20132014,1,65,3,3,0,3.66699754608544,3.0640091194,0.602988426685442,29,35,-6,41,43,-2,61,56,5,5,4,0,0
"5009","CGY","EDM",2013020575,16066,20132014,1,60,0,2,-2,3.72540788524202,2.37962395769082,1.3457839275512,27,28,-1,36,32,4,50,42,8,2,4,0,0
"5010","CGY","VAN",2013020589,16068,20132014,1,60,0,2,-2,2.36430189193925,4.2206688002625,-1.85636690832325,18,30,-12,26,41,-15,41,52,-11,1,0,0,0
"5011","CGY","PHI",2013020608,16070,20132014,1,60,1,4,-3,2.02381949359551,2.59612442360958,-0.57230493001407,24,21,3,38,30,8,60,37,23,2,1,0,0
"5012","CGY","T.B",2013020624,16073,20132014,1,60,0,2,-2,3.4121468772646,3.29866455629417,0.113482320970434,19,29,-10,33,42,-9,54,55,-1,6,6,0,0
"5013","CGY","COL",2013020646,16076,20132014,0,60,4,3,1,5.53516048003803,1.94253060697946,3.59262987305857,19,25,-6,36,33,3,48,45,3,3,4,0,0
"5014","CGY","ARI",2013020652,16077,20132014,0,60,0,6,-6,4.12427658309753,5.28560060053132,-1.1613240174338,27,30,-3,46,41,5,61,60,1,2,3,0,0
"5015","CGY","STL",2013020665,16079,20132014,1,60,0,5,-5,3.16838136065568,4.20173167260948,-1.0333503119538,33,29,4,43,37,6,63,50,13,7,7,0,0
"5016","CGY","CAR",2013020692,16083,20132014,0,60,2,0,2,5.46668751898687,3.1107023145305,2.35598520445637,29,23,6,44,36,8,56,54,2,4,2,0,0
"5017","CGY","NSH",2013020704,16084,20132014,0,60,2,4,-2,1.85629617681224,4.18377635584329,-2.32748017903106,24,34,-10,36,45,-9,50,60,-10,3,5,0,0
"5018","CGY","WPG",2013020719,16086,20132014,1,60,2,5,-3,3.93087339214981,3.41493246910977,0.515940923040034,22,23,-1,34,30,4,45,45,0,3,5,0,0
"5019","CGY","VAN",2013020735,16088,20132014,0,65,2,2,0,4.07218620903456,1.88409087772015,2.1880953313144,33,33,0,45,43,2,60,59,1,9,8,0,0
"5020","CGY","S.J",2013020745,16090,20132014,0,60,2,3,-1,3.54845976491924,3.82507928406994,-0.276619519150699,23,27,-4,32,37,-5,55,58,-3,0,1,0,0
"5021","CGY","ARI",2013020758,16092,20132014,1,60,3,2,1,2.14780578552745,6.97480152657954,-4.82699574105209,26,32,-6,32,42,-10,40,66,-26,2,2,0,0
"5022","CGY","NSH",2013020773,16094,20132014,1,65,4,4,0,3.77977987704799,4.35507904531005,-0.575299168262063,31,25,6,41,40,1,56,50,6,5,2,0,0
"5023","CGY","CHI",2013020803,16098,20132014,1,62.4333333333333,5,4,1,4.78320995549439,6.25148358029219,-1.4682736247978,29,33,-4,37,46,-9,46,71,-25,2,1,0,0
"5024","CGY","S.J",2013020815,16100,20132014,1,60,4,1,3,4.67897872428875,3.33378210790397,1.34519661638478,30,28,2,40,39,1,52,52,0,2,1,0,0
"5025","CGY","MIN",2013020832,16102,20132014,1,62.4166666666667,4,3,1,4.48194174928358,2.4382857606106,2.04365598867298,32,23,9,43,34,9,51,44,7,5,5,0,0
"5026","CGY","MTL",2013020847,16105,20132014,0,60,0,2,-2,5.51410686489544,6.78920187731273,-1.2750950124173,27,27,0,40,42,-2,63,62,1,4,3,0,0
"5027","CGY","NYI",2013020856,16107,20132014,0,60,4,2,2,5.75101075528073,3.70771329079685,2.04329746448389,22,30,-8,33,43,-10,47,69,-22,2,5,0,0
"5028","CGY","PHI",2013020872,16109,20132014,0,60,1,2,-1,5.03640733164775,3.82158849887492,1.21481883277283,33,23,10,51,31,20,69,43,26,3,3,0,0
"5029","CGY","L.A",2013020896,16128,20132014,1,60,0,2,-2,4.09994927560911,1.74852946238406,2.35141981322505,25,24,1,39,31,8,55,40,15,6,3,0,0
"5030","CGY","EDM",2013020911,16130,20132014,0,61.8333333333333,2,1,1,2.82777584332507,3.41374232364682,-0.585966480321748,30,22,8,46,37,9,65,64,1,4,3,0,0
"5031","CGY","MIN",2013020922,16132,20132014,0,60,2,3,-1,1.96440141361381,4.18578592943959,-2.22138451582578,23,27,-4,29,38,-9,43,49,-6,1,2,0,0
"5032","CGY","OTT",2013020936,16134,20132014,1,60,4,1,3,3.89759080522163,4.49710029109022,-0.599509485868595,28,31,-3,39,43,-4,43,60,-17,9,7,0,0
"5033","CGY","NYI",2013020951,16136,20132014,1,60,4,3,1,3.1468062397625,4.77878580975812,-1.63197956999562,23,26,-3,39,36,3,51,49,2,4,7,0,0
"5034","CGY","VAN",2013020961,16137,20132014,0,60,1,2,-1,3.72020465449896,2.9909106136246,0.729294040874362,23,14,9,38,30,8,70,62,8,5,1,0,0
"5035","CGY","L.A",2013020973,16139,20132014,1,60,2,3,-1,1.91239090947056,2.49673932926089,-0.584348419790331,26,23,3,32,35,-3,49,51,-2,3,2,0,0
"5036","CGY","ANA",2013020988,16141,20132014,1,60,7,2,5,3.49481953496553,3.7472374765224,-0.25241794155687,25,22,3,33,30,3,48,45,3,4,2,0,0
"5037","CGY","DAL",2013021002,16143,20132014,0,65,3,3,0,6.88331886999367,4.71237941757136,2.17093945242232,30,25,5,53,39,14,74,51,23,2,1,0,0
"5038","CGY","ARI",2013021011,16144,20132014,0,60,2,3,-1,4.01352057591694,6.02628548099892,-2.01276490508198,31,26,5,37,45,-8,55,62,-7,6,10,0,0
"5039","CGY","NSH",2013021054,16150,20132014,1,60,5,6,-1,4.12348760220493,1.66529929969518,2.45818830250975,29,22,7,45,27,18,55,38,17,2,2,0,0
"5040","CGY","EDM",2013021064,16151,20132014,0,60,8,1,7,6.67202658602037,5.23861583703547,1.4334107489849,31,25,6,51,38,13,60,50,10,5,3,0,0
"5041","CGY","S.J",2013021078,16153,20132014,1,65,1,1,0,3.05213937813543,4.97633542163021,-1.92419604349478,27,34,-7,34,52,-18,48,69,-21,3,2,0,0
"5042","CGY","ANA",2013021091,16155,20132014,1,60,2,3,-1,6.54096590216795,5.2112444738159,1.32972142835206,34,34,0,47,45,2,66,65,1,2,3,0,0
"5043","CGY","NYR",2013021106,16157,20132014,1,60,4,3,1,3.2098183062626,9.73771571999532,-6.52789741373272,28,41,-13,37,55,-18,42,72,-30,2,1,0,0
"5044","CGY","OTT",2013021119,16159,20132014,0,60,3,6,-3,6.32148488190294,5.16790774854599,1.15357713335696,40,37,3,50,51,-1,62,68,-6,3,2,0,0
"5045","CGY","TOR",2013021130,16161,20132014,0,60,2,3,-1,7.14983346757072,4.79968034284502,2.35015312472569,24,23,1,48,37,11,60,53,7,3,1,0,0
"5046","CGY","T.B",2013021147,16163,20132014,0,60,4,1,3,4.2365262049625,3.21400890873338,1.02251729622913,25,32,-7,32,45,-13,42,69,-27,2,3,0,0
"5047","CGY","FLA",2013021156,16164,20132014,0,60,2,1,1,3.26066738646477,3.04970289106541,0.210964495399367,17,35,-18,25,43,-18,35,63,-28,4,2,0,0
"5048","CGY","N.J",2013021177,16167,20132014,0,60,1,0,1,3.62542443719576,3.29994830036355,0.325476136832208,22,31,-9,30,39,-9,35,52,-17,4,3,0,0
"5049","CGY","L.A",2013021192,16169,20132014,1,65,3,3,0,1.87767992920999,7.69694418311701,-5.81926425390702,18,44,-26,28,57,-29,42,79,-37,0,0,0,0
"5050","CGY","WPG",2013021210,16171,20132014,1,60,3,5,-2,6.07263708361279,6.05931663175579,0.0133204518569983,38,27,11,52,37,15,73,54,19,5,2,0,0
"5051","CGY","VAN",2013021228,16173,20132014,0,60,1,5,-4,3.10968828038676,4.98610268902848,-1.87641440864172,22,23,-1,32,37,-5,45,60,-15,2,2,0,0
"5052","CGY","VAN",2014020003,16351,20142015,1,60,2,4,-2,3.97172047084314,2.86133842723318,1.11038204360996,25,33,-8,32,39,-7,45,50,-5,6,5,0,0
"5053","CGY","EDM",2014020015,16352,20142015,0,60,5,2,3,4.89510364207948,5.46300508716376,-0.567901445084289,26,40,-14,33,57,-24,39,75,-36,2,3,0,0
"5054","CGY","STL",2014020026,16354,20142015,0,60,1,4,-3,1.96807822701521,5.75695589129464,-3.78887766427943,24,39,-15,32,53,-21,47,68,-21,8,7,0,0
"5055","CGY","NSH",2014020045,16357,20142015,0,65,2,2,0,4.73384661038195,2.50556885735671,2.22827775302524,28,21,7,39,32,7,61,46,15,4,3,0,0
"5056","CGY","CHI",2014020048,16358,20142015,0,64.5833333333333,2,1,1,1.69774435449668,5.93608418163058,-4.2383398271339,18,50,-32,22,66,-44,33,96,-63,1,7,0,0
"5057","CGY","CBJ",2014020058,16360,20142015,0,60,2,3,-1,1.72911787360495,4.34383295178884,-2.61471507818389,31,26,5,38,36,2,54,51,3,4,5,0,0
"5058","CGY","WPG",2014020076,16362,20142015,0,60,4,1,3,3.72869079071097,5.71202648872273,-1.98333569801176,29,35,-6,39,48,-9,48,70,-22,4,3,0,0
"5059","CGY","T.B",2014020088,16364,20142015,1,63,1,2,-1,3.01686541029267,2.72208417328709,0.29478123700558,22,22,0,34,31,3,42,49,-7,2,0,0,0
"5060","CGY","CAR",2014020098,16366,20142015,1,60,5,0,5,2.75735544918408,1.82672380085569,0.930631648328394,24,16,8,35,22,13,47,38,9,2,2,0,0
"5061","CGY","MTL",2014020134,16371,20142015,1,65,1,1,0,4.7751699401415,4.75816797143489,0.0170019687066087,38,19,19,54,30,24,70,47,23,9,5,0,0
"5062","CGY","NSH",2014020151,16374,20142015,1,60,4,3,1,4.43383957665355,6.20260783786944,-1.76876826121588,30,31,-1,38,54,-16,51,90,-39,2,1,0,0
"5063","CGY","MTL",2014020166,16376,20142015,0,60,6,2,4,0,0,0,36,20,16,47,31,16,65,57,8,8,3,0,0
"5064","CGY","T.B",2014020190,16380,20142015,0,60,2,5,-3,3.86588207399473,4.03518955696808,-0.169307482973354,31,33,-2,40,48,-8,59,60,-1,6,3,0,0
"5065","CGY","FLA",2014020202,16382,20142015,0,60,6,4,2,4.16005847411543,2.63185558665566,1.52820288745977,25,31,-6,33,47,-14,40,62,-22,3,3,0,0
"5066","CGY","CAR",2014020219,16384,20142015,0,60,1,4,-3,5.44684434699593,6.81467698866618,-1.36783264167025,23,31,-8,42,47,-5,55,65,-10,1,3,0,0
"5067","CGY","ARI",2014020239,16387,20142015,1,60,5,3,2,3.34903653993295,4.94678854646918,-1.59775200653623,25,23,2,42,34,8,61,52,9,4,2,0,0
"5068","CGY","OTT",2014020259,16389,20142015,1,60,4,2,2,2.65384165629803,2.18293503684981,0.470906619448215,25,25,0,35,36,-1,45,51,-6,2,6,0,0
"5069","CGY","ANA",2014020275,16392,20142015,1,65,3,3,0,2.34975225524977,2.87979341451239,-0.530041159262623,19,27,-8,31,40,-9,48,62,-14,5,3,0,0
"5070","CGY","CHI",2014020287,16394,20142015,1,60,3,4,-1,3.57916895166775,1.36230515528587,2.21686379638189,27,22,5,36,30,6,56,44,12,6,2,0,0
"5071","CGY","N.J",2014020305,16396,20142015,1,65,4,4,0,3.58298082283,3.71048152336152,-0.127500700531527,37,29,8,49,40,9,60,58,2,7,3,0,0
"5072","CGY","ANA",2014020322,16399,20142015,0,60,2,3,-1,5.9886053133705,2.81572670893308,3.17287860443741,34,29,5,45,41,4,60,49,11,6,2,0,0
"5073","CGY","ARI",2014020353,16403,20142015,0,60,3,0,3,4.54784131608176,2.14286386762069,2.40497744846107,29,26,3,36,37,-1,52,63,-11,2,1,0,0
"5074","CGY","ARI",2014020369,16406,20142015,1,60,5,2,3,2.7895026326878,6.00061619649442,-3.21111356380662,24,29,-5,35,41,-6,46,67,-21,3,1,0,0
"5075","CGY","COL",2014020384,16408,20142015,1,61.7833333333333,4,3,1,3.33419711783063,4.09185481653549,-0.757657698704861,25,29,-4,40,35,5,55,52,3,3,1,0,0
"5076","CGY","TOR",2014020412,16413,20142015,0,60,1,4,-3,3.68113028091022,6.50272551072439,-2.82159522981417,33,29,4,48,40,8,77,51,26,3,2,0,0
"5077","CGY","CHI",2014020449,16418,20142015,0,60,1,2,-1,3.14553080574842,5.31711590778991,-2.17158510204149,24,28,-4,36,52,-16,44,78,-34,3,2,0,0
"5078","CGY","NYR",2014020462,16420,20142015,1,60,2,5,-3,3.7021092659233,4.1228045168682,-0.420695250944902,31,23,8,38,30,8,64,38,26,4,3,0,0
"5079","CGY","DAL",2014020478,16423,20142015,1,60,1,2,-1,4.26689557665389,4.60438204884122,-0.337486472187324,22,21,1,33,34,-1,44,58,-14,5,2,0,0
"5080","CGY","EDM",2014020525,16431,20142015,1,60,4,1,3,5.46693221776218,5.00938283792548,0.457549379836699,27,27,0,33,46,-13,53,63,-10,5,7,0,0
"5081","CGY","EDM",2014020555,16435,20142015,1,61.1333333333333,4,3,1,3.623111632769,4.99606897363958,-1.37295734087058,28,20,8,43,32,11,63,50,13,5,4,0,0
"5082","CGY","NYI",2014020564,16437,20142015,1,60,1,2,-1,0,0,0,23,24,-1,28,38,-10,45,61,-16,3,2,0,0
"5083","CGY","ARI",2014020652,16450,20142015,0,60,4,1,3,4.3068027299305,2.51475944026606,1.79204328966443,25,28,-3,39,43,-4,51,57,-6,2,0,0,0
"5084","CGY","ANA",2014020695,16456,20142015,0,60,3,6,-3,5.18504192610271,5.14725849184299,0.0377834342597225,33,27,6,44,37,7,62,52,10,3,2,0,0
"5085","CGY","MIN",2014020719,16464,20142015,1,60,0,1,-1,5.26836159308004,3.97649896463918,1.29186262844087,30,32,-2,43,42,1,62,57,5,1,1,0,0
"5086","CGY","EDM",2014020736,16466,20142015,1,60,4,2,2,3.8112380028615,1.91708712137915,1.89415088148235,33,19,14,50,29,21,72,48,24,4,1,0,0
"5087","CGY","WPG",2014020743,16468,20142015,1,60,5,2,3,8.85236926395055,2.84319498916094,6.00917427478961,28,19,9,43,41,2,52,63,-11,4,3,0,0
"5088","CGY","MIN",2014020855,16484,20142015,1,61.8333333333333,2,3,-1,4.20638320555491,5.21511486988979,-1.00873166433487,37,29,8,52,38,14,73,58,15,3,1,0,0
"5089","CGY","ANA",2014020871,16486,20142015,1,60,3,6,-3,3.83746000698011,6.62783815804869,-2.79037815106858,28,38,-10,39,46,-7,63,64,-1,5,1,0,0
"5090","CGY","NYR",2014020896,16490,20142015,0,60,0,1,-1,2.35237906177645,3.08955592455459,-0.737176862778142,21,29,-8,30,41,-11,40,61,-21,0,2,0,0
"5091","CGY","N.J",2014020905,16491,20142015,0,60,3,1,2,5.95717915872228,2.34427851824148,3.6129006404808,26,27,-1,37,34,3,47,44,3,2,3,0,0
"5092","CGY","NYI",2014020918,16493,20142015,0,60,1,2,-1,4.18286895526398,6.89608729961401,-2.71321834435003,27,39,-12,39,47,-8,57,65,-8,4,4,0,0
"5093","CGY","PHI",2014020943,16497,20142015,0,61.3833333333333,3,2,1,4.5431816301425,6.26273600982802,-1.71955437968552,26,37,-11,41,53,-12,53,86,-33,2,2,0,0
"5094","CGY","OTT",2014020983,16502,20142015,0,65,4,4,0,7.69406206971739,9.11689711332275,-1.42283504360536,46,42,4,55,53,2,71,73,-2,2,2,0,0
"5095","CGY","ANA",2014021001,16505,20142015,1,60,6,3,3,3.91491316742531,5.55650963743417,-1.64159647000886,23,32,-9,30,43,-13,37,62,-25,6,3,0,0
"5096","CGY","TOR",2014021017,16507,20142015,1,60,6,3,3,2.66925519260352,2.74527866439894,-0.0760234717954216,28,28,0,37,39,-2,44,67,-23,3,4,0,0
"5097","CGY","COL",2014021028,16508,20142015,0,60,2,3,-1,6.41283212641429,4.75250283049772,1.66032929591657,31,26,5,38,40,-2,64,54,10,3,1,0,0
"5098","CGY","PHI",2014021060,16513,20142015,1,60,4,1,3,5.00038994028,4.21476166032153,0.785628279958473,26,27,-1,38,39,-1,57,59,-2,5,3,0,0
"5099","CGY","CBJ",2014021067,16515,20142015,1,64.0166666666667,2,3,-1,4.17200107251119,3.12706947954939,1.0449315929618,40,26,14,56,37,19,73,52,21,8,3,0,0
"5100","CGY","COL",2014021088,16517,20142015,1,60,3,2,1,3.68683608808351,4.49548251228407,-0.80864642420056,26,27,-1,36,39,-3,53,56,-3,1,3,0,0
"5101","CGY","DAL",2014021100,16519,20142015,1,65,3,3,0,5.21599826756808,3.66346230143079,1.55253596613729,34,30,4,45,45,0,57,69,-12,4,6,0,0
"5102","CGY","MIN",2014021112,16521,20142015,0,60,2,4,-2,5.40496495623051,3.07239928399213,2.33256567223839,25,36,-11,34,46,-12,43,64,-21,2,1,0,0
"5103","CGY","DAL",2014021139,16524,20142015,0,60,5,3,2,5.40103976102546,8.81260472166468,-3.41156496063923,25,36,-11,38,68,-30,47,100,-53,3,4,0,0
"5104","CGY","EDM",2014021178,16529,20142015,0,60,4,0,4,3.92235691376118,3.15474195453862,0.767614959222556,29,27,2,40,49,-9,57,66,-9,1,0,0,0
"5105","CGY","ARI",2014021198,16532,20142015,1,60,3,2,1,4.4793541324907,4.06333295325749,0.416021179233212,32,24,8,45,33,12,66,59,7,4,0,0,0
"5106","CGY","WPG",2014021218,16536,20142015,0,60,1,5,-4,2.85639369077398,2.11592669569654,0.740466995077441,25,22,3,32,28,4,45,40,5,2,4,0,0
"5107","CGY","VAN",2014030181,16540,20142015,0,60,2,1,1,4.52344431600068,2.97396366478642,1.54948065121425,30,30,0,41,41,0,54,61,-7,1,3,0,0
"5108","CGY","VAN",2014030182,16542,20142015,0,60,1,4,-3,3.56313909911907,6.29391444688077,-2.73077534776171,23,32,-9,34,41,-7,46,56,-10,3,5,0,0
"5109","CGY","VAN",2014030183,16544,20142015,1,60,4,2,2,3.55344014303409,3.99007843035542,-0.43663828732133,28,25,3,39,35,4,58,65,-7,7,5,0,0
"5110","CGY","VAN",2014030184,16546,20142015,1,60,3,1,2,2.57039893847277,6.59914813612567,-4.02874919765291,22,29,-7,29,41,-12,38,70,-32,4,2,0,0
"5111","CGY","VAN",2014030185,16548,20142015,0,60,1,2,-1,2.39430917729624,3.76185524616417,-1.36754606886794,21,43,-22,33,50,-17,50,66,-16,3,2,0,0
"5112","CGY","VAN",2014030186,16550,20142015,1,60,7,4,3,6.80932864918552,4.25394926082498,2.55537938836054,33,22,11,44,35,9,55,58,-3,3,2,0,0
"5113","CGY","ANA",2014030241,16555,20142015,0,60,1,6,-5,2.79167979097174,4.57596478992504,-1.7842849989533,24,35,-11,38,50,-12,57,63,-6,4,5,0,0
"5114","CGY","ANA",2014030242,16558,20142015,0,60,0,3,-3,6.31537148784264,5.93322362157051,0.382147866272135,30,34,-4,40,45,-5,60,63,-3,4,5,0,0
"5115","CGY","ANA",2014030243,16560,20142015,1,64.4,4,3,1,3.6912657241337,6.43882663217482,-2.74756090804112,21,21,0,39,36,3,57,45,12,7,3,0,0
"5116","CGY","ANA",2014030244,16563,20142015,1,60,2,4,-2,3.7552258642163,6.64906510990872,-2.89383924569242,27,29,-2,38,44,-6,52,67,-15,3,4,0,0
"5117","CGY","ANA",2014030245,16565,20142015,0,62.4333333333333,2,3,-1,3.003434406734,6.55385564771726,-3.55042124098327,19,47,-28,31,63,-32,40,90,-50,5,6,0,0
"5118","CGY","WPG",2015020061,16724,20152016,0,60,1,3,-2,4.75505356333451,5.40564888267545,-0.650595319340937,20,30,-10,30,39,-9,40,57,-17,2,3,0,0
"5119","CGY","EDM",2015020073,16725,20152016,1,60,2,5,-3,4.41521574801656,4.68559036689112,-0.270374618874559,24,28,-4,34,43,-9,53,63,-10,4,4,0,0
"5120","CGY","NYR",2015020119,16733,20152016,0,60,1,4,-3,3.47495229342758,1.5625714141531,1.91238087927448,23,26,-3,37,38,-1,55,54,1,3,3,0,0
"5121","CGY","NYI",2015020121,16734,20152016,0,60,0,4,-4,3.55318835692015,6.10422826895956,-2.55103991203941,29,35,-6,40,48,-8,52,66,-14,3,3,0,0
"5122","CGY","OTT",2015020134,16736,20152016,0,65,4,4,0,7.24129160799203,3.63279535492111,3.60849625307091,38,23,15,52,33,19,66,55,11,4,4,0,0
"5123","CGY","MTL",2015020152,16738,20152016,1,60,2,6,-4,0,0,0,32,31,1,43,42,1,59,55,4,4,4,0,0
"5124","CGY","EDM",2015020163,16739,20152016,0,60,5,4,1,4.9181237540738,2.90043949114624,2.01768426292756,32,23,9,41,31,10,48,48,0,4,5,0,0
"5125","CGY","COL",2015020178,16742,20152016,0,60,3,6,-3,4.42850689968327,8.55141007546119,-4.12290317577792,25,42,-17,36,56,-20,66,62,4,2,3,0,0
"5126","CGY","PHI",2015020190,16744,20152016,1,60.5833333333333,2,1,1,4.05864937288516,4.41841098861187,-0.359761615726711,30,27,3,33,41,-8,42,63,-21,2,2,0,0
"5127","CGY","T.B",2015020235,16751,20152016,0,60,1,3,-2,4.62726565229241,3.69453964332206,0.932726008970349,31,29,2,46,40,6,58,61,-3,4,2,0,0
"5128","CGY","CHI",2015020260,16754,20152016,0,60,1,4,-3,4.96799491125404,5.33823071006634,-0.370235798812304,26,41,-15,38,55,-17,55,71,-16,2,1,0,0
"5129","CGY","N.J",2015020274,16756,20152016,1,60,3,2,1,4.24310625509679,2.51916604442522,1.72394021067157,30,20,10,38,33,5,50,47,3,4,3,0,0
"5130","CGY","CHI",2015020291,16759,20152016,1,61.6333333333333,2,1,1,4.44752365216846,3.65421524123194,0.793308410936521,37,19,18,45,29,16,61,47,14,2,3,0,0
"5131","CGY","ANA",2015020316,16763,20152016,0,60,3,5,-2,3.44748795448686,6.24489185033235,-2.79740389584549,25,32,-7,30,53,-23,36,73,-37,2,2,0,0
"5132","CGY","ARI",2015020341,16766,20152016,0,64.3333333333333,1,2,-1,2.62487794528442,2.83589110802859,-0.211013162744166,26,21,5,37,31,6,56,45,11,7,3,0,0
"5133","CGY","DAL",2015020366,16770,20152016,1,65,3,3,0,6.76328642427817,5.69198504536325,1.07130137891492,32,29,3,55,43,12,72,60,12,3,2,0,0
"5134","CGY","NYR",2015020443,16781,20152016,1,62.15,5,4,1,0,0,0,27,29,-2,41,40,1,53,59,-6,3,5,0,0
"5135","CGY","DAL",2015020474,16786,20152016,0,60,3,1,2,4.11413875184371,6.45343395532988,-2.33929520348617,27,36,-9,39,54,-15,50,83,-33,3,3,0,0
"5136","CGY","WPG",2015020514,16791,20152016,1,60,4,1,3,5.21008573517089,2.61334528087173,2.59674045429917,33,20,13,51,32,19,68,49,19,5,1,0,0
"5137","CGY","EDM",2015020534,16796,20152016,1,60,5,3,2,5.30776919726259,5.48010290920675,-0.172333711944162,37,31,6,49,46,3,64,66,-2,3,1,0,0
"5138","CGY","ANA",2015020548,16798,20152016,1,60,0,1,-1,3.36435945681296,4.80273158662021,-1.43837212980725,14,21,-7,17,31,-14,31,45,-14,5,3,0,0
"5139","CGY","COL",2015020577,16802,20152016,0,60,4,0,4,3.28034445168475,5.35368221427104,-2.07333776258628,34,26,8,45,34,11,58,50,8,6,2,0,0
"5140","CGY","T.B",2015020595,16805,20152016,1,60,3,1,2,5.57885550387437,4.88097422354622,0.697881280328147,24,31,-7,44,42,2,58,59,-1,1,0,0,0
"5141","CGY","ARI",2015020605,16807,20152016,1,60,1,2,-1,3.64903466537146,3.03750602476066,0.6115286406108,26,33,-7,38,44,-6,52,60,-8,3,3,0,0
"5142","CGY","EDM",2015020668,16816,20152016,0,65,1,1,0,2.96748281878899,5.80205278465472,-2.83456996586573,32,37,-5,38,43,-5,59,67,-8,5,1,0,0
"5143","CGY","N.J",2015020682,16819,20152016,0,60,2,4,-2,5.42072069104051,6.41129141053213,-0.990570719491615,28,26,2,38,39,-1,45,50,-5,4,2,0,0
"5144","CGY","CBJ",2015020696,16821,20152016,0,60,4,2,2,3.43626148485532,4.88229289615265,-1.44603141129733,27,29,-2,40,45,-5,55,62,-7,1,2,0,0
"5145","CGY","DAL",2015020729,16825,20152016,0,60,1,2,-1,4.58580025838455,3.85504213784425,0.730758120540305,24,30,-6,36,48,-12,55,69,-14,6,3,0,0
"5146","CGY","CBJ",2015020773,16836,20152016,1,60,1,2,-1,6.00121202127775,4.29596520506311,1.70524681621464,31,18,13,45,25,20,75,34,41,2,1,0,0
"5147","CGY","TOR",2015020805,16840,20152016,1,60,4,3,1,3.79817960229411,6.48394560911356,-2.68576600681945,22,36,-14,29,49,-20,40,74,-34,4,3,0,0
"5148","CGY","ARI",2015020824,16843,20152016,0,60,1,4,-3,2.2826229800412,4.70847812625713,-2.42585514621593,27,35,-8,36,52,-16,47,68,-21,9,10,0,0
"5149","CGY","ANA",2015020841,16846,20152016,1,60,4,6,-2,4.77837316791556,3.19053654669551,1.58783662122005,37,28,9,44,39,5,57,51,6,6,4,0,0
"5150","CGY","MIN",2015020857,16848,20152016,1,60,3,5,-2,2.81148008567958,4.47616593893235,-1.66468585325277,28,24,4,46,30,16,64,35,29,5,3,0,0
"5151","CGY","ANA",2015020887,16852,20152016,0,60,2,5,-3,2.76260212226771,3.8585333719102,-1.09593124964249,24,33,-9,38,53,-15,51,70,-19,7,6,0,0
"5152","CGY","NYI",2015020913,16856,20152016,1,64.7,1,2,-1,3.98454846506502,5.46649344081379,-1.48194497574877,32,34,-2,41,41,0,63,55,8,2,2,0,0
"5153","CGY","OTT",2015020928,16858,20152016,1,60,4,6,-2,4.54510406886357,4.89313716234112,-0.348033093477554,38,26,12,48,40,8,58,54,4,3,3,0,0
"5154","CGY","PHI",2015020938,16860,20152016,0,60,3,5,-2,6.03032938051729,6.58946091287751,-0.559131532360219,32,29,3,50,41,9,71,64,7,5,4,0,0
"5155","CGY","PIT",2015020970,16865,20152016,0,60,4,2,2,3.33368253785375,3.29754844740455,0.0361340904491954,30,31,-1,37,41,-4,45,65,-20,2,2,0,0
"5156","CGY","ARI",2015021017,16871,20152016,1,60,1,4,-3,4.41040786681697,7.42660887195143,-3.01620100513446,25,26,-1,32,36,-4,45,49,-4,3,4,0,0
"5157","CGY","WPG",2015021050,16876,20152016,1,60,4,1,3,2.26494122312243,4.76817016024143,-2.50322893711899,21,29,-8,30,43,-13,42,65,-23,3,2,0,0
"5158","CGY","COL",2015021064,16878,20152016,1,65,3,3,0,5.35063099765426,5.00888665911043,0.341744338543826,33,28,5,44,39,5,68,50,18,2,2,0,0
"5159","CGY","MTL",2015021081,16880,20152016,0,60,4,1,3,0,0,0,35,22,13,40,28,12,57,44,13,4,2,0,0
"5160","CGY","TOR",2015021087,16881,20152016,0,60,2,5,-3,3.00917643457069,6.79973537063415,-3.79055893606346,25,26,-1,34,44,-10,47,67,-20,3,7,0,0
"5161","CGY","MIN",2015021107,16884,20152016,0,60,2,6,-4,5.59566964429588,4.53422002855223,1.06144961574365,33,29,4,46,37,9,69,43,26,5,5,0,0
"5162","CGY","CHI",2015021126,16886,20152016,1,60,1,4,-3,4.37756777430888,5.0709112904151,-0.693343516106221,32,27,5,46,40,6,59,52,7,4,4,0,0
"5163","CGY","ARI",2015021138,16888,20152016,0,60,5,2,3,4.73161216673907,6.49325339315692,-1.76164122641785,21,24,-3,35,40,-5,50,53,-3,3,4,0,0
"5164","CGY","ANA",2015021151,16890,20152016,0,60,3,8,-5,6.55952105462086,6.27606950202608,0.283451552594784,26,27,-1,44,41,3,62,54,8,4,4,0,0
"5165","CGY","EDM",2015021176,16893,20152016,0,60,5,0,5,4.01613454342038,4.28791248055131,-0.271777937130935,35,28,7,41,37,4,62,51,11,6,2,0,0
"5166","CGY","MIN",2015021224,16900,20152016,0,60,2,1,1,3.93859218997272,4.23357806751712,-0.294985877544393,25,36,-11,30,51,-21,39,68,-29,4,7,0,0
"5167","CGY","EDM",2016020003,17086,20162017,0,60,4,7,-3,5.67724197415174,5.08170679899285,0.595535175158886,41,28,13,54,39,15,64,52,12,4,8,0,0
"5168","CGY","EDM",2016020015,17088,20162017,1,60,3,5,-2,0,0,0,35,29,6,45,37,8,60,48,12,7,6,0,0
"5169","CGY","CHI",2016020082,17098,20162017,0,65,2,2,0,3.03900877568958,3.51153810572578,-0.472529330036195,31,34,-3,39,42,-3,52,67,-15,4,2,0,0
"5170","CGY","OTT",2016020110,17102,20162017,1,60,5,2,3,3.45009154910804,5.73183214780071,-2.28174059869268,19,33,-14,32,50,-18,50,70,-20,2,4,0,0
"5171","CGY","CHI",2016020139,17106,20162017,0,60,1,5,-4,4.72565473217219,2.97542021524226,1.75023451692993,34,22,12,44,32,12,61,45,16,5,5,0,0
"5172","CGY","ANA",2016020179,17111,20162017,0,60,1,4,-3,6.25963014924491,2.84985096776644,3.40977918147848,26,21,5,37,30,7,52,39,13,5,6,0,0
"5173","CGY","DAL",2016020204,17115,20162017,1,60,2,4,-2,3.15943259701089,3.56455375293081,-0.405121155919915,31,22,9,41,28,13,59,38,21,3,4,0,0
"5174","CGY","NYR",2016020222,17117,20162017,1,60,1,4,-3,5.64095421411912,3.68647654976485,1.95447766435427,36,28,8,46,41,5,70,49,21,3,2,0,0
"5175","CGY","MIN",2016020237,17120,20162017,0,60,1,0,1,2.47830238840908,6.17065134405493,-3.69234895564585,27,27,0,33,43,-10,46,57,-11,7,4,0,0
"5176","CGY","ARI",2016020244,17121,20162017,1,60.8166666666667,2,1,1,3.88109555928531,1.70569247475942,2.1754030845259,24,21,3,41,31,10,68,37,31,4,4,0,0
"5177","CGY","CHI",2016020259,17123,20162017,1,60,2,3,-1,3.71603532199515,5.69691945847515,-1.98088413648,30,24,6,42,38,4,58,52,6,5,1,0,0
"5178","CGY","CBJ",2016020292,17128,20162017,0,60,2,0,2,2.96974715071235,3.98465573851718,-1.01490858780483,20,34,-14,32,41,-9,44,59,-15,3,3,0,0
"5179","CGY","PHI",2016020327,17132,20162017,0,60,3,5,-2,5.27930787416356,5.42945631663315,-0.150148442469586,32,43,-11,41,61,-20,57,77,-20,2,7,0,0
"5180","CGY","NYI",2016020328,17133,20162017,0,61.8833333333333,1,2,-1,2.81828192356625,4.9233823409304,-2.10510041736416,26,27,-1,37,43,-6,50,54,-4,1,4,0,0
"5181","CGY","TOR",2016020343,17135,20162017,1,60,3,0,3,1.15283740196069,4.35464404310915,-3.20180664114846,29,39,-10,38,56,-18,45,69,-24,2,2,0,0
"5182","CGY","MIN",2016020357,17137,20162017,1,65,2,2,0,4.70700060857803,4.8939864760614,-0.186985867483372,31,25,6,43,37,6,63,46,17,7,5,0,0
"5183","CGY","ANA",2016020375,17139,20162017,1,60,8,3,5,3.47925294277229,4.83510553302025,-1.35585259024796,25,33,-8,33,39,-6,44,49,-5,3,4,0,0
"5184","CGY","DAL",2016020390,17141,20162017,0,60,2,1,1,3.91493130462572,3.27527484034363,0.639656464282098,20,30,-10,34,50,-16,50,68,-18,2,2,0,0
"5185","CGY","ARI",2016020403,17143,20162017,0,61.15,2,1,1,5.77888475684449,4.36796128130903,1.41092347553546,35,28,7,46,43,3,60,59,1,5,4,0,0
"5186","CGY","WPG",2016020419,17145,20162017,1,60,6,2,4,4.00496788896353,3.60446439377621,0.400503495187323,35,28,7,49,43,6,56,57,-1,4,4,0,0
"5187","CGY","T.B",2016020443,17149,20162017,1,60,3,6,-3,1.17778584090833,6.16230521773597,-4.98451937682764,22,35,-13,29,47,-18,46,58,-12,5,6,0,0
"5188","CGY","CBJ",2016020458,17151,20162017,1,60,1,4,-3,3.38298190940986,3.4848545328714,-0.101872623461531,23,29,-6,30,36,-6,53,47,6,5,4,0,0
"5189","CGY","ARI",2016020480,17154,20162017,0,60,4,2,2,5.70645945956494,4.40837371698581,1.29808574257913,28,27,1,48,40,8,64,55,9,7,6,0,0
"5190","CGY","COL",2016020524,17162,20162017,0,60,6,3,3,4.12978112220298,3.42303858490865,0.706742537294338,31,28,3,40,33,7,60,52,8,3,6,0,0
"5191","CGY","ANA",2016020541,17164,20162017,1,60,1,3,-2,4.8122010667942,5.23395529307891,-0.421754226284703,32,25,7,39,35,4,48,48,0,5,7,0,0
"5192","CGY","ARI",2016020556,17166,20162017,1,60,4,2,2,3.29672785757998,4.29138562585656,-0.99465776827658,24,29,-5,35,41,-6,50,55,-5,5,5,0,0
"5193","CGY","COL",2016020575,17170,20162017,1,60,4,1,3,4.99845968454511,2.85375614919828,2.14470353534684,37,18,19,49,30,19,60,37,23,7,3,0,0
"5194","CGY","WPG",2016020611,17175,20162017,0,60,0,2,-2,3.6401578149635,2.85856189853209,0.781595916431415,28,27,1,38,33,5,51,41,10,4,4,0,0
"5195","CGY","N.J",2016020638,17179,20162017,1,60,1,2,-1,3.74155687626973,3.18896985659376,0.552587019675975,32,36,-4,37,47,-10,52,61,-9,2,4,0,0
"5196","CGY","EDM",2016020649,17180,20162017,0,65,1,1,0,4.19014735391829,6.76713507554086,-2.57698772162257,25,27,-2,37,31,6,50,50,0,2,4,0,0
"5197","CGY","EDM",2016020700,17187,20162017,1,60,3,7,-4,5.61901641738496,5.38360124161126,0.235415175773694,41,31,10,58,35,23,77,40,37,5,7,0,0
"5198","CGY","TOR",2016020710,17189,20162017,0,60,0,4,-4,2.17432582070614,3.36087227874394,-1.1865464580378,26,28,-2,34,41,-7,56,52,4,8,8,0,0
"5199","CGY","MTL",2016020718,17190,20162017,0,60,1,5,-4,3.31875413495072,2.08785746313515,1.23089667181557,31,20,11,36,33,3,52,53,-1,6,4,0,0
"5200","CGY","MIN",2016020756,17198,20162017,1,60,5,1,4,6.87026084547126,4.03199946049972,2.83826138497154,36,29,7,48,45,3,64,57,7,5,4,0,0
"5201","CGY","N.J",2016020769,17200,20162017,0,61.2166666666667,4,3,1,6.89941428555176,4.66806362580974,2.23135065974202,38,29,9,49,40,9,60,53,7,3,4,0,0
"5202","CGY","NYR",2016020786,17202,20162017,0,60,3,4,-1,8.50561800680589,7.53978204279701,0.965835964008875,32,32,0,54,43,11,70,56,14,1,1,0,0
"5203","CGY","PIT",2016020792,17204,20162017,0,65,2,2,0,2.76209416612983,6.21737960263272,-3.45528543650289,30,33,-3,37,45,-8,51,59,-8,5,3,0,0
"5204","CGY","ARI",2016020835,17210,20162017,1,60,0,5,-5,2.29691578230268,2.67834089344251,-0.381425111139833,36,32,4,54,36,18,72,43,29,5,1,0,0
"5205","CGY","PHI",2016020845,17212,20162017,1,60,3,1,2,4.35684933859602,3.06143791013164,1.29541142846438,23,34,-11,34,45,-11,50,70,-20,4,3,0,0
"5206","CGY","T.B",2016020896,17220,20162017,0,60,3,2,1,3.51317675826294,1.96246351143054,1.5507132468324,25,25,0,37,36,1,47,46,1,4,3,0,0
"5207","CGY","NYI",2016020962,17230,20162017,1,60,5,2,3,5.01644687569933,6.41254359902814,-1.39609672332881,37,35,2,48,48,0,64,64,0,3,4,0,0
"5208","CGY","MTL",2016020990,17234,20162017,1,60,5,0,5,4.72083848952843,2.85750399391691,1.86333449561153,38,24,14,53,29,24,70,38,32,1,2,0,0
"5209","CGY","WPG",2016021005,17236,20162017,0,60,3,0,3,3.52481346664405,4.74276577797298,-1.21795231132893,29,31,-2,38,42,-4,54,57,-3,5,4,0,0
"5210","CGY","PIT",2016021020,17238,20162017,1,65,3,3,0,5.31608608012776,6.20325677739079,-0.887170697263024,30,35,-5,44,48,-4,61,61,0,3,4,0,0
"5211","CGY","DAL",2016021051,17242,20162017,1,60,3,1,2,3.78079640827491,3.48883812980785,0.291958278467064,24,25,-1,32,40,-8,46,57,-11,0,2,0,0
"5212","CGY","COL",2016021126,17252,20162017,1,60,4,2,2,2.76962513131948,5.19333348050714,-2.42370834918766,27,26,1,41,31,10,55,45,10,3,3,0,0
"5213","CGY","ANA",2016021174,17258,20162017,1,60,3,4,-1,3.41003541916143,3.49134803753986,-0.0813126183784334,21,34,-13,34,43,-9,46,51,-5,4,3,0,0
"5214","CGY","ANA",2016021189,17260,20162017,0,60,1,3,-2,4.50933994250224,4.78546000189489,-0.276120059392653,27,20,7,42,47,-5,59,54,5,8,8,0,0
"5215","CGY","ANA",2016030171,17269,20162017,0,60,2,3,-1,7.2515363726925,5.63063866746097,1.62089770523153,32,41,-9,50,53,-3,70,70,0,5,7,0,0
"5216","CGY","ANA",2016030172,17271,20162017,0,60,2,3,-1,5.1230225131585,7.66156815670911,-2.53854564355061,37,29,8,51,48,3,63,69,-6,5,5,0,0
"5217","CGY","ANA",2016030173,17273,20162017,1,61.5,4,5,-1,4.92765855565085,7.27538240764359,-2.34772385199274,32,27,5,45,45,0,62,56,6,6,1,0,0
"5218","CGY","ANA",2016030174,17275,20162017,1,60,1,3,-2,5.52010487119446,6.15749431756558,-0.637389446371117,37,25,12,50,36,14,59,47,12,3,2,0,0
"5219","CGY","EDM",2017020003,17443,20172018,0,60,0,3,-3,4.65161499520764,7.45447127262196,-2.80285627741432,27,45,-18,40,63,-23,58,80,-22,1,2,0,0
"5220","CGY","WPG",2017020027,17446,20172018,1,60,6,3,3,6.08663126501779,3.87804918189067,2.20858208312711,45,28,17,57,37,20,78,47,31,6,3,0,0
"5221","CGY","ANA",2017020038,17448,20172018,0,60,2,0,2,5.83697999505966,6.16790207877055,-0.330922083710885,29,43,-14,47,62,-15,64,78,-14,4,5,0,0
"5222","CGY","MIN",2017020120,17460,20172018,1,60,2,4,-2,6.68407540941132,5.91747928070617,0.766596128705146,37,32,5,52,44,8,74,54,20,6,3,0,0
"5223","CGY","DAL",2017020154,17466,20172018,1,60,1,2,-1,4.95476645918461,4.07392685313243,0.880839606052177,30,24,6,42,37,5,59,50,9,3,4,0,0
"5224","CGY","PIT",2017020195,17472,20172018,1,62.3166666666667,2,1,1,4.3085615435848,4.62624415173866,-0.317682608153859,34,44,-10,51,55,-4,71,62,9,4,1,0,0
"5225","CGY","N.J",2017020216,17475,20172018,1,65,4,4,0,4.43566788928001,7.05358248119667,-2.61791459191666,34,30,4,48,43,5,64,57,7,4,3,0,0
"5226","CGY","PHI",2017020292,17488,20172018,0,61.3,5,4,1,2.85879635141464,2.94399451689856,-0.0851981654839165,31,39,-8,42,46,-4,59,62,-3,6,4,0,0
"5227","CGY","CBJ",2017020327,17492,20172018,0,62.0333333333333,0,1,-1,2.11466617330734,4.85171490984794,-2.7370487365406,22,41,-19,37,55,-18,54,70,-16,1,2,0,0
"5228","CGY","DAL",2017020345,17494,20172018,0,60,4,6,-2,3.76301636919379,5.90644248967874,-2.14342612048495,38,41,-3,47,47,0,61,63,-2,4,5,0,0
"5229","CGY","COL",2017020356,17495,20172018,0,60,3,2,1,3.77809271219121,5.92762020006194,-2.14952748787073,28,26,2,46,40,6,66,57,9,4,3,0,0
"5230","CGY","TOR",2017020374,17498,20172018,1,60,1,4,-3,3.87513565981499,4.77861786502763,-0.90348220521264,20,30,-10,34,41,-7,51,62,-11,3,2,0,0
"5231","CGY","ARI",2017020386,17500,20172018,1,60,3,0,3,6.12372820838209,4.36505221882172,1.75867598956037,44,28,16,56,42,14,70,57,13,1,2,0,0
"5232","CGY","EDM",2017020407,17502,20172018,1,60,5,7,-2,5.02022962710675,6.37739417281322,-1.35716454570647,34,33,1,43,51,-8,67,59,8,5,3,0,0
"5233","CGY","PHI",2017020415,17504,20172018,1,60,2,5,-3,4.87234007900461,3.01076744706675,1.86157263193786,45,21,24,61,31,30,80,39,41,2,2,0,0
"5234","CGY","TOR",2017020426,17506,20172018,0,65,1,1,0,9.7654930950257,4.74154012648796,5.02395296853774,48,29,19,65,50,15,77,74,3,2,4,0,0
"5235","CGY","MTL",2017020432,17507,20172018,0,61.2333333333333,3,2,1,7.7546541695192,8.71462787759839,-0.95997370807919,37,37,0,54,54,0,76,73,3,4,1,0,0
"5236","CGY","MIN",2017020472,17512,20172018,0,65,1,1,0,5.59767042095067,4.04238610288328,1.55528431806739,27,22,5,45,36,9,64,45,19,3,2,0,0
"5237","CGY","MTL",2017020541,17522,20172018,1,60,2,3,-1,4.30346465687035,5.28849566204008,-0.985031005169731,23,35,-12,45,48,-3,66,55,11,3,1,0,0
"5238","CGY","ANA",2017020586,17529,20172018,0,60,1,2,-1,3.89132727725441,6.09031208360102,-2.19898480634661,23,41,-18,37,57,-20,58,64,-6,4,7,0,0
"5239","CGY","CHI",2017020599,17531,20172018,1,60.8666666666667,4,3,1,4.80620510988228,5.22448904969497,-0.418283939812682,39,37,2,51,55,-4,63,66,-3,2,2,0,0
"5240","CGY","ANA",2017020640,17537,20172018,1,60,3,2,1,5.23611640599484,2.44485978033663,2.79125662565821,31,29,2,47,36,11,65,43,22,6,6,0,0
"5241","CGY","MIN",2017020659,17540,20172018,0,62.65,3,2,1,2.08254928924365,4.57486751579319,-2.49231822654954,29,35,-6,38,47,-9,51,59,-8,6,7,0,0
"5242","CGY","T.B",2017020664,17542,20172018,0,60,5,1,4,3.55012326415181,5.0412218751153,-1.49109861096349,24,34,-10,30,49,-19,44,69,-25,1,4,0,0
"5243","CGY","WPG",2017020711,17551,20172018,1,65,1,1,0,3.17506555601488,6.41476998939246,-3.23970443337759,31,35,-4,49,48,1,65,61,4,4,2,0,0
"5244","CGY","EDM",2017020755,17556,20172018,0,65,3,3,0,5.9331690734464,5.58080679783779,0.352362275608604,37,37,0,52,52,0,70,68,2,5,4,0,0
"5245","CGY","VGK",2017020771,17561,20172018,1,60,2,4,-2,3.64718249836005,6.099664874527,-2.45248237616694,33,35,-2,56,50,6,78,63,15,3,2,0,0
"5246","CGY","T.B",2017020784,17563,20172018,1,60,4,7,-3,6.39557428623084,7.10779897379689,-0.712224687566049,46,31,15,63,49,14,78,63,15,2,4,0,0
"5247","CGY","CHI",2017020802,17565,20172018,1,60.9833333333333,4,3,1,5.12097558031502,4.97913293224701,0.141842648068007,39,28,11,58,47,11,78,62,16,1,1,0,0
"5248","CGY","CHI",2017020821,17568,20172018,0,60,3,2,1,7.61450121962491,5.98429107001517,1.63021014960974,23,36,-13,34,57,-23,61,75,-14,5,6,0,0
"5249","CGY","N.J",2017020827,17570,20172018,0,60,3,2,1,1.66230522953265,4.04681248109046,-2.38450725155781,25,32,-7,38,47,-9,46,58,-12,0,2,0,0
"5250","CGY","NYR",2017020836,17571,20172018,0,60,3,4,-1,5.10501514902221,5.99337214973146,-0.888357000709249,38,36,2,53,48,5,72,56,16,6,5,0,0
"5251","CGY","NYI",2017020858,17573,20172018,0,60,3,2,1,5.25059675914235,4.97004314238097,0.280553616761381,42,25,17,58,39,19,77,51,26,4,5,0,0
"5252","CGY","VGK",2017020929,17583,20172018,0,60,3,7,-4,6.8866210313281,3.87032465563971,3.0162963756884,31,26,5,47,33,14,66,45,21,3,4,0,0
"5253","CGY","ARI",2017020939,17584,20172018,0,60,5,2,3,6.83249315145508,5.74392730848285,1.08856584297223,38,37,1,57,47,10,69,65,4,5,7,0,0
"5254","CGY","COL",2017020947,17586,20172018,1,60,5,1,4,4.22236881475692,3.74299223497403,0.479376579782894,29,29,0,50,41,9,71,54,17,5,3,0,0
"5255","CGY","DAL",2017020975,17589,20172018,0,60,0,2,-2,6.17536862913272,2.47991735732846,3.69545127180426,38,26,12,57,37,20,80,52,28,7,7,0,0
"5256","CGY","COL",2017020981,17590,20172018,0,60,2,5,-3,6.3565457078646,5.42213730975466,0.934408398109941,32,34,-2,43,39,4,67,44,23,7,9,0,0
"5257","CGY","NYR",2017020996,17592,20172018,1,60,1,3,-2,7.54707201528608,3.10327855499236,4.44379346029372,51,27,24,71,41,30,87,48,39,3,3,0,0
"5258","CGY","PIT",2017021016,17595,20172018,0,62.6,3,4,-1,4.120600203707,4.52613902009608,-0.405538816389083,38,32,6,53,39,14,69,54,15,3,3,0,0
"5259","CGY","NYI",2017021060,17601,20172018,1,60,2,5,-3,8.10604837891879,3.02198530464148,5.08406307427731,52,27,25,74,36,38,94,48,46,4,1,0,0
"5260","CGY","EDM",2017021076,17603,20172018,1,60,1,0,1,4.0429663829303,5.04681183800676,-1.00384545507646,32,28,4,48,39,9,64,54,10,2,3,0,0
"5261","CGY","VGK",2017021109,17608,20172018,0,60,0,4,-4,8.22582707274114,3.62229249241521,4.60353458032593,42,31,11,56,40,16,67,50,17,4,4,0,0
"5262","CGY","ARI",2017021120,17609,20172018,0,60,2,5,-3,5.86410963498929,6.55359915250234,-0.689489517513046,44,30,14,65,43,22,81,64,17,5,3,0,0
"5263","CGY","ANA",2017021135,17611,20172018,1,60,0,4,-4,6.19839725984548,2.8545879428857,3.34380931695978,29,16,13,48,26,22,61,37,24,4,3,0,0
"5264","CGY","CBJ",2017021197,17619,20172018,1,60,1,5,-4,5.704150630394,2.61747735585959,3.08667327453441,38,28,10,57,37,20,73,48,25,2,3,0,0
"5265","CGY","EDM",2017021216,17621,20172018,1,60,3,2,1,3.67566220237902,4.37503805703974,-0.699375854660722,20,36,-16,30,48,-18,39,62,-23,6,7,0,0
"5266","CGY","ARI",2017021235,17624,20172018,1,60,1,4,-3,6.20480826330037,3.40271230356302,2.80209595973735,43,21,22,62,34,28,77,46,31,1,4,0,0
"5267","CGY","WPG",2017021248,17626,20172018,0,60,1,2,-1,2.84596588091346,3.42621441005794,-0.580248529144473,32,26,6,43,38,5,52,45,7,3,5,0,0
"5268","CGY","VGK",2017021268,17628,20172018,1,60,7,1,6,7.12675423453493,3.69211339180401,3.43464084273091,31,27,4,45,42,3,60,60,0,5,3,0,0
"5269","CGY","COL",2018020070,17817,20182019,0,60.7666666666667,3,2,1,7.22339872590965,1.87742703323602,5.34597169267363,41,26,15,58,34,24,77,43,34,5,4,0,0
"5270","CGY","NYR",2018020115,17825,20182019,0,60,4,1,3,3.57598458181383,6.10062108849885,-2.52463650668502,26,45,-19,35,57,-22,51,77,-26,3,3,0,0
"5271","CGY","MTL",2018020124,17827,20182019,0,60,2,3,-1,3.22401251913794,4.90193987480262,-1.67792735566468,23,40,-17,34,49,-15,54,63,-9,5,5,0,0
"5272","CGY","PIT",2018020141,17829,20182019,1,60,1,9,-8,4.4430103246923,3.63996525959405,0.803045065098246,39,36,3,60,44,16,83,57,26,3,2,0,0
"5273","CGY","TOR",2018020165,17833,20182019,0,60,3,1,2,5.16909549378761,3.93113881535828,1.23795667842933,34,25,9,46,45,1,56,58,-2,4,4,0,0
"5274","CGY","COL",2018020187,17836,20182019,1,60,6,5,1,4.49415070551913,4.43611826357665,0.0580324419424869,37,26,11,59,34,25,74,39,35,2,3,0,0
"5275","CGY","CHI",2018020203,17838,20182019,1,60,5,3,2,8.18253807770088,3.4079384378856,4.77459963981528,41,15,26,54,28,26,68,36,32,1,4,0,0
"5276","CGY","ANA",2018020226,17842,20182019,0,60,2,3,-1,0,0,0,39,24,15,57,40,17,68,45,23,3,3,0,0
"5277","CGY","MTL",2018020283,17850,20182019,1,60,2,3,-1,3.44290299161803,2.78157359909528,0.661329392522745,45,22,23,61,29,32,76,49,27,1,2,0,0
"5278","CGY","EDM",2018020301,17852,20182019,1,60,4,2,2,3.97445712787157,2.30850878103229,1.66594834683929,37,26,11,47,33,14,66,43,23,8,4,0,0
"5279","CGY","VGK",2018020315,17854,20182019,1,60,7,2,5,4.093281289679,3.67138846943632,0.421892820242682,32,22,10,42,37,5,55,49,6,6,2,0,0
"5280","CGY","WPG",2018020329,17856,20182019,1,60,6,3,3,4.43396804404983,5.17691126841237,-0.742943224362534,26,40,-14,34,55,-21,42,70,-28,2,6,0,0
"5281","CGY","VGK",2018020338,17858,20182019,0,60,0,2,-2,3.01280495147876,3.44943400505872,-0.436629053579964,29,28,1,39,42,-3,58,54,4,2,4,0,0
"5282","CGY","ARI",2018020358,17860,20182019,0,60,6,1,5,6.58305904812372,4.16701110017503,2.4160479479487,27,29,-2,39,41,-2,53,56,-3,6,4,0,0
"5283","CGY","DAL",2018020380,17863,20182019,1,60.4,3,4,-1,4.3677580809035,2.82354379654862,1.54421428435488,33,28,5,45,33,12,71,39,32,5,2,0,0
"5284","CGY","CHI",2018020411,17867,20182019,0,60,3,2,1,4.90688628953649,3.56093978615689,1.3459465033796,41,24,17,50,32,18,60,51,9,4,5,0,0
"5285","CGY","CBJ",2018020420,17869,20182019,0,60,9,6,3,5.27626497792517,4.7244335338728,0.551831444052368,28,30,-2,35,39,-4,44,49,-5,4,3,0,0
"5286","CGY","MIN",2018020435,17871,20182019,1,60,2,0,2,2.67701792769132,6.69959803870134,-4.02258011101002,20,31,-11,33,43,-10,54,54,0,3,6,0,0
"5287","CGY","EDM",2018020459,17874,20182019,0,60,0,1,-1,2.52574728481915,2.88236825828062,-0.356620973461474,24,30,-6,32,39,-7,52,53,-1,2,5,0,0
"5288","CGY","PHI",2018020477,17877,20182019,1,60.5833333333333,6,5,1,4.76451419730438,2.47442451882398,2.2900896784804,41,19,22,53,25,28,71,37,34,7,4,0,0
"5289","CGY","MIN",2018020495,17880,20182019,0,60,2,1,1,4.37155213672668,5.184339244086,-0.812787107359327,26,35,-9,37,44,-7,51,55,-4,3,4,0,0
"5290","CGY","DAL",2018020523,17883,20182019,0,60,0,2,-2,4.32670805958332,2.95636668117117,1.37034137841215,24,28,-4,36,39,-3,49,50,-1,4,2,0,0
"5291","CGY","T.B",2018020537,17885,20182019,1,65,4,4,0,4.65359597210136,4.43342781115472,0.220168160946638,37,36,1,49,47,2,60,61,-1,1,4,0,0
"5292","CGY","WPG",2018020574,17892,20182019,0,60,4,1,3,3.5124117032974,3.732356606118,-0.219944902820599,29,36,-7,38,52,-14,52,67,-15,5,3,0,0
"5293","CGY","BOS",2018020622,17899,20182019,0,60,4,6,-2,4.22678442184497,3.42218523605617,0.804599185788799,37,27,10,55,32,23,71,45,26,4,3,0,0
"5294","CGY","PHI",2018020636,17901,20182019,0,61.9833333333333,3,2,1,6.72651412579717,3.77232357022149,2.95419055557568,32,34,-2,46,51,-5,63,66,-3,3,5,0,0
"5295","CGY","CHI",2018020655,17903,20182019,0,60,4,3,1,6.98455790694425,4.7768229041867,2.20773500275754,43,35,8,54,45,9,68,61,7,4,3,0,0
"5296","CGY","COL",2018020669,17905,20182019,1,60,5,3,2,2.19079111225437,4.28569562194753,-2.09490450969315,16,35,-19,31,57,-26,42,79,-37,2,4,0,0
"5297","CGY","ARI",2018020704,17909,20182019,1,60,7,1,6,4.1641432621438,4.36007097535912,-0.195927713215326,26,23,3,35,40,-5,42,52,-10,1,3,0,0
"5298","CGY","EDM",2018020749,17915,20182019,0,60,5,2,3,6.26703619401621,4.71070524476277,1.55633094925344,34,24,10,41,37,4,55,52,3,10,8,0,0
"5299","CGY","CAR",2018020763,17918,20182019,1,60.25,3,2,1,4.77679295261623,4.63295794886653,0.1438350037497,25,35,-10,35,52,-17,47,70,-23,4,2,0,0
"5300","CGY","CAR",2018020804,17930,20182019,0,60,4,3,1,6.14588822406222,3.87401978716662,2.2718684368956,32,37,-5,49,47,2,57,68,-11,5,4,0,0
"5301","CGY","S.J",2018020835,17934,20182019,1,60,2,5,-3,5.71481151067411,3.52125858795625,2.19355292271786,38,30,8,53,41,12,73,53,20,7,3,0,0
"5302","CGY","VAN",2018020850,17936,20182019,0,65,3,3,0,4.10646937882811,2.37919933062494,1.72727004820317,47,25,22,61,39,22,77,56,21,5,6,0,0
"5303","CGY","T.B",2018020868,17939,20182019,0,60,3,6,-3,3.60175803923199,3.96044981716841,-0.358691777936425,22,27,-5,35,39,-4,51,53,-2,4,4,0,0
"5304","CGY","PIT",2018020893,17943,20182019,0,60,5,4,1,3.6931924266537,5.52105871932145,-1.82786629266775,31,38,-7,43,50,-7,53,66,-13,4,5,0,0
"5305","CGY","ARI",2018020910,17945,20182019,1,60,5,2,3,3.87990665335033,4.00242689602345,-0.122520242673113,33,29,4,45,42,3,65,53,12,2,3,0,0
"5306","CGY","NYI",2018020927,17947,20182019,1,60,4,2,2,5.1040828140489,3.02864251256688,2.07544030148202,32,19,13,48,28,20,68,47,21,5,4,0,0
"5307","CGY","ANA",2018020943,17949,20182019,1,60,2,1,1,4.31646815946943,4.52230211217829,-0.205833952708865,28,26,2,50,38,12,67,52,15,1,2,0,0
"5308","CGY","NYI",2018020969,17953,20182019,0,60,3,1,2,3.91526525855943,3.16441907371336,0.750846184846068,27,27,0,37,42,-5,55,53,2,5,4,0,0
"5309","CGY","N.J",2018020980,17954,20182019,0,60,2,1,1,5.14237072272226,2.8697457096132,2.27262501310906,35,20,15,47,30,17,58,40,18,5,3,0,0
"5310","CGY","MIN",2018021008,17957,20182019,1,60,2,4,-2,5.29179729210716,3.66236444737297,1.6294328447342,37,23,14,53,35,18,77,44,33,3,1,0,0
"5311","CGY","TOR",2018021018,17959,20182019,1,60,2,6,-4,5.01821114769342,4.84364232991356,0.174568817779853,37,32,5,58,41,17,78,57,21,1,2,0,0
"5312","CGY","VGK",2018021032,17961,20182019,0,60,1,2,-1,3.50564681308416,5.10923986713624,-1.60359305405209,34,38,-4,39,48,-9,56,66,-10,5,6,0,0
"5313","CGY","ARI",2018021041,17962,20182019,0,60,0,2,-2,3.87959046297965,3.44788352579053,0.431706937189119,30,26,4,53,40,13,80,56,24,3,4,0,0
"5314","CGY","VGK",2018021063,17965,20182019,1,60,6,3,3,5.71767991721551,3.72537488530297,1.99230503191254,35,28,7,43,45,-2,51,58,-7,3,3,0,0
"5315","CGY","N.J",2018021078,17967,20182019,1,60,9,4,5,7.48000416719151,2.17941153232667,5.30059263486484,39,26,13,53,36,17,72,43,29,2,2,0,0
"5316","CGY","NYR",2018021097,17970,20182019,1,60,5,1,4,4.6218421287158,2.62082401545194,2.00101811326385,32,25,7,40,31,9,54,36,18,5,5,0,0
"5317","CGY","WPG",2018021107,17971,20182019,0,60,1,2,-1,5.08465773765056,2.69455878770896,2.3900989499416,28,21,7,40,34,6,57,41,16,3,3,0,0
"5318","CGY","CBJ",2018021131,17974,20182019,1,60,4,2,2,3.49874244484818,3.41759287098648,0.0811495738616941,31,33,-2,43,52,-9,53,66,-13,1,3,0,0
"5319","CGY","VAN",2018021161,17978,20182019,0,60,3,1,2,5.39729316691228,4.3035895396024,1.09370362730988,31,28,3,49,41,8,62,51,11,6,4,0,0
"5320","CGY","L.A",2018021176,17980,20182019,1,60,0,3,-3,4.68364893674152,4.46842741132423,0.215221525417292,42,20,22,54,26,28,76,37,39,6,5,0,0
"5321","CGY","DAL",2018021187,17982,20182019,1,60,1,2,-1,3.11448895404195,3.21057396463584,-0.096085010593896,36,23,13,49,31,18,76,44,32,2,2,0,0
"5322","CGY","ANA",2018021201,17984,20182019,1,60,6,1,5,5.40246919487254,3.71806872684829,1.68440046802425,37,22,15,48,30,18,66,42,24,3,1,0,0
"5323","CGY","S.J",2018021220,17986,20182019,0,60,5,3,2,3.42234141378412,2.44642663132065,0.975914782463474,28,15,13,44,27,17,55,47,8,6,2,0,0
"5324","CGY","L.A",2018021228,17987,20182019,0,60,7,2,5,4.22030057310985,4.22337243659422,-0.00307186348436517,30,25,5,45,40,5,57,52,5,1,3,0,0
"5325","CGY","ANA",2018021241,17989,20182019,0,60,1,3,-2,3.16660082977251,4.03339105590843,-0.866790226135922,26,32,-6,36,47,-11,45,57,-12,5,2,0,0
"5326","CGY","EDM",2018021268,17992,20182019,1,60,1,3,-2,3.79785555589478,3.17331990625352,0.624535649641266,31,25,6,47,33,14,59,41,18,3,1,0,0
"5327","CGY","COL",2018030171,17997,20182019,1,60,4,0,4,5.36691339684789,4.81640561248059,0.550507784367299,32,26,6,42,39,3,60,58,2,6,5,0,0
"5328","CGY","COL",2018030172,17999,20182019,1,68.45,2,3,-1,5.47756694505934,5.21732228787084,0.260244657188498,37,39,-2,49,55,-6,61,84,-23,7,6,0,0
"5329","CGY","COL",2018030173,18001,20182019,0,60,2,6,-4,3.80201122464464,4.60825964110438,-0.806248416459738,29,56,-27,41,65,-24,61,80,-19,8,9,0,0
"5330","CGY","COL",2018030174,18003,20182019,0,70.3833333333333,2,3,-1,4.23184064304587,7.52921468167915,-3.29737403863328,37,52,-15,45,65,-20,61,84,-23,4,5,0,0
"5331","CGY","COL",2018030175,18005,20182019,1,60,1,5,-4,3.64430843079413,2.44141186381398,1.20289656698014,29,32,-3,42,43,-1,59,53,6,4,5,0,0
"5332","CHI","NYR",2008020010,14162,20082009,0,60,2,4,-2,0,0,0,32,29,3,45,39,6,53,51,2,3,3,0,0
"5333","CHI","WSH",2008020020,14163,20082009,0,60,2,4,-2,0,0,0,21,34,-13,36,44,-8,47,59,-12,6,5,0,0
"5334","CHI","NSH",2008020038,14165,20082009,1,65,2,2,0,0,0,0,25,27,-2,34,41,-7,45,50,-5,5,3,0,0
"5335","CHI","ARI",2008020046,14167,20082009,1,60,4,1,3,0,0,0,30,30,0,37,36,1,53,49,4,9,10,0,0
"5336","CHI","STL",2008020073,14170,20082009,0,65,3,3,0,0,0,0,26,29,-3,32,43,-11,47,58,-11,4,4,0,0
"5337","CHI","VAN",2008020076,14171,20082009,1,60,4,2,2,0,0,0,26,30,-4,32,34,-2,35,53,-18,8,8,0,0
"5338","CHI","EDM",2008020091,14174,20082009,1,60,3,0,3,0,0,0,30,23,7,37,28,9,50,39,11,4,5,0,0
"5339","CHI","DET",2008020115,14177,20082009,1,65,5,5,0,0,0,0,41,44,-3,49,47,2,56,53,3,8,3,0,0
"5340","CHI","MIN",2008020123,14179,20082009,0,60,2,3,-1,0,0,0,36,18,18,49,32,17,62,40,22,4,5,0,0
"5341","CHI","DAL",2008020148,14183,20082009,1,60,5,2,3,0,0,0,32,23,9,41,27,14,53,41,12,5,7,0,0
"5342","CHI","CBJ",2008020156,14184,20082009,0,65,3,3,0,0,0,0,24,51,-27,36,66,-30,42,84,-42,4,10,0,0
"5343","CHI","COL",2008020170,14186,20082009,1,60,6,2,4,0,0,0,37,26,11,42,35,7,56,44,12,5,6,0,0
"5344","CHI","CGY",2008020210,14192,20082009,1,60,6,1,5,0,0,0,27,23,4,37,26,11,43,35,8,8,8,0,0
"5345","CHI","BOS",2008020226,14195,20082009,1,65,1,1,0,0,0,0,32,39,-7,38,42,-4,50,59,-9,8,8,0,0
"5346","CHI","STL",2008020240,14197,20082009,1,62.25,3,4,-1,0,0,0,35,30,5,46,35,11,64,48,16,6,6,0,0
"5347","CHI","S.J",2008020255,14199,20082009,1,60,5,6,-1,0,0,0,33,31,2,40,39,1,46,49,-3,5,6,0,0
"5348","CHI","ARI",2008020266,14201,20082009,0,65,2,2,0,0,0,0,40,38,2,49,51,-2,71,70,1,5,7,0,0
"5349","CHI","DAL",2008020275,14203,20082009,0,60,6,3,3,0,0,0,30,34,-4,46,46,0,52,52,0,5,3,0,0
"5350","CHI","TOR",2008020288,14205,20082009,0,60.8166666666667,5,4,1,0,0,0,36,38,-2,52,54,-2,64,65,-1,3,3,0,0
"5351","CHI","S.J",2008020320,14209,20082009,0,60.75,2,3,-1,0,0,0,26,40,-14,36,56,-20,58,68,-10,1,3,0,0
"5352","CHI","ANA",2008020327,14211,20082009,0,60,0,1,-1,0,0,0,26,21,5,39,28,11,42,34,8,2,1,0,0
"5353","CHI","L.A",2008020335,14212,20082009,0,60,2,5,-3,0,0,0,24,28,-4,32,50,-18,52,65,-13,3,4,0,0
"5354","CHI","ANA",2008020364,14216,20082009,1,60,4,2,2,0,0,0,41,32,9,48,38,10,60,43,17,5,3,0,0
"5355","CHI","DET",2008020386,14219,20082009,0,65,4,4,0,0,0,0,32,30,2,39,42,-3,50,51,-1,3,3,0,0
"5356","CHI","ARI",2008020394,14220,20082009,1,60,7,1,6,0,0,0,28,21,7,39,25,14,58,32,26,5,3,0,0
"5357","CHI","OTT",2008020410,14223,20082009,1,60,2,0,2,0,0,0,30,23,7,42,30,12,54,39,15,6,5,0,0
"5358","CHI","COL",2008020427,14225,20082009,0,60,4,3,1,0,0,0,30,21,9,43,26,17,59,35,24,6,5,0,0
"5359","CHI","CBJ",2008020441,14227,20082009,1,60,3,1,2,0,0,0,31,32,-1,39,42,-3,49,54,-5,3,1,0,0
"5360","CHI","EDM",2008020453,14229,20082009,0,60,9,2,7,0,0,0,44,33,11,61,45,16,79,57,22,5,3,0,0
"5361","CHI","CGY",2008020472,14232,20082009,0,60.3833333333333,3,2,1,0,0,0,31,34,-3,39,45,-6,51,54,-3,3,4,0,0
"5362","CHI","VAN",2008020484,14233,20082009,0,60,3,1,2,0,0,0,34,31,3,48,51,-3,54,65,-11,5,7,0,0
"5363","CHI","PHI",2008020513,14239,20082009,1,60,5,1,4,0,0,0,38,18,20,50,21,29,67,29,38,8,2,0,0
"5364","CHI","MIN",2008020529,14241,20082009,0,60,4,1,3,0,0,0,32,19,13,44,28,16,68,42,26,4,2,0,0
"5365","CHI","DET",2008020543,14243,20082009,0,60,0,4,-4,0,0,0,36,39,-3,50,45,5,59,53,6,6,6,0,0
"5366","CHI","DET",2008020554,14245,20082009,1,60,4,6,-2,0,0,0,37,43,-6,40,54,-14,51,60,-9,6,5,0,0
"5367","CHI","CGY",2008020579,14248,20082009,1,60,5,2,3,0,0,0,36,36,0,46,40,6,54,53,1,6,4,0,0
"5368","CHI","ARI",2008020594,14250,20082009,0,60,6,0,6,0,0,0,41,22,19,58,31,27,71,41,30,4,8,0,0
"5369","CHI","COL",2008020605,14252,20082009,0,60,1,2,-1,0,0,0,44,32,12,55,43,12,65,57,8,1,3,0,0
"5370","CHI","NSH",2008020622,14254,20082009,0,60,1,4,-3,0,0,0,35,38,-3,56,48,8,70,56,14,6,5,0,0
"5371","CHI","NSH",2008020626,14255,20082009,1,60,3,1,2,0,0,0,33,27,6,39,32,7,49,40,9,5,2,0,0
"5372","CHI","BUF",2008020644,14258,20082009,1,60,4,1,3,0,0,0,25,23,2,32,27,5,37,38,-1,6,9,0,0
"5373","CHI","NYR",2008020660,14260,20082009,1,62.3833333333333,2,3,-1,0,0,0,34,22,12,42,25,17,57,35,22,10,5,0,0
"5374","CHI","STL",2008020669,14261,20082009,0,61.3833333333333,2,1,1,0,0,0,21,28,-7,35,49,-14,50,56,-6,3,5,0,0
"5375","CHI","MIN",2008020682,14263,20082009,1,60,1,4,-3,0,0,0,41,26,15,49,34,15,57,40,17,3,3,0,0
"5376","CHI","STL",2008020698,14265,20082009,1,60,0,2,-2,0,0,0,21,29,-8,26,33,-7,39,53,-14,4,4,0,0
"5377","CHI","ANA",2008020714,14272,20082009,0,60,3,2,1,0,0,0,27,38,-11,37,58,-21,43,66,-23,4,3,0,0
"5378","CHI","L.A",2008020723,14273,20082009,0,60,2,5,-3,0,0,0,33,26,7,51,33,18,70,47,23,2,3,0,0
"5379","CHI","S.J",2008020741,14275,20082009,0,60,4,2,2,0,0,0,29,34,-5,43,43,0,62,58,4,3,4,0,0
"5380","CHI","EDM",2008020757,14278,20082009,0,60,3,1,2,0,0,0,41,21,20,55,32,23,69,46,23,1,3,0,0
"5381","CHI","CGY",2008020770,14280,20082009,0,60,5,2,3,0,0,0,33,31,2,47,45,2,60,58,2,7,6,0,0
"5382","CHI","VAN",2008020788,14282,20082009,0,60,3,7,-4,0,0,0,39,26,13,46,36,10,64,47,17,5,7,0,0
"5383","CHI","ATL",2008020804,14286,20082009,0,60,3,1,2,0,0,0,28,37,-9,36,46,-10,45,62,-17,3,4,0,0
"5384","CHI","STL",2008020822,14288,20082009,0,60,0,1,-1,0,0,0,22,23,-1,38,32,6,47,45,2,6,6,0,0
"5385","CHI","DAL",2008020832,14289,20082009,1,60,6,2,4,0,0,0,36,18,18,49,25,24,61,29,32,4,1,0,0
"5386","CHI","T.B",2008020849,14292,20082009,0,60,5,3,2,0,0,0,49,23,26,59,28,31,73,34,39,6,6,0,0
"5387","CHI","FLA",2008020865,14294,20082009,0,60,4,0,4,0,0,0,42,31,11,60,42,18,78,46,32,6,3,0,0
"5388","CHI","DAL",2008020876,14296,20082009,0,60,3,1,2,0,0,0,36,31,5,52,45,7,67,65,2,5,6,0,0
"5389","CHI","MIN",2008020891,14297,20082009,1,60,1,2,-1,0,0,0,45,24,21,55,28,27,63,43,20,7,6,0,0
"5390","CHI","NSH",2008020899,14299,20082009,0,60,3,5,-2,0,0,0,32,29,3,43,39,4,57,51,6,2,6,0,0
"5391","CHI","PIT",2008020920,14302,20082009,1,61.6,4,5,-1,0,0,0,45,28,17,54,30,24,70,43,27,9,6,0,0
"5392","CHI","L.A",2008020936,14304,20082009,1,60,4,2,2,0,0,0,38,24,14,50,30,20,61,35,26,5,4,0,0
"5393","CHI","ANA",2008020949,14306,20082009,1,61.6666666666667,3,2,1,0,0,0,37,28,9,46,41,5,54,51,3,2,3,0,0
"5394","CHI","BOS",2008020969,14310,20082009,0,60,3,5,-2,0,0,0,35,39,-4,52,42,10,69,56,13,3,3,0,0
"5395","CHI","COL",2008020983,14311,20082009,1,60,1,5,-4,0,0,0,25,29,-4,36,33,3,48,37,11,6,5,0,0
"5396","CHI","CAR",2008021001,14314,20082009,1,65,2,2,0,0,0,0,41,31,10,52,37,15,60,42,18,6,4,0,0
"5397","CHI","NYI",2008021033,14318,20082009,1,60,2,4,-2,0,0,0,42,19,23,54,22,32,73,30,43,6,7,0,0
"5398","CHI","N.J",2008021040,14320,20082009,0,60,2,3,-1,0,0,0,32,30,2,44,40,4,48,48,0,5,4,0,0
"5399","CHI","EDM",2008021068,14323,20082009,1,65,4,4,0,0,0,0,43,31,12,54,38,16,64,43,21,4,3,0,0
"5400","CHI","L.A",2008021080,14325,20082009,1,60,4,1,3,0,0,0,32,15,17,41,25,16,53,37,16,7,3,0,0
"5401","CHI","S.J",2008021100,14328,20082009,1,65,5,5,0,0,0,0,32,28,4,37,35,2,46,46,0,2,2,0,0
"5402","CHI","N.J",2008021113,14330,20082009,1,63.6,3,2,1,0,0,0,42,30,12,52,36,16,61,42,19,6,2,0,0
"5403","CHI","VAN",2008021131,14332,20082009,1,60,0,4,-4,0,0,0,26,23,3,36,27,9,45,35,10,5,9,0,0
"5404","CHI","MTL",2008021139,14334,20082009,0,60,1,4,-3,0,0,0,29,33,-4,40,42,-2,55,49,6,6,5,0,0
"5405","CHI","STL",2008021148,14335,20082009,1,60,3,1,2,0,0,0,30,17,13,41,18,23,55,22,33,7,3,0,0
"5406","CHI","NSH",2008021163,14337,20082009,1,60,3,1,2,0,0,0,32,26,6,34,28,6,39,30,9,2,1,0,0
"5407","CHI","NSH",2008021191,14341,20082009,0,60,4,2,2,0,0,0,28,24,4,36,34,2,0,0,0,2,3,0,0
"5408","CHI","DET",2008021216,14345,20082009,0,60,4,2,2,0,0,0,26,23,3,37,34,3,44,45,-1,5,2,0,0
"5409","CHI","DET",2008021230,14346,20082009,1,60,3,0,3,0,0,0,23,37,-14,31,51,-20,37,59,-22,3,5,0,0
"5410","CHI","CGY",2008030181,14350,20082009,1,60.2,3,2,1,0,0,0,28,25,3,40,29,11,50,34,16,3,2,0,0
"5411","CHI","CGY",2008030182,14352,20082009,1,60,3,2,1,0,0,0,33,32,1,42,35,7,51,46,5,4,5,0,0
"5412","CHI","CGY",2008030183,14354,20082009,0,60,2,4,-2,0,0,0,38,28,10,55,38,17,70,51,19,11,7,0,0
"5413","CHI","CGY",2008030184,14356,20082009,0,60,4,6,-2,0,0,0,32,27,5,42,37,5,46,50,-4,4,1,0,0
"5414","CHI","CGY",2008030185,14359,20082009,1,60,5,1,4,0,0,0,28,20,8,38,28,10,44,40,4,5,4,0,0
"5415","CHI","CGY",2008030186,14361,20082009,0,60,4,1,3,0,0,0,16,44,-28,27,53,-26,33,70,-37,2,3,0,0
"5416","CHI","VAN",2008030241,14364,20082009,0,60,3,5,-2,0,0,0,31,27,4,40,45,-5,52,59,-7,3,5,0,0
"5417","CHI","VAN",2008030242,14366,20082009,0,60,6,3,3,0,0,0,32,21,11,43,29,14,62,38,24,11,10,0,0
"5418","CHI","VAN",2008030243,14369,20082009,1,60,1,3,-2,0,0,0,24,21,3,30,23,7,51,36,15,6,6,0,0
"5419","CHI","VAN",2008030244,14371,20082009,1,62.8666666666667,2,1,1,0,0,0,28,15,13,40,17,23,49,26,23,5,4,0,0
"5420","CHI","VAN",2008030245,14373,20082009,0,60,4,2,2,0,0,0,30,21,9,40,31,9,56,44,12,6,3,0,0
"5421","CHI","VAN",2008030246,14375,20082009,1,60,7,5,2,0,0,0,30,38,-8,37,42,-5,42,55,-13,4,5,0,0
"5422","CHI","DET",2008030321,14381,20082009,0,60,2,5,-3,0,0,0,32,43,-11,37,54,-17,44,74,-30,3,5,0,0
"5423","CHI","DET",2008030322,14383,20082009,0,65.2333333333333,2,3,-1,0,0,0,39,38,1,54,55,-1,67,75,-8,6,5,0,0
"5424","CHI","DET",2008030323,14386,20082009,1,61.8666666666667,4,3,1,0,0,0,27,30,-3,32,36,-4,41,51,-10,4,5,0,0
"5425","CHI","DET",2008030324,14388,20082009,1,60,1,6,-5,0,0,0,28,33,-5,36,44,-8,47,50,-3,7,13,0,0
"5426","CHI","DET",2008030325,14391,20082009,0,63.9666666666667,1,2,-1,0,0,0,31,46,-15,42,55,-13,55,67,-12,4,4,0,0
"5427","CHI","FLA",2009020007,14519,20092010,1,65,3,3,0,0,0,0,55,24,31,70,36,34,90,53,37,3,3,0,0
"5428","CHI","FLA",2009020017,14520,20092010,0,60,4,0,4,0,0,0,33,23,10,44,38,6,59,48,11,5,3,0,0
"5429","CHI","DET",2009020041,14525,20092010,0,60,2,3,-1,0,0,0,34,23,11,49,31,18,64,48,16,5,5,0,0
"5430","CHI","COL",2009020058,14527,20092010,1,65,3,3,0,0,0,0,26,19,7,36,24,12,62,41,21,5,5,0,0
"5431","CHI","CGY",2009020071,14529,20092010,1,60.4333333333333,6,5,1,0,0,0,39,20,19,56,27,29,72,28,44,4,1,0,0
"5432","CHI","EDM",2009020077,14531,20092010,1,60,4,3,1,0,0,0,38,19,19,42,22,20,59,36,23,4,4,0,0
"5433","CHI","NSH",2009020085,14532,20092010,0,60,3,1,2,0,0,0,30,13,17,40,26,14,49,42,7,2,3,0,0
"5434","CHI","DAL",2009020102,14534,20092010,1,60,3,4,-1,0,0,0,32,25,7,41,32,9,54,47,7,5,5,0,0
"5435","CHI","VAN",2009020116,14538,20092010,1,60,2,3,-1,0,0,0,20,31,-11,31,36,-5,42,55,-13,5,6,0,0
"5436","CHI","NSH",2009020140,14541,20092010,1,60,2,0,2,0,0,0,34,27,7,42,40,2,55,47,8,3,4,0,0
"5437","CHI","MIN",2009020150,14543,20092010,1,60,3,1,2,0,0,0,35,21,14,40,29,11,56,46,10,5,7,0,0
"5438","CHI","NSH",2009020169,14546,20092010,0,60,0,2,-2,0,0,0,22,28,-6,32,41,-9,49,53,-4,5,7,0,0
"5439","CHI","MTL",2009020176,14547,20092010,1,60,3,2,1,0,0,0,36,22,14,43,29,14,58,46,12,9,4,0,0
"5440","CHI","COL",2009020224,14554,20092010,0,65,3,3,0,0,0,0,32,22,10,43,27,16,72,48,24,5,3,0,0
"5441","CHI","L.A",2009020240,14557,20092010,1,60,4,1,3,0,0,0,29,18,11,38,29,9,53,41,12,4,3,0,0
"5442","CHI","COL",2009020252,14559,20092010,1,65,2,2,0,0,0,0,39,27,12,53,37,16,74,49,25,2,4,0,0
"5443","CHI","TOR",2009020267,14561,20092010,1,60,3,2,1,0,0,0,34,31,3,46,35,11,60,45,15,5,3,0,0
"5444","CHI","S.J",2009020282,14563,20092010,1,60.6833333333333,4,3,1,0,0,0,30,23,7,42,32,10,52,43,9,2,4,0,0
"5445","CHI","CGY",2009020305,14567,20092010,0,60,7,1,6,0,0,0,26,28,-2,36,36,0,45,54,-9,5,5,0,0
"5446","CHI","EDM",2009020324,14569,20092010,0,60,5,2,3,0,0,0,30,27,3,42,38,4,60,50,10,2,2,0,0
"5447","CHI","VAN",2009020327,14570,20092010,0,60,1,0,1,0,0,0,17,30,-13,28,46,-18,37,64,-27,4,5,0,0
"5448","CHI","S.J",2009020352,14573,20092010,0,60,7,2,5,0,0,0,41,24,17,52,39,13,63,55,8,2,6,0,0
"5449","CHI","ANA",2009020359,14575,20092010,0,60,0,3,-3,0,0,0,28,34,-6,41,40,1,52,48,4,4,5,0,0
"5450","CHI","L.A",2009020379,14576,20092010,0,65,1,1,0,0,0,0,33,22,11,41,34,7,50,51,-1,4,3,0,0
"5451","CHI","NSH",2009020412,14582,20092010,1,60,1,4,-3,0,0,0,35,23,12,44,29,15,56,37,19,2,3,0,0
"5452","CHI","PIT",2009020422,14583,20092010,0,62.6333333333333,2,1,1,0,0,0,31,33,-2,51,48,3,71,69,2,5,3,0,0
"5453","CHI","NYR",2009020448,14587,20092010,1,63.7166666666667,2,1,1,0,0,0,41,18,23,58,21,37,75,32,43,6,2,0,0
"5454","CHI","T.B",2009020478,14591,20092010,1,60,4,0,4,0,0,0,29,18,11,38,25,13,53,34,19,8,6,0,0
"5455","CHI","STL",2009020500,14594,20092010,1,60,3,0,3,0,0,0,35,27,8,45,35,10,51,48,3,9,7,0,0
"5456","CHI","BOS",2009020515,14596,20092010,1,65,4,4,0,0,0,0,44,29,15,56,38,18,65,50,15,2,1,0,0
"5457","CHI","DET",2009020529,14598,20092010,1,60,3,0,3,0,0,0,35,20,15,47,25,22,63,38,25,5,3,0,0
"5458","CHI","S.J",2009020542,14600,20092010,1,60,2,3,-1,0,0,0,47,14,33,60,19,41,77,32,45,8,6,0,0
"5459","CHI","DET",2009020553,14601,20092010,0,60,3,0,3,0,0,0,31,33,-2,37,44,-7,53,55,-2,5,7,0,0
"5460","CHI","NSH",2009020564,14604,20092010,0,60,4,1,3,0,0,0,40,26,14,50,37,13,61,54,7,4,4,0,0
"5461","CHI","NSH",2009020574,14605,20092010,1,60,5,4,1,0,0,0,29,20,9,41,27,14,52,33,19,6,4,0,0
"5462","CHI","DAL",2009020587,14607,20092010,0,60,4,5,-1,0,0,0,37,24,13,54,31,23,73,41,32,4,5,0,0
"5463","CHI","N.J",2009020607,14609,20092010,1,60,5,1,4,0,0,0,36,27,9,48,37,11,67,50,17,3,3,0,0
"5464","CHI","STL",2009020618,14611,20092010,0,60,6,3,3,0,0,0,33,22,11,44,46,-2,53,62,-9,7,4,0,0
"5465","CHI","ANA",2009020626,14612,20092010,1,60,5,2,3,0,0,0,28,24,4,50,31,19,63,43,20,4,3,0,0
"5466","CHI","MIN",2009020635,14614,20092010,1,60,4,1,3,0,0,0,33,20,13,39,27,12,53,41,12,4,3,0,0
"5467","CHI","BOS",2009020645,14616,20092010,0,60,5,2,3,0,0,0,36,21,15,45,31,14,56,47,9,3,5,0,0
"5468","CHI","MIN",2009020668,14618,20092010,0,65,5,5,0,0,0,0,25,21,4,32,27,5,45,40,5,2,2,0,0
"5469","CHI","ANA",2009020675,14619,20092010,1,60,1,3,-2,0,0,0,43,12,31,57,14,43,73,25,48,4,3,0,0
"5470","CHI","DET",2009020720,14626,20092010,0,65,3,3,0,0,0,0,29,38,-9,45,51,-6,58,67,-9,4,3,0,0
"5471","CHI","OTT",2009020737,14628,20092010,0,60,1,4,-3,0,0,0,30,18,12,38,23,15,50,36,14,5,6,0,0
"5472","CHI","CGY",2009020753,14630,20092010,0,60,3,1,2,0,0,0,28,20,8,38,34,4,49,51,-2,3,2,0,0
"5473","CHI","VAN",2009020770,14632,20092010,0,60,1,5,-4,0,0,0,44,28,16,53,33,20,70,43,27,6,3,0,0
"5474","CHI","EDM",2009020785,14635,20092010,0,60,4,2,2,0,0,0,37,24,13,56,33,23,69,48,21,2,1,0,0
"5475","CHI","S.J",2009020800,14637,20092010,0,61.6166666666667,4,3,1,0,0,0,39,37,2,47,51,-4,61,68,-7,2,3,0,0
"5476","CHI","CAR",2009020811,14639,20092010,0,60,2,4,-2,0,0,0,41,24,17,60,40,20,79,53,26,3,2,0,0
"5477","CHI","STL",2009020837,14643,20092010,1,60,2,3,-1,0,0,0,34,19,15,43,28,15,52,32,20,2,3,0,0
"5478","CHI","STL",2009020865,14646,20092010,0,60,2,1,1,0,0,0,30,35,-5,38,43,-5,46,58,-12,6,8,0,0
"5479","CHI","DAL",2009020882,14649,20092010,1,65,3,3,0,0,0,0,40,27,13,49,37,12,63,51,12,3,5,0,0
"5480","CHI","ATL",2009020913,14653,20092010,1,65,4,4,0,0,0,0,40,27,13,55,34,21,74,44,30,7,6,0,0
"5481","CHI","NYI",2009020925,14670,20092010,0,60,3,5,-2,0,0,0,44,23,21,61,31,30,82,40,42,3,0,0,0
"5482","CHI","EDM",2009020938,14671,20092010,1,60,5,2,3,0,0,0,47,14,33,68,16,52,80,25,55,9,6,0,0
"5483","CHI","VAN",2009020952,14673,20092010,1,60,6,3,3,0,0,0,24,23,1,28,33,-5,41,40,1,9,6,0,0
"5484","CHI","DET",2009020971,14675,20092010,1,60,4,5,-1,0,0,0,32,25,7,43,30,13,58,44,14,5,3,0,0
"5485","CHI","L.A",2009020988,14678,20092010,1,62.1333333333333,3,2,1,0,0,0,43,30,13,56,35,21,74,48,26,4,2,0,0
"5486","CHI","PHI",2009021006,14681,20092010,0,60,2,3,-1,0,0,0,41,34,7,56,50,6,82,67,15,5,4,0,0
"5487","CHI","ANA",2009021041,14685,20092010,0,60,2,4,-2,0,0,0,41,36,5,63,45,18,76,58,18,5,4,0,0
"5488","CHI","L.A",2009021052,14686,20092010,0,60,3,0,3,0,0,0,37,17,20,57,27,30,75,36,39,4,0,0,0
"5489","CHI","STL",2009021139,14698,20092010,0,60,2,4,-2,0,0,0,34,30,4,46,43,3,66,50,16,2,1,0,0
"5490","CHI","MIN",2009021145,14699,20092010,0,60,4,0,4,0,0,0,35,21,14,51,33,18,64,52,12,1,3,0,0
"5491","CHI","N.J",2009021157,14701,20092010,0,65,1,1,0,0,0,0,26,33,-7,29,45,-16,42,52,-10,0,0,0,0
"5492","CHI","CGY",2009021176,14703,20092010,1,60,4,1,3,0,0,0,31,26,5,41,34,7,55,50,5,3,1,0,0
"5493","CHI","DAL",2009021189,14705,20092010,0,60,5,2,3,0,0,0,38,28,10,51,46,5,63,64,-1,2,5,0,0
"5494","CHI","STL",2009021195,14706,20092010,1,60,6,5,1,0,0,0,26,31,-5,34,37,-3,52,53,-1,7,6,0,0
"5495","CHI","COL",2009021211,14708,20092010,0,60,5,2,3,0,0,0,37,32,5,55,39,16,70,53,17,4,2,0,0
"5496","CHI","DET",2009021225,14710,20092010,1,63.1833333333333,2,3,-1,0,0,0,29,21,8,44,28,16,59,46,13,4,2,0,0
"5497","CHI","NSH",2009030161,14715,20092010,1,60,1,4,-3,0,0,0,26,26,0,44,43,1,63,57,6,2,3,0,0
"5498","CHI","NSH",2009030162,14717,20092010,1,60,2,0,2,0,0,0,33,23,10,44,33,11,54,46,8,7,7,0,0
"5499","CHI","NSH",2009030163,14719,20092010,0,60,1,4,-3,0,0,0,27,35,-8,38,49,-11,52,66,-14,4,6,0,0
"5500","CHI","NSH",2009030164,14721,20092010,0,60,3,0,3,0,0,0,30,33,-3,37,48,-11,51,66,-15,3,6,0,0
"5501","CHI","NSH",2009030165,14723,20092010,1,64.1166666666667,5,4,1,0,0,0,32,21,11,46,27,19,59,41,18,4,4,0,0
"5502","CHI","NSH",2009030166,14725,20092010,0,60,5,3,2,0,0,0,32,28,4,45,39,6,52,57,-5,5,5,0,0
"5503","CHI","VAN",2009030241,14730,20092010,1,60,1,5,-4,0,0,0,37,28,9,51,35,16,64,48,16,6,4,0,0
"5504","CHI","VAN",2009030242,14732,20092010,1,60,4,2,2,0,0,0,34,26,8,47,44,3,63,62,1,2,6,0,0
"5505","CHI","VAN",2009030243,14734,20092010,0,60,5,2,3,0,0,0,35,33,2,45,47,-2,52,63,-11,8,5,0,0
"5506","CHI","VAN",2009030244,14736,20092010,0,60,7,4,3,0,0,0,34,30,4,38,45,-7,48,65,-17,8,4,0,0
"5507","CHI","VAN",2009030245,14738,20092010,1,60,1,4,-3,0,0,0,30,24,6,41,32,9,53,46,7,5,7,0,0
"5508","CHI","VAN",2009030246,14740,20092010,0,60,5,1,4,0,0,0,35,30,5,45,38,7,54,53,1,2,2,0,0
"5509","CHI","S.J",2009030321,14745,20092010,0,60,2,1,1,0,0,0,40,45,-5,53,59,-6,76,78,-2,0,5,0,0
"5510","CHI","S.J",2009030322,14747,20092010,0,60,4,2,2,0,0,0,22,27,-5,34,39,-5,52,62,-10,6,3,0,0
"5511","CHI","S.J",2009030323,14750,20092010,1,72.4,3,2,1,0,0,0,38,46,-8,48,61,-13,60,88,-28,2,6,0,0
"5512","CHI","S.J",2009030324,14752,20092010,1,60,4,2,2,0,0,0,27,18,9,40,23,17,59,41,18,5,2,0,0
"5513","CHI","PHI",2009030411,14758,20092010,1,60,6,5,1,0,0,0,32,32,0,39,44,-5,46,55,-9,0,4,0,0
"5514","CHI","PHI",2009030412,14760,20092010,1,60,2,1,1,0,0,0,26,33,-7,37,43,-6,52,61,-9,4,4,0,0
"5515","CHI","PHI",2009030413,14762,20092010,0,65.9833333333333,3,4,-1,0,0,0,27,32,-5,42,44,-2,62,67,-5,3,3,0,0
"5516","CHI","PHI",2009030414,14764,20092010,0,60,3,5,-2,0,0,0,34,31,3,49,43,6,77,54,23,4,7,0,0
"5517","CHI","PHI",2009030415,14766,20092010,1,60,7,4,3,0,0,0,28,27,1,42,36,6,62,44,18,4,3,0,0
"5518","CHI","PHI",2009030416,14769,20092010,0,64.1666666666667,4,3,1,0,0,0,41,24,17,51,41,10,71,63,8,5,4,0,0
"5519","CHI","COL",2010020004,14889,20102011,0,63.6666666666667,3,4,-1,5.5341023521687,7.01437583527081,-1.48027348310211,38,41,-3,46,48,-2,62,58,4,7,3,0,0
"5520","CHI","DET",2010020021,14891,20102011,1,60,2,3,-1,4.39890222075155,2.09033987772145,2.3085623430301,28,26,2,40,34,6,54,50,4,5,4,0,0
"5521","CHI","NSH",2010020040,14895,20102011,1,60,2,3,-1,3.65988936522626,3.41184638763661,0.248042977589648,25,27,-2,35,37,-2,46,51,-5,2,4,0,0
"5522","CHI","STL",2010020073,14900,20102011,1,63.8333333333333,3,2,1,4.7494202004309,4.83443906783941,-0.0850188674085075,33,34,-1,42,42,0,66,58,8,3,1,0,0
"5523","CHI","VAN",2010020080,14902,20102011,1,65,1,1,0,3.15578580078221,3.97891560030439,-0.823129799522178,32,37,-5,47,48,-1,59,64,-5,4,4,0,0
"5524","CHI","STL",2010020096,14904,20102011,0,60,2,4,-2,2.92177817062475,3.31378877224051,-0.392010601615766,25,28,-3,31,41,-10,48,51,-3,4,4,0,0
"5525","CHI","L.A",2010020127,14909,20102011,1,60,3,1,2,2.09542687866531,4.93724149558693,-2.84181461692162,28,34,-6,36,43,-7,55,59,-4,3,2,0,0
"5526","CHI","EDM",2010020141,14911,20102011,1,60,4,7,-3,3.54866669210605,4.2394407788355,-0.690774086729448,41,22,19,50,29,21,69,35,34,5,1,0,0
"5527","CHI","MIN",2010020150,14912,20102011,0,60,3,1,2,4.34603936679923,3.85523717591423,0.490802190885006,32,26,6,48,31,17,59,52,7,2,3,0,0
"5528","CHI","NYR",2010020157,14914,20102011,0,60,2,3,-1,5.53772440853322,3.20995677646715,2.32776763206607,35,23,12,45,34,11,78,49,29,4,3,0,0
"5529","CHI","N.J",2010020168,14916,20102011,1,60,3,5,-2,6.6498816551757,5.64573769372745,1.00414396144825,32,24,8,43,29,14,62,44,18,4,3,0,0
"5530","CHI","ATL",2010020193,14919,20102011,0,65,4,4,0,4.03731087849337,2.83219868841115,1.20511219008222,40,37,3,50,45,5,65,53,12,2,5,0,0
"5531","CHI","EDM",2010020201,14920,20102011,1,60,1,2,-1,2.89276511517096,3.28799975592119,-0.395234640750232,27,26,1,36,38,-2,52,50,2,3,4,0,0
"5532","CHI","NSH",2010020240,14926,20102011,0,65,3,3,0,4.59920292592869,4.50124512049873,0.0979578054299672,32,33,-1,43,44,-1,58,66,-8,7,6,0,0
"5533","CHI","ANA",2010020247,14927,20102011,1,64.5333333333333,3,2,1,5.80264683569334,2.89608684681298,2.90655998888036,43,26,17,66,37,29,84,49,35,4,2,0,0
"5534","CHI","EDM",2010020267,14930,20102011,0,60,5,0,5,4.95336618166039,3.83486265624042,1.11850352541997,47,18,29,60,33,27,71,49,22,3,2,0,0
"5535","CHI","CGY",2010020280,14932,20102011,0,60,2,7,-5,7.97817922318416,5.93492763389528,2.04325158928888,33,36,-3,60,45,15,80,58,22,2,5,0,0
"5536","CHI","VAN",2010020292,14933,20102011,0,60,7,1,6,0,0,0,41,28,13,53,37,16,62,56,6,8,4,0,0
"5537","CHI","S.J",2010020319,14937,20102011,0,60,2,5,-3,3.31185748189904,5.04563765582861,-1.73378017392957,32,29,3,47,42,5,61,52,9,4,6,0,0
"5538","CHI","ANA",2010020326,14939,20102011,0,60,4,1,3,4.35370045991221,4.24845415994059,0.105246299971622,34,27,7,50,38,12,62,46,16,3,6,0,0
"5539","CHI","L.A",2010020344,14940,20102011,0,60,2,1,1,3.80222925402495,2.68192441421045,1.1203048398145,23,22,1,33,36,-3,46,50,-4,4,6,0,0
"5540","CHI","STL",2010020355,14943,20102011,1,60,7,5,2,3.25291903025936,4.93079277038851,-1.67787374012914,24,26,-2,33,33,0,43,44,-1,7,6,0,0
"5541","CHI","VAN",2010020377,14946,20102011,1,60,0,3,-3,4.05619695056328,3.55649408166573,0.499702868897543,32,18,14,41,27,14,60,38,22,4,5,0,0
"5542","CHI","CGY",2010020393,14948,20102011,1,60,4,2,2,3.56298930566118,4.57269675452096,-1.00970744885979,32,26,6,48,37,11,61,50,11,9,8,0,0
"5543","CHI","DAL",2010020409,14951,20102011,1,60,5,3,2,4.77223476086147,4.09097914683142,0.68125561403005,25,31,-6,36,37,-1,51,47,4,6,1,0,0
"5544","CHI","S.J",2010020437,14954,20102011,0,63.8666666666667,1,2,-1,2.36803129219503,6.74834667067807,-4.38031537848305,29,30,-1,39,47,-8,53,67,-14,1,2,0,0
"5545","CHI","COL",2010020444,14956,20102011,0,60,5,7,-2,6.11018673328363,5.27880867631609,0.831378056967537,34,30,4,48,37,11,62,50,12,5,2,0,0
"5546","CHI","COL",2010020458,14958,20102011,1,60,3,4,-1,5.62949392136943,3.21763809209369,2.41185582927574,38,23,15,47,29,18,71,38,33,4,3,0,0
"5547","CHI","DET",2010020471,14960,20102011,1,60,4,1,3,3.12098570552189,2.53804745298112,0.582938252540771,31,30,1,41,43,-2,53,67,-14,1,0,0,0
"5548","CHI","L.A",2010020486,14962,20102011,1,60,3,2,1,2.39935919793788,2.7562518267023,-0.35689262876442,24,28,-4,28,38,-10,40,60,-20,3,1,0,0
"5549","CHI","NSH",2010020505,14965,20102011,1,60,4,1,3,0,0,0,35,25,10,45,31,14,51,50,1,3,3,0,0
"5550","CHI","STL",2010020540,14971,20102011,0,60,1,3,-2,4.23589802213706,5.43303716038007,-1.197139138243,26,43,-17,38,57,-19,50,64,-14,2,4,0,0
"5551","CHI","S.J",2010020554,14973,20102011,1,60,3,5,-2,3.6381596004976,7.5830820214469,-3.9449224209493,29,25,4,42,30,12,56,44,12,5,6,0,0
"5552","CHI","ANA",2010020580,14976,20102011,0,60,1,2,-1,5.26026361749155,2.92662307916908,2.33364053832247,40,18,22,58,29,29,71,39,32,2,4,0,0
"5553","CHI","L.A",2010020584,14977,20102011,0,60,4,3,1,5.53997285896912,4.27442046072974,1.26555239823938,28,29,-1,42,50,-8,48,61,-13,4,5,0,0
"5554","CHI","DAL",2010020594,14979,20102011,1,60,2,4,-2,6.05113001605787,3.87562595144846,2.17550406460941,37,22,15,51,27,24,71,36,35,5,3,0,0
"5555","CHI","OTT",2010020607,14981,20102011,1,65,2,2,0,3.03971114594606,3.21893265275867,-0.17922150681261,26,26,0,37,37,0,55,48,7,0,1,0,0
"5556","CHI","NYI",2010020626,14983,20102011,1,60,5,0,5,3.4502638548438,1.9895978346467,1.4606660201971,45,29,16,59,38,21,78,53,25,6,3,0,0
"5557","CHI","COL",2010020644,14986,20102011,1,60,4,0,4,3.12417389650363,2.13158690069758,0.99258699580605,31,24,7,46,34,12,58,48,10,3,4,0,0
"5558","CHI","NSH",2010020667,14989,20102011,0,65,2,2,0,6.11505834514896,1.59738937784818,4.51766896730078,33,26,7,41,39,2,50,52,-2,2,2,0,0
"5559","CHI","NSH",2010020675,14990,20102011,1,60,6,3,3,4.15034029978095,3.7389724033419,0.411367896439046,34,23,11,45,31,14,61,49,12,4,6,0,0
"5560","CHI","DET",2010020713,14996,20102011,0,60,4,1,3,5.05725111560605,4.61060536408331,0.446645751522738,33,37,-4,42,56,-14,50,73,-23,3,2,0,0
"5561","CHI","PHI",2010020725,14997,20102011,1,60,1,4,-3,3.87191595127751,6.44053487834753,-2.56861892707002,31,34,-3,38,37,1,56,48,8,3,2,0,0
"5562","CHI","MIN",2010020740,14999,20102011,1,60,2,4,-2,2.48611660546158,1.57155352469999,0.914563080761582,33,22,11,44,28,16,60,39,21,2,3,0,0
"5563","CHI","VAN",2010020781,15009,20102011,0,60,3,4,-1,3.79887866356876,4.45809303697159,-0.659214373402833,45,32,13,60,40,20,76,61,15,6,5,0,0
"5564","CHI","CGY",2010020799,15012,20102011,0,60,1,3,-2,5.61461482020147,3.74839135897128,1.8662234612302,23,28,-5,42,36,6,62,56,6,4,4,0,0
"5565","CHI","EDM",2010020814,15014,20102011,0,60,4,1,3,3.89110227295896,2.76004742634723,1.13105484661173,26,24,2,42,36,6,50,49,1,6,2,0,0
"5566","CHI","DAL",2010020827,15016,20102011,0,65,3,3,0,4.27770603063982,6.70887359662743,-2.43116756598761,26,35,-9,38,50,-12,52,65,-13,7,7,0,0
"5567","CHI","MIN",2010020859,15021,20102011,1,60,3,1,2,5.7503011522349,2.43579716892805,3.31450398330685,37,34,3,44,38,6,60,48,12,5,3,0,0
"5568","CHI","PIT",2010020888,15025,20102011,1,65,2,2,0,4.60884410497276,5.67538761784509,-1.06654351287233,31,26,5,42,38,4,54,61,-7,3,3,0,0
"5569","CHI","STL",2010020892,15026,20102011,0,60,5,3,2,5.29674160450668,4.61894885774836,0.677792746758314,26,34,-8,38,53,-15,45,71,-26,1,2,0,0
"5570","CHI","NSH",2010020912,15029,20102011,0,60,3,0,3,5.50569756014738,3.22781346313423,2.27788409701316,25,31,-6,36,46,-10,42,67,-25,1,1,0,0
"5571","CHI","MIN",2010020940,15033,20102011,0,60,4,2,2,4.39671613881092,3.59307723919719,0.803638899613725,34,26,8,43,34,9,58,44,14,3,4,0,0
"5572","CHI","CGY",2010020955,15035,20102011,1,60,6,4,2,2.99646195324021,3.77975288718881,-0.783290933948592,30,25,5,35,31,4,46,38,8,4,3,0,0
"5573","CHI","CAR",2010020970,15037,20102011,1,60,5,2,3,1.69171602322108,1.95108592030365,-0.259369897082578,29,20,9,41,31,10,49,41,8,2,2,0,0
"5574","CHI","TOR",2010020977,15038,20102011,0,60,5,3,2,4.25714837856158,3.33089821563618,0.926250162925399,25,33,-8,34,46,-12,45,65,-20,4,5,0,0
"5575","CHI","FLA",2010020997,15041,20102011,0,60,2,3,-1,6.56792656509788,2.92579700789497,3.64212955720291,39,15,24,53,23,30,64,28,36,3,0,0,0
"5576","CHI","T.B",2010021005,15042,20102011,0,65,3,3,0,6.65626310944208,3.60986038496048,3.0464027244816,31,30,1,40,41,-1,50,49,1,1,2,0,0
"5577","CHI","S.J",2010021039,15047,20102011,1,60,6,3,3,5.96975276787998,5.77584302606834,0.193909741811645,34,36,-2,42,44,-2,50,64,-14,6,3,0,0
"5578","CHI","DAL",2010021061,15050,20102011,0,60,0,5,-5,4.16733742564067,4.36700060957128,-0.19966318393061,23,27,-4,33,37,-4,47,48,-1,3,5,0,0
"5579","CHI","FLA",2010021099,15056,20102011,1,60,4,0,4,2.91828454192728,2.29106752533698,0.627217016590293,31,23,8,37,31,6,53,40,13,4,2,0,0
"5580","CHI","ANA",2010021125,15059,20102011,1,60,1,2,-1,0,0,0,28,25,3,38,32,6,54,37,17,2,2,0,0
"5581","CHI","DET",2010021132,15061,20102011,0,60.85,3,2,1,3.89841544885602,4.93624362474657,-1.03782817589054,41,35,6,53,48,5,67,69,-2,4,6,0,0
"5582","CHI","BOS",2010021134,15062,20102011,0,60,0,3,-3,5.59823449054966,4.98928810319921,0.608946387350443,32,34,-2,49,42,7,68,53,15,2,0,0,0
"5583","CHI","T.B",2010021179,15067,20102011,1,60,0,2,-2,2.319018297443,3.54501036379952,-1.22599206635652,31,15,16,42,25,17,63,33,30,4,5,0,0
"5584","CHI","MTL",2010021187,15069,20102011,0,61.3166666666667,1,2,-1,7.87066904111566,8.23652580005728,-0.365856758941618,43,35,8,58,54,4,83,67,16,5,4,0,0
"5585","CHI","STL",2010021197,15070,20102011,1,63.3166666666667,4,3,1,3.97185773744422,2.50963718581625,1.46222055162798,39,24,15,46,29,17,60,40,20,4,2,0,0
"5586","CHI","DET",2010021206,15072,20102011,0,60,4,2,2,4.76407565346869,4.57387789385393,0.190197759614762,29,28,1,39,40,-1,46,61,-15,1,2,0,0
"5587","CHI","DET",2010021229,15074,20102011,1,60,3,4,-1,0,0,0,36,31,5,45,40,5,53,51,2,4,1,0,0
"5588","CHI","VAN",2010030151,15077,20102011,0,60,0,2,-2,6.82875099340163,4.28617812759114,2.54257286581048,32,33,-1,51,45,6,62,63,-1,4,3,0,0
"5589","CHI","VAN",2010030152,15079,20102011,0,60,3,4,-1,3.42139757107361,7.00697744627118,-3.58557987519757,26,27,-1,33,42,-9,43,54,-11,2,2,0,0
"5590","CHI","VAN",2010030153,15081,20102011,1,60,2,3,-1,4.76537652208935,4.38936037824774,0.376016143841611,32,26,6,43,36,7,52,43,9,7,2,0,0
"5591","CHI","VAN",2010030154,15083,20102011,1,60,7,2,5,5.07361765843234,2.55365090697887,2.51996675145347,35,23,12,44,32,12,51,43,8,8,6,0,0
"5592","CHI","VAN",2010030155,15085,20102011,0,60,5,0,5,4.68125324948252,4.19030411855783,0.490949130924683,26,36,-10,32,43,-11,41,63,-22,5,5,0,0
"5593","CHI","VAN",2010030156,15088,20102011,1,75.5,4,3,1,6.59365594724659,8.11358103476596,-1.51992508751937,33,35,-2,42,54,-12,54,85,-31,6,3,0,0
"5594","CHI","VAN",2010030157,15090,20102011,0,65.3666666666667,1,2,-1,5.37490671688874,7.53556886728377,-2.16066215039503,32,38,-6,41,53,-12,57,69,-12,2,3,0,0
"5595","CHI","DAL",2011020008,15254,20112012,0,60,1,2,-1,0,0,0,38,33,5,54,42,12,68,56,12,4,2,0,0
"5596","CHI","DAL",2011020017,15255,20112012,1,60,5,2,3,7.4496888415888,2.94187077259862,4.50781806899018,31,21,10,44,30,14,51,43,8,7,5,0,0
"5597","CHI","WPG",2011020045,15260,20112012,1,60,4,3,1,4.12554443156114,6.13202587226624,-2.0064814407051,32,30,2,38,50,-12,51,62,-11,3,2,0,0
"5598","CHI","BOS",2011020060,15262,20112012,1,65,2,2,0,5.27452081546584,3.52175558592353,1.75276522954231,29,37,-8,45,50,-5,64,64,0,3,3,0,0
"5599","CHI","COL",2011020086,15267,20112012,0,60,3,1,2,5.4444898558059,2.52368331247999,2.92080654332591,30,32,-2,41,40,1,57,60,-3,2,2,0,0
"5600","CHI","COL",2011020106,15269,20112012,1,65,4,4,0,7.55905654875096,4.51174531970173,3.04731122904923,38,24,14,49,32,17,57,43,14,3,0,0,0
"5601","CHI","ANA",2011020118,15272,20112012,1,65,2,2,0,5.53059821252828,3.47896805102937,2.05163016149891,35,31,4,48,38,10,62,53,9,3,6,0,0
"5602","CHI","CAR",2011020136,15275,20112012,0,60,0,3,-3,7.69517650714261,2.85570406031911,4.83947244682349,30,33,-3,46,42,4,66,57,9,4,6,0,0
"5603","CHI","NSH",2011020159,15278,20112012,1,62.3,5,4,1,7.29615351994289,2.21140247528187,5.08475104466102,35,28,7,56,33,23,74,38,36,8,4,0,0
"5604","CHI","FLA",2011020172,15281,20112012,0,65,2,2,0,4.26235167036066,3.87201597160329,0.390335698757369,33,43,-10,48,53,-5,61,71,-10,2,2,0,0
"5605","CHI","T.B",2011020181,15282,20112012,0,64.1,4,5,-1,3.46357984042264,5.55376792698235,-2.09018808655971,32,32,0,46,41,5,67,54,13,2,1,0,0
"5606","CHI","VAN",2011020198,15284,20112012,1,60,2,6,-4,6.08569701371289,3.56850928828311,2.51718772542978,40,38,2,47,46,1,55,64,-9,6,7,0,0
"5607","CHI","STL",2011020208,15286,20112012,0,60,0,3,-3,3.69650947884656,4.44560959025603,-0.749100111409462,29,23,6,36,38,-2,48,54,-6,4,2,0,0
"5608","CHI","CGY",2011020227,15289,20112012,1,60,4,1,3,4.20500630304014,4.06885739068425,0.136148912355889,31,25,6,46,36,10,62,49,13,4,1,0,0
"5609","CHI","EDM",2011020241,15291,20112012,1,60,6,3,3,3.75273314964119,3.26366767776199,0.489065471879201,35,23,12,42,29,13,49,43,6,4,3,0,0
"5610","CHI","VAN",2011020258,15294,20112012,0,60,5,1,4,4.81311155666481,2.51115554054559,2.30195601611922,27,29,-2,34,45,-11,43,68,-25,5,3,0,0
"5611","CHI","CGY",2011020273,15296,20112012,0,60,2,5,-3,4.94417660869536,4.75542788894381,0.188748719751551,32,26,6,41,36,5,58,46,12,6,4,0,0
"5612","CHI","EDM",2011020285,15297,20112012,0,60,2,9,-7,5.48485915584024,4.74439571622497,0.740463439615269,36,34,2,48,43,5,60,52,8,6,6,0,0
"5613","CHI","S.J",2011020312,15301,20112012,0,60,0,1,-1,4.141309030927,3.6698825679148,0.471426463012206,34,21,13,44,29,15,59,40,19,4,4,0,0
"5614","CHI","ANA",2011020318,15303,20112012,0,60,6,5,1,7.26356976193301,2.88142649247227,4.38214326946075,42,28,14,56,38,18,73,49,24,7,3,0,0
"5615","CHI","L.A",2011020336,15304,20112012,0,60,2,1,1,5.27389350930025,4.49986768065719,0.774025828643062,27,27,0,42,44,-2,53,57,-4,2,2,0,0
"5616","CHI","NYI",2011020368,15310,20112012,1,65,4,4,0,4.38940873918333,5.66141843583381,-1.27200969665048,36,41,-5,48,49,-1,65,64,1,4,4,0,0
"5617","CHI","STL",2011020378,15311,20112012,0,60,5,2,3,4.39328829396982,3.78704236191697,0.606245932052843,36,25,11,45,43,2,60,60,0,6,7,0,0
"5618","CHI","NYI",2011020407,15316,20112012,0,61.5666666666667,3,2,1,4.1819126860355,3.61716270225224,0.564749983783258,28,33,-5,34,41,-7,48,53,-5,3,6,0,0
"5619","CHI","S.J",2011020434,15319,20112012,1,64.4333333333333,3,2,1,3.09407581150299,5.58822842486552,-2.49415261336253,34,37,-3,40,44,-4,54,55,-1,3,2,0,0
"5620","CHI","MIN",2011020449,15322,20112012,0,65,3,3,0,6.99035226364504,5.45820941605894,1.5321428475861,31,30,1,53,43,10,69,53,16,2,2,0,0
"5621","CHI","ANA",2011020465,15324,20112012,1,60,4,1,3,1.60032832893194,4.07324438390788,-2.47291605497594,24,25,-1,32,42,-10,44,59,-15,3,3,0,0
"5622","CHI","CGY",2011020479,15326,20112012,1,60,4,2,2,4.66103235300712,3.34974474416231,1.31128760884482,25,24,1,37,36,1,49,47,2,6,7,0,0
"5623","CHI","MTL",2011020495,15329,20112012,1,60,5,1,4,2.60090550199206,2.22326921898639,0.377636283005671,28,21,7,39,30,9,57,35,22,2,3,0,0
"5624","CHI","CBJ",2011020525,15334,20112012,1,60,4,1,3,2.98970489469934,5.56656526654826,-2.57686037184892,22,38,-16,26,48,-22,36,56,-20,3,2,0,0
"5625","CHI","L.A",2011020539,15336,20112012,1,60,0,2,-2,3.75761550670404,3.59192279586568,0.165692710838357,38,38,0,55,48,7,73,64,9,4,4,0,0
"5626","CHI","DET",2011020555,15338,20112012,1,60,3,2,1,3.47508309484738,5.92683998012217,-2.45175688527479,28,28,0,36,39,-3,52,47,5,6,1,0,0
"5627","CHI","EDM",2011020571,15341,20112012,1,60,3,4,-1,3.3369735801883,3.68416597199393,-0.347192391805635,42,30,12,50,44,6,58,60,-2,4,2,0,0
"5628","CHI","PHI",2011020587,15344,20112012,0,60,4,5,-1,7.25630695398286,9.17337365534331,-1.91706670136045,34,46,-12,46,60,-14,62,75,-13,0,3,0,0
"5629","CHI","COL",2011020596,15345,20112012,1,60,0,4,-4,2.93689532975035,3.22860289906384,-0.291707569313495,27,22,5,46,31,15,57,42,15,2,2,0,0
"5630","CHI","DET",2011020612,15347,20112012,1,63.1333333333333,2,3,-1,2.43787008797517,3.89764857053569,-1.45977848256052,31,27,4,39,40,-1,62,53,9,6,2,0,0
"5631","CHI","CBJ",2011020625,15349,20112012,1,60,5,2,3,2.8000135916518,2.8979071698035,-0.0978935781516945,25,34,-9,35,40,-5,47,48,-1,5,6,0,0
"5632","CHI","MIN",2011020639,15351,20112012,1,60,5,2,3,4.50653976172907,3.31199443724472,1.19454532448435,30,23,7,36,29,7,53,38,15,3,1,0,0
"5633","CHI","DET",2011020647,15353,20112012,0,64.35,2,3,-1,3.76232138788328,4.62463872439525,-0.862317336511978,27,43,-16,38,52,-14,52,59,-7,2,1,0,0
"5634","CHI","S.J",2011020661,15354,20112012,1,60,4,3,1,3.32239568344266,3.2670547278467,0.0553409555959661,40,24,16,56,30,26,72,34,38,1,3,0,0
"5635","CHI","FLA",2011020697,15359,20112012,1,60,3,1,2,3.18094452492369,2.01884800297921,1.16209652194448,22,19,3,31,26,5,46,34,12,4,3,0,0
"5636","CHI","NSH",2011020708,15360,20112012,0,60,2,5,-3,5.40186340361834,3.2034828569158,2.19838054670254,22,23,-1,41,36,5,55,48,7,1,2,0,0
"5637","CHI","NSH",2011020729,15363,20112012,1,60,1,3,-2,3.74684553670522,2.56810882900066,1.17873670770456,25,26,-1,39,35,4,63,42,21,4,3,0,0
"5638","CHI","VAN",2011020747,15370,20112012,0,63.6166666666667,2,3,-1,5.50103793627932,5.34429536829703,0.156742567982292,39,33,6,50,43,7,66,62,4,2,0,0,0
"5639","CHI","EDM",2011020759,15372,20112012,0,60,4,8,-4,3.8290706249436,6.86526887112996,-3.03619824618636,47,41,6,60,50,10,78,69,9,3,7,0,0
"5640","CHI","CGY",2011020765,15373,20112012,0,60,1,3,-2,2.4756263284944,5.47959191849804,-3.00396559000365,27,32,-5,32,42,-10,42,56,-14,2,4,0,0
"5641","CHI","COL",2011020796,15377,20112012,0,60,2,5,-3,4.6937522256776,4.02388084189579,0.66987138378181,31,29,2,38,41,-3,59,49,10,3,0,0,0
"5642","CHI","S.J",2011020815,15380,20112012,0,60,3,5,-2,6.58409606797235,3.07015076680129,3.51394530117105,33,27,6,40,37,3,65,50,15,5,7,0,0
"5643","CHI","NSH",2011020842,15384,20112012,0,60,2,3,-1,5.20559550234049,3.10378663346637,2.10180886887412,32,19,13,43,33,10,59,45,14,3,3,0,0
"5644","CHI","NYR",2011020851,15386,20112012,0,60,4,2,2,1.70115197980203,3.94895307312254,-2.2478010933205,22,24,-2,29,35,-6,46,48,-2,5,8,0,0
"5645","CHI","CBJ",2011020866,15388,20112012,0,60,6,1,5,0,0,0,28,34,-6,40,42,-2,50,54,-4,2,1,0,0
"5646","CHI","STL",2011020875,15389,20112012,1,60,3,1,2,4.56628260418074,2.22862404600437,2.33765855817637,27,30,-3,38,39,-1,53,42,11,4,2,0,0
"5647","CHI","DET",2011020893,15391,20112012,1,60,2,1,1,3.27125093691484,4.34547006437788,-1.07421912746304,29,32,-3,39,41,-2,53,48,5,3,3,0,0
"5648","CHI","DAL",2011020905,15393,20112012,1,60,1,3,-2,1.43538522045128,4.27693640406142,-2.84155118361014,27,25,2,32,39,-7,47,50,-3,1,0,0,0
"5649","CHI","L.A",2011020917,15395,20112012,0,60,0,4,-4,4.22047292153002,5.24971334149086,-1.02924041996084,19,30,-11,31,41,-10,44,51,-7,6,3,0,0
"5650","CHI","ANA",2011020931,15396,20112012,0,60,1,3,-2,2.2189130015322,3.39280528135328,-1.17389227982108,19,38,-19,30,49,-19,50,62,-12,4,4,0,0
"5651","CHI","TOR",2011020947,15399,20112012,1,60,5,4,1,4.49656796111958,5.1001350285951,-0.603567067475524,35,34,1,46,44,2,55,64,-9,3,4,0,0
"5652","CHI","OTT",2011020960,15401,20112012,0,60,2,1,1,0,0,0,39,26,13,50,38,12,62,55,7,4,2,0,0
"5653","CHI","DET",2011020976,15403,20112012,0,60,2,1,1,2.79286809964964,3.8859582511941,-1.09309015154446,18,24,-6,29,40,-11,34,53,-19,3,4,0,0
"5654","CHI","STL",2011020990,15405,20112012,0,60,1,5,-4,3.12046219631156,6.58743621728536,-3.46697402097379,20,31,-11,32,46,-14,45,50,-5,5,2,0,0
"5655","CHI","NYR",2011021012,15408,20112012,1,60,4,3,1,4.95591129476088,1.92128850208246,3.03462279267842,22,25,-3,34,37,-3,51,48,3,1,2,0,0
"5656","CHI","L.A",2011021031,15410,20112012,1,65,2,2,0,5.34109414218983,3.53764319491893,1.8034509472709,37,29,8,47,46,1,67,60,7,3,2,0,0
"5657","CHI","STL",2011021043,15412,20112012,1,65,3,3,0,8.12829872197472,4.61088194441982,3.5174167775549,46,24,22,68,33,35,86,45,41,7,2,0,0
"5658","CHI","DAL",2011021062,15415,20112012,0,60,4,1,3,7.22162747502443,6.07593659194911,1.14569088307532,31,22,9,47,39,8,62,59,3,3,1,0,0
"5659","CHI","CBJ",2011021091,15419,20112012,0,60,5,1,4,5.14652041411318,3.52925467293244,1.61726574118074,27,25,2,38,37,1,49,55,-6,2,2,0,0
"5660","CHI","VAN",2011021100,15420,20112012,1,62.7,2,1,1,4.91946650235991,4.67952394113036,0.239942561229554,37,24,13,49,34,15,68,49,19,7,5,0,0
"5661","CHI","NSH",2011021131,15424,20112012,1,60,1,6,-5,3.1111527635984,4.80155507331801,-1.69040230971962,25,24,1,36,30,6,61,41,20,4,2,0,0
"5662","CHI","N.J",2011021142,15426,20112012,0,65,1,1,0,5.0070935566317,2.69568015367258,2.31141340295912,38,22,16,47,30,17,62,46,16,4,3,0,0
"5663","CHI","STL",2011021159,15428,20112012,1,65,3,3,0,4.55850643957092,3.57891171157826,0.979594727992662,40,20,20,47,31,16,55,47,8,2,2,0,0
"5664","CHI","NSH",2011021176,15430,20112012,0,60,5,4,1,4.23890889089671,3.26903566162036,0.969873229276345,37,33,4,42,37,5,50,51,-1,6,4,0,0
"5665","CHI","MIN",2011021184,15431,20112012,1,65,4,4,0,3.8930874124344,2.94406155809543,0.94902585433897,35,30,5,49,41,8,72,51,21,5,4,0,0
"5666","CHI","MIN",2011021210,15435,20112012,0,65,1,1,0,6.66258929262403,3.35725999542052,3.30532929720351,23,23,0,45,29,16,63,40,23,6,5,0,0
"5667","CHI","DET",2011021220,15437,20112012,0,65,2,2,0,5.99266942785471,4.42154068673194,1.57112874112277,33,32,1,41,46,-5,52,55,-3,4,3,0,0
"5668","CHI","ARI",2011030171,15442,20112012,0,69.4833333333333,2,3,-1,6.31117989599738,5.53734776546662,0.773832130530764,45,34,11,59,57,2,86,69,17,5,3,0,0
"5669","CHI","ARI",2011030172,15444,20112012,0,70.6,4,3,1,6.19477643826394,5.57962977365241,0.61514666461153,50,33,17,59,54,5,76,64,12,3,2,0,0
"5670","CHI","ARI",2011030173,15447,20112012,1,73.25,2,3,-1,4.97847085213289,4.83005901897559,0.148411833157297,37,34,3,48,42,6,63,58,5,4,4,0,0
"5671","CHI","ARI",2011030174,15449,20112012,1,62.25,2,3,-1,2.78822599496925,2.09281558933435,0.695410405634902,32,19,13,38,25,13,59,31,28,3,2,0,0
"5672","CHI","ARI",2011030175,15451,20112012,0,62.7333333333333,2,1,1,3.85033302930788,1.48262787509884,2.36770515420903,38,19,19,55,23,32,84,32,52,4,4,0,0
"5673","CHI","ARI",2011030176,15453,20112012,1,60,0,4,-4,7.07978016432004,3.77953745075041,3.30024271356963,39,20,19,61,28,33,80,42,38,2,2,0,0
"5674","CHI","L.A",2012020003,15724,20122013,0,60,5,2,3,4.06191132750246,4.67752164578997,-0.615610318287509,22,21,1,35,35,0,42,50,-8,5,5,0,0
"5675","CHI","ARI",2012020019,15725,20122013,0,60,6,4,2,5.75393997249193,4.47936926343959,1.27457070905234,31,29,2,43,40,3,60,52,8,5,3,0,0
"5676","CHI","STL",2012020033,15727,20122013,1,60,3,2,1,3.93658223655075,3.82312240242027,0.113459834130481,27,34,-7,37,41,-4,46,60,-14,3,2,0,0
"5677","CHI","DAL",2012020046,15729,20122013,0,61.6833333333333,3,2,1,6.85669376819715,2.83485400306076,4.02183976513638,41,23,18,53,35,18,77,42,35,7,2,0,0
"5678","CHI","CBJ",2012020059,15731,20122013,0,60,3,2,1,3.21679874372785,3.27191964701126,-0.0551209032834095,24,26,-2,29,37,-8,40,50,-10,5,6,0,0
"5679","CHI","DET",2012020069,15732,20122013,1,62.75,2,1,1,2.54106955094217,2.16791270609247,0.373156844849701,27,30,-3,34,38,-4,48,58,-10,3,6,0,0
"5680","CHI","MIN",2012020089,15735,20122013,0,65,2,2,0,5.08246730211874,3.59515094209928,1.48731636001946,32,25,7,48,38,10,58,48,10,2,4,0,0
"5681","CHI","VAN",2012020106,15737,20122013,0,65,1,1,0,2.41278930959561,3.3237450668895,-0.910955757293891,28,22,6,38,31,7,54,42,12,6,5,0,0
"5682","CHI","CGY",2012020116,15738,20122013,0,65,2,2,0,4.5458281128092,4.87913717021002,-0.333309057400811,19,47,-28,30,61,-31,46,87,-41,1,5,0,0
"5683","CHI","S.J",2012020137,15741,20122013,0,60,5,3,2,4.545948296407,3.3462063932966,1.19974190311041,31,33,-2,35,44,-9,46,55,-9,4,6,0,0
"5684","CHI","ARI",2012020152,15743,20122013,0,60,6,2,4,5.91965609355248,2.19197484654272,3.72768124700976,33,24,9,44,32,12,59,50,9,10,3,0,0
"5685","CHI","NSH",2012020171,15746,20122013,0,60,3,0,3,2.97505859819648,1.71848042774945,1.25657817044703,27,17,10,36,27,9,50,41,9,2,1,0,0
"5686","CHI","ANA",2012020185,15748,20122013,1,65,2,2,0,3.9883309045108,2.45895380859292,1.52937709591788,30,31,-1,35,38,-3,50,52,-2,6,5,0,0
"5687","CHI","S.J",2012020201,15751,20122013,1,60,4,1,3,4.20181367906298,5.31539314428483,-1.11357946522185,37,28,9,45,38,7,54,53,1,7,6,0,0
"5688","CHI","L.A",2012020213,15753,20122013,1,60,3,2,1,5.0264853892877,3.85320366203496,1.17328172725274,37,27,10,48,30,18,62,54,8,6,5,0,0
"5689","CHI","VAN",2012020232,15755,20122013,1,65,3,3,0,6.15243441826442,2.49130666431392,3.6611277539505,43,32,11,53,36,17,67,49,18,7,5,0,0
"5690","CHI","S.J",2012020249,15758,20122013,1,60,2,1,1,4.45661848472264,2.03676963278849,2.41984885193415,34,27,7,42,36,6,59,51,8,3,5,0,0
"5691","CHI","CBJ",2012020266,15760,20122013,1,60,1,0,1,5.54500233623548,3.13046717771795,2.41453515851754,27,28,-1,39,34,5,50,50,0,5,7,0,0
"5692","CHI","EDM",2012020273,15761,20122013,1,61.7333333333333,3,2,1,4.20948459617767,1.21980124165225,2.98968335452542,34,19,15,46,24,22,65,33,32,2,4,0,0
"5693","CHI","STL",2012020294,15764,20122013,0,60,3,0,3,2.32574933740986,2.45444806746673,-0.128698730056868,23,21,2,30,28,2,40,39,1,2,5,0,0
"5694","CHI","CBJ",2012020300,15765,20122013,1,63.3833333333333,4,3,1,7.08812585682608,5.07856342883315,2.00956242799293,35,22,13,49,34,15,68,48,20,2,1,0,0
"5695","CHI","DET",2012020311,15767,20122013,0,65,1,1,0,5.72115085769474,4.1942284317254,1.52692242596934,33,33,0,49,41,8,65,53,12,4,2,0,0
"5696","CHI","MIN",2012020332,15769,20122013,1,60,5,3,2,4.10490838441183,2.80738962008036,1.29751876433147,32,23,9,42,32,10,56,38,18,3,2,0,0
"5697","CHI","COL",2012020336,15770,20122013,1,60,3,2,1,3.18637885036514,2.96171496898046,0.224663881384686,32,22,10,42,33,9,63,56,7,3,2,0,0
"5698","CHI","COL",2012020353,15772,20122013,0,60,2,6,-4,5.68134835096134,3.95746197030911,1.72388638065223,33,31,2,42,41,1,62,54,8,3,5,0,0
"5699","CHI","EDM",2012020370,15774,20122013,1,60,5,6,-1,5.96599013048234,2.69672252934106,3.26926760114128,37,25,12,51,32,19,68,43,25,3,5,0,0
"5700","CHI","CBJ",2012020394,15778,20122013,0,65,1,1,0,5.642534245766,8.42737521799783,-2.78484097223183,40,30,10,49,43,6,66,58,8,1,2,0,0
"5701","CHI","DAL",2012020415,15780,20122013,0,60,8,1,7,6.3329930951586,2.42404857728707,3.90894451787153,34,19,15,55,26,29,69,36,33,7,3,0,0
"5702","CHI","COL",2012020425,15782,20122013,0,60,5,2,3,4.8399426488767,1.77237656686748,3.06756608200922,32,19,13,41,27,14,57,41,16,1,1,0,0
"5703","CHI","ANA",2012020442,15784,20122013,0,60,2,4,-2,3.66155875342567,4.89678675539708,-1.23522800197141,24,26,-2,34,40,-6,50,51,-1,2,1,0,0
"5704","CHI","L.A",2012020474,15789,20122013,1,60,4,5,-1,2.82856582419822,4.51762409138553,-1.68905826718731,25,36,-11,32,42,-10,41,50,-9,3,2,0,0
"5705","CHI","CGY",2012020486,15790,20122013,1,60,2,0,2,2.49660892439915,1.69426399233635,0.802344932062807,35,16,19,42,24,18,54,40,14,4,4,0,0
"5706","CHI","ANA",2012020503,15793,20122013,1,60,1,2,-1,3.84375288550655,2.94805381589486,0.895699069611689,26,24,2,34,31,3,46,41,5,4,1,0,0
"5707","CHI","DET",2012020517,15795,20122013,0,60,7,1,6,5.12552693815087,4.10999446857022,1.01553246958065,26,34,-8,32,50,-18,46,62,-16,0,2,0,0
"5708","CHI","NSH",2012020527,15796,20122013,1,65,2,2,0,4.0139800308616,3.20678107421554,0.807198956646062,40,27,13,51,31,20,68,44,24,3,2,0,0
"5709","CHI","STL",2012020549,15799,20122013,1,65,3,3,0,4.5330882271935,3.87329419486923,0.659794032324271,36,22,14,49,27,22,58,36,22,2,1,0,0
"5710","CHI","NSH",2012020560,15801,20122013,0,60,1,0,1,4.89665206199288,3.39834657055326,1.49830549143962,30,20,10,41,31,10,58,44,14,1,2,0,0
"5711","CHI","NSH",2012020574,15802,20122013,1,60,5,3,2,5.54008015527506,1.49510737578385,4.04497277949122,40,22,18,47,26,21,65,37,28,1,1,0,0
"5712","CHI","MIN",2012020589,15804,20122013,0,60,1,0,1,4.44227012073679,4.22954274833319,0.212727372403606,31,20,11,44,33,11,51,44,7,3,2,0,0
"5713","CHI","DET",2012020608,15807,20122013,1,65,2,2,0,3.52091373665806,5.1896374119533,-1.66872367529524,28,29,-1,37,41,-4,50,58,-8,3,5,0,0
"5714","CHI","STL",2012020621,15809,20122013,0,60,2,0,2,3.73108237591805,2.93794745521882,0.793134920699231,26,30,-4,38,41,-3,47,51,-4,7,7,0,0
"5715","CHI","DAL",2012020627,15810,20122013,1,60,5,2,3,3.23267945951739,4.65001631947234,-1.41733685995496,28,18,10,41,26,15,57,37,20,5,3,0,0
"5716","CHI","NSH",2012020657,15814,20122013,1,60.8666666666667,5,4,1,2.52696664972553,2.43136173475068,0.0956049149748486,30,27,3,46,32,14,59,40,19,2,3,0,0
"5717","CHI","ARI",2012020666,15815,20122013,1,65,2,2,0,5.3201966299149,4.67814962562989,0.642047004285018,38,31,7,46,37,9,65,54,11,4,5,0,0
"5718","CHI","VAN",2012020680,15817,20122013,0,60,1,3,-2,3.69342773863536,4.68470469705062,-0.991276958415256,25,32,-7,30,41,-11,46,65,-19,3,6,0,0
"5719","CHI","EDM",2012020692,15819,20122013,0,60,4,1,3,3.60651637939372,4.91529236640781,-1.30877598701409,30,22,8,42,34,8,54,47,7,2,4,0,0
"5720","CHI","CGY",2012020706,15821,20122013,1,60,3,1,2,7.00286331860116,1.5357231306516,5.46714018794955,38,26,12,54,30,24,78,40,38,2,0,0,0
"5721","CHI","STL",2012020716,15822,20122013,0,60,1,3,-2,2.75436907459516,4.86998404840156,-2.1156149738064,23,28,-5,34,44,-10,46,61,-15,2,2,0,0
"5722","CHI","MIN",2012030151,15825,20122013,1,76.5833333333333,2,1,1,3.81649583950639,6.76265867215002,-2.94616283264364,37,27,10,45,37,8,66,47,19,3,4,0,0
"5723","CHI","MIN",2012030152,15828,20122013,1,60,5,2,3,4.08565325746895,3.17726755607873,0.908385701390216,48,28,20,56,33,23,77,44,33,5,3,0,0
"5724","CHI","MIN",2012030153,15830,20122013,0,62.25,2,3,-1,5.88659665312079,7.79439977082971,-1.90780311770892,27,37,-10,43,47,-4,55,58,-3,3,4,0,0
"5725","CHI","MIN",2012030154,15832,20122013,0,60,3,0,3,5.8716997636077,4.03560709714657,1.83609266646114,24,25,-1,36,42,-6,46,68,-22,2,6,0,0
"5726","CHI","MIN",2012030155,15834,20122013,1,60,5,1,4,8.2614997091805,2.92492514941841,5.33657455976208,33,22,11,39,29,10,54,39,15,4,3,0,0
"5727","CHI","DET",2012030231,15840,20122013,1,60,4,1,3,6.22650938739298,2.50944612291642,3.71706326447656,42,21,21,53,33,20,68,46,22,5,5,0,0
"5728","CHI","DET",2012030232,15843,20122013,1,60,1,4,-3,1.63065610096237,4.42148145174724,-2.79082535078487,20,30,-10,26,44,-18,41,55,-14,3,5,0,0
"5729","CHI","DET",2012030233,15845,20122013,0,60,1,3,-2,5.18139758910734,3.00063771350688,2.18075987560046,40,30,10,51,36,15,66,48,18,5,6,0,0
"5730","CHI","DET",2012030234,15848,20122013,0,60,0,2,-2,4.85464807839583,3.32265956752531,1.53198851087052,28,27,1,38,33,5,49,44,5,5,5,0,0
"5731","CHI","DET",2012030235,15850,20122013,1,60,4,1,3,3.51433341664032,2.24305495119188,1.27127846544844,45,26,19,55,32,23,66,40,26,5,6,0,0
"5732","CHI","DET",2012030236,15852,20122013,0,60,4,3,1,3.55166359369448,6.29545644548489,-2.74379285179041,28,38,-10,39,49,-10,49,60,-11,7,5,0,0
"5733","CHI","DET",2012030237,15854,20122013,1,63.5833333333333,2,1,1,6.37605862856506,4.95813496329356,1.4179236652715,35,27,8,45,37,8,58,52,6,5,3,0,0
"5734","CHI","L.A",2012030321,15857,20122013,1,60,2,1,1,3.43300145894386,2.61143746883169,0.821563990112173,36,22,14,47,29,18,58,38,20,4,2,0,0
"5735","CHI","L.A",2012030322,15858,20122013,1,60,4,2,2,3.0040891359115,2.37434108686284,0.629748049048658,26,31,-5,31,45,-14,41,58,-17,4,7,0,0
"5736","CHI","L.A",2012030323,15860,20122013,0,60,1,3,-2,2.49657368197222,4.43523600214394,-1.93866232017172,20,28,-8,30,45,-15,42,60,-18,3,5,0,0
"5737","CHI","L.A",2012030324,15862,20122013,0,60,3,2,1,3.02316720292175,5.72557884655488,-2.70241164363313,28,21,7,38,31,7,45,42,3,4,3,0,0
"5738","CHI","L.A",2012030325,15864,20122013,1,80,3,3,0,2.7647221662337,4.96936925326008,-2.20464708702639,30,34,-4,45,51,-6,60,69,-9,2,2,0,0
"5739","CHI","BOS",2012030411,15868,20122013,1,80,3,3,0,5.84959969957708,3.6618479190729,2.18775178050419,47,37,10,68,43,25,99,61,38,3,2,0,0
"5740","CHI","BOS",2012030412,15871,20122013,1,73.8,1,2,-1,3.86921349113585,4.51785773639494,-0.648644245259097,34,28,6,46,32,14,64,48,16,3,2,0,0
"5741","CHI","BOS",2012030413,15873,20122013,0,60,0,2,-2,3.55614799676388,6.65350423346536,-3.09735623670148,28,35,-7,39,44,-5,56,51,5,6,5,0,0
"5742","CHI","BOS",2012030414,15875,20122013,0,69.85,6,5,1,8.95075910126972,6.81406376315954,2.13669533811018,47,33,14,59,47,12,70,60,10,5,6,0,0
"5743","CHI","BOS",2012030415,15878,20122013,1,60,3,1,2,4.41954916535178,1.83202500254265,2.58752416280913,32,25,7,41,32,9,55,49,6,4,2,0,0
"5744","CHI","BOS",2012030416,15880,20122013,0,60,3,2,1,4.77957755761915,2.51394165754061,2.26563590007853,31,25,6,41,38,3,48,62,-14,2,4,0,0
"5745","CHI","T.B",2013020026,15983,20132014,1,65,2,2,0,4.35181295336224,3.77173676667735,0.580076186684892,39,16,23,55,26,29,72,43,29,5,1,0,0
"5746","CHI","STL",2013020045,15987,20132014,0,60,2,3,-1,2.56553583938512,4.67663390008966,-2.11109806070453,28,34,-6,37,43,-6,51,52,-1,4,4,0,0
"5747","CHI","NYI",2013020061,15989,20132014,1,60,3,2,1,2.62607363599091,4.1160163130844,-1.4899426770935,28,19,9,42,27,15,69,40,29,5,3,0,0
"5748","CHI","CAR",2013020086,15993,20132014,0,65,2,2,0,5.82317167166912,3.19229438726325,2.63087728440587,36,34,2,51,45,6,64,71,-7,3,4,0,0
"5749","CHI","STL",2013020104,15995,20132014,1,65,2,2,0,2.99897525865526,6.44596874584893,-3.44699348719366,29,28,1,39,36,3,53,48,5,5,4,0,0
"5750","CHI","TOR",2013020119,15997,20132014,1,60,3,1,2,6.45611138583627,1.93939157131535,4.51671981452091,40,20,20,52,26,26,67,40,27,4,6,0,0
"5751","CHI","FLA",2013020133,16000,20132014,0,65,2,2,0,4.35186155815609,3.89699811959872,0.454863438557368,29,22,7,44,40,4,71,53,18,2,2,0,0
"5752","CHI","T.B",2013020143,16002,20132014,0,61.2666666666667,5,6,-1,6.43909607463866,2.07875635640494,4.36033971823372,44,25,19,57,33,24,73,40,33,6,4,0,0
"5753","CHI","MIN",2013020162,16004,20132014,1,60,3,5,-2,3.14056749641895,3.0589471609686,0.0816203354503564,36,25,11,44,30,14,63,37,26,7,5,0,0
"5754","CHI","MIN",2013020174,16006,20132014,0,60,5,1,4,4.92693312489337,3.59958914418237,1.327343980711,28,30,-2,44,41,3,57,58,-1,5,5,0,0
"5755","CHI","OTT",2013020180,16007,20132014,1,60,6,5,1,4.36438582003843,7.069558269759,-2.70517244972057,40,37,3,51,49,2,62,59,3,3,2,0,0
"5756","CHI","WPG",2013020199,16011,20132014,0,60,5,1,4,5.48650890315184,5.39718900686057,0.089319896291272,25,27,-2,36,40,-4,54,56,-2,3,1,0,0
"5757","CHI","CGY",2013020213,16012,20132014,1,61.5333333333333,2,3,-1,4.38367252156604,3.95925725742742,0.424415264138624,44,30,14,59,36,23,85,43,42,3,1,0,0
"5758","CHI","WPG",2013020227,16015,20132014,1,60,4,1,3,2.66067258024123,4.32841184106655,-1.66773926082533,28,25,3,37,32,5,52,42,10,2,2,0,0
"5759","CHI","DAL",2013020252,16018,20132014,0,60,5,2,3,3.87542264114063,2.96712330868468,0.908299332455951,31,33,-2,35,47,-12,47,68,-21,2,6,0,0
"5760","CHI","EDM",2013020258,16019,20132014,1,60,5,4,1,4.2681818548881,2.50860357299814,1.75957828188996,36,23,13,47,33,14,70,37,33,5,3,0,0
"5761","CHI","ARI",2013020280,16023,20132014,1,65,4,4,0,6.35068130702712,3.51893047490012,2.831750832127,52,30,22,60,42,18,79,55,24,4,4,0,0
"5762","CHI","NSH",2013020299,16025,20132014,0,60,2,7,-5,6.22923409019131,2.86841936000565,3.36081473018567,41,30,11,60,37,23,76,44,32,4,5,0,0
"5763","CHI","S.J",2013020306,16026,20132014,1,60,5,1,4,4.00830505572674,2.9402428100293,1.06806224569743,27,24,3,37,33,4,54,47,7,2,2,0,0
"5764","CHI","COL",2013020318,16028,20132014,0,60,1,5,-4,6.71584971796256,3.07018346183162,3.64566625613093,37,23,14,52,32,20,67,41,26,1,1,0,0
"5765","CHI","WPG",2013020330,16030,20132014,0,60,6,3,3,5.3585880991991,4.45987799695831,0.898710102240791,33,25,8,48,38,10,62,49,13,5,5,0,0
"5766","CHI","VAN",2013020350,16032,20132014,0,60,2,1,1,3.91615813475801,4.03899664760684,-0.12283851284883,29,37,-8,39,47,-8,50,61,-11,2,3,0,0
"5767","CHI","EDM",2013020362,16034,20132014,0,60,5,1,4,6.51495723208063,2.91123582037983,3.6037214117008,27,25,2,44,31,13,52,42,10,4,3,0,0
"5768","CHI","CGY",2013020376,16036,20132014,0,60,3,2,1,5.06895163477748,3.24248168180929,1.82646995296818,30,22,8,46,28,18,75,35,40,2,1,0,0
"5769","CHI","DAL",2013020391,16038,20132014,0,65,1,1,0,3.81710310102587,3.96372750721218,-0.146624406186313,26,29,-3,35,43,-8,60,56,4,2,3,0,0
"5770","CHI","ARI",2013020399,16039,20132014,0,60,5,2,3,7.11839828127995,3.93886464106617,3.17953364021378,36,34,2,47,49,-2,63,60,3,5,5,0,0
"5771","CHI","DAL",2013020415,16042,20132014,1,60,3,4,-1,2.91452367807506,2.84986917191168,0.0646545061633788,50,18,32,60,28,32,85,35,50,5,3,0,0
"5772","CHI","MIN",2013020430,16044,20132014,0,60,3,4,-1,1.55953183494421,5.00925065792399,-3.44971882297978,19,23,-4,28,27,1,45,38,7,2,3,0,0
"5773","CHI","ANA",2013020435,16045,20132014,1,65,2,2,0,3.04712322307751,1.45763447756565,1.58948874551186,25,26,-1,40,38,2,61,49,12,3,1,0,0
"5774","CHI","FLA",2013020452,16047,20132014,1,60,6,2,4,4.95952247024476,5.96627623045821,-1.00675376021345,32,35,-3,41,46,-5,50,69,-19,5,6,0,0
"5775","CHI","DAL",2013020465,16049,20132014,0,60,6,2,4,4.0275549293458,3.88675699935993,0.140797929985865,33,29,4,45,45,0,57,66,-9,7,6,0,0
"5776","CHI","PHI",2013020471,16050,20132014,1,60,7,2,5,3.55163299581977,4.18138486577108,-0.629751869951306,23,30,-7,31,40,-9,46,52,-6,7,5,0,0
"5777","CHI","TOR",2013020490,16053,20132014,0,60,3,7,-4,3.54777566384883,5.05424831152418,-1.50647264767535,28,32,-4,44,44,0,67,56,11,2,4,0,0
"5778","CHI","L.A",2013020503,16054,20132014,1,60,3,1,2,4.07847470446359,3.40188413245542,0.676590572008166,40,22,18,49,28,21,56,39,17,3,3,0,0
"5779","CHI","NSH",2013020517,16056,20132014,0,60,3,1,2,3.09348804805643,2.80085935836541,0.292628689691014,27,28,-1,33,33,0,46,52,-6,5,6,0,0
"5780","CHI","VAN",2013020537,16059,20132014,1,65,2,2,0,3.01860011104145,3.70270902942866,-0.68410891838721,26,24,2,36,37,-1,48,50,-2,4,4,0,0
"5781","CHI","N.J",2013020561,16062,20132014,1,60,5,2,3,7.71142266379588,3.6046814980634,4.10674116573248,37,12,25,53,21,32,65,32,33,4,1,0,0
"5782","CHI","COL",2013020572,16066,20132014,1,60,7,2,5,7.09039776723512,3.04840484005399,4.04199292718113,37,18,19,49,22,27,59,30,29,3,2,0,0
"5783","CHI","STL",2013020581,16067,20132014,0,65,5,5,0,4.33384074945312,4.54067935599596,-0.206838606542846,32,25,7,41,43,-2,53,61,-8,1,4,0,0
"5784","CHI","L.A",2013020596,16069,20132014,1,60,1,0,1,1.71321298729754,4.55149797163904,-2.8382849843415,30,26,4,37,36,1,45,49,-4,3,3,0,0
"5785","CHI","NYI",2013020613,16072,20132014,0,60.9666666666667,2,3,-1,4.37998199637514,3.81519853830105,0.564783458074089,39,34,5,47,45,2,63,59,4,1,2,0,0
"5786","CHI","N.J",2013020622,16073,20132014,0,60,5,3,2,1.30660442868248,2.56680429575499,-1.26019986707252,24,27,-3,29,36,-7,36,47,-11,3,4,0,0
"5787","CHI","S.J",2013020640,16075,20132014,1,65,2,2,0,7.18814267501875,9.13712991290959,-1.94898723789083,35,42,-7,44,48,-4,58,65,-7,0,1,0,0
"5788","CHI","NYR",2013020658,16078,20132014,1,60,2,3,-1,3.45378706301562,4.79165009975213,-1.33786303673651,37,32,5,46,36,10,57,48,9,3,2,0,0
"5789","CHI","MTL",2013020676,16081,20132014,0,61.4666666666667,1,2,-1,1.72715872752087,5.97858884917139,-4.25143012165051,20,38,-18,28,50,-22,45,65,-20,1,3,0,0
"5790","CHI","EDM",2013020689,16082,20132014,1,60,5,3,2,6.81808776925027,2.46045174162282,4.35763602762745,41,21,20,56,28,28,74,40,34,5,1,0,0
"5791","CHI","COL",2013020702,16084,20132014,1,64.15,2,3,-1,5.72706325314675,3.75066723977341,1.97639601337335,48,26,22,65,29,36,88,37,51,5,4,0,0
"5792","CHI","ANA",2013020722,16087,20132014,1,60,4,2,2,4.62781252071727,2.22122120534755,2.40659131536972,35,21,14,51,28,23,74,38,36,5,2,0,0
"5793","CHI","BOS",2013020736,16089,20132014,1,65,2,2,0,6.93359730171505,6.07944058244109,0.854156719273959,37,36,1,46,44,2,58,62,-4,2,3,0,0
"5794","CHI","DET",2013020757,16092,20132014,0,65,4,4,0,6.76970288811509,3.07387783252852,3.69582505558657,35,31,4,43,48,-5,52,61,-9,4,4,0,0
"5795","CHI","MIN",2013020764,16093,20132014,0,60,1,2,-1,5.00192602583229,2.98416804446606,2.01775798136623,34,19,15,45,28,17,60,37,23,1,4,0,0
"5796","CHI","WPG",2013020786,16096,20132014,1,60,1,3,-2,4.23994064001264,5.15016606696219,-0.910225426949543,35,21,14,54,36,18,67,46,21,4,2,0,0
"5797","CHI","CGY",2013020803,16098,20132014,0,62.4333333333333,4,5,-1,6.25148358029219,4.78320995549439,1.4682736247978,33,29,4,46,37,9,71,46,25,1,2,0,0
"5798","CHI","VAN",2013020808,16099,20132014,0,60,5,2,3,4.94775675325945,3.94812457006554,0.99963218319391,40,31,9,59,41,18,74,72,2,4,4,0,0
"5799","CHI","S.J",2013020834,16102,20132014,0,65,1,1,0,4.49691130948486,4.59278696648488,-0.0958756570000219,30,39,-9,44,47,-3,65,58,7,4,4,0,0
"5800","CHI","L.A",2013020842,16104,20132014,0,60,5,3,2,5.7589747980237,4.28814941813471,1.47082537988899,30,34,-4,45,52,-7,56,61,-5,5,4,0,0
"5801","CHI","ANA",2013020854,16106,20132014,0,60,2,0,2,3.44603905253462,3.78221757761639,-0.336178525081777,25,29,-4,33,47,-14,44,69,-25,2,4,0,0
"5802","CHI","ARI",2013020870,16108,20132014,0,60,0,2,-2,3.43150712747592,3.82467546335829,-0.393168335882365,30,26,4,37,37,0,51,49,2,3,6,0,0
"5803","CHI","NYR",2013020888,16128,20132014,0,60,1,2,-1,3.29429516103028,4.54859712332836,-1.25430196229809,32,24,8,45,34,11,62,39,23,3,1,0,0
"5804","CHI","COL",2013020927,16133,20132014,1,60,2,4,-2,4.22718649812441,3.71378928679042,0.513397211333995,38,21,17,48,25,23,65,36,29,4,3,0,0
"5805","CHI","CBJ",2013020942,16135,20132014,1,60,6,1,5,5.42921149772883,3.10085551859811,2.32835597913072,33,23,10,40,31,9,52,37,15,4,4,0,0
"5806","CHI","COL",2013020987,16141,20132014,0,60,2,3,-1,5.02833684720926,4.29134958913419,0.736987258075075,39,29,10,53,43,10,71,57,14,3,4,0,0
"5807","CHI","NSH",2013021000,16143,20132014,1,60,2,3,-1,4.87279810686596,4.09424932151887,0.778548785347084,33,29,4,44,34,10,63,49,14,2,3,0,0
"5808","CHI","DET",2013021020,16145,20132014,1,60,4,1,3,4.76490527734859,4.78394092456438,-0.0190356472157873,30,20,10,35,36,-1,53,47,6,4,5,0,0
"5809","CHI","PHI",2013021033,16147,20132014,0,64.9166666666667,2,3,-1,4.39927924379589,6.50735962067847,-2.10808037688258,25,37,-12,37,57,-20,49,71,-22,4,6,0,0
"5810","CHI","STL",2013021039,16148,20132014,1,60,4,0,4,5.2965020625852,3.93983490725077,1.35666715533443,30,23,7,43,34,9,52,45,7,3,3,0,0
"5811","CHI","CAR",2013021052,16150,20132014,1,60,3,2,1,2.31943167119975,3.92726901754384,-1.60783734634409,25,28,-3,31,30,1,42,42,0,5,6,0,0
"5812","CHI","NSH",2013021069,16152,20132014,1,60,0,2,-2,4.30598849576185,2.7801212195897,1.52586727617215,29,17,12,41,19,22,58,24,34,5,4,0,0
"5813","CHI","DAL",2013021086,16154,20132014,1,60,4,2,2,6.75063775897797,6.50600809181628,0.244629667161689,42,27,15,48,39,9,54,49,5,3,2,0,0
"5814","CHI","BOS",2013021092,16156,20132014,0,60,0,3,-3,2.94626490332303,2.36244018575105,0.58382471757198,28,23,5,37,33,4,47,44,3,2,1,0,0
"5815","CHI","OTT",2013021104,16157,20132014,0,60,3,5,-2,6.12054738905499,3.4882271392853,2.63232024976969,49,29,20,57,39,18,73,56,17,7,2,0,0
"5816","CHI","MIN",2013021148,16163,20132014,1,65,2,2,0,3.69250639205347,4.46162471251591,-0.769118320462439,26,27,-1,34,36,-2,52,54,-2,2,2,0,0
"5817","CHI","CBJ",2013021154,16164,20132014,0,60,4,3,1,5.57798891694735,3.12806503944033,2.44992387750702,38,27,11,46,32,14,56,48,8,2,3,0,0
"5818","CHI","STL",2013021174,16166,20132014,1,60,4,2,2,4.03680368537607,3.10227415601371,0.934529529362358,35,23,12,45,30,15,60,38,22,5,4,0,0
"5819","CHI","MTL",2013021190,16169,20132014,1,60.7166666666667,3,2,1,4.43580948357703,3.04744699766161,1.38836248591542,28,30,-2,36,37,-1,60,44,16,2,0,0,0
"5820","CHI","NSH",2013021217,16172,20132014,0,60,5,7,-2,4.78500735503621,5.52652460902127,-0.741517253985052,25,33,-8,33,41,-8,48,50,-2,2,3,0,0
"5821","CHI","STL",2013030161,16177,20132014,0,80,3,3,0,4.94687566616449,9.67284514677885,-4.72596948061437,35,38,-3,48,63,-15,71,76,-5,5,3,0,0
"5822","CHI","STL",2013030162,16179,20132014,0,65.8333333333333,3,4,-1,5.33121909718466,6.54294668979128,-1.21172759260662,28,31,-3,39,45,-6,53,63,-10,5,8,0,0
"5823","CHI","STL",2013030163,16181,20132014,1,60,2,0,2,5.35814140428556,7.33033660631918,-1.97219520203362,25,34,-9,32,46,-14,49,70,-21,4,3,0,0
"5824","CHI","STL",2013030164,16183,20132014,1,71.2833333333333,4,3,1,6.48674968391424,5.37169041525362,1.11505926866062,34,33,1,49,45,4,74,62,12,3,6,0,0
"5825","CHI","STL",2013030165,16185,20132014,0,67.6,3,2,1,4.84813496272545,5.83783091776161,-0.989695955036154,30,29,1,42,44,-2,60,65,-5,3,3,0,0
"5826","CHI","STL",2013030166,16187,20132014,1,60,5,1,4,4.47864806617144,5.06732008992321,-0.588672023751769,27,36,-9,32,46,-14,45,66,-21,3,5,0,0
"5827","CHI","MIN",2013030231,16192,20132014,1,60,5,2,3,4.53308460535482,4.66040679323942,-0.127322187884602,22,32,-10,30,50,-20,49,60,-11,3,3,0,0
"5828","CHI","MIN",2013030232,16194,20132014,1,60,4,1,3,0,0,0,22,19,3,35,25,10,46,50,-4,2,1,0,0
"5829","CHI","MIN",2013030233,16196,20132014,0,60,0,4,-4,5.20234764899942,4.33253945433535,0.869808194664074,19,18,1,38,28,10,52,44,8,2,4,0,0
"5830","CHI","MIN",2013030234,16199,20132014,0,60,2,4,-2,3.59317922668165,6.60576681990642,-3.01258759322477,20,31,-11,26,44,-18,41,57,-16,2,5,0,0
"5831","CHI","MIN",2013030235,16201,20132014,1,60,2,1,1,3.69831329770386,5.56040738348383,-1.86209408577997,28,28,0,33,33,0,49,42,7,3,2,0,0
"5832","CHI","MIN",2013030236,16203,20132014,0,69.7,2,1,1,3.23519435313938,6.97860803472577,-3.74341368158639,27,35,-8,32,47,-15,52,68,-16,1,3,0,0
"5833","CHI","L.A",2013030321,16208,20132014,1,60,3,1,2,2.67630463335081,3.28495707921684,-0.608652445866028,20,26,-6,28,33,-5,43,58,-15,2,2,0,0
"5834","CHI","L.A",2013030322,16211,20132014,1,60,2,6,-4,2.96901998629979,4.28939225545037,-1.32037226915057,25,31,-6,30,38,-8,47,51,-4,5,5,0,0
"5835","CHI","L.A",2013030323,16214,20132014,0,60,3,4,-1,5.994099839314,4.01390961634969,1.98019022296431,27,32,-5,42,47,-5,58,57,1,4,3,0,0
"5836","CHI","L.A",2013030324,16216,20132014,0,60,2,5,-3,6.04356681974605,4.95379728899673,1.08976953074932,24,21,3,39,36,3,62,48,14,4,4,0,0
"5837","CHI","L.A",2013030325,16218,20132014,1,80,4,4,0,6.24909718648996,4.58975083474721,1.65934635174276,44,43,1,56,57,-1,79,74,5,4,3,0,0
"5838","CHI","L.A",2013030326,16220,20132014,0,60,4,3,1,2.92081668587343,3.30242955510039,-0.381612869226956,25,29,-4,36,44,-8,47,63,-16,2,2,0,0
"5839","CHI","L.A",2013030327,16222,20132014,1,65.7833333333333,4,5,-1,4.17445278170999,7.72168746510533,-3.54723468339534,41,32,9,45,48,-3,57,71,-14,5,2,0,0
"5840","CHI","DAL",2014020013,16352,20142015,0,65,2,2,0,4.88328545651166,4.93395653400371,-0.0506710774920514,26,34,-8,42,57,-15,68,73,-5,6,7,0,0
"5841","CHI","CGY",2014020048,16358,20142015,1,64.5833333333333,1,2,-1,5.93608418163058,1.69774435449668,4.2383398271339,50,18,32,66,22,44,96,33,63,7,1,0,0
"5842","CHI","NSH",2014020071,16361,20142015,1,63.4333333333333,2,1,1,6.54435983197608,5.62799363011825,0.916366201857826,37,20,17,43,30,13,60,47,13,5,4,0,0
"5843","CHI","PHI",2014020085,16364,20142015,1,60,4,0,4,7.2971861451806,3.60631276556524,3.69087337961537,43,32,11,56,40,16,71,55,16,4,2,0,0
"5844","CHI","NSH",2014020096,16366,20142015,0,60,2,3,-1,5.25497660771666,4.09567157534184,1.15930503237482,32,27,5,41,40,1,57,52,5,1,2,0,0
"5845","CHI","STL",2014020112,16368,20142015,0,60,2,3,-1,3.3658452718052,5.08810329827247,-1.72225802646727,24,31,-7,37,45,-8,53,52,1,4,4,0,0
"5846","CHI","OTT",2014020119,16369,20142015,1,60,2,1,1,6.54429135105759,5.98291504717162,0.561376303885964,45,33,12,50,47,3,63,60,3,9,5,0,0
"5847","CHI","ANA",2014020131,16371,20142015,1,60,0,1,-1,4.46166182355955,3.17798053324248,1.28368129031708,38,25,13,48,35,13,66,44,22,4,2,0,0
"5848","CHI","OTT",2014020141,16373,20142015,0,65,4,4,0,6.0406289042471,7.94402647754481,-1.90339757329771,39,32,7,53,53,0,70,68,2,6,7,0,0
"5849","CHI","TOR",2014020154,16375,20142015,0,60,2,3,-1,8.09537480036083,2.58599155620323,5.50938324415761,47,27,20,68,34,34,87,44,43,4,3,0,0
"5850","CHI","WPG",2014020169,16376,20142015,1,60,0,1,-1,4.70058635604801,2.49663601670181,2.20395033934619,33,27,6,46,34,12,76,43,33,2,2,0,0
"5851","CHI","MTL",2014020177,16378,20142015,0,60,5,0,5,7.22307175263995,4.30927388387499,2.91379786876496,32,28,4,46,35,11,70,50,20,5,6,0,0
"5852","CHI","S.J",2014020216,16383,20142015,1,60,5,2,3,4.7385637880725,7.05700073598655,-2.31843694791405,37,34,3,43,42,1,53,59,-6,5,3,0,0
"5853","CHI","T.B",2014020228,16385,20142015,1,65,2,2,0,5.3010600778216,3.87091927268071,1.43014080514089,39,27,12,46,36,10,69,50,19,8,5,0,0
"5854","CHI","DET",2014020245,16388,20142015,0,60,1,4,-3,4.40704641974298,4.3154705435154,0.09157587622758,26,37,-11,35,40,-5,47,49,-2,4,3,0,0
"5855","CHI","DAL",2014020263,16390,20142015,1,60,6,2,4,3.13994509284385,2.89828128765657,0.241663805187272,47,24,23,59,32,27,77,46,31,4,1,0,0
"5856","CHI","CGY",2014020287,16394,20142015,0,60,4,3,1,1.36230515528587,3.57916895166775,-2.21686379638189,22,27,-5,30,36,-6,44,56,-12,2,6,0,0
"5857","CHI","EDM",2014020306,16396,20142015,0,60,7,1,6,4.49158703466258,2.57286716034463,1.91871987431795,30,25,5,46,33,13,59,47,12,8,3,0,0
"5858","CHI","VAN",2014020311,16397,20142015,0,60,1,4,-3,3.0364528400136,4.48714415184804,-1.45069131183445,25,30,-5,35,43,-8,53,57,-4,4,2,0,0
"5859","CHI","COL",2014020330,16400,20142015,0,60,3,2,1,5.54949164985938,3.57974847113655,1.96974317872282,45,29,16,60,36,24,76,48,28,6,2,0,0
"5860","CHI","ANA",2014020334,16402,20142015,0,60,4,1,3,6.11565071617997,1.60414145690942,4.51150925927055,38,24,14,53,31,22,64,35,29,4,3,0,0
"5861","CHI","L.A",2014020354,16403,20142015,0,60,4,1,3,0,0,0,25,20,5,41,44,-3,48,57,-9,2,3,0,0
"5862","CHI","STL",2014020373,16407,20142015,1,60,4,1,3,4.54058656158668,3.6743251702286,0.866261391358077,33,41,-8,44,48,-4,60,60,0,5,7,0,0
"5863","CHI","MTL",2014020389,16409,20142015,1,60,4,3,1,4.38737557105135,5.99743197092175,-1.6100563998704,36,41,-5,44,50,-6,64,61,3,4,4,0,0
"5864","CHI","NSH",2014020398,16410,20142015,0,60,3,1,2,4.93415885861032,6.35457841359312,-1.4204195549828,31,33,-2,39,41,-2,52,53,-1,3,1,0,0
"5865","CHI","N.J",2014020410,16413,20142015,0,65,2,2,0,6.91033860425523,2.34070531157158,4.56963329268365,39,24,15,56,33,23,73,41,32,2,1,0,0
"5866","CHI","BOS",2014020421,16415,20142015,0,60,3,2,1,4.20980476238765,2.93678350504442,1.27302125734323,21,34,-13,35,46,-11,43,57,-14,5,3,0,0
"5867","CHI","NYI",2014020439,16417,20142015,0,60,2,3,-1,2.90419391495222,6.13278839923441,-3.2285944842822,25,41,-16,31,59,-28,49,71,-22,1,3,0,0
"5868","CHI","CGY",2014020449,16418,20142015,1,60,2,1,1,5.31711590778991,3.14553080574842,2.17158510204149,28,24,4,52,36,16,78,44,34,2,3,0,0
"5869","CHI","MIN",2014020461,16420,20142015,1,60,5,3,2,5.77782689034939,4.03732131308061,1.74050557726878,39,29,10,44,38,6,61,56,5,3,4,0,0
"5870","CHI","CBJ",2014020487,16424,20142015,0,65,2,2,0,6.0516649815836,5.40072382218204,0.650941159401555,41,19,22,59,28,31,65,42,23,6,4,0,0
"5871","CHI","TOR",2014020495,16425,20142015,1,60,4,0,4,4.70166233658904,5.43036364405202,-0.728701307462984,34,31,3,41,40,1,53,54,-1,2,2,0,0
"5872","CHI","WPG",2014020511,16427,20142015,1,60,1,5,-4,4.22584677319264,3.96034593003716,0.265500843155479,39,26,13,50,35,15,68,53,15,2,2,0,0
"5873","CHI","COL",2014020524,16431,20142015,0,60,5,2,3,7.45077225656132,6.03766889170947,1.41310336485185,33,25,8,46,38,8,62,55,7,4,3,0,0
"5874","CHI","NSH",2014020537,16433,20142015,1,65,4,4,0,6.82947800721212,5.61956874136224,1.20990926584988,42,40,2,56,53,3,80,67,13,6,6,0,0
"5875","CHI","DAL",2014020579,16439,20142015,1,61.2833333333333,5,4,1,5.95898913947167,4.24755922888653,1.71142991058514,38,34,4,49,35,14,76,46,30,3,0,0,0
"5876","CHI","COL",2014020589,16441,20142015,1,60,0,2,-2,5.563377774939,2.21743040827363,3.34594736666537,54,24,30,71,32,39,92,44,48,4,3,0,0
"5877","CHI","MIN",2014020603,16443,20142015,0,60,4,2,2,4.27511745016091,6.25645523448475,-1.98133778432384,20,44,-24,27,58,-31,36,81,-45,1,5,0,0
"5878","CHI","EDM",2014020612,16444,20142015,0,60,2,5,-3,3.21846306370571,3.37589477642905,-0.157431712723337,21,22,-1,28,33,-5,49,52,-3,2,2,0,0
"5879","CHI","MIN",2014020625,16446,20142015,1,60,4,1,3,3.62867998955335,5.06901801982895,-1.4403380302756,35,37,-2,46,48,-2,63,60,3,2,3,0,0
"5880","CHI","WPG",2014020658,16451,20142015,1,60,2,4,-2,3.72141334208164,4.64214470688967,-0.920731364808024,33,35,-2,42,42,0,62,51,11,4,5,0,0
"5881","CHI","DAL",2014020673,16453,20142015,1,60,3,6,-3,4.69298736152996,5.39682362662643,-0.70383626509647,41,34,7,57,43,14,77,53,24,3,2,0,0
"5882","CHI","ARI",2014020689,16455,20142015,1,60,6,1,5,7.37466027880146,3.7295443121111,3.64511596669035,51,36,15,62,39,23,82,49,33,5,2,0,0
"5883","CHI","L.A",2014020710,16463,20142015,0,60,3,4,-1,4.9790001915826,3.18931502184205,1.78968516974055,29,27,2,44,43,1,60,51,9,4,2,0,0
"5884","CHI","ANA",2014020726,16465,20142015,0,60,4,1,3,4.54355758053134,3.942317279279,0.601240301252346,33,22,11,45,35,10,60,45,15,3,3,0,0
"5885","CHI","S.J",2014020737,16466,20142015,0,60,0,2,-2,2.2314272458658,4.63071509485599,-2.39928784899018,31,20,11,36,34,2,50,46,4,2,4,0,0
"5886","CHI","MIN",2014020752,16469,20142015,0,60,0,3,-3,4.05876732023899,5.14497534699171,-1.08620802675273,24,43,-19,34,51,-17,45,65,-20,3,4,0,0
"5887","CHI","WPG",2014020771,16472,20142015,0,63.0166666666667,2,1,1,5.1589437671937,0.899087615543976,4.25985615164973,22,21,1,35,28,7,48,43,5,3,3,0,0
"5888","CHI","ARI",2014020795,16475,20142015,1,65,2,2,0,5.31810324635444,2.64566267643193,2.67244056992251,38,29,9,47,39,8,65,58,7,4,2,0,0
"5889","CHI","VAN",2014020807,16477,20142015,1,61.3333333333333,4,5,-1,7.23851102197659,6.96637600072427,0.272135021252325,41,36,5,52,45,7,73,56,17,4,1,0,0
"5890","CHI","N.J",2014020819,16479,20142015,1,60,3,1,2,7.39252026252507,4.63980227031905,2.75271799220602,35,26,9,48,31,17,65,48,17,4,2,0,0
"5891","CHI","DET",2014020854,16484,20142015,1,65,2,2,0,6.19760760845566,3.90376790208393,2.29383970637173,34,28,6,51,34,17,74,54,20,4,1,0,0
"5892","CHI","COL",2014020870,16486,20142015,1,60,1,4,-3,2.42149833153235,5.44785451475764,-3.02635618322529,28,30,-2,37,35,2,63,42,21,3,4,0,0
"5893","CHI","BOS",2014020885,16488,20142015,1,60,2,6,-4,4.84195395529969,3.47328593728719,1.3686680180125,28,30,-2,35,41,-6,53,52,1,6,6,0,0
"5894","CHI","T.B",2014020920,16493,20142015,0,60,0,4,-4,3.49658919787758,2.2517977236439,1.24479147423368,28,29,-1,36,44,-8,50,61,-11,3,6,0,0
"5895","CHI","CAR",2014020940,16496,20142015,1,60,5,2,3,2.49607091715734,3.86470384721179,-1.36863293005445,26,29,-3,34,38,-4,53,53,0,0,3,0,0
"5896","CHI","EDM",2014020968,16500,20142015,1,65,1,1,0,7.24023771926295,5.14846158496465,2.0917761342983,39,47,-8,56,56,0,78,76,2,3,1,0,0
"5897","CHI","NYR",2014020985,16502,20142015,1,60.5333333333333,0,1,-1,3.06465887033846,3.78837216182728,-0.723713291488821,29,36,-7,42,40,2,60,48,12,4,2,0,0
"5898","CHI","ARI",2014021011,16506,20142015,0,60,2,1,1,8.68843531471248,3.03537718008738,5.6530581346251,44,18,26,56,26,30,79,36,43,6,2,0,0
"5899","CHI","S.J",2014021020,16508,20142015,0,60,6,2,4,5.82615821100978,4.53815769211526,1.28800051889452,30,35,-5,42,47,-5,59,63,-4,4,4,0,0
"5900","CHI","NYI",2014021047,16511,20142015,1,60,4,1,3,5.95500245556468,6.47189319256631,-0.516890737001631,30,39,-9,42,50,-8,54,63,-9,1,1,0,0
"5901","CHI","NYR",2014021050,16512,20142015,0,60,1,0,1,5.36492214275495,4.89585208712379,0.469070055631164,31,25,6,45,42,3,58,54,4,2,2,0,0
"5902","CHI","DAL",2014021076,16515,20142015,0,60,0,4,-4,0,0,0,33,29,4,44,39,5,62,46,16,3,3,0,0
"5903","CHI","CAR",2014021084,16517,20142015,0,60,3,1,2,5.23894416220719,6.19295781070832,-0.954013648501132,25,44,-19,37,57,-20,46,82,-36,0,1,0,0
"5904","CHI","PHI",2014021098,16519,20142015,0,60,1,4,-3,4.02878760021849,6.79656249808613,-2.76777489786764,35,33,2,47,48,-1,63,62,1,2,2,0,0
"5905","CHI","CBJ",2014021113,16521,20142015,1,60,2,5,-3,4.08233780460432,3.31588043062948,0.766457373974845,33,27,6,41,30,11,58,39,19,5,1,0,0
"5906","CHI","WPG",2014021135,16523,20142015,0,60,4,3,1,4.95968917432947,5.16724591010396,-0.207556735774496,24,34,-10,36,47,-11,55,56,-1,3,4,0,0
"5907","CHI","L.A",2014021138,16524,20142015,1,60,4,1,3,5.99775559522095,5.90822088139743,0.0895347138235181,40,32,8,50,37,13,62,50,12,2,1,0,0
"5908","CHI","VAN",2014021160,16527,20142015,1,60,3,1,2,4.9604341471491,5.30509610376907,-0.344661956619969,38,36,2,46,41,5,57,56,1,4,2,0,0
"5909","CHI","MIN",2014021196,16532,20142015,1,60,1,2,-1,4.85036004800349,4.35740092815831,0.492959119845182,33,30,3,39,45,-6,59,55,4,1,1,0,0
"5910","CHI","COL",2014021228,16536,20142015,0,60,2,3,-1,6.71382278011879,3.03735663974658,3.67646614037221,30,24,6,47,31,16,57,41,16,1,3,0,0
"5911","CHI","MIN",2014030231,16556,20142015,1,60,4,3,1,4.99162794458971,3.18363917991519,1.80798876467452,35,33,2,43,40,3,55,52,3,1,3,0,0
"5912","CHI","MIN",2014030232,16558,20142015,1,60,4,1,3,7.09964501991635,7.25533899664879,-0.155693976732437,31,31,0,45,42,3,63,51,12,2,2,0,0
"5913","CHI","MIN",2014030233,16560,20142015,0,60,1,0,1,3.28299831195909,5.7624851805158,-2.47948686855671,22,30,-8,31,46,-15,41,65,-24,1,3,0,0
"5914","CHI","MIN",2014030234,16562,20142015,0,60,4,3,1,3.55977274928591,4.54784709436353,-0.988074345077621,25,37,-12,39,50,-11,53,64,-11,2,3,0,0
"5915","CHI","ANA",2014030321,16572,20142015,0,60,1,4,-3,6.04807026666448,4.93917166675521,1.10889859990927,33,27,6,48,44,4,70,53,17,3,1,0,0
"5916","CHI","ANA",2014030322,16574,20142015,0,80,2,2,0,7.12892624622964,9.3823990537785,-2.25347280754886,36,43,-7,51,65,-14,76,87,-11,4,5,0,0
"5917","CHI","ANA",2014030323,16576,20142015,1,60,1,2,-1,6.64058906352147,2.92728177348545,3.71330729003603,28,27,1,40,37,3,67,46,21,5,2,0,0
"5918","CHI","ANA",2014030324,16578,20142015,1,80,4,4,0,6.4982492380077,8.18230053581647,-1.68405129780876,38,47,-9,54,54,0,86,72,14,5,3,0,0
"5919","CHI","ANA",2014030325,16580,20142015,0,60.75,4,5,-1,3.26355722071712,5.34992354374845,-2.08636632303133,28,28,0,45,43,2,66,54,12,2,2,0,0
"5920","CHI","ANA",2014030326,16582,20142015,1,60,5,2,3,5.7910103816539,4.88779689737385,0.903213484280059,23,32,-9,31,38,-7,54,57,-3,3,3,0,0
"5921","CHI","ANA",2014030327,16585,20142015,0,60,5,3,2,4.11951864325601,7.37644325086148,-3.25692460760547,26,38,-12,37,53,-16,51,68,-17,4,2,0,0
"5922","CHI","T.B",2014030411,16589,20142015,0,60,2,1,1,3.05653861819883,4.06384769629221,-1.00730907809339,21,23,-2,37,34,3,52,45,7,3,2,0,0
"5923","CHI","T.B",2014030412,16592,20142015,0,60,3,4,-1,5.46990353584988,1.81365973702941,3.65624379882047,29,24,5,40,36,4,49,48,1,3,3,0,0
"5924","CHI","T.B",2014030413,16594,20142015,1,60,2,3,-1,5.88450596208077,5.57656384682923,0.307942115251535,38,32,6,48,37,11,67,51,16,3,3,0,0
"5925","CHI","T.B",2014030414,16596,20142015,1,60,2,1,1,2.07787842125981,3.55211690050783,-1.47423847924802,19,25,-6,28,38,-10,45,61,-16,3,4,0,0
"5926","CHI","T.B",2014030415,16599,20142015,0,60,2,1,1,4.75049657642376,6.21799716673518,-1.46750059031142,29,32,-3,40,43,-3,56,61,-5,2,1,0,0
"5927","CHI","T.B",2014030416,16601,20142015,1,60,2,0,2,5.0149532277137,5.5245464678826,-0.509593240168897,32,25,7,46,35,11,58,60,-2,3,1,0,0
"5928","CHI","NYR",2015020002,16715,20152016,1,60,2,3,-1,5.90410337418143,6.1170808870811,-0.21297751289967,34,27,7,48,38,10,63,41,22,2,1,0,0
"5929","CHI","NYI",2015020015,16717,20152016,0,61.8166666666667,3,2,1,4.69587922026403,4.83731691121648,-0.141437690952444,35,36,-1,43,50,-7,57,70,-13,3,2,0,0
"5930","CHI","NYI",2015020026,16718,20152016,1,60,4,1,3,4.77328097843929,6.07886819364838,-1.30558721520909,34,29,5,42,42,0,52,56,-4,7,2,0,0
"5931","CHI","PHI",2015020047,16722,20152016,0,60,0,3,-3,5.78486125963923,4.71915385380845,1.06570740583078,30,29,1,45,43,2,62,57,5,5,6,0,0
"5932","CHI","CBJ",2015020072,16725,20152016,1,60,4,1,3,5.28961867434555,4.2741706355373,1.01544803880824,30,23,7,40,29,11,60,39,21,7,4,0,0
"5933","CHI","T.B",2015020114,16732,20152016,1,60.2833333333333,1,0,1,4.07266866521331,3.09064455414773,0.982024111065584,32,21,11,44,30,14,66,51,15,3,4,0,0
"5934","CHI","ANA",2015020123,16734,20152016,1,60.85,1,0,1,2.36055826614756,4.58733290765667,-2.22677464150911,24,39,-15,31,46,-15,47,60,-13,5,5,0,0
"5935","CHI","WPG",2015020142,16737,20152016,0,60,1,3,-2,5.06199233624375,2.12263095956769,2.93936137667606,46,31,15,52,41,11,70,51,19,3,3,0,0
"5936","CHI","MIN",2015020151,16738,20152016,0,60,4,5,-1,6.36295700468253,3.2393794223899,3.12357758229263,29,30,-1,41,48,-7,56,66,-10,1,2,0,0
"5937","CHI","L.A",2015020170,16741,20152016,1,60,4,2,2,3.69156897696666,8.04166281194193,-4.35009383497527,26,35,-9,37,46,-9,53,63,-10,2,3,0,0
"5938","CHI","N.J",2015020195,16745,20152016,0,60,2,4,-2,4.10476751800161,3.63263401901607,0.472133498985542,29,26,3,36,33,3,53,38,15,3,2,0,0
"5939","CHI","EDM",2015020214,16747,20152016,1,60,4,2,2,3.34049824730027,3.64989009010719,-0.309391842806917,28,36,-8,35,45,-10,60,56,4,5,2,0,0
"5940","CHI","N.J",2015020238,16751,20152016,1,60,2,3,-1,4.82552342610503,2.9765186609593,1.84900476514573,29,22,7,38,25,13,60,33,27,5,3,0,0
"5941","CHI","CGY",2015020260,16754,20152016,1,60,4,1,3,5.33823071006634,4.96799491125404,0.370235798812304,41,26,15,55,38,17,71,55,16,1,2,0,0
"5942","CHI","EDM",2015020277,16757,20152016,0,61.1333333333333,4,3,1,0,0,0,27,37,-10,34,49,-15,43,64,-21,2,3,0,0
"5943","CHI","CGY",2015020291,16759,20152016,0,61.6333333333333,1,2,-1,3.65421524123194,4.44752365216846,-0.793308410936521,19,37,-18,29,45,-16,47,61,-14,3,2,0,0
"5944","CHI","VAN",2015020303,16760,20152016,0,60,3,6,-3,2.59206618260032,2.13346590020228,0.458600282398041,29,20,9,39,34,5,55,44,11,2,4,0,0
"5945","CHI","S.J",2015020329,16764,20152016,0,60,5,2,3,3.72982084098476,3.50420454933192,0.225616291652841,26,29,-3,46,42,4,65,55,10,3,5,0,0
"5946","CHI","ANA",2015020333,16766,20152016,0,61.8833333333333,3,2,1,4.93094182209143,5.72556137460197,-0.79461955251054,32,25,7,49,40,9,70,57,13,5,4,0,0
"5947","CHI","L.A",2015020353,16767,20152016,0,62.0666666666667,2,3,-1,1.38453092022974,5.65159419697011,-4.26706327674037,22,36,-14,33,54,-21,40,68,-28,1,1,0,0
"5948","CHI","MIN",2015020365,16770,20152016,1,60,1,2,-1,3.59229437037684,5.19115387995589,-1.59885950957905,31,36,-5,37,51,-14,59,64,-5,3,4,0,0
"5949","CHI","OTT",2015020376,16772,20152016,0,60.5,3,4,-1,4.32029636601222,3.87317611882463,0.447120247187587,38,27,11,50,33,17,68,41,27,4,4,0,0
"5950","CHI","WPG",2015020399,16775,20152016,1,60,3,1,2,0,0,0,32,31,1,43,38,5,54,56,-2,3,2,0,0
"5951","CHI","NSH",2015020414,16777,20152016,1,60,4,1,3,4.37453414967335,4.61393635017731,-0.239402200503954,24,37,-13,35,41,-6,54,60,-6,3,2,0,0
"5952","CHI","NSH",2015020425,16779,20152016,0,60,1,5,-4,4.45528627626481,4.5178565797396,-0.0625703034747858,36,34,2,44,37,7,59,52,7,3,1,0,0
"5953","CHI","WPG",2015020430,16780,20152016,1,60,2,0,2,3.0564654963317,3.9059689223634,-0.849503426031697,31,25,6,37,34,3,45,57,-12,5,5,0,0
"5954","CHI","VAN",2015020447,16782,20152016,1,60,4,0,4,3.44112433407292,4.38166047330014,-0.94053613922722,30,30,0,41,38,3,60,53,7,2,3,0,0
"5955","CHI","COL",2015020462,16784,20152016,1,60,0,3,-3,2.96119357570211,7.23327472212259,-4.27208114642048,29,27,2,38,37,1,60,49,11,2,4,0,0
"5956","CHI","EDM",2015020473,16786,20152016,1,60,4,0,4,3.65067119596642,3.83111574055511,-0.180444544588681,37,33,4,41,39,2,60,49,11,2,0,0,0
"5957","CHI","S.J",2015020498,16789,20152016,1,62.35,4,3,1,4.86291232501389,4.70699683457133,0.155915490442567,32,36,-4,42,40,2,56,55,1,1,3,0,0
"5958","CHI","DAL",2015020513,16791,20152016,0,60,0,4,-4,5.60145734702746,3.95892023254214,1.64253711448532,20,32,-12,31,44,-13,49,66,-17,3,5,0,0
"5959","CHI","CAR",2015020530,16796,20152016,1,60,1,2,-1,7.34116139146499,5.80380344379228,1.53735794767272,36,27,9,49,35,14,70,44,26,3,2,0,0
"5960","CHI","ARI",2015020550,16798,20152016,0,60,7,5,2,5.2359898078979,4.91183101180366,0.324158796094239,29,37,-8,41,53,-12,47,65,-18,4,8,0,0
"5961","CHI","COL",2015020560,16800,20152016,0,63.4833333333333,4,3,1,8.8723090326564,6.24454734894077,2.62776168371563,43,30,13,54,44,10,72,57,15,6,3,0,0
"5962","CHI","OTT",2015020581,16803,20152016,1,60,3,0,3,5.35148658947219,4.72686247830279,0.624624111169396,30,26,4,40,41,-1,56,65,-9,1,2,0,0
"5963","CHI","PIT",2015020592,16805,20152016,0,63.7833333333333,3,2,1,6.00261573382886,7.66113371704705,-1.65851798321819,30,36,-6,44,53,-9,54,68,-14,2,1,0,0
"5964","CHI","PIT",2015020597,16806,20152016,1,60,3,1,2,3.76766888753627,2.64288005761045,1.12478882992582,37,18,19,47,25,22,60,37,23,4,4,0,0
"5965","CHI","COL",2015020626,16810,20152016,1,60,6,3,3,3.65205664024916,3.13348919901182,0.518567441237337,35,37,-2,44,48,-4,65,58,7,2,2,0,0
"5966","CHI","NSH",2015020639,16812,20152016,1,60,3,2,1,2.25479316907604,4.41383610874129,-2.15904293966526,23,43,-20,35,55,-20,49,70,-21,5,6,0,0
"5967","CHI","MTL",2015020648,16814,20152016,0,60,2,1,1,4.3535747062997,7.82169009857898,-3.46811539227929,33,40,-7,43,47,-4,52,68,-16,1,1,0,0
"5968","CHI","TOR",2015020655,16815,20152016,0,60,4,1,3,4.59643298922969,3.35930377225407,1.23712921697563,29,29,0,42,48,-6,50,60,-10,6,3,0,0
"5969","CHI","MTL",2015020674,16817,20152016,1,60,5,2,3,5.64888218676788,4.1055964266161,1.54328576015178,33,29,4,41,43,-2,52,63,-11,4,2,0,0
"5970","CHI","NSH",2015020688,16819,20152016,0,60,4,1,3,4.66707894443607,3.54062031267677,1.12645863175931,27,39,-12,35,52,-17,48,61,-13,2,3,0,0
"5971","CHI","T.B",2015020698,16821,20152016,0,60,1,2,-1,3.20243692190373,3.33662687218748,-0.13418995028375,18,33,-15,30,45,-15,36,56,-20,3,4,0,0
"5972","CHI","CAR",2015020733,16826,20152016,0,60,0,5,-5,2.13230701982275,9.67011183996874,-7.53780482014599,26,40,-14,36,57,-21,48,65,-17,4,2,0,0
"5973","CHI","COL",2015020752,16833,20152016,0,60,2,1,1,8.11639012165138,4.57627261118614,3.54011751046524,42,23,19,62,30,32,83,45,38,3,2,0,0
"5974","CHI","ARI",2015020768,16835,20152016,0,64.5166666666667,5,4,1,5.03472349548247,2.7873246781528,2.24739881732967,40,28,12,58,37,21,69,46,23,6,6,0,0
"5975","CHI","DAL",2015020784,16837,20152016,0,60,5,1,4,1.54562203137903,5.20515637449646,-3.65953434311744,26,37,-11,34,53,-19,39,71,-32,6,6,0,0
"5976","CHI","S.J",2015020803,16840,20152016,1,60,0,2,-2,2.62690419150749,6.47770035668509,-3.8507961651776,33,27,6,43,36,7,57,51,6,3,1,0,0
"5977","CHI","DAL",2015020815,16842,20152016,1,60,2,4,-2,7.94454163170774,3.96079930354426,3.98374232816347,46,32,14,51,39,12,62,51,11,3,3,0,0
"5978","CHI","ANA",2015020832,16844,20152016,1,62.2666666666667,2,3,-1,2.43082114127174,6.79591330334006,-4.36509216206832,23,44,-21,29,59,-30,38,74,-36,3,4,0,0
"5979","CHI","TOR",2015020844,16846,20152016,1,60,7,2,5,3.42582175439833,6.59963909274666,-3.17381733834833,32,37,-5,41,48,-7,54,69,-15,6,3,0,0
"5980","CHI","NYR",2015020855,16848,20152016,0,60,5,3,2,3.9905246362614,5.70451120342113,-1.71398656715974,20,34,-14,28,47,-19,38,63,-25,4,1,0,0
"5981","CHI","MIN",2015020884,16852,20152016,0,60,1,6,-5,2.89169447956491,4.98085876729056,-2.08916428772565,32,33,-1,43,44,-1,63,50,13,5,6,0,0
"5982","CHI","NSH",2015020911,16856,20152016,1,60,1,3,-2,6.5890863077724,5.72500427468913,0.864082033083275,39,32,7,48,39,9,67,51,16,2,2,0,0
"5983","CHI","DET",2015020952,16862,20152016,0,60,5,2,3,4.72681548912078,4.51075314667833,0.216062342442456,33,33,0,39,44,-5,52,56,-4,4,5,0,0
"5984","CHI","BOS",2015020954,16863,20152016,0,60,2,4,-2,4.92874933424173,2.92160424712347,2.00714508711826,27,25,2,42,34,8,59,47,12,2,2,0,0
"5985","CHI","DET",2015020983,16866,20152016,1,60,4,1,3,3.31171386204996,4.02364800686701,-0.711934144817051,26,34,-8,39,43,-4,55,63,-8,4,4,0,0
"5986","CHI","DAL",2015021016,16871,20152016,0,60,2,5,-3,3.73663182351447,3.64607191435061,0.0905599091638578,23,31,-8,35,43,-8,61,52,9,5,6,0,0
"5987","CHI","L.A",2015021034,16874,20152016,1,60,0,5,-5,4.73226536111906,4.66016419513471,0.0721011659843498,32,25,7,41,31,10,65,46,19,6,2,0,0
"5988","CHI","PHI",2015021048,16876,20152016,1,60,2,3,-1,2.34969412888267,2.98834823811957,-0.638654109236899,26,29,-3,37,37,0,60,47,13,3,2,0,0
"5989","CHI","WPG",2015021063,16878,20152016,0,60,4,0,4,6.77551033462078,4.96828218997689,1.80722814464389,36,28,8,46,38,8,59,50,9,2,5,0,0
"5990","CHI","MIN",2015021082,16880,20152016,1,65,2,2,0,4.05660142362467,4.51167238428025,-0.455070960655576,31,34,-3,43,45,-2,56,66,-10,1,3,0,0
"5991","CHI","DAL",2015021096,16882,20152016,1,60,2,6,-4,5.05075579294916,4.8919159951547,0.158839797794457,32,33,-1,46,37,9,72,46,26,3,3,0,0
"5992","CHI","CGY",2015021126,16886,20152016,0,60,4,1,3,5.0709112904151,4.37756777430888,0.693343516106221,27,32,-5,40,46,-6,52,59,-7,4,4,0,0
"5993","CHI","VAN",2015021131,16887,20152016,0,60,3,2,1,3.87393158608211,3.75598096346948,0.117950622612625,32,28,4,41,34,7,53,53,0,2,2,0,0
"5994","CHI","MIN",2015021146,16889,20152016,0,60,1,4,-3,4.5519136399962,3.59087918671139,0.96103445328481,19,18,1,35,31,4,59,44,15,3,2,0,0
"5995","CHI","WPG",2015021164,16892,20152016,0,61.0333333333333,5,4,1,2.96185716085085,3.56325339651085,-0.60139623565999,27,32,-5,33,43,-10,48,62,-14,3,3,0,0
"5996","CHI","BOS",2015021178,16894,20152016,1,60,6,4,2,8.05902523838449,7.03223380001145,1.02679143837304,34,46,-12,43,59,-16,60,76,-16,5,3,0,0
"5997","CHI","ARI",2015021196,16896,20152016,1,60,6,2,4,4.00944199969808,3.99504120855687,0.0144007911412096,32,31,1,40,41,-1,54,54,0,3,6,0,0
"5998","CHI","CBJ",2015021223,16900,20152016,0,62.4666666666667,4,5,-1,1.88811266608536,3.00660067725704,-1.11848801117168,26,25,1,34,32,2,46,39,7,5,2,0,0
"5999","CHI","NSH",2016020014,17088,20162017,0,60,2,3,-1,5.04118518839823,4.46119986352278,0.579985324875452,24,27,-3,36,37,-1,55,45,10,5,7,0,0
"6000","CHI","NSH",2016020026,17089,20162017,1,60,5,3,2,4.07126742159016,6.79381609569828,-2.72254867410811,27,36,-9,39,45,-6,50,62,-12,3,2,0,0
"6001","CHI","PHI",2016020045,17092,20162017,1,60,7,4,3,5.43711221638659,4.40717266608044,1.02993955030615,28,27,1,32,35,-3,43,44,-1,3,4,0,0
"6002","CHI","CBJ",2016020063,17095,20162017,0,60,2,3,-1,6.72111797546313,5.27292153512826,1.44819644033487,34,28,6,51,41,10,71,50,21,4,2,0,0
"6003","CHI","TOR",2016020072,17096,20162017,1,65,4,4,0,7.51764047390316,4.81375760822357,2.70388286567959,35,34,1,49,41,8,73,52,21,6,2,0,0
"6004","CHI","CGY",2016020082,17098,20162017,1,65,2,2,0,3.51153810572578,3.03900877568958,0.472529330036195,34,31,3,42,39,3,67,52,15,2,4,0,0
"6005","CHI","N.J",2016020107,17102,20162017,0,61.25,3,2,1,5.1693198736757,4.39215735159814,0.77716252207756,29,32,-3,41,38,3,57,44,13,4,4,0,0
"6006","CHI","L.A",2016020128,17104,20162017,1,60,3,0,3,4.70475132853608,7.10207079560496,-2.39731946706888,29,32,-3,41,43,-2,57,53,4,6,2,0,0
"6007","CHI","CGY",2016020139,17106,20162017,1,60,5,1,4,2.97542021524226,4.72565473217219,-1.75023451692993,22,34,-12,32,44,-12,45,61,-16,5,5,0,0
"6008","CHI","COL",2016020153,17108,20162017,1,60,4,0,4,2.6051568029543,5.58949983586717,-2.98434303291288,21,38,-17,24,44,-20,43,55,-12,2,3,0,0
"6009","CHI","DAL",2016020171,17110,20162017,0,60,3,2,1,6.90210551525524,8.79672761852464,-1.8946221032694,32,33,-1,40,56,-16,53,74,-21,8,6,0,0
"6010","CHI","DAL",2016020178,17111,20162017,1,64.5166666666667,4,3,1,3.281497903532,5.03052697136449,-1.7490290678325,33,35,-2,49,43,6,59,59,0,4,4,0,0
"6011","CHI","MTL",2016020226,17118,20162017,1,60,3,2,1,5.45376870837936,3.8223729344121,1.63139577396726,35,23,12,47,32,15,55,54,1,3,3,0,0
"6012","CHI","WPG",2016020238,17120,20162017,0,60,0,4,-4,4.46020123086521,1.85661932770191,2.6035819031633,27,24,3,40,34,6,58,49,9,3,1,0,0
"6013","CHI","CGY",2016020259,17123,20162017,0,60,3,2,1,5.69691945847515,3.71603532199515,1.98088413648,24,30,-6,38,42,-4,52,58,-6,1,5,0,0
"6014","CHI","VAN",2016020270,17124,20162017,0,64.0666666666667,4,3,1,5.74942757486133,2.63138926716056,3.11803830770077,32,27,5,39,41,-2,59,52,7,3,2,0,0
"6015","CHI","EDM",2016020281,17126,20162017,0,60,0,5,-5,4.48959653562633,5.45095992315328,-0.961363387526944,31,27,4,40,40,0,61,49,12,2,4,0,0
"6016","CHI","S.J",2016020299,17128,20162017,0,60,1,2,-1,3.69084335149819,3.15062686637975,0.540216485118435,34,35,-1,49,49,0,66,55,11,3,5,0,0
"6017","CHI","ANA",2016020304,17130,20162017,0,60,3,2,1,3.5777591674705,5.1936767862644,-1.6159176187939,25,36,-11,31,52,-21,41,67,-26,2,2,0,0
"6018","CHI","L.A",2016020320,17131,20162017,0,61.1,1,2,-1,2.0566252595163,2.04708556708647,0.00953969242982566,19,29,-10,31,42,-11,47,55,-8,3,3,0,0
"6019","CHI","N.J",2016020353,17136,20162017,1,61.5166666666667,4,3,1,4.53748842974892,4.37141759577707,0.166070833971844,33,33,0,46,49,-3,65,65,0,4,2,0,0
"6020","CHI","PHI",2016020361,17138,20162017,0,60,1,3,-2,2.94254412477299,5.33649322351266,-2.39394909873967,27,30,-3,36,46,-10,49,63,-14,1,3,0,0
"6021","CHI","WPG",2016020374,17139,20162017,1,60,1,2,-1,3.35817310309332,4.73779422012058,-1.37962111702726,26,32,-6,33,41,-8,53,51,2,2,2,0,0
"6022","CHI","ARI",2016020389,17141,20162017,1,60,4,0,4,4.40332407745753,2.53400627280644,1.86931780465109,27,22,5,33,29,4,50,42,8,3,2,0,0
"6023","CHI","NYR",2016020409,17144,20162017,1,60.9166666666667,0,1,-1,1.79995304747717,5.07645815790238,-3.27650511042521,26,37,-11,33,46,-13,54,62,-8,1,2,0,0
"6024","CHI","DAL",2016020427,17146,20162017,1,60,3,1,2,4.87047721815179,2.14630260628473,2.72417461186706,27,24,3,37,36,1,51,51,0,3,2,0,0
"6025","CHI","NYR",2016020433,17148,20162017,0,60,2,1,1,4.57485886593349,4.57296912994934,0.00188973598415032,26,34,-8,39,51,-12,58,62,-4,2,1,0,0
"6026","CHI","NYI",2016020446,17150,20162017,0,60,5,4,1,2.67298247616884,6.35934908405761,-3.68636660788877,32,32,0,44,43,1,65,53,12,3,2,0,0
"6027","CHI","S.J",2016020474,17153,20162017,1,60,4,1,3,4.16502924659289,7.06001306937299,-2.89498382278009,26,34,-8,36,38,-2,49,57,-8,2,2,0,0
"6028","CHI","COL",2016020512,17158,20162017,1,60.4166666666667,1,2,-1,7.16226969403215,6.90652601642068,0.255743677611463,39,34,5,49,39,10,68,54,14,5,2,0,0
"6029","CHI","WPG",2016020523,17162,20162017,1,60,1,3,-2,5.41896257153712,5.42429923223244,-0.00533666069532046,35,34,1,44,43,1,62,52,10,3,1,0,0
"6030","CHI","NSH",2016020537,17164,20162017,0,60,3,2,1,5.11498497373128,3.92410934170655,1.19087563202473,23,38,-15,33,49,-16,43,72,-29,5,5,0,0
"6031","CHI","CAR",2016020544,17165,20162017,0,60,2,3,-1,8.25446719268803,2.96731047868053,5.28715671400749,29,28,1,44,36,8,61,46,15,1,1,0,0
"6032","CHI","CAR",2016020587,17172,20162017,1,60,2,1,1,3.49488252011361,8.06821550471068,-4.57333298459707,24,40,-16,31,48,-17,43,67,-24,3,3,0,0
"6033","CHI","NSH",2016020607,17174,20162017,1,60,5,2,3,6.88951761834323,5.76674776195432,1.12276985638891,31,27,4,38,41,-3,57,64,-7,1,3,0,0
"6034","CHI","DET",2016020617,17176,20162017,1,60.6333333333333,4,3,1,5.38819234550465,6.1457210773151,-0.757528731810453,43,36,7,50,43,7,71,55,16,7,2,0,0
"6035","CHI","MIN",2016020653,17181,20162017,1,60,2,3,-1,5.07596867828397,4.45511162024377,0.620857058040201,35,32,3,54,41,13,69,51,18,3,2,0,0
"6036","CHI","COL",2016020668,17183,20162017,0,60,6,4,2,5.68468435289105,4.82262099839136,0.862063354499696,27,23,4,37,29,8,52,42,10,2,3,0,0
"6037","CHI","BOS",2016020685,17186,20162017,0,60,1,0,1,3.21490380315663,4.46147414210129,-1.24657033894466,22,30,-8,27,42,-15,42,61,-19,3,2,0,0
"6038","CHI","VAN",2016020706,17188,20162017,1,60,4,2,2,4.20708596880081,3.39497337763896,0.812112591161849,35,28,7,48,37,11,59,53,6,1,3,0,0
"6039","CHI","T.B",2016020722,17190,20162017,1,60,2,5,-3,4.58636194687125,8.85386913631058,-4.26750718943933,36,36,0,40,49,-9,57,59,-2,3,2,0,0
"6040","CHI","WPG",2016020737,17192,20162017,1,60,3,5,-2,2.91443784498649,4.0080937414823,-1.0936558964958,41,33,8,47,37,10,66,49,17,5,5,0,0
"6041","CHI","S.J",2016020754,17197,20162017,0,60,1,3,-2,3.05946046946337,3.93340223372797,-0.8739417642646,25,29,-4,35,42,-7,56,64,-8,3,3,0,0
"6042","CHI","ARI",2016020764,17199,20162017,0,60,4,3,1,3.30786001078991,2.86754411339415,0.440315897395758,26,27,-1,37,34,3,48,55,-7,6,7,0,0
"6043","CHI","DAL",2016020781,17201,20162017,0,60,5,3,2,3.78114913147874,5.18508221723141,-1.40393308575267,36,34,2,44,48,-4,64,57,7,2,3,0,0
"6044","CHI","MIN",2016020801,17205,20162017,0,63.15,4,3,1,3.423162718198,3.79983873583842,-0.37667601764042,32,38,-6,38,50,-12,56,65,-9,3,3,0,0
"6045","CHI","WPG",2016020814,17207,20162017,0,60,5,2,3,7.59006414504904,6.36966745660175,1.22039668844729,36,30,6,50,45,5,62,63,-1,2,3,0,0
"6046","CHI","EDM",2016020827,17208,20162017,0,60,5,1,4,2.59554361819755,3.55507497334838,-0.95953135515083,25,31,-6,33,42,-9,43,67,-24,2,2,0,0
"6047","CHI","EDM",2016020863,17215,20162017,1,60,1,3,-2,3.71211941892398,5.1953564922665,-1.48323707334252,39,22,17,57,29,28,83,40,43,3,2,0,0
"6048","CHI","MIN",2016020889,17218,20162017,0,60,5,3,2,7.078899668144,7.93857042738819,-0.859670759244182,39,32,7,51,43,8,67,58,9,2,2,0,0
"6049","CHI","ARI",2016020898,17220,20162017,1,60,6,3,3,3.76012927423976,5.85554555180352,-2.09541627756375,29,37,-8,40,46,-6,53,64,-11,2,3,0,0
"6050","CHI","PIT",2016020935,17226,20162017,1,60,4,1,3,3.23358453768742,5.78982493596749,-2.55624039828007,29,37,-8,40,50,-10,57,68,-11,1,0,0,0
"6051","CHI","NYI",2016020949,17228,20162017,1,65,1,1,0,5.00377192691667,4.46646259703266,0.53730932988401,31,32,-1,53,42,11,76,55,21,2,3,0,0
"6052","CHI","NSH",2016020959,17229,20162017,0,60,5,3,2,5.12150097463746,3.8015488612582,1.31995211337926,33,35,-2,42,48,-6,52,64,-12,2,1,0,0
"6053","CHI","ANA",2016020988,17234,20162017,1,60,0,1,-1,6.17608102076338,2.56712299807987,3.60895802268351,43,26,17,58,32,26,79,56,23,3,3,0,0
"6054","CHI","DET",2016020996,17235,20162017,0,60,2,4,-2,2.97071059579685,4.54535045234966,-1.57463985655281,26,29,-3,29,39,-10,35,51,-16,3,4,0,0
"6055","CHI","MIN",2016021012,17237,20162017,1,60,4,2,2,5.56322282925248,6.15757257399628,-0.594349744743795,22,44,-22,35,55,-20,43,72,-29,3,1,0,0
"6056","CHI","MTL",2016021027,17239,20162017,0,60,4,2,2,6.81500384236278,7.1932699343306,-0.378266091967816,24,42,-18,34,59,-25,51,90,-39,1,2,0,0
"6057","CHI","TOR",2016021055,17243,20162017,0,64.7166666666667,2,1,1,5.76631179793003,4.61204183124937,1.15426996668066,39,26,13,49,47,2,66,65,1,0,1,0,0
"6058","CHI","COL",2016021067,17244,20162017,1,60,6,3,3,5.55432861500594,4.45147575499141,1.10285286001454,34,25,9,44,29,15,59,45,14,1,0,0,0
"6059","CHI","VAN",2016021084,17246,20162017,1,62.2,4,5,-1,7.79551617766265,3.37225053925067,4.42326563841198,44,15,29,63,20,43,83,29,54,6,2,0,0
"6060","CHI","DAL",2016021098,17248,20162017,1,65,2,2,0,2.95689433952793,5.71568057657942,-2.75878623705148,26,44,-18,34,51,-17,50,64,-14,4,3,0,0
"6061","CHI","T.B",2016021124,17252,20162017,0,64.4166666666667,4,5,-1,2.4916879972443,3.44302456657499,-0.951336569330692,32,30,2,34,51,-17,44,74,-30,3,3,0,0
"6062","CHI","PIT",2016021137,17254,20162017,0,60,5,1,4,3.98920067620929,2.23846283763123,1.75073783857806,36,32,4,41,38,3,56,56,0,4,2,0,0
"6063","CHI","CBJ",2016021152,17256,20162017,1,60,3,1,2,3.97190088336356,4.96133079433457,-0.989429910971012,24,33,-9,27,42,-15,40,61,-21,4,5,0,0
"6064","CHI","BOS",2016021165,17258,20162017,1,60,2,3,-1,6.9447137019597,2.99440077040211,3.95031293155759,43,29,14,52,40,12,71,54,17,3,1,0,0
"6065","CHI","COL",2016021188,17260,20162017,0,61.95,3,4,-1,5.14750209109157,5.09743193849029,0.0500701526012772,27,51,-24,35,60,-25,48,84,-36,3,4,0,0
"6066","CHI","ANA",2016021203,17262,20162017,0,60,0,4,-4,4.3430979409446,3.38666761964964,0.95643032129496,37,26,11,51,41,10,62,52,10,3,5,0,0
"6067","CHI","L.A",2016021220,17264,20162017,0,60.45,2,3,-1,6.35283565460122,3.28851801858741,3.06431763601381,27,26,1,43,42,1,55,60,-5,3,2,0,0
"6068","CHI","PIT",2017020010,17444,20172018,1,60,10,1,9,5.07984385447344,4.12292269482482,0.956921159648619,44,29,15,51,37,14,75,50,25,6,2,0,0
"6069","CHI","CBJ",2017020025,17446,20172018,1,60,5,1,4,4.42381870092052,5.18358779459959,-0.759769093679074,29,33,-4,31,42,-11,44,54,-10,3,3,0,0
"6070","CHI","TOR",2017020035,17448,20172018,0,63.7166666666667,3,4,-1,1.62808877740099,5.19743751439091,-3.56934873698992,21,43,-22,32,60,-28,44,75,-31,7,6,0,0
"6071","CHI","MTL",2017020041,17449,20172018,0,60,3,1,2,5.2127047616701,6.74530485265791,-1.53260009098781,25,42,-17,35,60,-25,46,83,-37,2,5,0,0
"6072","CHI","MIN",2017020054,17451,20172018,1,60,2,5,-3,3.61457296603893,5.90367343908292,-2.28910047304399,38,34,4,46,41,5,63,56,7,6,5,0,0
"6073","CHI","NSH",2017020071,17453,20172018,1,63.0833333333333,2,1,1,3.93383004018214,4.65248253266714,-0.718652492484997,35,38,-3,45,56,-11,67,68,-1,8,6,0,0
"6074","CHI","EDM",2017020100,17458,20172018,1,64.7333333333333,1,2,-1,5.09632647648687,8.2176744433591,-3.12134796687224,31,42,-11,45,49,-4,68,61,7,5,2,0,0
"6075","CHI","ARI",2017020119,17460,20172018,0,60,4,2,2,7.31357934180414,6.26823558058823,1.04534376121592,29,29,0,45,51,-6,63,67,-4,5,6,0,0
"6076","CHI","VGK",2017020135,17463,20172018,0,60,2,4,-2,3.76509257761063,5.38322110479159,-1.61812852718096,31,33,-2,39,49,-10,56,67,-11,3,5,0,0
"6077","CHI","NSH",2017020153,17466,20172018,1,60,1,2,-1,4.78540300221357,4.03557196775773,0.749831034455838,44,30,14,56,36,20,74,50,24,6,6,0,0
"6078","CHI","COL",2017020165,17467,20172018,0,60,3,6,-3,5.44283711514619,4.82217999437125,0.620657120774939,42,28,14,64,37,27,83,46,37,6,5,0,0
"6079","CHI","PHI",2017020181,17471,20172018,1,60,3,0,3,4.51057711336773,7.51179965236224,-3.00122253899451,35,35,0,40,45,-5,51,65,-14,4,3,0,0
"6080","CHI","MIN",2017020208,17474,20172018,0,60,2,0,2,7.81011557125862,4.71627959112811,3.09383598013051,35,24,11,50,39,11,72,48,24,3,2,0,0
"6081","CHI","MTL",2017020215,17475,20172018,1,60,0,2,-2,3.16860973963048,4.16219189754293,-0.993582157912442,38,35,3,51,47,4,69,64,5,3,3,0,0
"6082","CHI","PHI",2017020236,17479,20172018,0,60,1,3,-2,7.12164130230667,4.13447483066813,2.98716647163855,39,31,8,53,42,11,69,52,17,5,3,0,0
"6083","CHI","CAR",2017020256,17481,20172018,0,61.7333333333333,4,3,1,4.64817576563667,4.55178490826983,0.0963908573668331,30,38,-8,46,46,0,71,61,10,5,3,0,0
"6084","CHI","N.J",2017020262,17482,20172018,1,60,5,7,-2,0,0,0,44,38,6,58,47,11,87,60,27,4,4,0,0
"6085","CHI","NYR",2017020276,17485,20172018,1,60,6,3,3,5.72809901530854,5.45600587294877,0.272093142359779,43,28,15,53,41,12,63,55,8,5,2,0,0
"6086","CHI","PIT",2017020300,17488,20172018,0,60,2,1,1,5.35662468356895,7.02885141986646,-1.6722267362975,38,36,2,46,44,2,67,59,8,6,4,0,0
"6087","CHI","T.B",2017020328,17492,20172018,0,63.4166666666667,2,3,-1,2.80463977332693,4.81842276008319,-2.01378298675627,31,38,-7,40,58,-18,56,66,-10,4,6,0,0
"6088","CHI","ANA",2017020366,17497,20172018,1,60,7,3,4,6.45009455565742,4.13314875052311,2.31694580513431,35,29,6,48,38,10,68,51,17,5,4,0,0
"6089","CHI","NSH",2017020373,17498,20172018,0,60,2,3,-1,5.46718262479408,5.33046380986652,0.136718814927561,39,31,8,59,46,13,74,62,12,3,4,0,0
"6090","CHI","DAL",2017020385,17500,20172018,1,60.85,3,4,-1,3.20320971659385,4.42634971288669,-1.22313999629284,22,35,-13,32,44,-12,51,57,-6,6,4,0,0
"6091","CHI","DAL",2017020406,17502,20172018,0,65,2,2,0,4.37104026459221,2.543495903069,1.82754436152321,34,35,-1,44,47,-3,58,69,-11,4,6,0,0
"6092","CHI","L.A",2017020408,17503,20172018,1,60,1,3,-2,4.84416394372238,8.14676109250125,-3.30259714877888,25,24,1,36,33,3,55,46,9,4,1,0,0
"6093","CHI","ARI",2017020457,17510,20172018,1,60,3,1,2,5.87426060612779,5.91301547200419,-0.038754865876399,37,32,5,51,42,9,60,56,4,2,1,0,0
"6094","CHI","WPG",2017020485,17514,20172018,0,60,5,1,4,4.59300866429112,5.22678720135099,-0.633778537059869,30,28,2,41,46,-5,57,63,-6,3,2,0,0
"6095","CHI","MIN",2017020508,17517,20172018,1,60,4,1,3,8.93717342592963,5.83963023505103,3.0975431908786,46,28,18,54,41,13,78,53,25,7,3,0,0
"6096","CHI","DAL",2017020535,17521,20172018,0,60,0,4,-4,4.10451126953916,2.99784776075338,1.10666350878578,24,22,2,46,35,11,75,54,21,2,4,0,0
"6097","CHI","N.J",2017020547,17523,20172018,0,60,1,4,-3,3.76348387666076,3.92008806461618,-0.156604187955421,40,29,11,49,38,11,77,45,32,3,3,0,0
"6098","CHI","VAN",2017020573,17528,20172018,0,60,2,5,-3,3.72013302834966,2.71422524867393,1.00590777967573,32,31,1,43,37,6,58,45,13,6,4,0,0
"6099","CHI","EDM",2017020585,17529,20172018,0,60.8333333333333,4,3,1,5.38854344008723,4.26160504273139,1.12693839735584,36,45,-9,53,62,-9,78,80,-2,3,2,0,0
"6100","CHI","CGY",2017020599,17531,20172018,0,60.8666666666667,3,4,-1,5.22448904969497,4.80620510988228,0.418283939812682,37,39,-2,55,51,4,66,63,3,2,2,0,0
"6101","CHI","NYR",2017020615,17534,20172018,0,60,5,2,3,7.02978547863474,4.48571190040093,2.54407357823381,35,25,10,48,41,7,70,58,12,1,6,0,0
"6102","CHI","VGK",2017020632,17536,20172018,1,60,4,5,-1,2.98244001378589,4.55645732831908,-1.57401731453319,32,43,-11,40,55,-15,53,59,-6,2,2,0,0
"6103","CHI","EDM",2017020645,17538,20172018,1,60,4,1,3,2.384416675588,3.9294167652879,-1.5450000896999,29,33,-4,41,35,6,68,47,21,3,1,0,0
"6104","CHI","MIN",2017020661,17541,20172018,1,60,1,2,-1,4.80128547202207,3.9491680350352,0.852117436986873,35,27,8,54,36,18,81,46,35,3,3,0,0
"6105","CHI","WPG",2017020668,17543,20172018,1,60,2,1,1,6.34904670116066,3.08134101285586,3.2677056883048,27,32,-5,41,42,-1,54,59,-5,3,3,0,0
"6106","CHI","DET",2017020681,17545,20172018,1,60,0,4,-4,2.70718181475248,4.70074377168203,-1.99356195692955,27,26,1,41,35,6,67,51,16,3,4,0,0
"6107","CHI","NYI",2017020718,17551,20172018,1,60,3,7,-4,3.42834327707003,4.03181616919755,-0.603472892127527,39,46,-7,46,56,-10,69,70,-1,1,4,0,0
"6108","CHI","T.B",2017020729,17553,20172018,1,60,0,2,-2,3.46316735696746,4.30403200716107,-0.840864650193609,40,31,9,46,40,6,70,52,18,6,2,0,0
"6109","CHI","TOR",2017020744,17555,20172018,1,60.1,2,3,-1,5.89662916113977,5.98795057818279,-0.0913214170430194,36,36,0,48,53,-5,68,68,0,4,5,0,0
"6110","CHI","DET",2017020751,17556,20172018,0,60,5,1,4,3.60912307383842,2.59411559186879,1.01500748196963,28,24,4,42,42,0,61,58,3,2,1,0,0
"6111","CHI","NSH",2017020768,17561,20172018,0,60,2,1,1,3.72843665255277,7.10712408543986,-3.37868743288709,31,43,-12,40,54,-14,56,73,-17,2,1,0,0
"6112","CHI","VAN",2017020787,17563,20172018,0,60,2,4,-2,3.16895562182594,3.2291818424128,-0.0602262205868556,28,21,7,40,31,9,59,44,15,4,2,0,0
"6113","CHI","CGY",2017020802,17565,20172018,0,60.9833333333333,3,4,-1,4.97913293224701,5.12097558031502,-0.141842648068007,28,39,-11,47,58,-11,62,78,-16,1,1,0,0
"6114","CHI","CGY",2017020821,17568,20172018,1,60,2,3,-1,5.98429107001517,7.61450121962491,-1.63021014960974,36,23,13,57,34,23,75,61,14,6,5,0,0
"6115","CHI","DAL",2017020833,17570,20172018,1,60,2,4,-2,5.11382326965395,5.10321335300978,0.0106099166441709,39,30,9,50,39,11,82,52,30,4,1,0,0
"6116","CHI","MIN",2017020849,17572,20172018,0,60,0,3,-3,6.74445615834766,1.98338429629803,4.76107186204963,44,19,25,59,26,33,85,36,49,4,4,0,0
"6117","CHI","ARI",2017020863,17574,20172018,0,60,1,6,-5,5.08081945073077,4.80377344020847,0.277046010522292,38,22,16,54,32,22,72,44,28,8,6,0,0
"6118","CHI","VGK",2017020874,17575,20172018,0,60,2,5,-3,3.90818194072053,6.81513323204126,-2.90695129132073,31,37,-6,43,51,-8,61,67,-6,4,7,0,0
"6119","CHI","ANA",2017020886,17577,20172018,1,60,2,3,-1,4.03311245824443,4.43761923270358,-0.404506774459151,44,32,12,53,36,17,82,43,39,6,3,0,0
"6120","CHI","L.A",2017020916,17581,20172018,1,60,1,3,-2,5.06841059123508,2.48043501975189,2.58797557148318,28,32,-4,39,38,1,70,50,20,1,3,0,0
"6121","CHI","S.J",2017020944,17585,20172018,1,60,3,1,2,4.50786990097549,5.45172279170947,-0.943852890733979,36,43,-7,43,57,-14,66,70,-4,2,1,0,0
"6122","CHI","CBJ",2017020954,17586,20172018,0,60,2,3,-1,3.01466906243149,3.70712155704814,-0.692452494616646,33,29,4,45,35,10,62,45,17,3,1,0,0
"6123","CHI","S.J",2017020990,17591,20172018,0,60,2,7,-5,3.04895622569893,4.01731293165358,-0.968356705954648,34,34,0,43,45,-2,71,59,12,2,1,0,0
"6124","CHI","L.A",2017021002,17593,20172018,0,60,5,3,2,5.44254952414235,4.0955271345847,1.34702238955765,25,32,-7,41,44,-3,60,54,6,5,2,0,0
"6125","CHI","ANA",2017021010,17594,20172018,0,60,3,6,-3,8.37197312620265,7.37484071494691,0.997132411255734,40,31,9,64,47,17,81,57,24,2,2,0,0
"6126","CHI","COL",2017021027,17596,20172018,1,60.15,2,1,1,3.3479596546531,5.36962575663347,-2.02166610198037,27,34,-7,39,43,-4,54,57,-3,2,3,0,0
"6127","CHI","CAR",2017021040,17598,20172018,1,60,2,3,-1,2.40412918840313,6.43942657617496,-4.03529738777183,24,40,-16,35,51,-16,45,73,-28,2,2,0,0
"6128","CHI","BOS",2017021048,17600,20172018,0,60,4,7,-3,5.77275472653307,6.26053375500405,-0.487779028470971,27,40,-13,35,59,-24,45,72,-27,2,5,0,0
"6129","CHI","BOS",2017021059,17601,20172018,1,60,3,1,2,5.579604176266,4.99343348055845,0.586170695707551,39,32,7,46,44,2,64,61,3,4,1,0,0
"6130","CHI","WPG",2017021089,17605,20172018,0,60,2,6,-4,1.9148868513571,5.97897556939279,-4.06408871803569,27,39,-12,41,55,-14,55,68,-13,3,4,0,0
"6131","CHI","COL",2017021129,17610,20172018,1,60,1,5,-4,4.46917577037311,7.86622781367691,-3.3970520433038,45,40,5,53,50,3,86,67,19,4,3,0,0
"6132","CHI","VAN",2017021143,17612,20172018,1,60,2,5,-3,0,0,0,41,27,14,54,34,20,69,45,24,4,1,0,0
"6133","CHI","NYI",2017021158,17614,20172018,0,60,3,1,2,2.73088953629485,1.72368959896266,1.00719993733219,25,32,-7,30,37,-7,49,53,-4,2,2,0,0
"6134","CHI","S.J",2017021174,17616,20172018,1,65,3,3,0,4.39969287269693,4.87815025176678,-0.478457379069855,31,38,-7,41,55,-14,61,81,-20,2,3,0,0
"6135","CHI","WPG",2017021196,17619,20172018,1,60,6,2,4,4.67743597924709,6.09718516014578,-1.41974918089869,42,34,8,48,42,6,62,64,-2,2,1,0,0
"6136","CHI","COL",2017021203,17620,20172018,0,60,0,5,-5,4.0735368799069,7.19986719840381,-3.12633031849691,33,36,-3,41,43,-2,60,63,-3,1,4,0,0
"6137","CHI","WPG",2017021264,17628,20172018,0,60,1,4,-3,5.18491619372799,4.86078391661377,0.324132277114217,31,39,-8,36,52,-16,46,76,-30,1,4,0,0
"6138","CHI","TOR",2018020030,17811,20182019,1,60.3166666666667,6,7,-1,3.84823923624936,3.79036789904058,0.0578713372087805,31,34,-3,40,42,-2,69,56,13,2,2,0,0
"6139","CHI","MIN",2018020056,17815,20182019,0,63.4166666666667,3,4,-1,4.26835125189609,5.74708878729143,-1.47873753539534,30,46,-16,46,60,-14,55,72,-17,5,2,0,0
"6140","CHI","ARI",2018020095,17822,20182019,1,60,1,4,-3,6.71167367181624,7.24834363944448,-0.536669967628239,34,31,3,50,43,7,77,57,20,3,1,0,0
"6141","CHI","CBJ",2018020109,17824,20182019,0,60,4,1,3,2.8742170407204,4.11221500861077,-1.23799796789037,26,38,-12,36,62,-26,47,77,-30,3,4,0,0
"6142","CHI","T.B",2018020116,17825,20182019,1,60,3,6,-3,5.16916522440727,6.89129196372232,-1.72212673931506,36,55,-19,48,60,-12,66,73,-7,5,4,0,0
"6143","CHI","ANA",2018020127,17827,20182019,1,60,3,1,2,6.18968335188674,4.12180532311322,2.06787802877352,38,25,13,51,32,19,68,52,16,5,5,0,0
"6144","CHI","NYR",2018020139,17829,20182019,1,60,4,1,3,5.01568352458438,2.53519501560368,2.48048850898071,37,19,18,48,31,17,67,42,25,4,2,0,0
"6145","CHI","EDM",2018020162,17832,20182019,1,60.8833333333333,1,2,-1,4.30544944526628,3.10336720815712,1.20208223710915,32,26,6,44,37,7,56,53,3,5,2,0,0
"6146","CHI","VAN",2018020178,17835,20182019,0,60,2,4,-2,2.76434784900923,3.74870633217506,-0.984358483165835,26,28,-2,38,39,-1,51,53,-2,2,3,0,0
"6147","CHI","EDM",2018020188,17836,20182019,0,60,0,4,-4,3.82252603977099,3.82275432727511,-0.000228287504114633,40,29,11,51,42,9,64,56,8,4,3,0,0
"6148","CHI","CGY",2018020203,17838,20182019,0,60,3,5,-2,3.4079384378856,8.18253807770088,-4.77459963981528,15,41,-26,28,54,-26,36,68,-32,4,1,0,0
"6149","CHI","CAR",2018020233,17843,20182019,1,60,3,4,-1,6.0459853713437,6.25511714351207,-0.209131772168362,38,34,4,55,37,18,71,50,21,2,2,0,0
"6150","CHI","PHI",2018020243,17845,20182019,0,60,0,4,-4,4.11308920904412,4.71810883311264,-0.605019624068518,33,25,8,48,42,6,69,54,15,4,3,0,0
"6151","CHI","CAR",2018020261,17847,20182019,0,61.2666666666667,2,3,-1,5.65179944837928,6.88955488131614,-1.23775543293686,35,40,-5,48,58,-10,60,71,-11,1,3,0,0
"6152","CHI","L.A",2018020288,17851,20182019,1,65,1,1,0,6.21447719965363,7.384946896017,-1.17046969636337,35,32,3,45,44,1,59,56,3,3,1,0,0
"6153","CHI","MIN",2018020305,17853,20182019,1,60,3,1,2,3.95862720555488,4.30144190473948,-0.342814699184601,28,40,-12,41,51,-10,50,65,-15,3,3,0,0
"6154","CHI","T.B",2018020341,17858,20182019,0,60,2,4,-2,4.8774749661716,2.46269412420224,2.41478084196936,32,29,3,46,47,-1,60,56,4,2,3,0,0
"6155","CHI","VGK",2018020374,17862,20182019,1,60,3,8,-5,3.24255421785347,5.54235251341015,-2.29979829555668,24,43,-19,33,52,-19,38,65,-27,2,3,0,0
"6156","CHI","WPG",2018020387,17864,20182019,0,60,5,6,-1,4.57638560407783,2.71055253194936,1.86583307212847,31,33,-2,46,40,6,64,50,14,2,3,0,0
"6157","CHI","NSH",2018020404,17866,20182019,0,60,2,5,-3,2.67410012741311,5.3305014305497,-2.65640130313659,21,30,-9,28,48,-20,44,57,-13,2,3,0,0
"6158","CHI","CGY",2018020411,17867,20182019,1,60,2,3,-1,3.56093978615689,4.90688628953649,-1.3459465033796,24,41,-17,32,50,-18,51,60,-9,5,4,0,0
"6159","CHI","ANA",2018020427,17870,20182019,0,60,2,4,-2,3.82154477105034,7.47565978931615,-3.65411501826581,27,32,-5,41,47,-6,57,62,-5,3,1,0,0
"6160","CHI","VGK",2018020438,17871,20182019,0,60,3,4,-1,4.35081989638275,4.25399174236895,0.0968281540137923,35,36,-1,57,49,8,79,60,19,4,2,0,0
"6161","CHI","MTL",2018020457,17874,20182019,1,60,2,3,-1,3.27214286390199,3.8741104435212,-0.601967579619213,39,28,11,48,39,9,68,48,20,7,4,0,0
"6162","CHI","WPG",2018020473,17876,20182019,0,60,3,6,-3,5.16171176405288,4.59307876128423,0.568633002768649,35,34,1,45,50,-5,53,60,-7,2,5,0,0
"6163","CHI","PIT",2018020476,17877,20182019,1,60,6,3,3,7.23001893625042,6.17065193154849,1.05936700470193,29,43,-14,37,49,-12,58,57,1,2,2,0,0
"6164","CHI","WPG",2018020493,17879,20182019,1,60.8333333333333,3,4,-1,2.73335258501902,6.39982911260449,-3.66647652758547,37,42,-5,45,50,-5,58,64,-6,2,4,0,0
"6165","CHI","S.J",2018020509,17881,20182019,1,60,3,7,-4,0.907660081749782,6.78920936528836,-5.88154928353857,20,43,-23,23,52,-29,39,66,-27,5,3,0,0
"6166","CHI","NSH",2018020522,17883,20182019,1,60,2,1,1,2.4932380378068,3.79459605726879,-1.30135801946199,36,31,5,42,41,1,56,56,0,3,2,0,0
"6167","CHI","DAL",2018020536,17885,20182019,0,60,5,2,3,5.81591318242442,4.34702348879364,1.46888969363079,29,28,1,39,51,-12,53,65,-12,1,1,0,0
"6168","CHI","COL",2018020544,17886,20182019,0,60,2,1,1,2.63953796387068,4.55529457656667,-1.91575661269599,28,36,-8,33,52,-19,41,74,-33,3,5,0,0
"6169","CHI","MIN",2018020575,17892,20182019,1,60,5,2,3,5.00322030051515,5.39043733610276,-0.387217035587611,20,48,-28,29,63,-34,47,85,-38,4,3,0,0
"6170","CHI","COL",2018020595,17894,20182019,0,60.6833333333333,3,2,1,4.3197685207997,3.81952030223329,0.500248218566412,37,32,5,45,43,2,63,54,9,4,3,0,0
"6171","CHI","BOS",2018020612,17897,20182019,1,60,2,4,-2,3.73940786669846,6.06893830960786,-2.3295304429094,38,36,2,44,44,0,63,57,6,4,5,0,0
"6172","CHI","NYI",2018020624,17899,20182019,0,61.8,2,3,-1,3.33481058129109,6.89878728884914,-3.56397670755805,21,50,-29,32,60,-28,46,72,-26,2,2,0,0
"6173","CHI","PIT",2018020650,17902,20182019,0,60,5,3,2,6.05919744842686,4.38101409782951,1.67818335059735,31,34,-3,42,41,1,54,52,2,3,3,0,0
"6174","CHI","CGY",2018020655,17903,20182019,1,60,3,4,-1,4.7768229041867,6.98455790694425,-2.20773500275754,35,43,-8,45,54,-9,61,68,-7,3,4,0,0
"6175","CHI","NSH",2018020668,17905,20182019,1,61,3,4,-1,2.54642632990726,3.34869946818662,-0.802273138279361,31,37,-6,34,47,-13,52,65,-13,2,3,0,0
"6176","CHI","VGK",2018020694,17908,20182019,1,61.3166666666667,3,4,-1,5.3104420157033,4.01922688312334,1.29121513257996,23,34,-11,29,43,-14,39,62,-23,3,2,0,0
"6177","CHI","N.J",2018020707,17910,20182019,0,60,5,8,-3,3.69690829524188,4.24449037344696,-0.547582078205075,32,41,-9,43,47,-4,58,54,4,6,4,0,0
"6178","CHI","NYR",2018020728,17913,20182019,0,60,3,4,-1,2.91438135970384,5.07277183735278,-2.15839047764894,27,33,-6,33,40,-7,47,45,2,3,1,0,0
"6179","CHI","NYI",2018020762,17918,20182019,1,65,2,2,0,5.99758148213732,7.59794867523306,-1.60036719309574,40,36,4,53,51,2,69,71,-2,3,2,0,0
"6180","CHI","MIN",2018020799,17929,20182019,0,61.3166666666667,4,3,1,5.91236184634738,4.88816685541041,1.02419499093697,31,31,0,41,42,-1,49,56,-7,6,4,0,0
"6181","CHI","EDM",2018020820,17932,20182019,0,60,6,2,4,5.4416426064563,4.54230119590409,0.899341410552211,35,27,8,44,37,7,61,54,7,4,4,0,0
"6182","CHI","VAN",2018020834,17934,20182019,1,63.35,4,3,1,4.74178879091869,6.32243739213628,-1.58064860121759,35,43,-8,47,58,-11,62,73,-11,5,5,0,0
"6183","CHI","DET",2018020857,17937,20182019,1,60,5,2,3,4.64437934447778,6.17923200553103,-1.53485266105325,36,45,-9,42,57,-15,58,77,-19,2,2,0,0
"6184","CHI","BOS",2018020863,17939,20182019,0,60,3,6,-3,3.46182050800962,4.40213950253383,-0.940318994524205,26,37,-11,33,54,-21,44,66,-22,4,6,0,0
"6185","CHI","N.J",2018020883,17941,20182019,1,60,5,2,3,4.05054607976924,4.83075992535932,-0.780213845590074,36,43,-7,42,51,-9,63,64,-1,3,3,0,0
"6186","CHI","CBJ",2018020900,17943,20182019,1,60,2,5,-3,4.08114056382328,4.03658840153366,0.0445521622896194,41,30,11,49,38,11,61,50,11,1,1,0,0
"6187","CHI","DET",2018020925,17947,20182019,0,62.7,5,4,1,1.7068547620438,4.94789090598351,-3.24103614393971,20,35,-15,25,45,-20,37,51,-14,1,4,0,0
"6188","CHI","COL",2018020942,17949,20182019,1,60,3,5,-2,4.8893729088341,5.07573319599032,-0.186360287156226,44,31,13,50,35,15,73,47,26,4,4,0,0
"6189","CHI","DAL",2018020958,17951,20182019,1,60,3,4,-1,6.05057099787518,5.37587116516079,0.674699832714396,47,29,18,51,36,15,63,48,15,4,2,0,0
"6190","CHI","ANA",2018020983,17954,20182019,0,60,4,3,1,4.33242269753828,2.99500139628924,1.33742130124903,35,32,3,42,46,-4,59,59,0,2,1,0,0
"6191","CHI","L.A",2018021000,17957,20182019,0,60,3,6,-3,6.00785043362703,5.15644676974625,0.851403663880774,32,25,7,49,34,15,65,42,23,3,3,0,0
"6192","CHI","S.J",2018021016,17958,20182019,0,60,2,5,-3,3.71293965575751,2.80746240464214,0.905477251115371,30,34,-4,47,43,4,63,54,9,3,1,0,0
"6193","CHI","DAL",2018021057,17964,20182019,0,60,2,1,1,3.80089184214012,3.58925387577619,0.211637966363924,39,27,12,49,39,10,77,60,17,3,0,0,0
"6194","CHI","ARI",2018021069,17966,20182019,1,60,7,1,6,4.7722328735108,5.80677861458389,-1.03454574107309,34,25,9,36,31,5,50,39,11,2,2,0,0
"6195","CHI","TOR",2018021080,17968,20182019,0,60,5,4,1,6.21524117258377,7.16717210118077,-0.951930928596994,39,47,-8,47,66,-19,56,94,-38,0,1,0,0
"6196","CHI","MTL",2018021103,17971,20182019,0,60,2,0,2,4.46487470404827,6.72489829163533,-2.26002358758706,24,48,-24,35,67,-32,46,91,-45,2,4,0,0
"6197","CHI","VAN",2018021119,17973,20182019,1,60.2666666666667,2,3,-1,5.29536737367744,3.83216302586112,1.46320434781631,31,34,-3,41,40,1,59,50,9,3,1,0,0
"6198","CHI","PHI",2018021142,17976,20182019,1,60,1,3,-2,6.12144125223131,3.14691240022148,2.97452885200983,41,28,13,54,33,21,72,44,28,2,1,0,0
"6199","CHI","COL",2018021152,17978,20182019,0,60,2,4,-2,5.0889218703669,6.00364232528955,-0.914720454922644,31,25,6,48,37,11,67,49,18,3,4,0,0
"6200","CHI","COL",2018021167,17979,20182019,1,61.3833333333333,2,1,1,6.31290068613703,2.01799265820591,4.29490802793111,42,20,22,51,24,27,75,47,28,2,3,0,0
"6201","CHI","ARI",2018021184,17981,20182019,0,60,0,1,-1,5.25206746141856,3.09702618990559,2.15504127151297,31,29,2,44,39,5,58,57,1,1,2,0,0
"6202","CHI","S.J",2018021196,17983,20182019,0,60,5,4,1,2.63926445972174,4.47497091055266,-1.83570645083091,27,30,-3,30,43,-13,39,63,-24,2,5,0,0
"6203","CHI","L.A",2018021214,17985,20182019,0,64.8,2,3,-1,3.37448582438844,2.98079631550469,0.393689508883751,35,29,6,55,38,17,67,48,19,3,3,0,0
"6204","CHI","WPG",2018021226,17987,20182019,1,63.6333333333333,3,4,-1,4.7877153225848,8.33391348063932,-3.54619815805452,28,38,-10,45,50,-5,63,63,0,3,5,0,0
"6205","CHI","DAL",2018021255,17991,20182019,1,60,6,1,5,3.0869460151298,2.95392739840463,0.133018616725167,32,35,-3,41,45,-4,61,62,-1,3,1,0,0
"6206","CHI","NSH",2018021266,17992,20182019,0,60,2,5,-3,3.24772012742628,6.5778361030425,-3.33011597561622,33,50,-17,40,61,-21,55,72,-17,2,3,0,0
"6207","COL","BOS",2008020006,14161,20082009,1,60,4,5,-1,0,0,0,39,20,19,47,28,19,69,38,31,5,2,0,0
"6208","COL","EDM",2008020029,14164,20082009,0,60,2,3,-1,0,0,0,33,19,14,48,29,19,60,41,19,4,3,0,0
"6209","COL","CGY",2008020041,14166,20082009,0,60,4,5,-1,0,0,0,29,35,-6,36,46,-10,43,59,-16,6,7,0,0
"6210","COL","PHI",2008020055,14168,20082009,1,60,5,2,3,0,0,0,34,18,16,42,24,18,50,37,13,12,9,0,0
"6211","COL","DAL",2008020063,14170,20082009,0,60,5,4,1,0,0,0,22,30,-8,30,46,-16,40,61,-21,8,5,0,0
"6212","COL","L.A",2008020081,14172,20082009,0,60,4,3,1,0,0,0,16,29,-13,25,43,-18,28,57,-29,4,4,0,0
"6213","COL","EDM",2008020097,14175,20082009,1,60,4,1,3,0,0,0,25,26,-1,32,34,-2,42,58,-16,6,4,0,0
"6214","COL","BUF",2008020117,14177,20082009,1,65,1,1,0,0,0,0,29,30,-1,48,46,2,61,62,-1,3,3,0,0
"6215","COL","CGY",2008020130,14180,20082009,0,60,0,3,-3,0,0,0,22,30,-8,33,45,-12,37,66,-29,3,2,0,0
"6216","COL","CBJ",2008020143,14182,20082009,1,60,2,4,-2,0,0,0,32,17,15,41,24,17,56,40,16,4,0,0,0
"6217","COL","S.J",2008020165,14185,20082009,1,60,3,5,-2,0,0,0,36,29,7,49,43,6,61,55,6,3,2,0,0
"6218","COL","CHI",2008020170,14186,20082009,0,60,2,6,-4,0,0,0,26,37,-11,35,42,-7,44,56,-12,6,5,0,0
"6219","COL","MIN",2008020187,14189,20082009,1,60,1,3,-2,0,0,0,36,20,16,45,30,15,60,39,21,7,4,0,0
"6220","COL","NSH",2008020203,14191,20082009,1,60,1,0,1,0,0,0,20,26,-6,30,39,-9,43,48,-5,9,7,0,0
"6221","COL","VAN",2008020227,14195,20082009,0,65,1,1,0,0,0,0,34,32,2,39,40,-1,48,67,-19,5,4,0,0
"6222","COL","EDM",2008020250,14198,20082009,0,65,2,2,0,0,0,0,32,35,-3,40,49,-9,46,69,-23,4,4,0,0
"6223","COL","CGY",2008020267,14201,20082009,0,60,1,4,-3,0,0,0,23,51,-28,28,66,-38,33,91,-58,2,8,0,0
"6224","COL","CGY",2008020276,14203,20082009,1,60,0,1,-1,0,0,0,18,33,-15,24,44,-20,36,65,-29,3,8,0,0
"6225","COL","L.A",2008020295,14205,20082009,0,65,3,3,0,0,0,0,29,30,-1,46,47,-1,63,66,-3,5,8,0,0
"6226","COL","ANA",2008020305,14207,20082009,0,60,1,4,-3,0,0,0,30,24,6,44,37,7,51,41,10,4,3,0,0
"6227","COL","STL",2008020318,14209,20082009,1,60,3,1,2,0,0,0,28,22,6,35,34,1,49,50,-1,3,2,0,0
"6228","COL","ARI",2008020326,14211,20082009,0,60,1,2,-1,0,0,0,38,20,18,49,30,19,64,49,15,4,4,0,0
"6229","COL","T.B",2008020343,14212,20082009,1,60,4,3,1,0,0,0,31,20,11,34,29,5,40,50,-10,4,5,0,0
"6230","COL","MIN",2008020353,14214,20082009,0,60,6,5,1,0,0,0,31,17,14,38,27,11,49,43,6,3,4,0,0
"6231","COL","NSH",2008020373,14217,20082009,0,60,2,3,-1,0,0,0,21,24,-3,28,34,-6,37,50,-13,4,6,0,0
"6232","COL","DAL",2008020378,14218,20082009,0,65,1,1,0,0,0,0,27,24,3,44,30,14,64,48,16,3,3,0,0
"6233","COL","VAN",2008020395,14220,20082009,1,65,4,4,0,0,0,0,35,38,-3,46,51,-5,59,65,-6,4,5,0,0
"6234","COL","L.A",2008020412,14222,20082009,1,60,6,1,5,0,0,0,26,30,-4,34,49,-15,42,75,-33,5,5,0,0
"6235","COL","CHI",2008020427,14225,20082009,1,60,3,4,-1,0,0,0,21,30,-9,26,43,-17,35,59,-24,5,6,0,0
"6236","COL","DET",2008020444,14228,20082009,0,60,3,2,1,0,0,0,27,36,-9,33,45,-12,35,61,-26,6,6,0,0
"6237","COL","PHI",2008020447,14229,20082009,0,60,2,5,-3,0,0,0,31,24,7,41,35,6,55,51,4,5,5,0,0
"6238","COL","T.B",2008020465,14231,20082009,0,65,1,1,0,0,0,0,35,38,-3,45,50,-5,64,62,2,5,2,0,0
"6239","COL","FLA",2008020486,14234,20082009,0,60,0,3,-3,0,0,0,23,24,-1,33,38,-5,42,52,-10,5,6,0,0
"6240","COL","ARI",2008020504,14236,20082009,1,61.8,5,4,1,0,0,0,48,23,25,56,38,18,68,44,24,4,4,0,0
"6241","COL","DET",2008020524,14240,20082009,1,65,3,3,0,0,0,0,32,44,-12,37,58,-21,48,80,-32,6,5,0,0
"6242","COL","NSH",2008020536,14242,20082009,1,60,5,1,4,0,0,0,21,26,-5,29,37,-8,40,56,-16,5,6,0,0
"6243","COL","ARI",2008020550,14244,20082009,0,60,1,3,-2,0,0,0,29,29,0,35,46,-11,52,54,-2,3,2,0,0
"6244","COL","CBJ",2008020562,14246,20082009,1,60,1,6,-5,0,0,0,24,30,-6,36,35,1,50,46,4,7,6,0,0
"6245","COL","MIN",2008020580,14248,20082009,1,60,0,2,-2,0,0,0,33,37,-4,48,50,-2,75,66,9,4,7,0,0
"6246","COL","NSH",2008020592,14250,20082009,0,60,2,1,1,0,0,0,21,23,-2,27,47,-20,38,70,-32,2,3,0,0
"6247","COL","CHI",2008020605,14252,20082009,1,60,2,1,1,0,0,0,32,44,-12,43,55,-12,57,65,-8,3,1,0,0
"6248","COL","PIT",2008020615,14254,20082009,1,60,5,3,2,0,0,0,32,24,8,39,36,3,54,49,5,1,1,0,0
"6249","COL","CBJ",2008020635,14257,20082009,0,60,3,4,-1,0,0,0,26,27,-1,32,38,-6,36,53,-17,5,5,0,0
"6250","COL","STL",2008020651,14259,20082009,0,60,2,5,-3,0,0,0,26,26,0,30,38,-8,43,49,-6,4,3,0,0
"6251","COL","EDM",2008020661,14260,20082009,1,60,2,3,-1,0,0,0,39,37,2,59,48,11,74,66,8,3,4,0,0
"6252","COL","CGY",2008020674,14262,20082009,1,60,6,2,4,0,0,0,39,41,-2,53,55,-2,61,74,-13,6,5,0,0
"6253","COL","L.A",2008020699,14265,20082009,1,60,5,6,-1,0,0,0,41,28,13,60,39,21,82,48,34,8,4,0,0
"6254","COL","S.J",2008020709,14271,20082009,1,60,0,3,-3,0,0,0,31,38,-7,51,51,0,65,63,2,3,3,0,0
"6255","COL","TOR",2008020722,14273,20082009,1,60,4,7,-3,0,0,0,20,30,-10,34,42,-8,51,56,-5,1,3,0,0
"6256","COL","ANA",2008020733,14275,20082009,1,60,3,4,-1,0,0,0,37,31,6,52,45,7,67,66,1,4,5,0,0
"6257","COL","CGY",2008020746,14277,20082009,1,60,4,3,1,0,0,0,42,39,3,50,53,-3,61,80,-19,4,2,0,0
"6258","COL","DAL",2008020769,14280,20082009,1,60,3,2,1,0,0,0,21,24,-3,33,40,-7,48,60,-12,3,4,0,0
"6259","COL","STL",2008020786,14282,20082009,0,60,1,4,-3,0,0,0,24,23,1,34,34,0,47,45,2,6,5,0,0
"6260","COL","CBJ",2008020797,14285,20082009,0,60,0,3,-3,0,0,0,31,30,1,42,50,-8,50,70,-20,3,2,0,0
"6261","COL","MIN",2008020807,14286,20082009,0,60,2,3,-1,0,0,0,22,26,-4,36,39,-3,54,46,8,6,4,0,0
"6262","COL","MTL",2008020824,14288,20082009,1,60,2,4,-2,0,0,0,48,23,25,54,32,22,75,52,23,5,2,0,0
"6263","COL","DET",2008020837,14290,20082009,0,65,5,5,0,0,0,0,28,45,-17,35,64,-29,42,88,-46,2,6,0,0
"6264","COL","OTT",2008020851,14292,20082009,1,61.3333333333333,3,2,1,0,0,0,27,22,5,32,36,-4,54,51,3,4,4,0,0
"6265","COL","WSH",2008020871,14295,20082009,0,60,4,1,3,0,0,0,25,29,-4,33,43,-10,47,61,-14,5,3,0,0
"6266","COL","CAR",2008020888,14297,20082009,0,60,2,5,-3,0,0,0,19,39,-20,30,55,-25,38,75,-37,4,9,0,0
"6267","COL","ATL",2008020896,14299,20082009,0,60,3,4,-1,0,0,0,33,26,7,41,37,4,57,50,7,6,5,0,0
"6268","COL","N.J",2008020909,14301,20082009,0,60,0,4,-4,0,0,0,24,32,-8,32,47,-15,36,61,-25,3,4,0,0
"6269","COL","NYR",2008020929,14303,20082009,0,60,1,6,-5,0,0,0,24,30,-6,31,50,-19,45,61,-16,6,9,0,0
"6270","COL","NYI",2008020940,14305,20082009,0,60,2,4,-2,0,0,0,22,31,-9,38,41,-3,58,64,-6,3,2,0,0
"6271","COL","DET",2008020954,14307,20082009,1,60,2,3,-1,0,0,0,27,30,-3,37,46,-9,51,68,-17,1,2,0,0
"6272","COL","CHI",2008020983,14311,20082009,0,60,5,1,4,0,0,0,29,25,4,33,36,-3,37,48,-11,5,6,0,0
"6273","COL","ATL",2008020999,14313,20082009,1,60,0,3,-3,0,0,0,35,36,-1,54,44,10,64,67,-3,3,5,0,0
"6274","COL","MIN",2008021014,14315,20082009,1,65,1,1,0,0,0,0,41,17,24,52,32,20,65,46,19,5,5,0,0
"6275","COL","EDM",2008021028,14317,20082009,0,60.7,3,2,1,0,0,0,30,20,10,37,34,3,60,51,9,4,2,0,0
"6276","COL","VAN",2008021037,14318,20082009,0,60,2,4,-2,0,0,0,20,23,-3,36,37,-1,52,45,7,8,5,0,0
"6277","COL","MIN",2008021047,14320,20082009,0,65,2,2,0,0,0,0,26,29,-3,37,41,-4,49,66,-17,1,3,0,0
"6278","COL","EDM",2008021059,14322,20082009,1,60,1,8,-7,0,0,0,27,24,3,35,33,2,51,53,-2,3,6,0,0
"6279","COL","S.J",2008021084,14325,20082009,0,60,1,3,-2,0,0,0,32,28,4,44,36,8,61,52,9,2,3,0,0
"6280","COL","ANA",2008021101,14328,20082009,1,60,2,7,-5,0,0,0,36,29,7,50,33,17,58,50,8,6,8,0,0
"6281","COL","VAN",2008021114,14330,20082009,1,60,1,4,-3,0,0,0,23,34,-11,36,50,-14,48,66,-18,4,6,0,0
"6282","COL","ANA",2008021133,14332,20082009,0,60,1,4,-3,0,0,0,27,31,-4,43,43,0,54,53,1,3,4,0,0
"6283","COL","ARI",2008021149,14335,20082009,1,60,0,3,-3,0,0,0,23,35,-12,35,41,-6,48,55,-7,4,7,0,0
"6284","COL","VAN",2008021180,14339,20082009,0,60,4,1,3,0,0,0,26,21,5,34,41,-7,37,62,-25,2,4,0,0
"6285","COL","S.J",2008021196,14341,20082009,0,65,0,0,0,0,0,0,20,30,-10,27,48,-21,40,73,-33,3,5,0,0
"6286","COL","DAL",2008021207,14343,20082009,1,65,2,2,0,0,0,0,27,39,-12,36,48,-12,44,63,-19,5,2,0,0
"6287","COL","VAN",2008021217,14345,20082009,1,60.6666666666667,0,1,-1,0,0,0,22,33,-11,29,44,-15,36,54,-18,3,3,0,0
"6288","COL","STL",2008021227,14346,20082009,1,60,0,1,-1,0,0,0,28,17,11,42,29,13,50,37,13,4,3,0,0
"6289","COL","S.J",2009020003,14518,20092010,1,60,5,2,3,0,0,0,20,40,-20,30,59,-29,38,75,-37,3,6,0,0
"6290","COL","VAN",2009020009,14520,20092010,1,60,3,0,3,0,0,0,27,35,-8,37,47,-10,49,63,-14,7,4,0,0
"6291","COL","NSH",2009020043,14525,20092010,0,60,2,3,-1,0,0,0,24,37,-13,29,42,-13,36,55,-19,3,2,0,0
"6292","COL","CHI",2009020058,14527,20092010,0,65,3,3,0,0,0,0,19,26,-7,24,36,-12,41,62,-21,5,5,0,0
"6293","COL","BOS",2009020064,14529,20092010,0,60,4,3,1,0,0,0,22,32,-10,27,47,-20,36,68,-32,5,6,0,0
"6294","COL","TOR",2009020075,14530,20092010,0,60,4,1,3,0,0,0,28,31,-3,45,45,0,58,65,-7,6,4,0,0
"6295","COL","MTL",2009020082,14532,20092010,0,60,3,2,1,0,0,0,23,31,-8,31,50,-19,42,65,-23,4,6,0,0
"6296","COL","DET",2009020099,14534,20092010,0,65,3,3,0,0,0,0,29,31,-2,37,45,-8,48,65,-17,3,3,0,0
"6297","COL","MIN",2009020115,14538,20092010,0,65,2,2,0,0,0,0,35,26,9,45,45,0,48,58,-10,2,7,0,0
"6298","COL","CAR",2009020129,14540,20092010,1,60,5,4,1,0,0,0,36,36,0,44,47,-3,60,64,-4,6,5,0,0
"6299","COL","DET",2009020141,14541,20092010,1,60,3,1,2,0,0,0,23,49,-26,28,62,-34,41,82,-41,2,7,0,0
"6300","COL","EDM",2009020153,14544,20092010,0,60,3,0,3,0,0,0,34,25,9,43,36,7,57,52,5,4,5,0,0
"6301","COL","CGY",2009020163,14545,20092010,0,60,3,2,1,0,0,0,14,32,-18,17,48,-31,30,67,-37,2,3,0,0
"6302","COL","S.J",2009020179,14547,20092010,0,60,1,3,-2,0,0,0,25,46,-21,36,62,-26,43,82,-39,5,5,0,0
"6303","COL","VAN",2009020194,14549,20092010,0,60,0,3,-3,0,0,0,18,20,-2,26,29,-3,34,40,-6,4,4,0,0
"6304","COL","ARI",2009020208,14552,20092010,1,60,4,1,3,0,0,0,29,29,0,39,37,2,55,62,-7,6,4,0,0
"6305","COL","CHI",2009020224,14554,20092010,1,65,3,3,0,0,0,0,22,32,-10,27,43,-16,48,72,-24,3,5,0,0
"6306","COL","EDM",2009020239,14556,20092010,1,60,3,5,-2,0,0,0,37,32,5,47,37,10,67,49,18,5,8,0,0
"6307","COL","CHI",2009020252,14559,20092010,0,65,2,2,0,0,0,0,27,39,-12,37,53,-16,49,74,-25,4,2,0,0
"6308","COL","VAN",2009020279,14562,20092010,1,60,2,8,-6,0,0,0,34,30,4,41,45,-4,50,57,-7,8,9,0,0
"6309","COL","CGY",2009020293,14565,20092010,0,60,3,2,1,0,0,0,24,36,-12,35,43,-8,41,67,-26,5,4,0,0
"6310","COL","EDM",2009020297,14566,20092010,0,60,4,6,-2,0,0,0,18,33,-15,26,40,-14,34,51,-17,4,6,0,0
"6311","COL","VAN",2009020311,14568,20092010,0,60,2,5,-3,0,0,0,24,27,-3,36,41,-5,47,56,-9,4,4,0,0
"6312","COL","PHI",2009020335,14571,20092010,1,60,5,4,1,0,0,0,31,34,-3,36,46,-10,44,59,-15,7,3,0,0
"6313","COL","NSH",2009020348,14573,20092010,1,63.1166666666667,3,4,-1,0,0,0,22,27,-5,35,39,-4,42,56,-14,3,3,0,0
"6314","COL","MIN",2009020358,14575,20092010,0,60,3,5,-2,0,0,0,34,32,2,46,45,1,55,61,-6,4,4,0,0
"6315","COL","MIN",2009020377,14576,20092010,1,65,2,2,0,0,0,0,22,36,-14,27,49,-22,35,66,-31,1,4,0,0
"6316","COL","T.B",2009020387,14578,20092010,0,60,3,0,3,0,0,0,29,33,-4,38,51,-13,44,67,-23,5,7,0,0
"6317","COL","FLA",2009020396,14580,20092010,0,65,5,5,0,0,0,0,34,44,-10,41,55,-14,53,66,-13,7,9,0,0
"6318","COL","PIT",2009020403,14581,20092010,0,60,1,4,-3,0,0,0,16,33,-17,30,49,-19,46,54,-8,3,4,0,0
"6319","COL","CBJ",2009020421,14583,20092010,0,60,3,2,1,0,0,0,19,31,-12,25,45,-20,36,63,-27,3,5,0,0
"6320","COL","STL",2009020435,14585,20092010,0,60,4,0,4,0,0,0,22,35,-13,29,58,-29,33,78,-45,1,1,0,0
"6321","COL","MIN",2009020449,14587,20092010,1,60,0,1,-1,0,0,0,22,22,0,32,28,4,48,40,8,6,3,0,0
"6322","COL","T.B",2009020463,14589,20092010,1,65,1,1,0,0,0,0,34,22,12,49,30,19,60,38,22,3,1,0,0
"6323","COL","CGY",2009020479,14591,20092010,1,60,3,2,1,0,0,0,35,21,14,44,37,7,54,54,0,5,5,0,0
"6324","COL","WSH",2009020492,14593,20092010,1,60,1,6,-5,0,0,0,28,25,3,36,34,2,47,41,6,6,1,0,0
"6325","COL","CBJ",2009020527,14597,20092010,1,60,5,2,3,0,0,0,31,30,1,40,47,-7,48,67,-19,5,3,0,0
"6326","COL","MIN",2009020538,14599,20092010,0,60,4,3,1,0,0,0,21,31,-10,24,41,-17,41,56,-15,6,5,0,0
"6327","COL","ANA",2009020543,14600,20092010,1,60,2,4,-2,0,0,0,17,43,-26,29,57,-28,35,73,-38,3,3,0,0
"6328","COL","DAL",2009020567,14604,20092010,1,60,4,1,3,0,0,0,33,40,-7,42,55,-13,57,70,-13,3,1,0,0
"6329","COL","OTT",2009020594,14608,20092010,0,60,4,3,1,0,0,0,20,30,-10,29,44,-15,42,63,-21,2,1,0,0
"6330","COL","DET",2009020600,14609,20092010,0,60,2,4,-2,0,0,0,22,35,-13,30,43,-13,38,57,-19,7,4,0,0
"6331","COL","CBJ",2009020616,14611,20092010,0,60,3,2,1,0,0,0,37,28,9,44,33,11,52,48,4,6,4,0,0
"6332","COL","NYI",2009020643,14615,20092010,1,60,2,3,-1,0,0,0,32,35,-3,40,45,-5,58,56,2,3,2,0,0
"6333","COL","CAR",2009020656,14617,20092010,0,60,1,2,-1,0,0,0,30,20,10,47,34,13,61,45,16,8,6,0,0
"6334","COL","BUF",2009020661,14618,20092010,0,65,3,3,0,0,0,0,30,35,-5,39,53,-14,51,67,-16,5,4,0,0
"6335","COL","CGY",2009020677,14620,20092010,0,65,2,2,0,0,0,0,21,46,-25,33,57,-24,41,84,-43,4,4,0,0
"6336","COL","N.J",2009020709,14625,20092010,1,60,3,1,2,0,0,0,28,38,-10,34,55,-21,44,70,-26,3,4,0,0
"6337","COL","EDM",2009020731,14627,20092010,1,60,6,0,6,0,0,0,34,24,10,41,33,8,48,53,-5,6,5,0,0
"6338","COL","NSH",2009020758,14631,20092010,1,60,2,1,1,0,0,0,23,30,-7,31,43,-12,38,56,-18,8,6,0,0
"6339","COL","DAL",2009020774,14633,20092010,1,60,4,0,4,0,0,0,36,27,9,47,35,12,55,43,12,5,4,0,0
"6340","COL","MIN",2009020797,14637,20092010,1,60,0,1,-1,0,0,0,29,26,3,39,33,6,56,51,5,2,5,0,0
"6341","COL","DAL",2009020806,14638,20092010,0,60,2,3,-1,0,0,0,26,31,-5,41,46,-5,64,59,5,1,2,0,0
"6342","COL","NYR",2009020822,14640,20092010,1,60,1,3,-2,0,0,0,35,34,1,48,44,4,61,55,6,6,6,0,0
"6343","COL","CBJ",2009020833,14642,20092010,1,60,5,1,4,0,0,0,26,21,5,43,31,12,54,37,17,3,5,0,0
"6344","COL","NSH",2009020847,14644,20092010,0,60,3,5,-2,0,0,0,26,36,-10,35,43,-8,48,53,-5,4,6,0,0
"6345","COL","EDM",2009020868,14646,20092010,1,60,3,0,3,0,0,0,42,20,22,60,32,28,86,44,42,2,3,0,0
"6346","COL","STL",2009020873,14648,20092010,1,60,5,2,3,0,0,0,33,34,-1,42,44,-2,55,56,-1,6,2,0,0
"6347","COL","ATL",2009020889,14650,20092010,1,60.15,4,3,1,0,0,0,35,36,-1,47,50,-3,61,66,-5,5,5,0,0
"6348","COL","ARI",2009020904,14652,20092010,1,60,2,1,1,0,0,0,25,34,-9,36,45,-9,44,62,-18,7,6,0,0
"6349","COL","L.A",2009020915,14653,20092010,0,60,0,3,-3,0,0,0,22,23,-1,36,30,6,49,36,13,3,5,0,0
"6350","COL","DET",2009020922,14669,20092010,1,60,2,3,-1,0,0,0,24,30,-6,31,37,-6,45,53,-8,3,5,0,0
"6351","COL","ANA",2009020940,14671,20092010,0,60,4,3,1,0,0,0,25,34,-9,33,48,-15,34,51,-17,8,7,0,0
"6352","COL","ARI",2009020948,14672,20092010,0,60,1,3,-2,0,0,0,24,30,-6,33,39,-6,45,54,-9,4,3,0,0
"6353","COL","STL",2009020962,14674,20092010,1,60,7,3,4,0,0,0,33,42,-9,44,60,-16,51,73,-22,6,5,0,0
"6354","COL","VAN",2009020982,14677,20092010,1,60,4,6,-2,0,0,0,27,32,-5,28,48,-20,38,65,-27,2,3,0,0
"6355","COL","FLA",2009020997,14679,20092010,1,60,3,0,3,0,0,0,31,27,4,39,34,5,66,49,17,2,1,0,0
"6356","COL","DAL",2009021016,14682,20092010,0,60,5,3,2,0,0,0,22,51,-29,34,64,-30,41,77,-36,3,5,0,0
"6357","COL","STL",2009021034,14684,20092010,0,60,5,3,2,0,0,0,26,39,-13,33,61,-28,38,76,-38,3,5,0,0
"6358","COL","CGY",2009021040,14685,20092010,1,60,2,3,-1,0,0,0,34,34,0,43,41,2,55,52,3,4,5,0,0
"6359","COL","ANA",2009021076,14689,20092010,0,60,2,5,-3,0,0,0,28,33,-5,42,47,-5,46,61,-15,3,6,0,0
"6360","COL","L.A",2009021079,14690,20092010,0,63.6666666666667,3,4,-1,0,0,0,21,23,-2,32,36,-4,41,43,-2,6,4,0,0
"6361","COL","L.A",2009021094,14692,20092010,1,65,3,3,0,0,0,0,30,30,0,39,41,-2,51,61,-10,5,3,0,0
"6362","COL","ARI",2009021119,14695,20092010,0,60,2,6,-4,0,0,0,29,32,-3,42,41,1,52,51,1,3,2,0,0
"6363","COL","S.J",2009021127,14696,20092010,0,60,3,4,-1,0,0,0,45,32,13,52,42,10,66,58,8,4,2,0,0
"6364","COL","ANA",2009021147,14699,20092010,1,60,2,5,-3,0,0,0,29,27,2,45,34,11,61,41,20,3,1,0,0
"6365","COL","CGY",2009021162,14701,20092010,1,60,1,2,-1,0,0,0,36,27,9,40,36,4,55,55,0,1,3,0,0
"6366","COL","S.J",2009021177,14703,20092010,1,62.9833333333333,5,4,1,0,0,0,40,22,18,52,28,24,69,40,29,6,3,0,0
"6367","COL","VAN",2009021191,14705,20092010,0,65,3,3,0,0,0,0,31,32,-1,37,51,-14,47,65,-18,3,3,0,0
"6368","COL","EDM",2009021196,14706,20092010,0,63.8333333333333,4,5,-1,0,0,0,35,45,-10,47,57,-10,60,68,-8,2,2,0,0
"6369","COL","CHI",2009021211,14708,20092010,1,60,2,5,-3,0,0,0,32,37,-5,39,55,-16,53,70,-17,2,4,0,0
"6370","COL","L.A",2009021226,14710,20092010,1,61.5166666666667,1,2,-1,0,0,0,32,33,-1,36,41,-5,44,61,-17,4,3,0,0
"6371","COL","S.J",2009030151,14713,20092010,0,60,2,1,1,0,0,0,30,26,4,35,40,-5,45,57,-12,3,3,0,0
"6372","COL","S.J",2009030152,14715,20092010,0,65.3666666666667,5,6,-1,0,0,0,22,52,-30,29,68,-39,43,100,-57,5,8,0,0
"6373","COL","S.J",2009030153,14717,20092010,1,60.85,1,0,1,0,0,0,17,51,-34,24,71,-47,33,93,-60,3,7,0,0
"6374","COL","S.J",2009030154,14719,20092010,1,70.4,1,2,-1,0,0,0,34,45,-11,46,57,-11,59,81,-22,4,4,0,0
"6375","COL","S.J",2009030155,14721,20092010,0,60,0,5,-5,0,0,0,28,37,-9,46,50,-4,54,68,-14,4,6,0,0
"6376","COL","S.J",2009030156,14723,20092010,1,60,2,5,-3,0,0,0,18,34,-16,26,46,-20,41,61,-20,3,3,0,0
"6377","COL","CHI",2010020004,14889,20102011,1,63.6666666666667,4,3,1,7.01437583527081,5.5341023521687,1.48027348310211,41,38,3,48,46,2,58,62,-4,3,7,0,0
"6378","COL","PHI",2010020031,14893,20102011,0,60,2,4,-2,4.29721841531136,8.48372588087659,-4.18650746556523,27,38,-11,34,49,-15,44,60,-16,4,5,0,0
"6379","COL","DET",2010020034,14894,20102011,0,65,4,4,0,3.9307735717739,4.28717226546723,-0.356398693693336,38,28,10,45,39,6,56,65,-9,4,1,0,0
"6380","COL","N.J",2010020048,14897,20102011,0,60,3,2,1,2.83489532000385,2.97339739599387,-0.138502075990016,22,43,-21,30,50,-20,35,61,-26,4,3,0,0
"6381","COL","NYI",2010020057,14898,20102011,0,60,2,5,-3,4.73288643230146,5.96273784839035,-1.22985141608889,30,25,5,48,30,18,61,44,17,4,7,0,0
"6382","COL","NYR",2010020070,14900,20102011,0,60,3,1,2,2.77854844092485,4.65900462126592,-1.88045618034107,34,32,2,44,48,-4,52,71,-19,4,7,0,0
"6383","COL","S.J",2010020090,14903,20102011,1,60,2,4,-2,4.26994584685747,6.84183840377955,-2.57189255692208,31,34,-3,38,47,-9,47,61,-14,4,6,0,0
"6384","COL","L.A",2010020108,14905,20102011,1,60,4,6,-2,2.64621114823603,5.16123379419949,-2.51502264596346,32,30,2,41,39,2,48,51,-3,5,4,0,0
"6385","COL","VAN",2010020122,14908,20102011,0,60.4666666666667,3,4,-1,5.41345013025611,6.55312206612507,-1.13967193586896,39,31,8,46,43,3,60,57,3,2,3,0,0
"6386","COL","CGY",2010020136,14910,20102011,0,60,6,5,1,7.43278615529925,1.72310181836807,5.70968433693118,36,19,17,51,35,16,61,47,14,6,3,0,0
"6387","COL","CBJ",2010020152,14912,20102011,1,60,5,1,4,4.18849016816239,6.20271953371163,-2.01422936554924,31,34,-3,43,54,-11,50,64,-14,8,5,0,0
"6388","COL","VAN",2010020177,14917,20102011,1,60,1,3,-2,4.39721858351272,5.06124057770933,-0.664021994196608,34,36,-2,46,48,-2,62,58,4,2,4,0,0
"6389","COL","DAL",2010020195,14919,20102011,1,60,5,0,5,0,0,0,45,31,14,53,40,13,60,50,10,6,7,0,0
"6390","COL","CGY",2010020209,14922,20102011,1,60,2,4,-2,4.6015096496476,4.48000336217228,0.121506287475313,31,25,6,41,41,0,53,57,-4,8,6,0,0
"6391","COL","CBJ",2010020229,14925,20102011,0,60,5,1,4,4.12599859910551,4.63319359983947,-0.507195000733958,29,29,0,38,39,-1,44,56,-12,1,4,0,0
"6392","COL","DET",2010020239,14926,20102011,0,60,1,3,-2,4.16232785838656,3.85818727266087,0.30414058572569,22,25,-3,36,38,-2,47,45,2,5,4,0,0
"6393","COL","STL",2010020252,14928,20102011,1,60,6,3,3,3.427920008206,3.932107675937,-0.504187667731003,23,30,-7,37,38,-1,46,56,-10,6,5,0,0
"6394","COL","S.J",2010020265,14930,20102011,1,62.1166666666667,4,3,1,1.44623944247439,3.5788579186883,-2.13261847621391,22,43,-21,29,54,-25,42,68,-26,2,4,0,0
"6395","COL","NYR",2010020279,14932,20102011,1,60,5,1,4,3.54475242205307,2.78785425133538,0.756898170717696,26,26,0,34,32,2,42,48,-6,1,5,0,0
"6396","COL","DAL",2010020291,14933,20102011,0,65,3,3,0,5.89871008199088,3.49536221103699,2.40334787095389,26,29,-3,39,41,-2,55,57,-2,5,5,0,0
"6397","COL","VAN",2010020318,14937,20102011,0,60,2,4,-2,4.57007275705747,2.71664348734759,1.85342926970988,23,19,4,33,30,3,44,50,-6,5,4,0,0
"6398","COL","EDM",2010020320,14938,20102011,0,60,2,3,-1,3.34260116936815,3.08813180070138,0.254469368666776,37,24,13,46,36,10,55,56,-1,3,4,0,0
"6399","COL","MIN",2010020342,14940,20102011,1,60,7,4,3,7.02954216036596,4.02542792021995,3.00411424014601,40,32,8,50,41,9,63,51,12,5,3,0,0
"6400","COL","ATL",2010020356,14943,20102011,1,61.8166666666667,2,3,-1,3.62288299080408,5.53194740792969,-1.90906441712561,31,31,0,48,38,10,66,52,14,4,4,0,0
"6401","COL","CAR",2010020374,14946,20102011,0,61.2666666666667,1,2,-1,5.29480038931797,3.86529025924392,1.42951013007405,35,30,5,50,45,5,66,60,6,3,2,0,0
"6402","COL","T.B",2010020385,14947,20102011,0,60,5,6,-1,2.54532568151626,3.61838784911379,-1.07306216759753,24,39,-15,33,48,-15,45,67,-22,4,6,0,0
"6403","COL","FLA",2010020403,14950,20102011,0,60.7166666666667,3,4,-1,2.23813788843123,2.69155683205463,-0.453418943623397,25,25,0,33,36,-3,42,51,-9,1,2,0,0
"6404","COL","ATL",2010020421,14953,20102011,0,60,4,2,2,4.15294039432774,2.92803415365051,1.22490624067723,29,26,3,37,37,0,50,55,-5,4,4,0,0
"6405","COL","WSH",2010020430,14954,20102011,0,60,3,2,1,4.59782964552869,4.8737921272384,-0.275962481709712,26,42,-16,34,57,-23,43,84,-41,1,3,0,0
"6406","COL","CHI",2010020444,14956,20102011,1,60,7,5,2,5.27880867631609,6.11018673328363,-0.831378056967537,30,34,-4,37,48,-11,50,62,-12,2,5,0,0
"6407","COL","CHI",2010020458,14958,20102011,0,60,4,3,1,3.21763809209369,5.62949392136943,-2.41185582927574,23,38,-15,29,47,-18,38,71,-33,3,4,0,0
"6408","COL","OTT",2010020472,14960,20102011,1,62.6,6,5,1,5.42085173134595,5.35965835167917,0.0611933796667739,25,29,-4,36,35,1,50,49,1,3,5,0,0
"6409","COL","MTL",2010020487,14962,20102011,1,60,3,2,1,3.94296329393215,5.38407648951397,-1.44111319558182,28,29,-1,33,43,-10,45,63,-18,3,5,0,0
"6410","COL","L.A",2010020500,14964,20102011,1,60,0,5,-5,5.22884638345568,3.65606210421538,1.5727842792403,23,32,-9,38,48,-10,50,61,-11,4,4,0,0
"6411","COL","MIN",2010020516,14966,20102011,1,60,1,3,-2,7.74610312275763,4.68372882227586,3.06237430048177,37,32,5,45,44,1,63,61,2,2,3,0,0
"6412","COL","DET",2010020533,14970,20102011,1,63.7,3,4,-1,6.45392216340099,3.88428306672722,2.56963909667377,49,30,19,60,41,19,79,52,27,7,6,0,0
"6413","COL","EDM",2010020555,14973,20102011,0,65,3,3,0,2.24201262741281,3.06134415324777,-0.819331525834968,27,35,-8,43,49,-6,59,67,-8,2,4,0,0
"6414","COL","CGY",2010020565,14974,20102011,0,60,2,3,-1,3.10468074463523,3.80470340969623,-0.700022665061006,21,23,-2,26,36,-10,41,47,-6,2,4,0,0
"6415","COL","VAN",2010020579,14976,20102011,1,60,1,2,-1,2.8842027054925,4.16759810811982,-1.28339540262732,32,29,3,46,40,6,58,50,8,9,7,0,0
"6416","COL","BUF",2010020588,14978,20102011,1,64.2833333333333,4,3,1,3.38533802353437,5.54122824780643,-2.15589022427206,34,40,-6,46,47,-1,61,57,4,6,7,0,0
"6417","COL","ARI",2010020601,14980,20102011,1,60,0,2,-2,3.01039739505359,5.44325676838343,-2.43285937332985,34,33,1,46,46,0,65,59,6,1,1,0,0
"6418","COL","NYI",2010020613,14982,20102011,1,63.8666666666667,3,4,-1,4.0494285330642,4.53683992521837,-0.487411392154172,37,27,10,47,41,6,73,51,22,3,4,0,0
"6419","COL","DET",2010020630,14984,20102011,1,60,5,4,1,2.41139418181547,4.43162971147103,-2.02023552965557,26,30,-4,32,49,-17,47,66,-19,5,3,0,0
"6420","COL","CHI",2010020644,14986,20102011,0,60,0,4,-4,2.13158690069758,3.12417389650363,-0.99258699580605,24,31,-7,34,46,-12,48,58,-10,4,3,0,0
"6421","COL","MIN",2010020659,14988,20102011,0,60,4,1,3,3.17045178591298,5.22177494259086,-2.05132315667788,18,33,-15,21,49,-28,34,69,-35,2,4,0,0
"6422","COL","VAN",2010020690,14992,20102011,1,62.8666666666667,4,3,1,4.82192960250541,6.43324944069741,-1.611319838192,30,43,-13,41,54,-13,53,68,-15,6,3,0,0
"6423","COL","NSH",2010020704,14994,20102011,1,60,1,5,-4,0,0,0,33,28,5,43,36,7,51,50,1,2,5,0,0
"6424","COL","BOS",2010020714,14996,20102011,1,60,2,6,-4,5.23535164285568,5.00906769305584,0.226283949799836,34,40,-6,46,51,-5,53,69,-16,4,4,0,0
"6425","COL","STL",2010020731,14998,20102011,1,60,4,3,1,3.51391752898053,4.30075286718784,-0.786835338207311,32,24,8,42,43,-1,52,56,-4,4,3,0,0
"6426","COL","ARI",2010020747,15000,20102011,1,60,2,5,-3,5.4612832351923,4.24866032692807,1.21262290826422,31,37,-6,38,50,-12,44,60,-16,5,9,0,0
"6427","COL","STL",2010020759,15027,20102011,0,60,4,3,1,5.69781175401295,7.22631685243876,-1.52850509842582,27,45,-18,43,62,-19,58,81,-23,5,2,0,0
"6428","COL","MIN",2010020775,15008,20102011,1,60,3,4,-1,4.38939408861916,5.13542329745542,-0.746029208836262,41,25,16,48,34,14,56,43,13,2,3,0,0
"6429","COL","ANA",2010020784,15010,20102011,1,60,0,3,-3,3.38392354125972,5.15642644341278,-1.77250290215306,25,29,-4,41,45,-4,61,57,4,3,6,0,0
"6430","COL","ARI",2010020800,15012,20102011,0,60,0,3,-3,2.0799880635459,3.52988442598144,-1.44989636243554,26,26,0,43,35,8,54,48,6,6,5,0,0
"6431","COL","MIN",2010020811,15014,20102011,0,60,2,3,-1,3.89395704504568,3.85833533058477,0.0356217144609161,25,24,1,38,47,-9,51,55,-4,6,6,0,0
"6432","COL","CBJ",2010020824,15016,20102011,0,60,1,3,-2,2.62080943070089,4.24401536647565,-1.62320593577476,32,32,0,43,44,-1,52,60,-8,1,2,0,0
"6433","COL","NSH",2010020833,15017,20102011,0,60,3,5,-2,1.87518404417422,6.86343980692243,-4.98825576274821,18,39,-21,23,57,-34,35,74,-39,2,3,0,0
"6434","COL","CGY",2010020846,15019,20102011,1,60,1,9,-8,2.89949169888702,3.92617342370468,-1.02668172481766,23,33,-10,30,48,-18,42,55,-13,3,3,0,0
"6435","COL","PIT",2010020860,15021,20102011,1,64.1666666666667,2,3,-1,3.99458499708689,7.52718149860811,-3.53259650152122,31,36,-5,42,54,-12,56,72,-16,2,5,0,0
"6436","COL","S.J",2010020885,15024,20102011,0,60,0,4,-4,3.76978974304222,6.22853390866658,-2.45874416562435,25,33,-8,39,43,-4,60,56,4,4,4,0,0
"6437","COL","EDM",2010020907,15028,20102011,1,60,1,5,-4,3.53131495660637,6.04724227701346,-2.51592732040709,39,31,8,47,39,8,62,50,12,4,3,0,0
"6438","COL","L.A",2010020925,15031,20102011,0,60,3,4,-1,2.42739509022795,6.82253658776062,-4.39514149753268,17,42,-25,29,74,-45,37,89,-52,6,11,0,0
"6439","COL","ANA",2010020939,15032,20102011,0,60,2,3,-1,2.53891554194241,6.07372750552349,-3.53481196358109,24,32,-8,33,47,-14,47,51,-4,2,5,0,0
"6440","COL","S.J",2010020951,15034,20102011,0,65,1,1,0,2.79495374981524,7.34625600591971,-4.55130225610447,19,35,-16,34,58,-24,45,86,-41,2,4,0,0
"6441","COL","EDM",2010020981,15038,20102011,1,60,1,5,-4,4.1510776829964,6.49666031970236,-2.34558263670596,34,31,3,43,42,1,56,56,0,6,4,0,0
"6442","COL","MIN",2010020998,15041,20102011,0,60,2,5,-3,5.82334034477893,6.37393624464045,-0.55059589986152,30,25,5,42,37,5,56,49,7,5,6,0,0
"6443","COL","ANA",2010021022,15044,20102011,1,60,2,6,-4,3.34702952780574,5.19716061163695,-1.85013108383121,26,33,-7,31,41,-10,44,49,-5,6,6,0,0
"6444","COL","NSH",2010021030,15045,20102011,0,60,2,4,-2,2.90645237412245,4.77266698801031,-1.86621461388787,38,29,9,52,34,18,66,47,19,5,6,0,0
"6445","COL","VAN",2010021053,15049,20102011,0,60,2,4,-2,3.15339766493707,7.07232130835129,-3.91892364341422,29,40,-11,35,57,-22,45,80,-35,1,1,0,0
"6446","COL","CGY",2010021062,15050,20102011,0,60,2,5,-3,3.16907121145618,4.08196735950378,-0.912896148047594,29,28,1,38,38,0,52,56,-4,6,5,0,0
"6447","COL","EDM",2010021077,15052,20102011,0,65,2,2,0,0,0,0,27,33,-6,36,45,-9,46,67,-21,2,4,0,0
"6448","COL","CBJ",2010021096,15055,20102011,1,65,4,4,0,3.66420824164088,3.33598570949643,0.328222532144445,32,33,-1,41,45,-4,57,59,-2,4,2,0,0
"6449","COL","TOR",2010021108,15057,20102011,1,60,3,4,-1,3.04078800563093,3.23852599243401,-0.197737986803077,28,27,1,39,35,4,50,54,-4,2,3,0,0
"6450","COL","L.A",2010021117,15059,20102011,0,60,1,4,-3,3.19630334154317,6.32345005183015,-3.12714671028698,21,25,-4,31,41,-10,37,53,-16,2,3,0,0
"6451","COL","ANA",2010021133,15061,20102011,0,60,4,5,-1,4.87531677202617,6.15950318481555,-1.28418641278938,35,42,-7,50,52,-2,58,62,-4,4,7,0,0
"6452","COL","NSH",2010021157,15064,20102011,1,60,2,3,-1,4.02742918744182,4.79789446445648,-0.770465277014652,29,34,-5,43,43,0,59,55,4,1,4,0,0
"6453","COL","ARI",2010021163,15065,20102011,0,65,3,3,0,2.94115415340639,6.73466739642001,-3.79351324301363,20,38,-18,32,62,-30,40,76,-36,4,6,0,0
"6454","COL","CGY",2010021180,15067,20102011,1,60,1,2,-1,3.53059744497295,3.56385279691312,-0.0332553519401699,35,36,-1,47,46,1,61,56,5,3,1,0,0
"6455","COL","STL",2010021189,15069,20102011,0,60,1,3,-2,2.40843035909347,5.02748370063637,-2.61905334154289,27,29,-2,39,44,-5,54,53,1,5,6,0,0
"6456","COL","DAL",2010021203,15071,20102011,0,60,2,4,-2,2.4600024335976,3.88704001501901,-1.42703758142142,23,37,-14,31,50,-19,46,60,-14,1,5,0,0
"6457","COL","DAL",2010021211,15072,20102011,1,60,2,3,-1,2.84061364317313,4.58525120018749,-1.74463755701436,17,28,-11,27,41,-14,45,54,-9,1,3,0,0
"6458","COL","EDM",2010021228,15074,20102011,1,63.95,4,3,1,2.87373812143778,4.98248704878299,-2.1087489273452,25,28,-3,41,38,3,55,43,12,5,2,0,0
"6459","COL","DET",2011020018,15255,20112012,1,60,0,3,-3,5.20650450086396,7.72889872803353,-2.52239422716957,29,39,-10,40,50,-10,59,56,3,3,4,0,0
"6460","COL","BOS",2011020025,15257,20112012,0,60,1,0,1,3.88716573273996,6.03325493268494,-2.14608919994498,36,30,6,51,42,9,62,60,2,4,3,0,0
"6461","COL","CBJ",2011020034,15259,20112012,0,65,2,2,0,5.99465383567735,5.71882367381477,0.275830161862586,32,33,-1,49,42,7,68,53,15,5,5,0,0
"6462","COL","OTT",2011020041,15260,20112012,0,60,7,1,6,5.19686229330841,2.02883237437345,3.16802991893496,39,16,23,45,28,17,53,42,11,6,4,0,0
"6463","COL","MTL",2011020050,15262,20112012,0,65,5,5,0,4.24882233986285,7.18287661060924,-2.93405427074639,30,43,-13,40,58,-18,60,82,-22,5,4,0,0
"6464","COL","TOR",2011020064,15264,20112012,0,61.1833333333333,3,2,1,2.85620196856871,5.02498012443539,-2.16877815586668,24,29,-5,36,46,-10,56,69,-13,2,4,0,0
"6465","COL","CHI",2011020086,15267,20112012,1,60,1,3,-2,2.52368331247999,5.4444898558059,-2.92080654332591,32,30,2,40,41,-1,60,57,3,2,2,0,0
"6466","COL","CHI",2011020106,15269,20112012,0,65,4,4,0,4.51174531970173,7.55905654875096,-3.04731122904923,24,38,-14,32,49,-17,43,57,-14,0,3,0,0
"6467","COL","CGY",2011020123,15273,20112012,0,60,2,4,-2,0,0,0,36,35,1,51,44,7,66,51,15,2,3,0,0
"6468","COL","EDM",2011020138,15275,20112012,1,60,1,3,-2,5.4430368422346,2.60928743536351,2.83374940687109,41,19,22,60,28,32,83,39,44,5,5,0,0
"6469","COL","L.A",2011020155,15277,20112012,1,60,3,2,1,3.5889024187054,5.46679172538279,-1.87788930667739,16,32,-16,29,40,-11,39,51,-12,4,4,0,0
"6470","COL","ARI",2011020167,15280,20112012,1,60,1,4,-3,4.89511728519574,4.5837483034702,0.311368981725536,40,28,12,55,33,22,75,47,28,4,1,0,0
"6471","COL","DAL",2011020183,15282,20112012,0,63.9166666666667,6,7,-1,6.62979976368524,5.7583245858109,0.871475177874345,40,29,11,53,48,5,69,61,8,6,7,0,0
"6472","COL","CGY",2011020199,15284,20112012,1,60,1,2,-1,9.73325347715581,5.6969880592078,4.03626541794802,33,23,10,52,29,23,79,44,35,2,1,0,0
"6473","COL","DET",2011020207,15286,20112012,0,60,2,5,-3,5.02922214673708,4.69137488456909,0.337847262167998,26,30,-4,35,43,-8,48,49,-1,3,6,0,0
"6474","COL","NYI",2011020218,15288,20112012,1,62.65,4,3,1,7.06816747700123,4.01568269242125,3.05248478457997,51,33,18,61,39,22,85,56,29,7,5,0,0
"6475","COL","CGY",2011020237,15290,20112012,1,60,3,4,-1,3.5179150231137,3.49458799768854,0.0233270254251607,39,20,19,45,23,22,59,32,27,5,3,0,0
"6476","COL","PIT",2011020250,15293,20112012,0,60,3,6,-3,3.0321954859601,3.83152040070854,-0.799324914748439,27,33,-6,30,43,-13,43,61,-18,2,7,0,0
"6477","COL","MIN",2011020266,15295,20112012,0,60,0,1,-1,3.65474023105344,2.41665454247072,1.23808568858272,27,18,9,42,26,16,62,38,24,3,2,0,0
"6478","COL","DAL",2011020272,15296,20112012,1,60,3,0,3,5.49600949776323,6.07768332719123,-0.581673829428009,45,24,21,55,32,23,66,48,18,5,1,0,0
"6479","COL","S.J",2011020287,15298,20112012,1,60,1,4,-3,3.96463194612152,2.11717403744115,1.84745790868038,37,18,19,44,32,12,54,47,7,1,6,0,0
"6480","COL","VAN",2011020310,15301,20112012,1,60,0,3,-3,2.57799020117091,6.57954903914924,-4.00155883797834,24,29,-5,30,44,-14,43,47,-4,4,3,0,0
"6481","COL","EDM",2011020328,15304,20112012,1,60,5,2,3,3.74570258909671,5.35387775196432,-1.60817516286761,29,33,-4,34,48,-14,46,59,-13,3,3,0,0
"6482","COL","DAL",2011020342,15306,20112012,1,60,1,3,-2,3.7273121799477,7.09538368811059,-3.36807150816289,36,35,1,48,42,6,59,51,8,3,4,0,0
"6483","COL","N.J",2011020355,15308,20112012,1,60,6,1,5,2.10702975341701,2.89467984757453,-0.787650094157519,25,19,6,34,32,2,44,47,-3,3,4,0,0
"6484","COL","STL",2011020369,15310,20112012,1,65,2,2,0,5.10482701880949,4.95827359077521,0.146553428034281,35,37,-2,49,47,2,68,55,13,5,4,0,0
"6485","COL","DET",2011020384,15312,20112012,1,60,4,2,2,5.65733100608833,4.67738854294294,0.979942463145392,35,29,6,49,43,6,57,60,-3,3,5,0,0
"6486","COL","VAN",2011020399,15314,20112012,0,60,0,6,-6,3.32102628722691,2.99220538816689,0.32882089906002,33,23,10,43,31,12,63,38,25,7,6,0,0
"6487","COL","CGY",2011020414,15316,20112012,0,60,2,3,-1,5.06396986947584,4.86303039187624,0.200939477599604,18,35,-17,28,41,-13,33,55,-22,2,6,0,0
"6488","COL","EDM",2011020420,15317,20112012,0,60,1,4,-3,4.63508376665413,7.03924114215415,-2.40415737550001,29,35,-6,40,56,-16,54,65,-11,3,5,0,0
"6489","COL","S.J",2011020447,15321,20112012,1,65,3,3,0,5.49114777939394,7.27402330306359,-1.78287552366965,33,30,3,45,37,8,60,54,6,2,3,0,0
"6490","COL","S.J",2011020460,15323,20112012,0,60,4,5,-1,2.4011506918325,5.31674427015241,-2.91559357831992,27,34,-7,40,49,-9,52,73,-21,3,3,0,0
"6491","COL","WSH",2011020476,15325,20112012,1,60,2,1,1,4.0726824238759,6.75964815128827,-2.68696572741237,28,26,2,38,39,-1,51,47,4,2,4,0,0
"6492","COL","PHI",2011020484,15327,20112012,1,65,2,2,0,4.0591214340493,5.3477948144573,-1.288673380408,27,33,-6,32,53,-21,51,66,-15,3,4,0,0
"6493","COL","STL",2011020497,15329,20112012,1,60,3,2,1,2.09388018473578,5.803385582957,-3.70950539822122,22,39,-17,30,53,-23,41,68,-27,4,5,0,0
"6494","COL","T.B",2011020515,15331,20112012,1,63.6333333333333,2,1,1,4.06864843916219,3.82622956969135,0.242418869470839,29,30,-1,43,38,5,57,51,6,3,3,0,0
"6495","COL","MIN",2011020519,15334,20112012,0,60,4,2,2,3.16093188947635,3.43589079293565,-0.274958903459298,32,22,10,42,31,11,53,40,13,7,4,0,0
"6496","COL","WPG",2011020535,15335,20112012,1,60,1,4,-3,4.5255577256612,4.37873675994342,0.146820965717779,33,26,7,42,32,10,60,40,20,1,1,0,0
"6497","COL","ARI",2011020549,15337,20112012,1,60,3,2,1,5.45514471644854,1.52269102400169,3.93245369244686,35,27,8,51,32,19,63,42,21,5,6,0,0
"6498","COL","ANA",2011020566,15339,20112012,0,60,4,2,2,2.65506734568044,1.89622708647863,0.758840259201804,26,20,6,38,30,8,47,45,2,2,2,0,0
"6499","COL","L.A",2011020573,15341,20112012,0,65,1,1,0,5.64893910425599,3.39264301361982,2.25629609063617,21,32,-11,39,57,-18,55,60,-5,3,5,0,0
"6500","COL","CHI",2011020596,15345,20112012,0,60,4,0,4,3.22860289906384,2.93689532975035,0.291707569313495,22,27,-5,31,46,-15,42,57,-15,2,2,0,0
"6501","COL","STL",2011020606,15346,20112012,0,60,0,4,-4,2.66557018209687,4.19459608071061,-1.52902589861374,15,39,-24,25,65,-40,36,75,-39,6,7,0,0
"6502","COL","NSH",2011020626,15349,20112012,1,60,1,4,-3,0,0,0,33,26,7,42,38,4,60,50,10,3,3,0,0
"6503","COL","NSH",2011020637,15351,20112012,0,60.5666666666667,2,3,-1,2.83571413757545,6.32334500433353,-3.48763086675808,29,35,-6,33,50,-17,46,68,-22,2,6,0,0
"6504","COL","DAL",2011020648,15353,20112012,0,60,2,1,1,3.35949069270282,4.98318511340767,-1.62369442070485,23,22,1,28,40,-12,46,53,-7,4,4,0,0
"6505","COL","ARI",2011020665,15355,20112012,0,60,1,6,-5,3.25754323431124,5.56450743487221,-2.30696420056097,39,33,6,48,46,2,56,57,-1,0,3,0,0
"6506","COL","FLA",2011020683,15357,20112012,1,63.9166666666667,4,3,1,7.72053522495844,5.31679058331065,2.40374464164779,44,29,15,54,39,15,75,57,18,3,2,0,0
"6507","COL","L.A",2011020712,15360,20112012,0,60,3,1,2,2.37708055996336,4.27388179364221,-1.89680123367885,31,26,5,44,36,8,51,49,2,3,3,0,0
"6508","COL","ANA",2011020715,15361,20112012,0,60,2,3,-1,4.65787360306767,3.28689822849628,1.37097537457139,45,18,27,61,35,26,88,49,39,4,3,0,0
"6509","COL","MIN",2011020731,15363,20112012,1,60,2,3,-1,4.65073310304433,5.18965951725841,-0.538926414214075,26,34,-8,34,47,-13,54,69,-15,3,5,0,0
"6510","COL","EDM",2011020746,15370,20112012,0,60,2,3,-1,6.33909030884388,2.97452955049084,3.36456075835304,33,23,10,47,34,13,65,39,26,2,1,0,0
"6511","COL","MIN",2011020758,15372,20112012,1,60,0,1,-1,3.19833210812067,3.6040701615857,-0.405738053465029,37,21,16,49,28,21,75,40,35,3,3,0,0
"6512","COL","VAN",2011020770,15374,20112012,1,65,2,2,0,5.46129784302299,4.32818503570525,1.13311280731774,46,29,17,55,43,12,67,60,7,5,6,0,0
"6513","COL","CHI",2011020796,15377,20112012,1,60,5,2,3,4.02388084189579,4.6937522256776,-0.66987138378181,29,31,-2,41,38,3,49,59,-10,0,3,0,0
"6514","COL","CAR",2011020814,15380,20112012,1,64.9666666666667,4,3,1,5.18211761647763,5.52287261589663,-0.340754999419005,33,42,-9,43,60,-17,55,80,-25,0,3,0,0
"6515","COL","STL",2011020823,15381,20112012,0,63.3,2,3,-1,1.30035436539296,6.46027620680979,-5.15992184141684,19,44,-25,25,61,-36,35,79,-44,2,5,0,0
"6516","COL","VAN",2011020850,15385,20112012,0,60,1,3,-2,7.08055279243854,6.13849418775499,0.942058604683552,30,31,-1,44,39,5,59,51,8,2,1,0,0
"6517","COL","EDM",2011020864,15387,20112012,0,60,3,1,2,3.35299678454047,2.33066304255044,1.02233374199002,23,27,-4,31,37,-6,43,52,-9,4,4,0,0
"6518","COL","WPG",2011020882,15389,20112012,0,60,1,5,-4,4.46976470377558,4.38599507457911,0.0837696291964676,32,25,7,45,47,-2,58,58,0,5,5,0,0
"6519","COL","L.A",2011020898,15392,20112012,1,60,4,1,3,3.2735839415716,4.5777162509039,-1.3041323093323,27,33,-6,33,46,-13,48,60,-12,2,4,0,0
"6520","COL","CBJ",2011020911,15394,20112012,0,60,5,0,5,3.00821221986553,3.02722880401416,-0.0190165841486305,25,28,-3,26,37,-11,36,55,-19,1,4,0,0
"6521","COL","DET",2011020922,15395,20112012,0,60,4,3,1,4.51730988911004,1.81693601195002,2.70037387716002,27,31,-4,31,41,-10,41,52,-11,2,3,0,0
"6522","COL","ANA",2011020935,15397,20112012,1,60,4,1,3,2.91572510477272,2.92879880015971,-0.0130736953869928,23,28,-5,35,39,-4,53,55,-2,1,3,0,0
"6523","COL","CBJ",2011020955,15400,20112012,1,60,0,2,-2,6.04596619660151,3.08228139173245,2.96368480486906,33,28,5,41,37,4,58,50,8,3,3,0,0
"6524","COL","MIN",2011020980,15403,20112012,0,60,2,0,2,7.24362615569765,4.4096445202722,2.83398163542546,36,30,6,51,40,11,69,56,13,2,3,0,0
"6525","COL","MIN",2011020992,15405,20112012,1,60,7,1,6,5.83864956086109,2.58801099820192,3.25063856265917,39,22,17,53,28,25,70,43,27,5,4,0,0
"6526","COL","NSH",2011021005,15407,20112012,0,60,2,4,-2,2.18245417789149,3.79827577807009,-1.61582160017861,17,31,-14,28,38,-10,40,54,-14,1,3,0,0
"6527","COL","EDM",2011021015,15409,20112012,1,65,2,2,0,5.91329589445377,5.08373899746221,0.829556896991562,32,30,2,46,43,3,58,60,-2,2,2,0,0
"6528","COL","ANA",2011021034,15411,20112012,1,61.8666666666667,3,2,1,4.18927751434967,7.18924087042251,-2.99996335607284,33,40,-7,43,57,-14,67,66,1,1,1,0,0
"6529","COL","BUF",2011021046,15413,20112012,0,65,4,4,0,5.42603042593805,4.04972689619171,1.37630352974634,42,24,18,51,40,11,67,60,7,5,3,0,0
"6530","COL","N.J",2011021052,15414,20112012,0,65,0,0,0,3.34955432679044,5.62917542428477,-2.27962109749433,28,33,-5,31,46,-15,40,59,-19,1,1,0,0
"6531","COL","NYR",2011021070,15416,20112012,0,60,3,1,2,3.9385074125807,4.91336067665634,-0.974853264075636,20,42,-22,26,58,-32,37,69,-32,2,5,0,0
"6532","COL","CGY",2011021095,15419,20112012,1,63.85,2,1,1,3.2074479946736,1.86104970870656,1.34639828596704,33,32,1,40,41,-1,56,57,-1,0,3,0,0
"6533","COL","ARI",2011021107,15421,20112012,0,60,2,3,-1,4.8381420654332,2.89310465107701,1.94503741435619,41,25,16,55,36,19,65,43,22,3,6,0,0
"6534","COL","VAN",2011021125,15423,20112012,1,61.6666666666667,2,3,-1,7.45247386221308,5.70895828308676,1.74351557912632,40,32,8,51,46,5,75,64,11,7,5,0,0
"6535","COL","S.J",2011021139,15425,20112012,0,60,1,5,-4,8.619269232433,3.50473864933156,5.11453058310144,32,36,-4,44,54,-10,71,69,2,2,4,0,0
"6536","COL","VAN",2011021152,15427,20112012,0,60,0,1,-1,5.35378371659317,3.38191920513054,1.97186451146263,43,22,21,53,28,25,71,49,22,5,3,0,0
"6537","COL","CGY",2011021166,15429,20112012,0,60,4,1,3,6.8752751062849,6.24650933886005,0.628765767424852,25,39,-14,44,55,-11,55,85,-30,0,4,0,0
"6538","COL","CBJ",2011021211,15435,20112012,1,60,2,5,-3,4.20881604247552,4.07664769521216,0.132168347263359,37,28,9,52,37,15,68,48,20,4,5,0,0
"6539","COL","NSH",2011021228,15437,20112012,1,60,1,6,-5,5.98278185920961,4.16001216755831,1.8227696916513,45,29,16,59,40,19,71,48,23,2,2,0,0
"6540","COL","MIN",2012020012,15724,20122013,0,60,2,4,-2,4.68959350037039,6.27751225891552,-1.58791875854513,27,35,-8,35,44,-9,53,54,-1,3,6,0,0
"6541","COL","L.A",2012020034,15727,20122013,1,60,3,1,2,5.50323076150369,3.35679949383757,2.14643126766612,31,29,2,42,44,-2,50,68,-18,5,7,0,0
"6542","COL","CBJ",2012020047,15729,20122013,1,60,4,0,4,2.8291047857856,3.4795750673652,-0.650470281579601,28,33,-5,37,49,-12,44,75,-31,7,9,0,0
"6543","COL","S.J",2012020057,15731,20122013,0,60,0,4,-4,3.16346013118164,8.18338318075985,-5.01992304957821,24,43,-19,37,53,-16,60,77,-17,3,8,0,0
"6544","COL","EDM",2012020076,15733,20122013,0,60,1,4,-3,6.86733849191296,2.12428979788092,4.74304869403204,38,27,11,51,40,11,64,54,10,3,6,0,0
"6545","COL","VAN",2012020091,15735,20122013,0,60,0,3,-3,3.21079717179236,5.48733564707254,-2.27653847528018,24,23,1,34,38,-4,41,61,-20,4,5,0,0
"6546","COL","CGY",2012020098,15736,20122013,0,60,6,3,3,3.18159272555931,3.08203699917067,0.099555726388644,22,28,-6,32,45,-13,39,63,-24,2,3,0,0
"6547","COL","EDM",2012020110,15738,20122013,1,60,3,1,2,7.17680674581788,2.25537598800656,4.92143075781132,40,26,14,47,38,9,64,53,11,6,3,0,0
"6548","COL","DAL",2012020124,15740,20122013,1,60,2,3,-1,2.78412048737774,3.55026990016046,-0.76614941278272,31,26,5,37,42,-5,46,62,-16,5,5,0,0
"6549","COL","ANA",2012020139,15742,20122013,1,60,0,3,-3,5.38829925212485,3.4172246279777,1.97107462414715,31,20,11,44,32,12,66,48,18,2,5,0,0
"6550","COL","ARI",2012020176,15747,20122013,1,64.0166666666667,2,3,-1,6.95358822316757,7.5557069497554,-0.602118726587832,43,30,13,56,43,13,67,60,7,5,6,0,0
"6551","COL","MIN",2012020196,15750,20122013,0,65,3,3,0,5.05062423826166,4.95788537114277,0.0927388671188965,32,29,3,42,34,8,51,51,0,2,1,0,0
"6552","COL","EDM",2012020211,15752,20122013,0,60,4,6,-2,3.14636206350406,5.89139024415332,-2.74502818064927,29,56,-27,44,67,-23,53,85,-32,4,4,0,0
"6553","COL","NSH",2012020221,15754,20122013,1,60,6,5,1,2.55570779420668,7.64018891676096,-5.08448112255428,28,38,-10,32,56,-24,41,83,-42,2,5,0,0
"6554","COL","STL",2012020235,15756,20122013,1,64.7166666666667,1,0,1,3.40306671991129,6.3956085309037,-2.99254181099241,20,33,-13,30,49,-19,47,71,-24,1,2,0,0
"6555","COL","L.A",2012020253,15759,20122013,0,60,1,4,-3,3.56847882363945,2.54350027680812,1.02497854683133,24,26,-2,34,41,-7,38,52,-14,5,3,0,0
"6556","COL","ANA",2012020269,15760,20122013,0,64.2333333333333,3,4,-1,4.58825626224244,7.6685065216152,-3.08025025937276,23,39,-16,38,56,-18,57,69,-12,4,5,0,0
"6557","COL","S.J",2012020283,15762,20122013,0,65,2,2,0,4.19394535563697,5.98927690553319,-1.79533154989622,27,41,-14,35,58,-23,47,80,-33,2,5,0,0
"6558","COL","CGY",2012020296,15764,20122013,1,60,5,4,1,5.33255415471724,2.62011823481134,2.7124359199059,36,23,13,47,36,11,63,56,7,5,5,0,0
"6559","COL","CBJ",2012020313,15767,20122013,0,62.4333333333333,1,2,-1,3.17655539222443,4.25401987446821,-1.07746448224378,19,34,-15,27,42,-15,39,62,-23,3,6,0,0
"6560","COL","DET",2012020331,15769,20122013,0,60,1,2,-1,5.2472045783361,4.10461161494459,1.14259296339151,37,33,4,43,37,6,54,47,7,1,2,0,0
"6561","COL","CHI",2012020336,15770,20122013,0,60,2,3,-1,2.96171496898046,3.18637885036514,-0.224663881384686,22,32,-10,33,42,-9,56,63,-7,2,3,0,0
"6562","COL","CHI",2012020353,15772,20122013,1,60,6,2,4,3.95746197030911,5.68134835096134,-1.72388638065223,31,33,-2,41,42,-1,54,62,-8,5,3,0,0
"6563","COL","S.J",2012020373,15774,20122013,1,64.9833333333333,3,2,1,5.08247900494747,8.21278586348931,-3.13030685854184,42,38,4,54,54,0,68,66,2,4,5,0,0
"6564","COL","EDM",2012020386,15776,20122013,1,60,0,4,-4,3.82843553495997,6.58039204472152,-2.75195650976156,35,32,3,47,42,5,58,45,13,2,4,0,0
"6565","COL","MIN",2012020398,15778,20122013,0,60,3,5,-2,4.74256969455746,8.13870904771893,-3.39613935316147,32,40,-8,49,55,-6,63,75,-12,3,5,0,0
"6566","COL","MIN",2012020408,15780,20122013,1,60,4,6,-2,4.87891096339699,3.31616667131311,1.56274429208388,32,28,4,39,40,-1,49,54,-5,3,3,0,0
"6567","COL","CHI",2012020425,15782,20122013,1,60,2,5,-3,1.77237656686748,4.8399426488767,-3.06756608200922,19,32,-13,27,41,-14,41,57,-16,1,1,0,0
"6568","COL","DAL",2012020440,15784,20122013,1,60,4,3,1,4.42825626661209,3.29654169638525,1.13171457022684,34,32,2,42,45,-3,50,63,-13,3,7,0,0
"6569","COL","DAL",2012020463,15787,20122013,0,60,2,5,-3,5.99063536242307,2.84261087918276,3.14802448324031,35,31,4,51,39,12,75,52,23,3,4,0,0
"6570","COL","VAN",2012020469,15788,20122013,1,60,2,3,-1,5.37530474552758,1.91087971461002,3.46442503091756,28,30,-2,35,39,-4,45,57,-12,5,3,0,0
"6571","COL","CGY",2012020490,15791,20122013,0,60,3,4,-1,5.0165791651234,3.66409110341821,1.35248806170519,30,27,3,40,35,5,59,47,12,5,3,0,0
"6572","COL","VAN",2012020500,15792,20122013,0,60,1,4,-3,1.80007035830931,5.29834622220369,-3.49827586389438,33,20,13,40,31,9,55,45,10,2,0,0,0
"6573","COL","NSH",2012020509,15794,20122013,1,60.8333333333333,1,0,1,5.68718870470184,6.44599114364246,-0.75880243894062,24,34,-10,39,50,-11,56,68,-12,1,5,0,0
"6574","COL","DET",2012020525,15796,20122013,0,60,2,3,-1,3.19086373254208,4.20034704357386,-1.00948331103177,24,20,4,30,33,-3,37,37,0,3,2,0,0
"6575","COL","NSH",2012020536,15797,20122013,0,60,1,3,-2,5.03642671022681,7.62296313807019,-2.58653642784338,26,38,-12,36,50,-14,52,64,-12,3,4,0,0
"6576","COL","DET",2012020556,15800,20122013,1,64.7333333333333,2,3,-1,2.99600762916227,5.50811789420459,-2.51211026504232,35,31,4,45,43,2,67,63,4,3,4,0,0
"6577","COL","ARI",2012020567,15801,20122013,0,60,0,4,-4,4.16928498481637,4.48077592770278,-0.311490942886408,24,28,-4,40,48,-8,52,58,-6,4,4,0,0
"6578","COL","CGY",2012020579,15803,20122013,1,60,1,3,-2,5.58770721386173,5.7391979561653,-0.15149074230357,40,34,6,49,43,6,63,56,7,5,7,0,0
"6579","COL","ANA",2012020595,15805,20122013,0,60,4,1,3,3.49056910528452,3.03400639657048,0.456562708714046,28,22,6,39,27,12,55,42,13,2,3,0,0
"6580","COL","L.A",2012020604,15806,20122013,0,65,2,2,0,2.30877171223983,5.85530797709134,-3.54653626485151,28,37,-9,39,54,-15,46,71,-25,2,4,0,0
"6581","COL","VAN",2012020611,15808,20122013,1,60,4,3,1,3.53530452831183,3.88444128085393,-0.349136752542108,26,27,-1,37,37,0,50,52,-2,3,2,0,0
"6582","COL","CBJ",2012020629,15810,20122013,1,64.5166666666667,3,4,-1,2.89206504391041,4.5358883705938,-1.64382332668339,32,30,2,53,43,10,73,64,9,2,1,0,0
"6583","COL","EDM",2012020658,15814,20122013,1,60,1,4,-3,3.48055949667469,2.9236169627929,0.556942533881783,34,24,10,44,36,8,68,49,19,4,4,0,0
"6584","COL","STL",2012020672,15816,20122013,1,60,5,3,2,7.89544183707892,5.66580528982797,2.22963654725095,31,32,-1,44,50,-6,60,67,-7,3,4,0,0
"6585","COL","STL",2012020686,15818,20122013,0,60,1,3,-2,1.85772290573732,4.9559757199022,-3.09825281416488,18,34,-16,27,51,-24,38,72,-34,4,6,0,0
"6586","COL","ARI",2012020707,15821,20122013,0,65,4,4,0,3.25289990642017,3.19502969644964,0.0578702099705311,28,37,-9,37,46,-9,51,57,-6,5,7,0,0
"6587","COL","MIN",2012020715,15822,20122013,1,60,1,3,-2,3.18662090957514,3.03464757153415,0.151973338040989,30,33,-3,42,40,2,58,46,12,1,3,0,0
"6588","COL","ANA",2013020006,15980,20132014,1,60,6,1,5,5.09957707044668,4.25097800948237,0.848599060964318,29,36,-7,41,46,-5,50,59,-9,7,6,0,0
"6589","COL","NSH",2013020020,15982,20132014,1,60,3,1,2,4.67782778330138,4.37805755734361,0.299770225957767,36,27,9,45,37,8,59,48,11,8,6,0,0
"6590","COL","TOR",2013020037,15986,20132014,0,60,2,1,1,2.98888273842749,3.42578784839134,-0.436905109963845,33,28,5,42,46,-4,55,64,-9,3,2,0,0
"6591","COL","BOS",2013020048,15988,20132014,0,60,2,0,2,4.22750537185766,2.79520139741181,1.43230397444585,30,39,-9,39,58,-19,56,72,-16,8,7,0,0
"6592","COL","WSH",2013020067,15990,20132014,0,60,5,1,4,4.89748719375653,2.31217513373485,2.58531206002168,28,41,-13,35,48,-13,44,67,-23,3,2,0,0
"6593","COL","DAL",2013020092,15993,20132014,1,60,3,2,1,1.98762901894224,4.52618407225236,-2.53855505331012,26,41,-15,31,50,-19,44,68,-24,3,5,0,0
"6594","COL","DET",2013020107,15995,20132014,1,60,2,4,-2,4.86674522593967,4.97771810353152,-0.110972877591848,40,28,12,50,36,14,68,52,16,6,3,0,0
"6595","COL","BUF",2013020112,15997,20132014,0,60,4,2,2,3.9925081920519,6.14761841134168,-2.15511021928978,26,30,-4,33,38,-5,40,50,-10,3,3,0,0
"6596","COL","CAR",2013020154,16003,20132014,1,60,4,2,2,3.88944405838265,4.40449157473631,-0.515047516353661,34,30,4,46,42,4,59,59,0,3,3,0,0
"6597","COL","WPG",2013020169,16005,20132014,1,60,3,2,1,5.36750432697204,6.15129852731479,-0.783794200342754,36,25,11,49,45,4,66,64,2,2,6,0,0
"6598","COL","DAL",2013020197,16010,20132014,0,63.6,3,2,1,4.92924540824606,4.2225623811828,0.706683027063264,29,29,0,40,44,-4,54,64,-10,4,2,0,0
"6599","COL","MTL",2013020209,16011,20132014,1,60,4,1,3,5.12792312103556,3.95766153582372,1.17026158521185,31,30,1,46,38,8,54,53,1,2,3,0,0
"6600","COL","NSH",2013020228,16015,20132014,1,60,4,6,-2,4.98904797923387,2.92522322630975,2.06382475292412,31,28,3,45,39,6,59,55,4,3,3,0,0
"6601","COL","CGY",2013020243,16017,20132014,1,60,4,2,2,5.58993009143533,5.61172131762305,-0.0217912261877204,27,32,-5,36,53,-17,54,69,-15,3,2,0,0
"6602","COL","WSH",2013020260,16019,20132014,1,60,4,1,3,5.0256612919884,4.21941628707755,0.806245004910853,37,34,3,47,44,3,64,61,3,3,4,0,0
"6603","COL","CAR",2013020267,16021,20132014,0,60,1,2,-1,6.55246030641138,5.21779382950626,1.33466647690511,34,28,6,56,48,8,72,60,12,2,1,0,0
"6604","COL","STL",2013020281,16023,20132014,0,60,3,7,-4,4.91119539985084,4.67283238192297,0.238363017927867,24,29,-5,37,40,-3,46,52,-6,5,5,0,0
"6605","COL","FLA",2013020301,16025,20132014,1,60,1,4,-3,4.66081002121791,4.05660755292047,0.604202468297444,33,33,0,44,45,-1,54,58,-4,1,4,0,0
"6606","COL","CHI",2013020318,16028,20132014,1,60,5,1,4,3.07018346183162,6.71584971796256,-3.64566625613093,23,37,-14,32,52,-20,41,67,-26,1,1,0,0
"6607","COL","ARI",2013020332,16030,20132014,0,64.3,4,3,1,3.81032766151998,12.4078228652361,-8.59749520371611,30,44,-14,36,64,-28,51,78,-27,5,3,0,0
"6608","COL","L.A",2013020351,16032,20132014,0,62.5333333333333,1,0,1,5.23997051321203,3.74034012900665,1.49963038420537,33,19,14,44,29,15,50,44,6,3,3,0,0
"6609","COL","STL",2013020375,16036,20132014,1,60,1,4,-3,2.35878926126315,4.36498674571599,-2.00619748445284,26,35,-9,34,44,-10,56,55,1,5,2,0,0
"6610","COL","MIN",2013020387,16038,20132014,0,60,3,1,2,4.67922093495174,3.48733070830349,1.19189022664825,21,28,-7,26,40,-14,38,59,-21,3,2,0,0
"6611","COL","MIN",2013020400,16039,20132014,1,65,2,2,0,3.61343787114311,5.5332286079647,-1.9197907368216,25,37,-12,35,42,-7,52,58,-6,0,0,0,0
"6612","COL","EDM",2013020431,16044,20132014,0,60,2,8,-6,6.10329187722263,5.3407707264123,0.762521150810329,35,28,7,51,42,9,65,51,14,8,9,0,0
"6613","COL","CGY",2013020436,16045,20132014,0,60,3,2,1,4.09079576935619,5.16521700814337,-1.07442123878718,25,28,-3,43,39,4,62,54,8,5,5,0,0
"6614","COL","VAN",2013020453,16047,20132014,0,60,1,3,-2,4.99644361587707,3.44425593534834,1.55218768052873,29,21,8,44,30,14,61,45,16,1,3,0,0
"6615","COL","ARI",2013020466,16049,20132014,1,60,1,3,-2,2.68965428786954,3.68522445409326,-0.995570166223715,30,25,5,41,37,4,48,51,-3,2,2,0,0
"6616","COL","WPG",2013020479,16051,20132014,0,65,3,3,0,5.08900945202913,5.66744986620324,-0.578440414174111,26,38,-12,36,56,-20,61,73,-12,2,6,0,0
"6617","COL","MIN",2013020497,16053,20132014,1,65,1,1,0,4.60009013733361,6.88435026479419,-2.28426012746058,27,27,0,35,42,-7,50,57,-7,2,1,0,0
"6618","COL","DAL",2013020508,16055,20132014,1,60,6,2,4,7.60232082666645,5.21041370006424,2.39190712660221,48,33,15,59,46,13,74,60,14,5,5,0,0
"6619","COL","DAL",2013020519,16056,20132014,0,60,2,3,-1,3.73145022242898,2.7701276082953,0.961322614133678,27,28,-1,36,43,-7,52,61,-9,7,6,0,0
"6620","COL","EDM",2013020532,16058,20132014,1,60,4,2,2,3.54207155447511,7.34324418823235,-3.80117263375723,39,29,10,48,39,9,68,47,21,1,1,0,0
"6621","COL","L.A",2013020540,16060,20132014,0,65,2,2,0,8.32225579387159,7.08089200541144,1.24136378846015,25,39,-14,43,59,-16,57,72,-15,4,2,0,0
"6622","COL","S.J",2013020566,16062,20132014,0,65,4,4,0,5.84453863518138,7.99626060132869,-2.15172196614731,33,45,-12,43,64,-21,65,90,-25,3,4,0,0
"6623","COL","CHI",2013020572,16066,20132014,0,60,2,7,-5,3.04840484005399,7.09039776723512,-4.04199292718113,18,37,-19,22,49,-27,30,59,-29,2,3,0,0
"6624","COL","WPG",2013020593,16068,20132014,1,64.9666666666667,1,2,-1,3.77786818129243,5.59228353932849,-1.81441535803606,34,37,-3,44,53,-9,64,72,-8,1,2,0,0
"6625","COL","CBJ",2013020606,16070,20132014,1,60,5,3,2,2.99208217786509,6.30563718658264,-3.31355500871756,23,38,-15,28,46,-18,40,57,-17,3,3,0,0
"6626","COL","PHI",2013020619,16072,20132014,1,60,2,1,1,4.95489033940248,3.43388894462805,1.52100139477443,31,30,1,40,44,-4,54,56,-2,2,3,0,0
"6627","COL","S.J",2013020627,16074,20132014,1,60,4,3,1,3.66808190797019,3.70172325694466,-0.03364134897447,21,33,-12,28,45,-17,36,67,-31,5,4,0,0
"6628","COL","CGY",2013020646,16076,20132014,1,60,3,4,-1,1.94253060697946,5.53516048003803,-3.59262987305857,25,19,6,33,36,-3,45,48,-3,4,3,0,0
"6629","COL","OTT",2013020659,16078,20132014,1,60.55,4,3,1,4.92497334981454,4.56193337051903,0.363039979295507,31,32,-1,45,47,-2,57,64,-7,1,3,0,0
"6630","COL","NYI",2013020672,16080,20132014,1,61.7666666666667,1,2,-1,0,0,0,31,24,7,38,30,8,53,39,14,2,2,0,0
"6631","COL","MIN",2013020680,16081,20132014,0,60,4,2,2,2.87457637867521,3.37245960046818,-0.497883221792961,18,27,-9,30,38,-8,37,53,-16,3,2,0,0
"6632","COL","CHI",2013020702,16084,20132014,0,64.15,3,2,1,3.75066723977341,5.72706325314675,-1.97639601337335,26,48,-22,29,65,-36,37,88,-51,4,5,0,0
"6633","COL","N.J",2013020718,16086,20132014,1,65,1,1,0,4.47973283371539,3.43059314148195,1.04913969223344,38,34,4,50,40,10,63,53,10,3,2,0,0
"6634","COL","NSH",2013020732,16088,20132014,0,60,5,4,1,6.65210923594125,5.83841216246947,0.813697073471786,29,31,-2,35,44,-9,42,61,-19,1,4,0,0
"6635","COL","TOR",2013020753,16091,20132014,1,60,2,5,-3,2.5542743464463,6.15196031978121,-3.59768597333491,37,31,6,48,39,9,63,49,14,4,4,0,0
"6636","COL","FLA",2013020772,16094,20132014,0,60,3,2,1,4.49629805888981,4.71993694799312,-0.223638889103313,25,36,-11,29,55,-26,34,64,-30,2,2,0,0
"6637","COL","T.B",2013020778,16095,20132014,0,60,2,5,-3,6.84737750826753,4.91490809737161,1.93246941089592,27,29,-2,41,45,-4,55,61,-6,3,3,0,0
"6638","COL","DAL",2013020792,16097,20132014,0,60,4,3,1,3.64734527294058,4.96212998921746,-1.31478471627688,21,44,-23,28,52,-24,41,71,-30,3,4,0,0
"6639","COL","MIN",2013020814,16100,20132014,1,60,5,4,1,4.08573424923816,5.72820830791703,-1.64247405867887,32,35,-3,50,48,2,57,60,-3,6,5,0,0
"6640","COL","BUF",2013020826,16102,20132014,1,60,7,1,6,4.56510569742173,4.73734542515012,-0.172239727728396,39,28,11,48,37,11,57,51,6,5,5,0,0
"6641","COL","N.J",2013020840,16104,20132014,0,60.4666666666667,2,1,1,4.2040563890585,3.52681879390081,0.677237595157696,25,28,-3,35,40,-5,40,47,-7,5,4,0,0
"6642","COL","NYR",2013020845,16105,20132014,0,60,1,5,-4,4.68017042457359,6.06667895700502,-1.38650853243144,28,43,-15,40,55,-15,57,71,-14,3,3,0,0
"6643","COL","PHI",2013020858,16107,20132014,0,60,1,3,-2,4.63721139772382,4.30167765537044,0.335533742353382,39,35,4,48,49,-1,74,60,14,4,3,0,0
"6644","COL","NYI",2013020878,16109,20132014,0,60,5,2,3,3.75983081338927,4.36867590663314,-0.608845093243872,26,33,-7,32,54,-22,38,66,-28,3,6,0,0
"6645","COL","L.A",2013020884,16127,20132014,1,60,4,6,-2,0,0,0,29,28,1,44,36,8,59,51,8,5,3,0,0
"6646","COL","ARI",2013020899,16129,20132014,1,60,4,2,2,2.15291666941524,5.40570398150157,-3.25278731208633,33,42,-9,43,56,-13,60,68,-8,4,5,0,0
"6647","COL","T.B",2013020917,16131,20132014,1,60,6,3,3,7.7306993813377,7.12382361106114,0.606875770276556,35,34,1,47,45,2,66,54,12,4,2,0,0
"6648","COL","CHI",2013020927,16133,20132014,0,60,4,2,2,3.71378928679042,4.22718649812441,-0.513397211333995,21,38,-17,25,48,-23,36,65,-29,3,4,0,0
"6649","COL","DET",2013020940,16135,20132014,0,64.4666666666667,3,2,1,5.68189160151633,5.86710906674853,-0.185217465232199,25,37,-12,31,45,-14,42,58,-16,2,2,0,0
"6650","COL","STL",2013020954,16137,20132014,1,60,1,2,-1,3.73329499148531,2.74293110412452,0.990363887360786,27,25,2,41,35,6,58,49,9,3,1,0,0
"6651","COL","WPG",2013020972,16139,20132014,1,62.55,3,2,1,6.28613190856777,3.97887535861992,2.30725654994785,34,35,-1,40,49,-9,50,67,-17,8,4,0,0
"6652","COL","CHI",2013020987,16141,20132014,1,60,3,2,1,4.29134958913419,5.02833684720926,-0.736987258075075,29,39,-10,43,53,-10,57,71,-14,4,3,0,0
"6653","COL","ANA",2013021003,16143,20132014,1,60,4,6,-2,6.22846202820074,5.2400377846534,0.988424243547342,38,33,5,50,47,3,67,63,4,7,2,0,0
"6654","COL","OTT",2013021017,16145,20132014,0,60,3,1,2,5.53112102138766,4.68993600493246,0.841185016455199,22,39,-17,30,57,-27,38,76,-38,1,2,0,0
"6655","COL","MTL",2013021030,16147,20132014,0,60,3,6,-3,4.36599499642796,5.43064080250042,-1.06464580607246,28,36,-8,39,47,-8,58,62,-4,3,3,0,0
"6656","COL","WPG",2013021040,16148,20132014,0,61.7,4,5,-1,2.58944989583688,5.14774436740845,-2.55829447157157,27,27,0,37,41,-4,49,52,-3,1,2,0,0
"6657","COL","BOS",2013021053,16150,20132014,1,60,0,2,-2,3.05949693915318,2.15307618599036,0.90642075316282,31,28,3,41,36,5,54,48,6,3,1,0,0
"6658","COL","NSH",2013021087,16154,20132014,0,65,4,4,0,4.21805963636143,6.36268437984836,-2.14462474348693,28,33,-5,42,47,-5,52,61,-9,0,2,0,0
"6659","COL","VAN",2013021100,16156,20132014,1,60.9166666666667,3,2,1,2.8897159784733,5.37027942969871,-2.48056345122541,28,31,-3,35,42,-7,48,62,-14,3,5,0,0
"6660","COL","S.J",2013021109,16158,20132014,1,60,3,2,1,3.52194674347993,7.59526197065134,-4.07331522717141,22,49,-27,30,62,-32,33,87,-54,5,5,0,0
"6661","COL","CBJ",2013021134,16161,20132014,0,64.45,3,2,1,7.1364448198583,5.76533249262138,1.37111232723692,28,26,2,35,41,-6,46,54,-8,1,2,0,0
"6662","COL","NYR",2013021151,16163,20132014,1,65,2,2,0,6.06876506489634,4.42380368757332,1.64496137732302,37,31,6,50,42,8,57,47,10,4,5,0,0
"6663","COL","STL",2013021161,16165,20132014,0,60,4,0,4,3.9263247653289,2.36636580422748,1.55995896110142,29,31,-2,44,44,0,53,60,-7,12,9,0,0
"6664","COL","EDM",2013021189,16168,20132014,0,60,4,1,3,3.39001569059383,2.26439064016449,1.12562505042933,33,23,10,47,36,11,58,53,5,2,3,0,0
"6665","COL","VAN",2013021204,16170,20132014,0,60,4,2,2,3.74861785203393,5.1451276117757,-1.39650975974177,28,40,-12,38,54,-16,51,68,-17,6,2,0,0
"6666","COL","S.J",2013021211,16171,20132014,0,60,1,5,-4,5.60792726461659,6.6773581703892,-1.06943090577261,33,30,3,40,47,-7,51,59,-8,2,2,0,0
"6667","COL","ANA",2013021229,16173,20132014,0,61.55,2,3,-1,4.02726468428256,5.68552116744011,-1.65825648315756,31,36,-5,41,62,-21,57,69,-12,1,2,0,0
"6668","COL","MIN",2013030151,16177,20132014,1,67.45,5,4,1,6.07041725455201,3.97240926948507,2.09800798506694,31,33,-2,43,42,1,58,57,1,5,5,0,0
"6669","COL","MIN",2013030152,16179,20132014,1,60,4,2,2,2.50140835929051,5.08352573886077,-2.58211737957026,29,32,-3,41,41,0,54,68,-14,3,3,0,0
"6670","COL","MIN",2013030153,16181,20132014,0,65.1333333333333,0,1,-1,2.81482785411274,7.65699132032061,-4.84216346620787,22,46,-24,27,61,-34,37,75,-38,8,7,0,0
"6671","COL","MIN",2013030154,16184,20132014,0,60,1,2,-1,2.09555209615269,5.08707984923967,-2.99152775308698,12,32,-20,23,50,-27,34,62,-28,4,4,0,0
"6672","COL","MIN",2013030155,16186,20132014,1,63.45,4,3,1,4.98263377092991,2.97573575560734,2.00689801532257,35,32,3,43,44,-1,64,63,1,4,4,0,0
"6673","COL","MIN",2013030156,16188,20132014,0,60,2,5,-3,4.89399842770945,4.18114743235083,0.712850995358622,23,23,0,39,34,5,53,45,8,7,6,0,0
"6674","COL","MIN",2013030157,16190,20132014,1,65.0333333333333,4,5,-1,2.0631299599026,7.19337446002464,-5.13024450012205,22,35,-13,28,51,-23,44,71,-27,3,3,0,0
"6675","COL","MIN",2014020014,16352,20142015,0,60,0,5,-5,1.9097475091985,5.30065556424722,-3.39090805504873,16,48,-32,23,69,-46,29,78,-49,6,4,0,0
"6676","COL","MIN",2014020029,16354,20142015,1,60,0,3,-3,4.01059832753366,5.042373344856,-1.03177501732235,30,34,-4,43,44,-1,64,58,6,6,6,0,0
"6677","COL","BOS",2014020035,16356,20142015,0,60,2,1,1,4.71830691915288,3.38953204025665,1.32877487889623,30,28,2,37,39,-2,46,51,-5,3,3,0,0
"6678","COL","TOR",2014020043,16357,20142015,0,60.5666666666667,2,3,-1,2.96384841451982,3.54161274374383,-0.57776432922401,24,40,-16,34,51,-17,50,70,-20,4,6,0,0
"6679","COL","OTT",2014020054,16359,20142015,0,60,3,5,-2,4.91700374808502,4.50488419091562,0.412119557169397,31,28,3,42,38,4,54,58,-4,6,8,0,0
"6680","COL","MTL",2014020064,16361,20142015,0,60,2,3,-1,4.14497385348659,8.6699219527776,-4.52494809929101,34,36,-2,40,52,-12,55,75,-20,4,3,0,0
"6681","COL","FLA",2014020087,16364,20142015,1,62.3833333333333,3,4,-1,4.58041576494725,5.38791441085272,-0.807498645905468,33,36,-3,44,44,0,53,55,-2,5,2,0,0
"6682","COL","VAN",2014020103,16367,20142015,1,60,7,3,4,6.87322756910956,5.70432008538046,1.16890748372911,48,29,19,59,39,20,67,47,20,6,5,0,0
"6683","COL","WPG",2014020117,16369,20142015,0,64.5833333333333,1,2,-1,4.37462265841507,6.94707458023913,-2.57245192182406,23,28,-5,26,48,-22,40,82,-42,4,5,0,0
"6684","COL","S.J",2014020133,16371,20142015,1,65,2,2,0,6.53379799911454,9.54542321801918,-3.01162521890464,33,51,-18,46,66,-20,53,84,-31,5,6,0,0
"6685","COL","NYI",2014020146,16373,20142015,1,60,5,0,5,5.71242724709904,3.82422583240259,1.88820141469645,23,40,-17,34,57,-23,38,79,-41,3,7,0,0
"6686","COL","STL",2014020161,16375,20142015,0,65,2,2,0,2.75204635845148,3.65307820484759,-0.901031846396108,29,29,0,38,40,-2,49,56,-7,4,3,0,0
"6687","COL","ANA",2014020168,16376,20142015,1,60,2,3,-1,3.22255995980231,3.68143892102353,-0.458878961221217,18,33,-15,23,40,-17,36,50,-14,3,5,0,0
"6688","COL","VAN",2014020182,16378,20142015,1,60,2,5,-3,3.49624200587168,3.77716394994712,-0.28092194407544,22,37,-15,29,47,-18,41,71,-30,4,4,0,0
"6689","COL","TOR",2014020194,16380,20142015,1,65,3,3,0,5.18105037172791,6.0457552566131,-0.864704884885192,34,38,-4,47,51,-4,69,73,-4,4,3,0,0
"6690","COL","PHI",2014020207,16382,20142015,0,60,3,4,-1,4.77600753739978,3.85397506881122,0.922032468588554,39,27,12,49,37,12,62,54,8,4,3,0,0
"6691","COL","NYI",2014020221,16385,20142015,0,60,0,6,-6,1.68466535577681,7.311621320221,-5.62695596444418,20,46,-26,27,56,-29,42,68,-26,4,7,0,0
"6692","COL","NYR",2014020233,16387,20142015,0,65,3,3,0,5.64567648724187,6.30350833723787,-0.657831849996001,29,33,-4,34,47,-13,45,60,-15,2,3,0,0
"6693","COL","N.J",2014020254,16389,20142015,0,60,3,2,1,3.718228910584,3.47462246858777,0.243606441996235,29,25,4,34,35,-1,37,43,-6,2,2,0,0
"6694","COL","WSH",2014020286,16394,20142015,1,60,2,3,-1,5.07958630658686,4.48584199062316,0.593744315963704,29,23,6,38,34,4,50,51,-1,1,2,0,0
"6695","COL","CAR",2014020304,16396,20142015,1,60,4,3,1,3.31060807505855,4.32817492317353,-1.01756684811498,35,27,8,44,38,6,61,57,4,4,0,0,0
"6696","COL","ARI",2014020320,16399,20142015,0,63.2666666666667,4,3,1,8.06430191158597,4.05031334121668,4.01398857036929,35,33,2,42,47,-5,60,54,6,2,1,0,0
"6697","COL","CHI",2014020330,16400,20142015,1,60,2,3,-1,3.57974847113655,5.54949164985938,-1.96974317872282,29,45,-16,36,60,-24,48,76,-28,2,6,0,0
"6698","COL","DAL",2014020352,16403,20142015,1,60,5,2,3,7.57108175155615,5.89983593154466,1.67124582001149,47,24,23,61,38,23,77,54,23,8,4,0,0
"6699","COL","MTL",2014020359,16405,20142015,1,60,3,4,-1,4.96699681453174,5.11279103771176,-0.145794223180019,29,30,-1,37,42,-5,50,59,-9,1,2,0,0
"6700","COL","CGY",2014020384,16408,20142015,0,61.7833333333333,3,4,-1,4.09185481653549,3.33419711783063,0.757657698704861,29,25,4,35,40,-5,52,55,-3,1,3,0,0
"6701","COL","WPG",2014020388,16409,20142015,0,60,2,6,-4,5.92734400636982,5.31336339272093,0.613980613648891,22,37,-15,34,50,-16,52,66,-14,6,5,0,0
"6702","COL","NSH",2014020417,16413,20142015,1,60,0,3,-3,0,0,0,26,36,-10,38,44,-6,58,55,3,3,6,0,0
"6703","COL","WPG",2014020428,16415,20142015,1,65,3,3,0,3.95730476433528,3.32345782404796,0.633846940287321,26,33,-7,37,48,-11,51,65,-14,4,4,0,0
"6704","COL","STL",2014020445,16417,20142015,1,61.05,2,3,-1,3.0657446309051,7.5897647659684,-4.52402013506329,25,42,-17,34,56,-22,50,72,-22,6,5,0,0
"6705","COL","BUF",2014020480,16424,20142015,0,60,5,1,4,4.44954207481351,2.98502900007588,1.46451307473762,23,29,-6,30,37,-7,44,51,-7,3,4,0,0
"6706","COL","DET",2014020491,16425,20142015,0,65,1,1,0,1.8826622182969,5.41732734551624,-3.53466512721934,23,35,-12,27,51,-24,32,71,-39,2,3,0,0
"6707","COL","STL",2014020513,16427,20142015,1,60,5,0,5,5.03627388807897,3.96838953182775,1.06788435625122,41,26,15,48,34,14,60,52,8,7,4,0,0
"6708","COL","CHI",2014020524,16431,20142015,1,60,2,5,-3,6.03766889170947,7.45077225656132,-1.41310336485185,25,33,-8,38,46,-8,55,62,-7,3,4,0,0
"6709","COL","STL",2014020535,16433,20142015,0,60,0,3,-3,2.49371505703311,3.63984602785786,-1.14613097082474,16,25,-9,22,47,-25,33,56,-23,1,1,0,0
"6710","COL","PHI",2014020554,16435,20142015,1,64.6666666666667,4,3,1,6.16513245082149,4.32507213686326,1.84006031395823,33,29,4,39,41,-2,57,55,2,5,6,0,0
"6711","COL","EDM",2014020563,16437,20142015,1,65,1,1,0,6.6708172931103,6.26791566341126,0.402901629699045,28,28,0,44,36,8,57,52,5,4,5,0,0
"6712","COL","CBJ",2014020580,16439,20142015,1,60,3,4,-1,4.17845194524853,4.32019049118348,-0.141738545934958,29,27,2,43,43,0,55,56,-1,4,3,0,0
"6713","COL","CHI",2014020589,16441,20142015,0,60,2,0,2,2.21743040827363,5.563377774939,-3.34594736666537,24,54,-30,32,71,-39,44,92,-48,3,4,0,0
"6714","COL","OTT",2014020604,16443,20142015,1,60,5,2,3,1.62659981900288,3.32530379127925,-1.69870397227638,21,38,-17,25,48,-23,29,73,-44,2,4,0,0
"6715","COL","DAL",2014020615,16445,20142015,1,60,4,3,1,6.68590646694423,5.11859925964382,1.56730720730041,30,40,-10,38,58,-20,43,84,-41,3,6,0,0
"6716","COL","WSH",2014020628,16447,20142015,0,60,1,2,-1,5.89235985280863,5.64444076835258,0.247919084456052,32,38,-6,44,59,-15,56,79,-23,3,4,0,0
"6717","COL","CAR",2014020634,16448,20142015,0,65,2,2,0,6.19211536558578,7.12186093417404,-0.92974556858826,30,46,-16,42,68,-26,60,95,-35,1,1,0,0
"6718","COL","FLA",2014020649,16450,20142015,0,60,4,2,2,4.27886087947991,4.43071894318564,-0.151858063705731,29,32,-3,37,45,-8,43,62,-19,5,3,0,0
"6719","COL","T.B",2014020665,16452,20142015,0,65,2,2,0,4.04485649074195,3.39163614174686,0.653220348995092,42,31,11,54,41,13,69,51,18,3,1,0,0
"6720","COL","STL",2014020679,16454,20142015,0,60,1,3,-2,2.57999699564607,2.84554980733446,-0.265552811688394,18,30,-12,25,49,-24,37,57,-20,3,2,0,0
"6721","COL","BOS",2014020694,16456,20142015,1,65,2,2,0,8.7421515075257,3.94017771648429,4.80197379104141,36,24,12,45,39,6,72,54,18,6,3,0,0
"6722","COL","NSH",2014020704,16462,20142015,0,62.7666666666667,3,4,-1,5.89332974310673,7.19915972814488,-1.30582998503814,24,39,-15,37,60,-23,46,80,-34,2,2,0,0
"6723","COL","NSH",2014020724,16465,20142015,1,60,3,0,3,4.64675736916251,4.32863914046902,0.318118228693493,28,23,5,37,37,0,47,61,-14,4,2,0,0
"6724","COL","DAL",2014020753,16469,20142015,0,65,2,2,0,4.88840595993679,5.54581162173872,-0.657405661801931,24,32,-8,37,45,-8,55,68,-13,2,3,0,0
"6725","COL","DET",2014020765,16471,20142015,1,60,0,3,-3,2.87917774566449,7.6195843479436,-4.74040660227911,28,29,-1,39,35,4,55,50,5,3,2,0,0
"6726","COL","MIN",2014020780,16473,20142015,0,60,0,1,-1,3.75302743643988,3.70275055404636,0.0502768823935185,18,29,-11,26,50,-24,42,66,-24,2,3,0,0
"6727","COL","WPG",2014020790,16474,20142015,0,60,3,5,-2,4.01257539929611,3.20625866959369,0.806316729702417,28,29,-1,40,41,-1,51,60,-9,3,5,0,0
"6728","COL","NYR",2014020816,16478,20142015,1,60,3,6,-3,4.46805005289551,3.52856666663311,0.939483386262406,29,31,-2,43,36,7,55,53,2,6,3,0,0
"6729","COL","DAL",2014020830,16480,20142015,1,60,4,1,3,5.06817157430851,2.70612573903054,2.36204583527797,30,25,5,41,36,5,59,59,0,3,1,0,0
"6730","COL","ARI",2014020842,16482,20142015,1,60,5,2,3,4.42309154116083,3.65790760940905,0.765183931751778,34,17,17,45,30,15,49,47,2,3,1,0,0
"6731","COL","L.A",2014020856,16484,20142015,1,60,1,4,-3,6.4218838993718,3.49520482245134,2.92667907692046,43,26,17,54,36,18,71,52,19,3,4,0,0
"6732","COL","CHI",2014020870,16486,20142015,0,60,4,1,3,5.44785451475764,2.42149833153235,3.02635618322529,30,28,2,35,37,-2,42,63,-21,4,3,0,0
"6733","COL","T.B",2014020889,16488,20142015,1,60,5,4,1,1.85728476831947,3.57610992495029,-1.71882515663081,18,32,-14,30,46,-16,44,65,-21,1,3,0,0
"6734","COL","NSH",2014020900,16490,20142015,0,60,2,5,-3,4.65652903789305,6.16953541409211,-1.51300637619905,20,41,-21,28,56,-28,40,67,-27,4,2,0,0
"6735","COL","DAL",2014020921,16493,20142015,0,65,4,4,0,3.20684494015586,4.4750053123862,-1.26816037223034,23,36,-13,41,57,-16,55,76,-21,3,3,0,0
"6736","COL","MIN",2014020930,16494,20142015,1,60,1,3,-2,5.20241278359808,5.32286538924382,-0.120452605645738,34,32,2,50,45,5,67,63,4,7,5,0,0
"6737","COL","CBJ",2014020975,16501,20142015,0,60,4,0,4,4.50497791840462,3.97642351474497,0.528554403659655,33,44,-11,36,52,-16,41,66,-25,6,2,0,0
"6738","COL","MIN",2014020982,16502,20142015,0,60,3,2,1,3.12818489434591,2.80346566118533,0.324719233160579,21,34,-13,27,51,-24,35,69,-34,3,2,0,0
"6739","COL","L.A",2014020998,16504,20142015,1,60,2,5,-3,2.67416943010176,3.58890699083508,-0.914737560733329,23,30,-7,28,38,-10,39,59,-20,3,3,0,0
"6740","COL","N.J",2014021009,16506,20142015,1,65,1,1,0,2.73165066281217,4.02410680366938,-1.29245614085721,29,24,5,41,37,4,60,60,0,3,2,0,0
"6741","COL","CGY",2014021028,16508,20142015,1,60,3,2,1,4.75250283049772,6.41283212641429,-1.66032929591657,26,31,-5,40,38,2,54,64,-10,1,3,0,0
"6742","COL","ARI",2014021062,16513,20142015,0,60,5,2,3,3.20338438378531,5.03310604602302,-1.82972166223772,29,30,-1,39,50,-11,50,59,-9,2,1,0,0
"6743","COL","ANA",2014021065,16514,20142015,0,61.4166666666667,2,3,-1,2.89903095648719,4.05241489107721,-1.15338393459001,24,40,-16,31,54,-23,38,68,-30,1,3,0,0
"6744","COL","CGY",2014021088,16517,20142015,0,60,2,3,-1,4.49548251228407,3.68683608808351,0.80864642420056,27,26,1,39,36,3,56,53,3,3,1,0,0
"6745","COL","EDM",2014021099,16519,20142015,0,60,3,4,-1,4.09597710461821,5.68440594465937,-1.58842884004116,44,34,10,57,43,14,77,58,19,5,1,0,0
"6746","COL","VAN",2014021111,16520,20142015,0,60,4,1,3,2.53162935658823,3.0691324234957,-0.537503066907476,38,34,4,42,43,-1,55,63,-8,5,4,0,0
"6747","COL","BUF",2014021126,16522,20142015,1,60,5,3,2,4.53225052350899,5.29052884087242,-0.758278317363429,22,38,-16,37,48,-11,45,65,-20,2,4,0,0
"6748","COL","EDM",2014021140,16524,20142015,1,60,1,4,-3,2.26130234028096,6.31357334097265,-4.05227100069169,30,36,-6,45,48,-3,52,56,-4,1,0,0,0
"6749","COL","S.J",2014021152,16526,20142015,0,60,1,5,-4,2.14128842030732,6.70103946892777,-4.55975104862045,20,30,-10,23,36,-13,36,64,-28,2,1,0,0
"6750","COL","ANA",2014021165,16528,20142015,0,60,4,2,2,3.72212221752852,5.53670521235178,-1.81458299482326,23,37,-14,37,55,-18,44,65,-21,5,4,0,0
"6751","COL","L.A",2014021179,16529,20142015,0,60,1,3,-2,2.44090214336757,7.8536276150262,-5.41272547165863,10,26,-16,17,51,-34,32,64,-32,1,0,0,0
"6752","COL","NSH",2014021197,16532,20142015,1,60,3,2,1,3.73262048186734,5.12553540612134,-1.392914924254,23,42,-19,28,57,-29,39,82,-43,3,4,0,0
"6753","COL","WPG",2014021210,16534,20142015,1,65,0,0,0,3.03027394145647,4.42476802345482,-1.39449408199835,21,41,-20,27,49,-22,39,64,-25,1,4,0,0
"6754","COL","CHI",2014021228,16536,20142015,1,60,3,2,1,3.03735663974658,6.71382278011879,-3.67646614037221,24,30,-6,31,47,-16,41,57,-16,3,1,0,0
"6755","COL","MIN",2015020011,16716,20152016,1,60,4,5,-1,3.57692198303994,4.52367684665114,-0.946754863611204,23,30,-7,36,46,-10,48,75,-27,3,3,0,0
"6756","COL","DAL",2015020027,16718,20152016,1,60,6,3,3,3.66874681495417,3.50253073239081,0.166216082563353,28,33,-5,40,42,-2,57,66,-9,5,5,0,0
"6757","COL","BOS",2015020048,16722,20152016,1,60,2,6,-4,3.62981165522065,3.93039476551348,-0.300583110292838,23,25,-2,38,35,3,47,45,2,3,2,0,0
"6758","COL","ANA",2015020063,16724,20152016,0,60,3,0,3,4.24530533165671,4.30124175977835,-0.0559364281216403,25,35,-10,32,51,-19,44,92,-48,4,7,0,0
"6759","COL","L.A",2015020079,16726,20152016,0,60,1,2,-1,2.33738667885751,6.46244661195669,-4.12505993309918,23,40,-17,30,57,-27,40,79,-39,6,4,0,0
"6760","COL","CAR",2015020091,16729,20152016,1,61.8166666666667,0,1,-1,4.58754771507407,4.02252056889756,0.565027146176504,26,19,7,35,32,3,52,47,5,4,5,0,0
"6761","COL","CBJ",2015020115,16732,20152016,1,60,3,4,-1,5.82937227399993,4.79723422136885,1.03213805263108,34,36,-2,50,48,2,61,60,1,6,5,0,0
"6762","COL","FLA",2015020128,16735,20152016,0,60,1,4,-3,4.30077603636892,4.15366543929122,0.147110597077699,32,28,4,38,38,0,51,47,4,5,3,0,0
"6763","COL","T.B",2015020140,16737,20152016,0,60,2,1,1,3.55584822346282,4.8944035326452,-1.33855530918238,26,35,-9,36,46,-10,43,66,-23,7,5,0,0
"6764","COL","CAR",2015020148,16738,20152016,0,60,2,3,-1,5.41846472062984,4.95056079668575,0.467903923944094,32,26,6,45,39,6,51,61,-10,3,4,0,0
"6765","COL","S.J",2015020164,16740,20152016,1,60,3,4,-1,3.0148278974666,4.08417723402945,-1.06934933656285,26,32,-6,33,38,-5,41,43,-2,4,2,0,0
"6766","COL","CGY",2015020178,16742,20152016,1,60,6,3,3,8.55141007546119,4.42850689968327,4.12290317577792,42,25,17,56,36,20,62,66,-4,3,2,0,0
"6767","COL","ARI",2015020191,16744,20152016,0,60,2,4,-2,3.90465580196678,5.70596621189907,-1.80131040993228,28,28,0,41,37,4,57,47,10,5,6,0,0
"6768","COL","NYR",2015020197,16745,20152016,1,60,1,2,-1,4.8440256989561,2.18344896852126,2.66057673043485,30,33,-3,39,36,3,49,43,6,6,3,0,0
"6769","COL","PHI",2015020218,16749,20152016,0,60,4,0,4,7.55375052755699,5.14496939931269,2.4087811282443,40,25,15,47,38,9,57,54,3,2,1,0,0
"6770","COL","BOS",2015020230,16751,20152016,0,60,3,2,1,3.82719502357577,4.69704804866342,-0.86985302508765,30,27,3,44,41,3,63,55,8,4,1,0,0
"6771","COL","MTL",2015020250,16753,20152016,0,60,6,1,5,5.60802267014515,5.71195990077103,-0.103937230625888,24,40,-16,31,53,-22,40,75,-35,2,4,0,0
"6772","COL","TOR",2015020272,16756,20152016,0,60,1,5,-4,6.28007244120818,4.18394820117837,2.0961242400298,35,30,5,48,48,0,62,60,2,4,5,0,0
"6773","COL","WSH",2015020298,16760,20152016,0,60,3,7,-4,3.21819636455835,2.7970872517908,0.421109112767553,27,32,-5,39,46,-7,46,62,-16,2,5,0,0
"6774","COL","WPG",2015020314,16762,20152016,0,60,4,1,3,5.56000550216413,4.56243526028993,0.9975702418742,29,21,8,35,41,-6,44,61,-17,2,2,0,0
"6775","COL","OTT",2015020328,16764,20152016,1,60,3,5,-2,4.85488243093769,4.56448931640125,0.290393114536442,43,29,14,62,37,25,83,43,40,6,1,0,0
"6776","COL","WPG",2015020350,16767,20152016,1,60,5,3,2,5.46391378817498,6.73171642864327,-1.26780264046829,25,28,-3,36,38,-2,47,55,-8,3,2,0,0
"6777","COL","NYI",2015020355,16769,20152016,0,60,3,5,-2,3.33506513205793,5.76868775542996,-2.43362262337203,28,28,0,38,40,-2,53,56,-3,3,3,0,0
"6778","COL","N.J",2015020359,16770,20152016,0,60,2,1,1,3.0390213628998,3.03018397017513,0.0088373927246721,25,28,-3,27,33,-6,34,49,-15,4,3,0,0
"6779","COL","NYR",2015020373,16772,20152016,0,60,2,1,1,4.29170209819858,6.44749803486047,-2.15579593666189,18,25,-7,25,43,-18,36,65,-29,0,1,0,0
"6780","COL","MIN",2015020395,16774,20152016,0,60,0,3,-3,2.67033643573561,4.91506504091376,-2.24472860517815,20,44,-24,28,56,-28,36,72,-36,3,5,0,0
"6781","COL","MIN",2015020406,16776,20152016,1,63.5833333333333,2,1,1,5.16146432896068,2.97567885485478,2.1857854741059,20,20,0,31,34,-3,41,47,-6,1,3,0,0
"6782","COL","PIT",2015020418,16778,20152016,1,60,2,4,-2,3.55330978613347,4.898335797584,-1.34502601145053,26,33,-7,35,49,-14,52,62,-10,5,2,0,0
"6783","COL","NSH",2015020441,16781,20152016,0,60,3,2,1,0,0,0,25,36,-11,33,51,-18,39,68,-29,6,6,0,0
"6784","COL","STL",2015020446,16782,20152016,0,60,3,1,2,3.43629830941791,5.84889563664492,-2.41259732722702,18,43,-25,31,60,-29,36,78,-42,2,1,0,0
"6785","COL","CHI",2015020462,16784,20152016,0,60,3,0,3,7.23327472212259,2.96119357570211,4.27208114642048,27,29,-2,37,38,-1,49,60,-11,4,2,0,0
"6786","COL","NYI",2015020475,16786,20152016,1,60,2,1,1,4.25338036620815,4.07569270193198,0.177687664276164,30,34,-4,43,50,-7,60,62,-2,2,5,0,0
"6787","COL","EDM",2015020492,16788,20152016,1,60,5,1,4,3.98400535152244,4.72657904176958,-0.742573690247147,29,40,-11,36,51,-15,47,70,-23,1,2,0,0
"6788","COL","TOR",2015020505,16790,20152016,1,60,4,7,-3,2.71200353682798,3.50817185728301,-0.796168320455028,28,22,6,40,30,10,49,46,3,4,3,0,0
"6789","COL","ARI",2015020532,16796,20152016,1,64.2833333333333,1,2,-1,5.7777083036505,4.27911320058781,1.49859510306269,39,28,11,48,39,9,68,53,15,5,6,0,0
"6790","COL","S.J",2015020540,16797,20152016,0,60,6,3,3,3.12562324755709,4.18855186356814,-1.06292861601105,26,38,-12,30,57,-27,37,83,-46,6,3,0,0
"6791","COL","CHI",2015020560,16800,20152016,1,63.4833333333333,3,4,-1,6.24454734894077,8.8723090326564,-2.62776168371563,30,43,-13,44,54,-10,57,72,-15,3,6,0,0
"6792","COL","CGY",2015020577,16802,20152016,1,60,0,4,-4,5.35368221427104,3.28034445168475,2.07333776258628,26,34,-8,34,45,-11,50,58,-8,2,6,0,0
"6793","COL","L.A",2015020585,16804,20152016,1,60,4,1,3,3.34948146504792,4.70242848041835,-1.35294701537043,33,31,2,43,43,0,52,60,-8,5,5,0,0
"6794","COL","STL",2015020598,16806,20152016,1,64.7166666666667,4,3,1,5.41456750040589,4.71141563185665,0.703151868549241,33,38,-5,47,56,-9,65,71,-6,3,2,0,0
"6795","COL","NSH",2015020611,16808,20152016,1,60,5,3,2,3.26262577268062,6.42736555624288,-3.16473978356225,27,22,5,34,35,-1,54,50,4,6,3,0,0
"6796","COL","CHI",2015020626,16810,20152016,0,60,3,6,-3,3.13348919901182,3.65205664024916,-0.518567441237337,37,35,2,48,44,4,58,65,-7,2,2,0,0
"6797","COL","T.B",2015020640,16812,20152016,1,60,0,4,-4,4.65972959855571,8.53345121220627,-3.87372161365056,21,38,-17,28,59,-31,42,73,-31,2,4,0,0
"6798","COL","N.J",2015020651,16814,20152016,1,60,3,0,3,5.8701972300734,3.28533421912296,2.58486301095044,26,27,-1,36,37,-1,46,47,-1,2,3,0,0
"6799","COL","CBJ",2015020664,16816,20152016,0,60,1,2,-1,1.88700385189577,3.47932494672568,-1.59232109482991,30,21,9,41,39,2,51,48,3,3,3,0,0
"6800","COL","WPG",2015020679,16818,20152016,0,60,2,1,1,4.1734823465813,5.48495852865744,-1.31147618207615,34,37,-3,42,51,-9,50,72,-22,2,2,0,0
"6801","COL","BUF",2015020691,16820,20152016,1,60,2,1,1,7.87186088516476,3.27424645671192,4.59761442845284,35,28,7,47,35,12,55,47,8,2,2,0,0
"6802","COL","STL",2015020708,16822,20152016,1,65,1,1,0,6.56548733476666,3.63170863379491,2.93377870097174,41,34,7,55,48,7,74,59,15,3,2,0,0
"6803","COL","DAL",2015020717,16823,20152016,0,60,3,1,2,1.00558956401073,8.69594706150383,-7.6903574974931,15,43,-28,23,74,-51,32,106,-74,1,5,0,0
"6804","COL","S.J",2015020739,16826,20152016,0,60,1,6,-5,2.60333630857122,3.25408375789266,-0.650747449321443,22,24,-2,35,32,3,57,46,11,6,6,0,0
"6805","COL","L.A",2015020743,16827,20152016,0,60,4,3,1,2.32469151855912,6.32799246160721,-4.00330094304809,19,38,-19,29,55,-26,37,72,-35,7,6,0,0
"6806","COL","CHI",2015020752,16833,20152016,1,60,1,2,-1,4.57627261118614,8.11639012165138,-3.54011751046524,23,42,-19,30,62,-32,45,83,-38,2,3,0,0
"6807","COL","DAL",2015020767,16835,20152016,1,60.5833333333333,3,4,-1,3.19142385310624,5.88760291816083,-2.69617906505458,24,44,-20,30,57,-27,34,85,-51,6,4,0,0
"6808","COL","WPG",2015020785,16837,20152016,1,60,2,4,-2,7.85354970485415,6.3866012088256,1.46694849602855,34,39,-5,43,53,-10,60,71,-11,8,6,0,0
"6809","COL","VAN",2015020804,16840,20152016,1,60,1,3,-2,4.35149524785811,4.67711191014678,-0.325616662288667,30,28,2,39,39,0,52,46,6,4,1,0,0
"6810","COL","OTT",2015020812,16842,20152016,0,60,4,3,1,5.85159742583869,3.98741222080025,1.86418520503844,27,29,-2,38,47,-9,44,65,-21,3,4,0,0
"6811","COL","DET",2015020821,16843,20152016,0,65,2,2,0,3.87164925728712,6.95492592627852,-3.0832766689914,21,45,-24,31,62,-31,35,87,-52,3,5,0,0
"6812","COL","BUF",2015020835,16845,20152016,0,60,1,4,-3,3.40205111290778,6.58196018948957,-3.17990907658179,35,21,14,47,29,18,60,42,18,5,3,0,0
"6813","COL","MTL",2015020856,16848,20152016,1,60,3,2,1,2.9727097038899,5.94153009506408,-2.96882039117418,28,34,-6,33,45,-12,51,62,-11,4,4,0,0
"6814","COL","EDM",2015020882,16851,20152016,0,60,3,2,1,3.73889972746838,3.82914774137316,-0.0902480139047839,29,27,2,40,41,-1,50,59,-9,3,3,0,0
"6815","COL","VAN",2015020888,16852,20152016,0,60,1,5,-4,5.64563958107325,3.9090620230088,1.73657755806445,38,29,9,50,36,14,64,38,26,4,4,0,0
"6816","COL","S.J",2015020904,16855,20152016,1,65,3,3,0,4.64568313050404,5.67395705042873,-1.02827391992469,41,33,8,50,44,6,64,62,2,2,1,0,0
"6817","COL","DET",2015020927,16858,20152016,1,60,3,5,-2,4.68228714397446,4.59265883313492,0.0896283108395437,27,28,-1,40,42,-2,51,61,-10,4,5,0,0
"6818","COL","MIN",2015020948,16861,20152016,0,60,3,6,-3,4.77797815969097,6.05388706564213,-1.27590890595116,33,30,3,44,41,3,63,52,11,3,3,0,0
"6819","COL","FLA",2015020962,16863,20152016,1,60,3,2,1,4.47955696156714,7.08520654626773,-2.60564958470059,26,40,-14,29,55,-26,34,74,-40,4,3,0,0
"6820","COL","NSH",2015020971,16865,20152016,1,60,2,5,-3,5.44284046402313,6.15356001821453,-0.7107195541914,36,40,-4,45,47,-2,67,69,-2,3,4,0,0
"6821","COL","ARI",2015020989,16867,20152016,1,60,3,1,2,4.43004336807644,6.01937990921942,-1.58933654114298,37,38,-1,46,58,-12,58,76,-18,2,3,0,0
"6822","COL","ANA",2015021004,16869,20152016,1,60,3,0,3,1.55537841037,4.86149366666041,-3.30611525629041,26,37,-11,30,55,-25,42,75,-33,4,5,0,0
"6823","COL","WPG",2015021024,16872,20152016,0,60,2,3,-1,5.12453269428167,4.5435213935998,0.581011300681867,37,30,7,45,42,3,63,58,5,3,4,0,0
"6824","COL","VAN",2015021051,16876,20152016,0,60,3,1,2,1.73296411812771,6.34413338807644,-4.61116926994873,34,29,5,42,37,5,50,58,-8,2,1,0,0
"6825","COL","CGY",2015021064,16878,20152016,0,65,3,3,0,5.00888665911043,5.35063099765426,-0.341744338543826,28,33,-5,39,44,-5,50,68,-18,2,2,0,0
"6826","COL","EDM",2015021083,16880,20152016,0,60,3,2,1,4.37581402631724,2.63510865392163,1.74070537239561,25,28,-3,43,35,8,58,54,4,2,4,0,0
"6827","COL","PHI",2015021109,16884,20152016,1,60,2,4,-2,3.43756523890235,9.7468821365037,-6.30931689760135,34,45,-11,44,57,-13,62,77,-15,2,3,0,0
"6828","COL","MIN",2015021117,16886,20152016,1,60,0,4,-4,4.07215704162945,4.8486112478713,-0.776454206241851,29,35,-6,46,41,5,59,59,0,5,5,0,0
"6829","COL","NSH",2015021136,16888,20152016,0,60,4,3,1,2.98766445656474,4.46899050669344,-1.4813260501287,27,35,-8,38,44,-6,47,63,-16,2,3,0,0
"6830","COL","STL",2015021145,16889,20152016,0,60,1,3,-2,2.99052260548342,2.18357174707489,0.806950858408527,21,27,-6,31,41,-10,45,55,-10,2,4,0,0
"6831","COL","WSH",2015021165,16892,20152016,1,60,2,4,-2,2.97690840950236,8.16688498779692,-5.18997657829456,19,47,-28,29,63,-34,37,83,-46,3,3,0,0
"6832","COL","STL",2015021181,16894,20152016,1,60,1,5,-4,5.40948817674002,4.97225436523199,0.437233811508033,31,39,-8,42,50,-8,56,62,-6,5,4,0,0
"6833","COL","NSH",2015021194,16896,20152016,0,60,3,4,-1,6.21346497966442,6.80318617478224,-0.589721195117818,28,28,0,41,44,-3,62,59,3,3,2,0,0
"6834","COL","DAL",2015021211,16898,20152016,0,60,2,4,-2,4.2122640144903,5.84238565037958,-1.63012163588928,19,31,-12,27,45,-18,51,65,-14,4,3,0,0
"6835","COL","ANA",2015021219,16900,20152016,1,60,3,5,-2,2.25026729602459,4.842890217969,-2.59262292194441,32,31,1,38,40,-2,57,52,5,7,2,0,0
"6836","COL","DAL",2016020027,17089,20162017,1,60,6,5,1,7.17632979334215,8.09643922647007,-0.920109433127926,33,28,5,44,40,4,60,54,6,3,4,0,0
"6837","COL","PIT",2016020034,17091,20162017,0,60.3666666666667,4,3,1,6.40452929675394,4.30684221484989,2.09768708190404,31,31,0,39,44,-5,57,57,0,7,6,0,0
"6838","COL","WSH",2016020039,17092,20162017,0,60,0,3,-3,4.23863514285767,6.201613094946,-1.96297795208832,18,40,-22,27,48,-21,36,61,-25,4,6,0,0
"6839","COL","T.B",2016020055,17094,20162017,0,60,4,0,4,2.55018636291879,3.58431644110988,-1.03413007819108,16,27,-11,29,41,-12,36,60,-24,2,3,0,0
"6840","COL","FLA",2016020068,17096,20162017,0,60,2,5,-3,2.63965824578137,4.11153387629972,-1.47187563051834,28,38,-10,32,50,-18,36,58,-22,3,6,0,0
"6841","COL","WPG",2016020109,17102,20162017,1,60,0,1,-1,6.04208314772802,0.983629516294343,5.05845363143368,37,21,16,54,24,30,68,42,26,4,3,0,0
"6842","COL","ARI",2016020120,17103,20162017,0,60,3,2,1,6.41814513468439,3.70084353174136,2.71730160294303,34,26,8,48,35,13,60,45,15,3,4,0,0
"6843","COL","NSH",2016020140,17106,20162017,1,60,1,5,-4,3.42439737697848,4.25350743631139,-0.829110059332916,29,36,-7,36,43,-7,53,63,-10,4,5,0,0
"6844","COL","CHI",2016020153,17108,20162017,0,60,0,4,-4,5.58949983586717,2.6051568029543,2.98434303291288,38,21,17,44,24,20,55,43,12,3,2,0,0
"6845","COL","MIN",2016020161,17110,20162017,1,60,1,0,1,5.51795414922828,4.64660101337358,0.871353135854694,32,32,0,38,40,-2,47,52,-5,5,4,0,0
"6846","COL","STL",2016020175,17111,20162017,0,60,1,5,-4,3.09258011146449,3.80132265821599,-0.708742546751508,23,28,-5,33,39,-6,44,46,-2,6,5,0,0
"6847","COL","ARI",2016020192,17113,20162017,1,60,2,4,-2,4.06994612428025,3.28330589534016,0.786640228940087,27,25,2,36,36,0,50,59,-9,1,4,0,0
"6848","COL","WPG",2016020210,17116,20162017,1,61.3833333333333,3,2,1,5.05808235264435,1.13037763140164,3.92770472124271,29,18,11,41,20,21,56,27,29,5,6,0,0
"6849","COL","BOS",2016020227,17118,20162017,1,60,0,2,-2,6.31427534366958,6.69461233945913,-0.380336995789548,21,46,-25,30,54,-24,46,65,-19,2,2,0,0
"6850","COL","L.A",2016020240,17120,20162017,1,60,4,1,3,6.45531575172406,5.44241547573483,1.01290027598923,30,33,-3,34,44,-10,49,64,-15,5,5,0,0
"6851","COL","DAL",2016020251,17122,20162017,0,60,2,3,-1,5.05311456597386,3.02101644250797,2.03209812346589,36,22,14,52,29,23,77,46,31,2,7,0,0
"6852","COL","MIN",2016020268,17124,20162017,0,60,3,2,1,5.6633315968229,6.36228101979941,-0.698949422976511,37,43,-6,55,58,-3,72,76,-4,3,5,0,0
"6853","COL","CBJ",2016020278,17126,20162017,0,61.8166666666667,3,2,1,5.92719804419903,6.50890878279563,-0.581710738596598,27,42,-15,38,64,-26,52,92,-40,1,1,0,0
"6854","COL","EDM",2016020296,17128,20162017,1,60,3,6,-3,3.7649877478027,7.90326637604448,-4.13827862824179,28,41,-13,40,50,-10,52,67,-15,4,8,0,0
"6855","COL","VAN",2016020319,17131,20162017,1,65,2,2,0,6.6026868249379,3.57204054904287,3.03064627589504,35,31,4,52,41,11,66,48,18,4,3,0,0
"6856","COL","NSH",2016020337,17134,20162017,1,60,3,5,-2,4.60727766641446,6.76363778129235,-2.15636011487788,40,33,7,47,44,3,63,61,2,1,2,0,0
"6857","COL","CBJ",2016020354,17136,20162017,1,60,2,3,-1,5.2399437688,5.40145959419897,-0.161515825398965,20,37,-17,30,51,-21,46,60,-14,4,5,0,0
"6858","COL","DAL",2016020369,17138,20162017,1,60,0,3,-3,3.18909323448315,5.30318286948862,-2.11408963500547,23,33,-10,36,42,-6,45,57,-12,4,4,0,0
"6859","COL","NSH",2016020387,17141,20162017,0,60,3,4,-1,5.59968533751089,4.61790982077946,0.981775516731432,28,32,-4,41,44,-3,56,61,-5,4,5,0,0
"6860","COL","BOS",2016020395,17143,20162017,0,60,4,2,2,3.53708090692935,5.74974142994324,-2.21266052301389,22,31,-9,31,48,-17,39,62,-23,3,3,0,0
"6861","COL","MTL",2016020414,17145,20162017,0,60,1,10,-9,1.42765485774726,4.38018589554849,-2.95253103780124,16,36,-20,21,47,-26,31,60,-29,5,4,0,0
"6862","COL","TOR",2016020425,17146,20162017,0,60,3,1,2,4.32100124663208,8.50592781305508,-4.184926566423,29,52,-23,43,77,-34,52,99,-47,3,6,0,0
"6863","COL","PHI",2016020444,17149,20162017,1,60,3,4,-1,6.21387711673742,5.19912108187418,1.01475603486324,29,25,4,42,36,6,54,46,8,3,3,0,0
"6864","COL","FLA",2016020457,17151,20162017,1,60,1,3,-2,3.25008086435264,3.71999843094799,-0.469917566595351,31,23,8,42,30,12,53,39,14,7,3,0,0
"6865","COL","WPG",2016020471,17153,20162017,0,60,1,4,-3,4.08761729020625,5.06523505708901,-0.977617766882759,28,30,-2,34,39,-5,43,47,-4,3,1,0,0
"6866","COL","MIN",2016020488,17155,20162017,0,60,0,2,-2,1.38811472279485,2.88212337514756,-1.4940086523527,18,33,-15,21,47,-26,35,57,-22,6,4,0,0
"6867","COL","TOR",2016020503,17157,20162017,1,60,0,6,-6,5.18892138420779,3.50616319250548,1.68275819170231,38,31,7,52,44,8,65,56,9,7,6,0,0
"6868","COL","CHI",2016020512,17158,20162017,0,60.4166666666667,2,1,1,6.90652601642068,7.16226969403215,-0.255743677611463,34,39,-5,39,49,-10,54,68,-14,2,5,0,0
"6869","COL","CGY",2016020524,17162,20162017,1,60,3,6,-3,3.42303858490865,4.12978112220298,-0.706742537294338,28,31,-3,33,40,-7,52,60,-8,6,3,0,0
"6870","COL","DAL",2016020540,17164,20162017,0,60,2,4,-2,5.11760809307452,6.16341133326182,-1.04580324018729,19,34,-15,35,59,-24,42,74,-32,5,7,0,0
"6871","COL","NYR",2016020555,17166,20162017,1,60,2,6,-4,3.26747197075343,7.37912460509688,-4.11165263434344,27,37,-10,40,45,-5,48,52,-4,3,5,0,0
"6872","COL","VAN",2016020564,17168,20162017,0,60,2,3,-1,2.66606612424948,4.07547353947302,-1.40940741522354,26,24,2,38,43,-5,51,55,-4,3,4,0,0
"6873","COL","CGY",2016020575,17170,20162017,0,60,1,4,-3,2.85375614919828,4.99845968454511,-2.14470353534684,18,37,-19,30,49,-19,37,60,-23,3,7,0,0
"6874","COL","NYI",2016020588,17172,20162017,1,64.7166666666667,2,1,1,7.15024065948091,5.16823625375764,1.98200440572327,39,36,3,46,52,-6,66,71,-5,6,5,0,0
"6875","COL","ANA",2016020630,17178,20162017,1,60,1,4,-3,4.05187119019683,5.24936778992909,-1.19749659973225,34,32,2,40,42,-2,56,55,1,3,1,0,0
"6876","COL","NSH",2016020641,17180,20162017,1,60,2,3,-1,3.94451927021146,2.93517016270198,1.00934910750948,30,32,-2,39,37,2,53,43,10,4,3,0,0
"6877","COL","CHI",2016020668,17183,20162017,1,60,4,6,-2,4.82262099839136,5.68468435289105,-0.862063354499696,23,27,-4,29,37,-8,42,52,-10,3,2,0,0
"6878","COL","ANA",2016020683,17185,20162017,0,60,1,2,-1,3.75089762583644,6.2822840064764,-2.53138638063996,22,36,-14,35,60,-25,45,81,-36,1,5,0,0
"6879","COL","S.J",2016020701,17187,20162017,0,61.3,2,3,-1,3.96328360150801,2.93100945692277,1.03227414458524,33,30,3,44,38,6,64,59,5,1,4,0,0
"6880","COL","S.J",2016020712,17189,20162017,1,60,2,5,-3,3.01963384181727,3.94299108395717,-0.9233572421399,28,26,2,32,37,-5,44,46,-2,3,4,0,0
"6881","COL","VAN",2016020726,17191,20162017,1,60,2,3,-1,5.23648309156488,7.18920972057595,-1.95272662901107,32,41,-9,51,46,5,59,58,1,2,2,0,0
"6882","COL","ANA",2016020753,17197,20162017,0,60,1,5,-4,4.49696126341587,3.71102863752662,0.785932625889245,29,31,-2,47,41,6,59,50,9,4,1,0,0
"6883","COL","L.A",2016020757,17198,20162017,0,60,0,5,-5,3.61698221540428,5.31431726677511,-1.69733505137083,22,40,-18,40,55,-15,56,64,-8,4,3,0,0
"6884","COL","WPG",2016020773,17201,20162017,1,60,5,2,3,3.18204824562417,3.23874815458839,-0.0566999089642195,28,25,3,36,40,-4,47,50,-3,3,5,0,0
"6885","COL","MTL",2016020800,17204,20162017,1,60,4,0,4,3.1503676894614,4.94608521298505,-1.79571752352365,26,27,-1,38,40,-2,48,53,-5,3,6,0,0
"6886","COL","PIT",2016020811,17206,20162017,1,60,1,4,-3,2.69175141616415,4.07947521513051,-1.38772379896636,28,30,-2,47,41,6,63,47,16,4,4,0,0
"6887","COL","NYR",2016020823,17208,20162017,0,60,2,4,-2,7.12023156528812,3.25480205714121,3.86542950814692,34,30,4,42,36,6,53,49,4,1,3,0,0
"6888","COL","NYI",2016020830,17209,20162017,0,60,1,5,-4,4.33757651818451,5.38370391786663,-1.04612739968212,27,33,-6,42,42,0,51,48,3,6,8,0,0
"6889","COL","N.J",2016020836,17211,20162017,0,60,2,3,-1,2.60798209893983,3.55731632083189,-0.949334221892059,30,40,-10,39,45,-6,51,55,-4,3,3,0,0
"6890","COL","BUF",2016020847,17213,20162017,0,60,0,2,-2,3.92073878552037,5.28156833327375,-1.36082954775338,23,32,-9,32,40,-8,46,51,-5,0,3,0,0
"6891","COL","CAR",2016020856,17214,20162017,0,64.3833333333333,2,1,1,3.41279056831263,5.77386062599001,-2.36107005767738,37,29,8,46,47,-1,58,56,2,3,2,0,0
"6892","COL","T.B",2016020876,17216,20162017,1,62.45,2,3,-1,5.28984848855544,2.38721195349087,2.90263653506456,29,40,-11,46,52,-6,61,64,-3,4,2,0,0
"6893","COL","L.A",2016020890,17218,20162017,1,60,1,2,-1,3.16595524078002,3.58415865247662,-0.418203411696595,25,32,-7,39,42,-3,50,53,-3,3,1,0,0
"6894","COL","NSH",2016020897,17220,20162017,0,60,2,4,-2,2.62594908268511,5.98815412860131,-3.3622050459162,22,29,-7,32,40,-8,55,51,4,0,2,0,0
"6895","COL","BUF",2016020910,17222,20162017,1,60,5,3,2,4.1950171448152,6.49596383900501,-2.30094669418981,30,37,-7,44,50,-6,53,66,-13,3,5,0,0
"6896","COL","PHI",2016020925,17225,20162017,0,60,0,4,-4,5.13954777031904,3.52254583557738,1.61700193474167,33,26,7,50,38,12,66,53,13,5,3,0,0
"6897","COL","OTT",2016020942,17227,20162017,0,60,1,2,-1,5.32328822459294,3.54855627036886,1.77473195422408,23,42,-19,40,51,-11,65,66,-1,2,4,0,0
"6898","COL","WPG",2016020958,17229,20162017,0,60,1,6,-5,2.18183124653297,5.31521062310186,-3.1333793765689,23,31,-8,34,42,-8,47,55,-8,4,5,0,0
"6899","COL","STL",2016020966,17230,20162017,1,60,0,3,-3,4.36718534516588,4.62701442593639,-0.25982908077051,27,25,2,39,32,7,50,40,10,1,4,0,0
"6900","COL","CAR",2016020978,17232,20162017,1,60,3,1,2,4.98753154945643,3.10570234778466,1.88182920167177,25,26,-1,38,35,3,47,45,2,1,2,0,0
"6901","COL","N.J",2016020989,17234,20162017,1,60,3,2,1,5.69996552008524,5.45497346908087,0.244992051004374,22,27,-5,39,42,-3,53,54,-1,3,1,0,0
"6902","COL","OTT",2016021006,17236,20162017,1,60,2,4,-2,2.14276916610834,2.37778112965908,-0.235011963550747,16,31,-15,26,40,-14,39,56,-17,5,4,0,0
"6903","COL","ARI",2016021022,17238,20162017,0,60,0,1,-1,5.21553931088923,3.37883377916296,1.83670553172627,22,35,-13,46,50,-4,59,57,2,3,2,0,0
"6904","COL","DET",2016021035,17240,20162017,1,60,3,1,2,3.38384176484387,4.29637434696087,-0.912532582117006,29,28,1,40,42,-2,61,56,5,5,1,0,0
"6905","COL","DET",2016021053,17243,20162017,0,60,1,5,-4,4.74326332448982,5.9365884559229,-1.19332513143308,24,23,1,38,37,1,48,44,4,2,3,0,0
"6906","COL","CHI",2016021067,17244,20162017,0,60,3,6,-3,4.45147575499141,5.55432861500594,-1.10285286001454,25,34,-9,29,44,-15,45,59,-14,0,1,0,0
"6907","COL","STL",2016021085,17246,20162017,1,60,2,4,-2,2.49072337972639,4.22744073280069,-1.7367173530743,28,29,-1,39,41,-2,50,49,1,3,3,0,0
"6908","COL","EDM",2016021099,17248,20162017,1,60,4,7,-3,3.3598163658171,3.68964667903492,-0.329830313217826,21,30,-9,37,41,-4,55,52,3,3,2,0,0
"6909","COL","EDM",2016021115,17250,20162017,0,60,1,4,-3,2.01797727297526,3.61179763577033,-1.59382036279507,25,29,-4,32,35,-3,58,48,10,4,5,0,0
"6910","COL","CGY",2016021126,17252,20162017,0,60,2,4,-2,5.19333348050714,2.76962513131948,2.42370834918766,26,27,-1,31,41,-10,45,55,-10,3,3,0,0
"6911","COL","WSH",2016021139,17254,20162017,1,60,3,5,-2,5.63262188690715,4.89062723508568,0.741994651821467,35,35,0,46,42,4,63,57,6,3,3,0,0
"6912","COL","STL",2016021153,17256,20162017,1,65,1,1,0,4.55767318407311,4.30703099789522,0.250642186177893,32,28,4,44,33,11,66,51,15,2,3,0,0
"6913","COL","MIN",2016021171,17258,20162017,0,60,2,5,-3,4.10296853583684,3.99432449311462,0.108644042722218,32,28,4,43,43,0,60,54,6,2,2,0,0
"6914","COL","CHI",2016021188,17260,20162017,1,61.95,4,3,1,5.09743193849029,5.14750209109157,-0.0500701526012772,51,27,24,60,35,25,84,48,36,4,3,0,0
"6915","COL","MIN",2016021201,17262,20162017,1,60,3,4,-1,5.4561354580801,5.90227225961091,-0.446136801530809,33,28,5,40,39,1,57,50,7,4,2,0,0
"6916","COL","DAL",2016021216,17264,20162017,0,65,3,3,0,3.18109316266055,7.62682145257713,-4.44572828991659,24,45,-21,35,54,-19,52,65,-13,1,1,0,0
"6917","COL","STL",2016021225,17265,20162017,0,60,2,3,-1,4.75536141998418,4.69694410756347,0.0584173124207155,34,27,7,46,35,11,57,51,6,2,4,0,0
"6918","COL","NYR",2017020007,17444,20172018,0,60,4,2,2,3.75945794093423,4.76856246689269,-1.00910452595846,26,39,-13,35,54,-19,44,69,-25,6,8,0,0
"6919","COL","N.J",2017020019,17446,20172018,0,60,1,4,-3,5.25581369904103,4.99183146729411,0.263982231746922,41,39,2,53,53,0,62,62,0,5,4,0,0
"6920","COL","BOS",2017020032,17448,20172018,0,60,4,0,4,3.79581689139923,3.8997405162736,-0.103923624874369,23,29,-6,33,45,-12,44,59,-15,1,4,0,0
"6921","COL","BOS",2017020048,17450,20172018,1,60,6,3,3,5.36588946177562,6.00105326782119,-0.635163806045576,37,23,14,48,35,13,63,52,11,5,4,0,0
"6922","COL","ANA",2017020060,17452,20172018,1,60,3,1,2,5.75287237949669,2.71053161011867,3.04234076937802,39,18,21,57,29,28,83,39,44,8,2,0,0
"6923","COL","DAL",2017020069,17453,20172018,0,60,1,3,-2,3.77584172591355,7.62571682295814,-3.84987509704458,23,36,-13,33,54,-21,42,69,-27,4,6,0,0
"6924","COL","NSH",2017020086,17456,20172018,0,60,1,4,-3,2.30627490026109,8.55918817281622,-6.25291327255513,21,34,-13,32,49,-17,43,59,-16,6,6,0,0
"6925","COL","STL",2017020101,17458,20172018,1,60,3,4,-1,7.59542053017017,4.21872234513648,3.37669818503369,41,28,13,48,44,4,56,55,1,2,2,0,0
"6926","COL","DAL",2017020134,17463,20172018,1,60,5,3,2,4.01181677263317,5.0186545973777,-1.00683782474453,33,37,-4,41,52,-11,52,67,-15,3,2,0,0
"6927","COL","VGK",2017020149,17466,20172018,0,60,0,7,-7,4.33370111407351,1.46267822786467,2.87102288620883,32,21,11,42,38,4,56,51,5,4,5,0,0
"6928","COL","CHI",2017020165,17467,20172018,1,60,6,3,3,4.82217999437125,5.44283711514619,-0.620657120774939,28,42,-14,37,64,-27,46,83,-37,5,6,0,0
"6929","COL","CAR",2017020194,17472,20172018,1,60,5,3,2,3.5560629205138,9.72296018654015,-6.16689726602635,27,60,-33,32,73,-41,42,90,-48,2,2,0,0
"6930","COL","PHI",2017020204,17474,20172018,0,65,4,4,0,4.77597273754154,7.51847515100962,-2.74250241346808,27,37,-10,42,58,-16,53,79,-26,3,6,0,0
"6931","COL","NYI",2017020214,17475,20172018,0,60,4,6,-2,3.73843816108638,3.44005277976248,0.298385381323897,35,28,7,45,40,5,62,56,6,4,2,0,0
"6932","COL","OTT",2017020247,17480,20172018,1,60.9833333333333,3,4,-1,2.89956922826605,6.28929431839788,-3.38972509013183,19,32,-13,38,51,-13,51,68,-17,3,2,0,0
"6933","COL","OTT",2017020252,17481,20172018,0,60,3,4,-1,3.81561536081063,6.08763324352913,-2.2720178827185,18,40,-22,26,51,-25,41,71,-30,5,7,0,0
"6934","COL","WSH",2017020285,17486,20172018,1,60,6,2,4,3.4149265836495,2.23755214349512,1.17737444015438,28,30,-2,36,35,1,54,54,0,11,9,0,0
"6935","COL","NSH",2017020302,17488,20172018,0,60,2,5,-3,2.90573023741308,4.28620241091235,-1.38047217349926,31,24,7,38,32,6,56,43,13,6,4,0,0
"6936","COL","DET",2017020306,17489,20172018,0,62.9166666666667,4,3,1,5.00420211365054,2.74540626388359,2.25879584976694,37,24,13,48,34,14,62,45,17,6,3,0,0
"6937","COL","DAL",2017020330,17492,20172018,1,60,3,0,3,3.91842152789468,3.9526772041267,-0.0342556762320214,32,28,4,40,36,4,52,46,6,3,2,0,0
"6938","COL","MIN",2017020336,17494,20172018,0,65,2,2,0,2.94814741404587,3.61286316776091,-0.664715753715035,30,27,3,44,29,15,58,42,16,3,2,0,0
"6939","COL","CGY",2017020356,17495,20172018,1,60,2,3,-1,5.92762020006194,3.77809271219121,2.14952748787073,26,28,-2,40,46,-6,57,66,-9,3,4,0,0
"6940","COL","WPG",2017020380,17499,20172018,1,60.9833333333333,3,2,1,2.35761524163612,5.09961006002845,-2.74199481839234,26,33,-7,39,44,-5,53,61,-8,7,6,0,0
"6941","COL","N.J",2017020395,17501,20172018,1,60,1,2,-1,2.63444537238684,3.58379684701868,-0.94935147463184,23,21,2,36,28,8,60,45,15,5,6,0,0
"6942","COL","DAL",2017020410,17503,20172018,1,60,2,7,-5,0,0,0,27,28,-1,37,32,5,57,42,15,3,4,0,0
"6943","COL","BUF",2017020422,17505,20172018,1,60,2,4,-2,4.48761896932797,3.45596820185892,1.03165076746905,37,35,2,53,48,5,75,63,12,7,4,0,0
"6944","COL","T.B",2017020433,17507,20172018,0,60,2,5,-3,1.89299057193057,3.00139811453118,-1.10840754260062,30,32,-2,37,47,-10,46,66,-20,3,5,0,0
"6945","COL","FLA",2017020448,17509,20172018,0,60,7,3,4,7.01491169218207,7.33039381966311,-0.315482127481042,30,42,-12,36,55,-19,49,72,-23,3,4,0,0
"6946","COL","PIT",2017020462,17511,20172018,0,60,2,1,1,4.73210479669828,6.11192960920659,-1.37982481250831,28,40,-12,40,55,-15,49,69,-20,4,3,0,0
"6947","COL","WSH",2017020469,17512,20172018,0,60,2,5,-3,2.14966078188156,3.60428050147215,-1.45461971959059,24,27,-3,34,42,-8,56,55,1,4,1,0,0
"6948","COL","FLA",2017020486,17514,20172018,1,60,2,1,1,3.97765275446,5.06731791057821,-1.08966515611822,30,33,-3,39,40,-1,57,54,3,3,1,0,0
"6949","COL","T.B",2017020505,17516,20172018,1,60,5,6,-1,5.25667610256642,5.67566362640355,-0.418987523837131,37,31,6,43,41,2,61,50,11,8,3,0,0
"6950","COL","PIT",2017020514,17518,20172018,1,60,4,2,2,7.06229955838353,4.96730179467704,2.09499776370649,37,32,5,46,40,6,64,56,8,4,3,0,0
"6951","COL","L.A",2017020537,17521,20172018,0,60.7333333333333,1,2,-1,3.94895138003631,4.517561843039,-0.568610463002699,32,27,5,44,42,2,56,64,-8,3,4,0,0
"6952","COL","ARI",2017020554,17523,20172018,0,60,6,2,4,6.10642740182811,4.74542476916758,1.36100263266053,28,34,-6,48,47,1,59,72,-13,4,7,0,0
"6953","COL","ARI",2017020567,17527,20172018,1,60,1,3,-2,5.26537452425691,3.81625195982633,1.44912256443058,26,27,-1,39,33,6,50,49,1,2,4,0,0
"6954","COL","TOR",2017020584,17529,20172018,1,63.4166666666667,4,3,1,3.88903464516625,5.59425151580945,-1.7052168706432,28,34,-6,44,41,3,58,58,0,4,2,0,0
"6955","COL","NYI",2017020597,17531,20172018,1,60,6,1,5,7.95343359167861,3.28148815690757,4.67194543477104,48,28,20,58,36,22,77,59,18,5,3,0,0
"6956","COL","WPG",2017020610,17533,20172018,1,64.8333333333333,3,2,1,3.71760610585625,5.44007238940685,-1.7224662835506,26,44,-18,38,57,-19,55,88,-33,2,4,0,0
"6957","COL","CBJ",2017020624,17535,20172018,1,60,2,0,2,2.88245825318154,3.42198132281192,-0.539523069630377,32,34,-2,38,46,-8,52,59,-7,4,4,0,0
"6958","COL","MIN",2017020635,17537,20172018,1,60,7,2,5,4.424479004447,5.58960252448445,-1.16512352003745,38,36,2,47,43,4,53,60,-7,8,8,0,0
"6959","COL","DAL",2017020675,17544,20172018,0,60,4,1,3,2.91740753232989,4.45707198500168,-1.53966445267179,23,28,-5,33,48,-15,47,62,-15,2,5,0,0
"6960","COL","ANA",2017020684,17546,20172018,1,60,3,1,2,3.01548781522433,3.93365126837132,-0.918163453146983,29,34,-5,38,45,-7,54,55,-1,6,2,0,0
"6961","COL","S.J",2017020703,17549,20172018,1,60,5,3,2,1.9014859210306,4.72694169718307,-2.82545577615246,22,48,-26,32,56,-24,44,79,-35,4,7,0,0
"6962","COL","NYR",2017020710,17551,20172018,1,60,3,1,2,8.26631381078914,5.77398205251666,2.49233175827248,37,28,9,46,36,10,66,50,16,1,1,0,0
"6963","COL","TOR",2017020726,17553,20172018,0,60,4,2,2,5.40847675462514,2.9982036823294,2.41027307229573,27,31,-4,42,48,-6,46,64,-18,0,3,0,0
"6964","COL","MTL",2017020734,17554,20172018,0,60,2,4,-2,3.73142966794853,6.29853512751288,-2.56710545956435,22,40,-18,31,51,-20,48,65,-17,4,4,0,0
"6965","COL","STL",2017020753,17556,20172018,0,60,1,3,-2,4.70234403779614,2.71215818931909,1.99018584847705,37,34,3,46,44,2,60,62,-2,2,3,0,0
"6966","COL","VAN",2017020772,17561,20172018,0,61.1166666666667,3,4,-1,3.44701971373479,4.56453202984994,-1.11751231611515,30,26,4,44,40,4,55,53,2,5,5,0,0
"6967","COL","EDM",2017020785,17563,20172018,0,62.4666666666667,4,3,1,4.99235458264593,3.45582719289814,1.53652738974779,31,32,-1,38,45,-7,58,63,-5,1,3,0,0
"6968","COL","WPG",2017020799,17565,20172018,0,60,0,3,-3,3.73030545898541,5.24383998080157,-1.51353452181615,25,32,-7,34,45,-11,44,59,-15,1,2,0,0
"6969","COL","S.J",2017020822,17568,20172018,1,60,3,1,2,5.59965010124142,5.93111280974699,-0.331462708505569,20,39,-19,32,50,-18,44,71,-27,2,2,0,0
"6970","COL","STL",2017020831,17570,20172018,0,60,1,6,-5,3.24752344121225,5.24295723542103,-1.99543379420878,24,31,-7,33,44,-11,51,54,-3,5,2,0,0
"6971","COL","CAR",2017020847,17572,20172018,0,60,1,3,-2,4.30268934884225,5.42582457076406,-1.12313522192181,30,35,-5,43,58,-15,54,68,-14,4,3,0,0
"6972","COL","BUF",2017020856,17573,20172018,0,60,5,4,1,0,0,0,27,33,-6,40,51,-11,50,58,-8,6,6,0,0
"6973","COL","MTL",2017020877,17576,20172018,1,60,2,0,2,2.99535183305852,9.43565062404377,-6.44029879098525,25,44,-19,34,61,-27,47,79,-32,2,4,0,0
"6974","COL","WPG",2017020892,17578,20172018,0,60,1,6,-5,4.47418699819309,4.48893045846078,-0.0147434602676935,31,28,3,42,40,2,56,53,3,6,5,0,0
"6975","COL","EDM",2017020906,17580,20172018,1,60,2,4,-2,5.59066526521929,7.02409503226409,-1.4334297670448,26,40,-14,39,53,-14,49,61,-12,3,1,0,0
"6976","COL","VAN",2017020926,17582,20172018,0,63.6,5,4,1,5.72222871942903,3.07107548270267,2.65115323672635,34,28,6,45,44,1,56,60,-4,6,3,0,0
"6977","COL","EDM",2017020938,17584,20172018,0,62.3166666666667,2,3,-1,5.45833321538521,5.47457667345589,-0.0162434580706758,30,46,-16,42,63,-21,61,81,-20,1,2,0,0
"6978","COL","CGY",2017020947,17586,20172018,0,60,1,5,-4,3.74299223497403,4.22236881475692,-0.479376579782894,29,29,0,41,50,-9,54,71,-17,3,5,0,0
"6979","COL","VAN",2017020967,17588,20172018,1,60,3,1,2,3.90971194163632,3.80195031664858,0.107761624987738,28,32,-4,51,43,8,67,63,4,5,2,0,0
"6980","COL","CGY",2017020981,17590,20172018,1,60,5,2,3,5.42213730975466,6.3565457078646,-0.934408398109941,34,32,2,39,43,-4,44,67,-23,9,7,0,0
"6981","COL","MIN",2017020995,17592,20172018,1,60,7,1,6,5.48886923058308,5.98928664872074,-0.500417418137658,26,32,-6,37,46,-9,52,62,-10,3,3,0,0
"6982","COL","NSH",2017021009,17594,20172018,1,61.1166666666667,3,4,-1,3.73182478887611,5.75778941804002,-2.02596462916391,26,31,-5,39,47,-8,57,68,-11,5,4,0,0
"6983","COL","CHI",2017021027,17596,20172018,0,60.15,1,2,-1,5.36962575663347,3.3479596546531,2.02166610198037,34,27,7,43,39,4,57,54,3,3,2,0,0
"6984","COL","CBJ",2017021034,17598,20172018,0,60.9833333333333,4,5,-1,3.40432391827926,3.70314828473158,-0.298824366452322,27,44,-17,35,58,-23,48,67,-19,3,5,0,0
"6985","COL","ARI",2017021052,17600,20172018,1,60,5,2,3,4.05826815009641,6.47721632436151,-2.4189481742651,31,28,3,41,44,-3,54,55,-1,7,6,0,0
"6986","COL","MIN",2017021075,17603,20172018,0,60,5,1,4,4.43287329678788,5.28919699461799,-0.856323697830117,22,34,-12,33,52,-19,49,66,-17,5,6,0,0
"6987","COL","STL",2017021088,17605,20172018,0,60,4,1,3,4.36841041461889,6.18663668044502,-1.81822626582613,23,45,-22,29,67,-38,42,82,-40,1,2,0,0
"6988","COL","NSH",2017021094,17606,20172018,1,60,2,4,-2,3.59797621866899,5.05012041152804,-1.45214419285906,35,28,7,46,37,9,53,52,1,4,4,0,0
"6989","COL","DET",2017021108,17608,20172018,1,60,5,1,4,3.71732398628956,3.85711505531644,-0.139791069026878,31,38,-7,41,48,-7,55,65,-10,4,3,0,0
"6990","COL","CHI",2017021129,17610,20172018,0,60,5,1,4,7.86622781367691,4.46917577037311,3.3970520433038,40,45,-5,50,53,-3,67,86,-19,3,4,0,0
"6991","COL","L.A",2017021144,17612,20172018,1,60,1,7,-6,3.85872512970718,4.17009377842624,-0.311368648719053,30,35,-5,40,45,-5,51,48,3,3,2,0,0
"6992","COL","VGK",2017021151,17614,20172018,1,65,1,1,0,4.41270842824815,3.95763392023349,0.455074508014663,30,40,-10,42,47,-5,60,61,-1,4,1,0,0
"6993","COL","VGK",2017021175,17616,20172018,0,60,1,4,-3,1.6371441938536,7.16642822480935,-5.52928403095575,29,30,-1,41,42,-1,54,62,-8,3,3,0,0
"6994","COL","PHI",2017021188,17618,20172018,1,60,1,2,-1,2.60433259239653,5.42553356749113,-2.8212009750946,28,33,-5,45,46,-1,78,61,17,3,2,0,0
"6995","COL","CHI",2017021203,17620,20172018,1,60,5,0,5,7.19986719840381,4.0735368799069,3.12633031849691,36,33,3,43,41,2,63,60,3,4,1,0,0
"6996","COL","ANA",2017021222,17622,20172018,0,61.5666666666667,3,4,-1,4.16751844843384,5.38048940523371,-1.21297095679988,32,42,-10,42,58,-16,57,79,-22,6,4,0,0
"6997","COL","L.A",2017021228,17623,20172018,0,60,1,3,-2,2.29664721235167,4.8232290725864,-2.52658186023473,28,25,3,36,39,-3,54,51,3,3,2,0,0
"6998","COL","S.J",2017021252,17626,20172018,0,60,2,4,-2,3.86117833600212,8.19091815898719,-4.32973982298507,25,36,-11,39,50,-11,67,68,-1,1,2,0,0
"6999","COL","STL",2017021266,17628,20172018,1,60,5,2,3,6.88655904424377,5.91878216632091,0.967776877922859,39,34,5,52,41,11,67,64,3,4,3,0,0
"7000","COL","NSH",2017030151,17633,20172018,0,60,2,5,-3,2.06583887161355,8.43717674634098,-6.37133787472743,27,31,-4,36,41,-5,54,58,-4,3,3,0,0
"7001","COL","NSH",2017030152,17635,20172018,0,60,4,5,-1,3.35229549020005,4.80745231949186,-1.45515682929181,30,33,-3,35,43,-8,50,66,-16,7,7,0,0
"7002","COL","NSH",2017030153,17637,20172018,1,60,5,3,2,5.59931887389394,7.73500947198595,-2.13569059809201,34,32,2,42,49,-7,58,74,-16,8,6,0,0
"7003","COL","NSH",2017030154,17639,20172018,1,60,2,3,-1,4.05118338251486,5.93142707162788,-1.88024368911302,33,34,-1,45,48,-3,63,62,1,7,5,0,0
"7004","COL","NSH",2017030155,17641,20172018,0,60,2,1,1,2.95076317924168,5.97416398943045,-3.02340081018878,27,45,-18,35,54,-19,53,68,-15,2,3,0,0
"7005","COL","NSH",2017030156,17643,20172018,1,60,0,5,-5,4.15116592221511,5.13729093012807,-0.98612500791296,22,37,-15,29,54,-25,42,67,-25,2,5,0,0
"7006","COL","MIN",2018020013,17808,20182019,1,60,4,1,3,5.04730616359529,3.42701142805163,1.62029473554367,40,21,19,52,32,20,65,49,16,5,5,0,0
"7007","COL","PHI",2018020026,17810,20182019,1,60,5,2,3,3.16316021710264,4.49996047415513,-1.33680025705249,35,37,-2,43,47,-4,66,64,2,6,5,0,0
"7008","COL","CBJ",2018020038,17813,20182019,0,60,2,5,-3,5.07690234437373,6.34592532309152,-1.26902297871779,27,35,-8,34,45,-11,45,54,-9,4,6,0,0
"7009","COL","BUF",2018020046,17815,20182019,0,60,6,1,5,4.10542624697598,4.94534571190889,-0.839919464932905,30,31,-1,41,48,-7,43,58,-15,4,7,0,0
"7010","COL","CGY",2018020070,17817,20182019,1,60.7666666666667,2,3,-1,1.87742703323602,7.22339872590965,-5.34597169267363,26,41,-15,34,58,-24,43,77,-34,4,5,0,0
"7011","COL","NYR",2018020079,17820,20182019,0,65,2,2,0,3.81317558327623,5.96274702501887,-2.14957144174264,33,43,-10,47,53,-6,64,76,-12,3,5,0,0
"7012","COL","N.J",2018020091,17822,20182019,0,60,5,3,2,4.45367399853421,3.72818635128155,0.725487647252669,34,30,4,40,42,-2,51,47,4,7,5,0,0
"7013","COL","CAR",2018020103,17824,20182019,0,60,3,1,2,1.43212609450088,3.90351325759913,-2.47138716309825,22,43,-21,31,58,-27,44,81,-37,5,6,0,0
"7014","COL","PHI",2018020118,17826,20182019,0,60,4,1,3,7.33415842818385,8.04057966918862,-0.706421241004771,33,38,-5,38,54,-16,48,76,-28,2,3,0,0
"7015","COL","T.B",2018020132,17828,20182019,1,60,0,1,-1,2.47394533160112,3.66626944115202,-1.1923241095509,22,24,-2,36,33,3,44,51,-7,4,3,0,0
"7016","COL","OTT",2018020147,17830,20182019,1,60,6,3,3,4.13148254571415,1.95029125643042,2.18119128928372,37,24,13,54,31,23,73,42,31,3,2,0,0
"7017","COL","MIN",2018020156,17831,20182019,0,60,2,3,-1,5.18341098532254,6.49566034879535,-1.31224936347282,32,28,4,48,39,9,66,54,12,6,5,0,0
"7018","COL","CGY",2018020187,17836,20182019,0,60,5,6,-1,4.43611826357665,4.49415070551913,-0.0580324419424869,26,37,-11,34,59,-25,39,74,-35,3,2,0,0
"7019","COL","VAN",2018020193,17837,20182019,0,64.6333333333333,6,7,-1,3.9523444622173,7.58241672407513,-3.63007226185783,29,37,-8,40,46,-6,54,67,-13,2,4,0,0
"7020","COL","NSH",2018020225,17842,20182019,1,60,1,4,-3,2.6039426685266,4.5261270175306,-1.922184349004,25,34,-9,31,45,-14,49,62,-13,3,3,0,0
"7021","COL","WPG",2018020240,17844,20182019,0,60,2,5,-3,5.46025961231308,6.04971555065453,-0.589455938341445,30,24,6,42,38,4,52,53,-1,4,4,0,0
"7022","COL","EDM",2018020259,17846,20182019,0,60,4,1,3,4.28710869907834,2.78441951645073,1.50268918262762,28,27,1,35,33,2,40,52,-12,2,3,0,0
"7023","COL","BOS",2018020275,17849,20182019,1,60,6,3,3,4.7912799687528,4.33676972684043,0.454510241912374,25,23,2,34,36,-2,54,54,0,4,4,0,0
"7024","COL","WSH",2018020289,17851,20182019,1,60.3666666666667,2,3,-1,4.37399108924581,4.07507178990636,0.298919299339445,26,29,-3,31,39,-8,49,56,-7,2,3,0,0
"7025","COL","ANA",2018020307,17853,20182019,0,64.9666666666667,4,3,1,4.51730438580853,4.47840606426689,0.0388983215416374,42,33,9,54,44,10,78,55,23,2,3,0,0
"7026","COL","L.A",2018020331,17856,20182019,0,60,7,3,4,7.04459017772808,6.93549765681382,0.10909252091426,34,36,-2,46,53,-7,52,63,-11,5,4,0,0
"7027","COL","ARI",2018020345,17858,20182019,0,60,5,1,4,8.12448821088765,4.09358458686935,4.0309036240183,39,38,1,57,55,2,76,69,7,5,3,0,0
"7028","COL","DAL",2018020355,17859,20182019,1,60,3,2,1,3.06006102214815,2.36679140808269,0.693269614065457,36,29,7,45,36,9,64,45,19,4,2,0,0
"7029","COL","NSH",2018020371,17862,20182019,0,60,3,2,1,1.09265982124816,7.17502553439915,-6.08236571315099,25,38,-13,30,55,-25,41,74,-33,2,3,0,0
"7030","COL","PIT",2018020381,17863,20182019,1,60,6,3,3,3.60854328268033,4.18791160568799,-0.579368323007657,26,25,1,30,36,-6,39,53,-14,1,4,0,0
"7031","COL","STL",2018020393,17865,20182019,1,61.5666666666667,2,3,-1,2.26669388006849,4.31853631032462,-2.05184243025613,29,37,-8,34,44,-10,51,67,-16,5,3,0,0
"7032","COL","DET",2018020410,17867,20182019,0,60,2,0,2,7.87267308144146,2.81527161192935,5.05740146951211,29,24,5,36,29,7,45,45,0,1,2,0,0
"7033","COL","PIT",2018020419,17869,20182019,0,60,3,6,-3,5.64995186538727,3.56055619346444,2.08939567192283,45,32,13,62,39,23,78,54,24,4,4,0,0
"7034","COL","FLA",2018020430,17871,20182019,0,60,5,2,3,6.07856594318401,5.44795583368786,0.630610109496156,37,35,2,50,47,3,64,62,2,4,5,0,0
"7035","COL","T.B",2018020449,17873,20182019,0,60,1,7,-6,2.07867563886657,3.06636194640305,-0.987686307536478,30,38,-8,37,51,-14,50,67,-17,3,4,0,0
"7036","COL","EDM",2018020474,17876,20182019,1,60,4,6,-2,5.76974136554054,4.57310699253867,1.19663437300187,43,26,17,58,37,21,74,46,28,6,4,0,0
"7037","COL","STL",2018020492,17879,20182019,0,62.0833333333333,3,4,-1,4.88387758681477,7.45631276978714,-2.57243518297237,42,28,14,53,40,13,68,55,13,5,3,0,0
"7038","COL","DAL",2018020503,17880,20182019,1,60,6,4,2,4.81578783854815,5.54534676353462,-0.729558924986472,37,42,-5,42,49,-7,56,60,-4,7,3,0,0
"7039","COL","NYI",2018020516,17882,20182019,1,60,1,4,-3,3.89733969495865,4.89331436962402,-0.995974674665376,31,21,10,46,37,9,70,50,20,5,4,0,0
"7040","COL","MTL",2018020529,17884,20182019,1,60,2,1,1,2.57833089527048,4.9289699607465,-2.35063906547602,26,36,-10,33,55,-22,40,81,-41,4,4,0,0
"7041","COL","CHI",2018020544,17886,20182019,1,60,1,2,-1,4.55529457656667,2.63953796387068,1.91575661269599,36,28,8,52,33,19,74,41,33,5,3,0,0
"7042","COL","ARI",2018020555,17887,20182019,0,60,4,6,-2,5.86600273984391,6.62422511412098,-0.758222374277073,28,39,-11,45,50,-5,56,69,-13,4,2,0,0
"7043","COL","VGK",2018020577,17892,20182019,0,60,1,2,-1,5.0415055981025,9.70559210227673,-4.66408650417423,32,43,-11,42,56,-14,58,79,-21,4,4,0,0
"7044","COL","CHI",2018020595,17894,20182019,1,60.6833333333333,2,3,-1,3.81952030223329,4.3197685207997,-0.500248218566412,32,37,-5,43,45,-2,54,63,-9,3,4,0,0
"7045","COL","L.A",2018020607,17896,20182019,1,60.9,2,3,-1,5.46421524882317,4.25240147173463,1.21181377708854,24,18,6,35,31,4,55,39,16,3,3,0,0
"7046","COL","S.J",2018020619,17898,20182019,1,60,4,5,-1,4.22670676495181,4.81703363198488,-0.59032686703307,35,27,8,46,37,9,57,53,4,4,3,0,0
"7047","COL","NYR",2018020633,17900,20182019,1,60,6,1,5,6.04976955297267,5.63676684259553,0.413002710377136,47,25,22,59,32,27,78,41,37,8,5,0,0
"7048","COL","WPG",2018020665,17904,20182019,0,60,4,7,-3,5.09796978038895,2.22911243952694,2.86885734086201,41,21,20,62,32,30,80,48,32,5,4,0,0
"7049","COL","CGY",2018020669,17905,20182019,0,60,3,5,-2,4.28569562194753,2.19079111225437,2.09490450969315,35,16,19,57,31,26,79,42,37,4,2,0,0
"7050","COL","MTL",2018020691,17908,20182019,0,60,0,3,-3,4.60861927833739,5.50590917374018,-0.897289895402793,28,31,-3,36,48,-12,56,79,-23,5,4,0,0
"7051","COL","TOR",2018020706,17910,20182019,0,60,6,3,3,7.20216595388998,3.06599324918352,4.13617270470646,38,20,18,52,28,24,66,42,24,3,3,0,0
"7052","COL","OTT",2018020721,17912,20182019,0,60,2,5,-3,4.060998978938,5.05761822703062,-0.996619248092617,32,31,1,45,41,4,69,48,21,3,3,0,0
"7053","COL","L.A",2018020741,17915,20182019,1,60,7,1,6,3.35480445542839,4.03123564235284,-0.676431186924447,40,31,9,51,41,10,71,55,16,6,4,0,0
"7054","COL","NSH",2018020756,17917,20182019,1,60,1,4,-3,3.33043395359982,6.15397348216911,-2.82353952856929,36,27,9,51,32,19,72,40,32,6,4,0,0
"7055","COL","MIN",2018020767,17919,20182019,1,60,2,5,-3,3.20694284352696,3.86531486327294,-0.658372019745978,22,28,-6,38,38,0,62,60,2,2,5,0,0
"7056","COL","VAN",2018020800,17929,20182019,1,60,1,5,-4,3.47844641597476,3.08966796376469,0.388778452210073,35,26,9,47,37,10,68,45,23,3,2,0,0
"7057","COL","CBJ",2018020819,17932,20182019,1,60,3,6,-3,4.53121629563248,8.54001533754717,-4.0087990419147,30,37,-7,36,45,-9,50,59,-9,4,2,0,0
"7058","COL","WSH",2018020827,17934,20182019,0,64.2,3,4,-1,5.57520410916044,4.88431005288281,0.690894056277632,37,42,-5,50,59,-9,75,76,-1,3,5,0,0
"7059","COL","NYI",2018020841,17936,20182019,0,62.3833333333333,3,4,-1,4.29675861488272,6.42515375335825,-2.12839513847553,28,41,-13,40,53,-13,53,65,-12,2,4,0,0
"7060","COL","BOS",2018020853,17937,20182019,0,64.05,1,2,-1,3.67455642649116,5.19747951168169,-1.52292308519053,36,35,1,45,50,-5,63,62,1,4,5,0,0
"7061","COL","TOR",2018020873,17939,20182019,1,60,2,5,-3,2.64700385541175,3.08291790848216,-0.435914053070411,36,28,8,46,33,13,66,44,22,3,5,0,0
"7062","COL","WPG",2018020882,17941,20182019,0,60,4,1,3,6.52130109019345,5.74328280094778,0.778018289245665,35,25,10,43,41,2,56,60,-4,4,5,0,0
"7063","COL","STL",2018020894,17943,20182019,1,60,0,3,-3,2.93416823211825,4.51100207405398,-1.57683384193573,32,33,-1,43,43,0,55,59,-4,5,5,0,0
"7064","COL","VGK",2018020913,17945,20182019,1,60,3,0,3,3.77986293059084,4.01608326377641,-0.236220333185561,38,40,-2,49,46,3,56,66,-10,3,4,0,0
"7065","COL","WPG",2018020926,17947,20182019,1,60,7,1,6,4.40924373842312,3.42688094547875,0.982362792944367,46,27,19,57,36,21,74,52,22,9,8,0,0
"7066","COL","CHI",2018020942,17949,20182019,0,60,5,3,2,5.07573319599032,4.8893729088341,0.186360287156226,31,44,-13,35,50,-15,47,73,-26,4,4,0,0
"7067","COL","NSH",2018020951,17950,20182019,0,60,5,0,5,3.87722612149082,6.27411429496351,-2.39688817347269,21,38,-17,29,55,-26,34,74,-40,7,7,0,0
"7068","COL","FLA",2018020966,17952,20182019,1,60.4333333333333,3,4,-1,3.50368887305603,4.36065714372334,-0.856968270667309,39,38,1,46,45,1,58,67,-9,2,2,0,0
"7069","COL","VAN",2018020982,17954,20182019,1,65,2,2,0,6.52085360140175,7.07688646188974,-0.556032860487996,45,32,13,53,42,11,70,60,10,4,6,0,0
"7070","COL","S.J",2018020998,17956,20182019,0,60,3,4,-1,5.47094289127836,4.09182395434421,1.37911893693414,25,40,-15,40,53,-13,53,75,-22,2,3,0,0
"7071","COL","ANA",2018021012,17958,20182019,0,60,1,2,-1,3.46029791771434,4.62979084750987,-1.16949292979552,26,23,3,39,44,-5,54,64,-10,6,3,0,0
"7072","COL","DET",2018021026,17960,20182019,1,62.4833333333333,4,3,1,5.1610546346139,3.59966442611767,1.56139020849623,34,23,11,41,30,11,54,48,6,3,3,0,0
"7073","COL","DAL",2018021039,17962,20182019,0,60,0,4,-4,3.79817355443894,4.60016921580214,-0.8019956613632,31,33,-2,44,41,3,63,54,9,2,1,0,0
"7074","COL","BUF",2018021048,17964,20182019,1,60,3,0,3,6.47712912689894,2.90892630477902,3.56820282211993,43,18,25,54,27,27,76,38,38,5,3,0,0
"7075","COL","CAR",2018021070,17966,20182019,1,60,0,3,-3,4.18831115344074,3.8524495919502,0.335861561490537,38,33,5,46,45,1,56,60,-4,3,1,0,0
"7076","COL","ANA",2018021096,17970,20182019,1,60,3,5,-2,5.44875695380324,6.80824298944208,-1.35948603563884,44,37,7,50,45,5,65,57,8,4,3,0,0
"7077","COL","N.J",2018021111,17972,20182019,1,60,3,0,3,6.01366096219135,3.52305099963814,2.49060996255321,34,22,12,48,35,13,63,52,11,3,4,0,0
"7078","COL","MIN",2018021129,17974,20182019,0,60,3,1,2,6.35842664371748,8.65362583563547,-2.29519919191799,38,37,1,50,50,0,68,65,3,4,4,0,0
"7079","COL","DAL",2018021143,17976,20182019,0,60,3,1,2,6.27823584547878,5.88752753197332,0.390708313505456,32,45,-13,42,56,-14,54,81,-27,3,2,0,0
"7080","COL","CHI",2018021152,17978,20182019,1,60,4,2,2,6.00364232528955,5.0889218703669,0.914720454922644,25,31,-6,37,48,-11,49,67,-18,4,3,0,0
"7081","COL","CHI",2018021167,17979,20182019,0,61.3833333333333,1,2,-1,2.01799265820591,6.31290068613703,-4.29490802793111,20,42,-22,24,51,-27,47,75,-28,3,2,0,0
"7082","COL","VGK",2018021188,17982,20182019,1,60,4,3,1,3.71304513125754,4.19231461795516,-0.479269486697627,30,37,-7,35,51,-16,40,69,-29,4,5,0,0
"7083","COL","ARI",2018021200,17984,20182019,1,65,2,2,0,4.70426679853039,6.49954837601035,-1.79528157747996,27,44,-17,37,50,-13,48,71,-23,4,3,0,0
"7084","COL","STL",2018021225,17987,20182019,0,65,2,2,0,2.74721992167179,2.39906085579412,0.348159065877667,26,27,-1,39,37,2,48,56,-8,1,1,0,0
"7085","COL","EDM",2018021236,17988,20182019,1,60,6,2,4,3.10206722075236,3.67130836209981,-0.569241141347447,29,29,0,39,35,4,52,51,1,3,1,0,0
"7086","COL","WPG",2018021251,17990,20182019,1,61.8166666666667,3,2,1,6.33520671933702,3.98738336403039,2.34782335530662,38,36,2,49,46,3,63,68,-5,4,3,0,0
"7087","COL","S.J",2018021271,17992,20182019,0,60,2,5,-3,4.59273412459879,4.47362259973306,0.11911152486573,30,30,0,42,42,0,62,58,4,2,2,0,0
"7088","COL","CGY",2018030171,17997,20182019,0,60,0,4,-4,4.81640561248059,5.36691339684789,-0.550507784367299,26,32,-6,39,42,-3,58,60,-2,5,6,0,0
"7089","COL","CGY",2018030172,17999,20182019,0,68.45,3,2,1,5.21732228787084,5.47756694505934,-0.260244657188498,39,37,2,55,49,6,84,61,23,6,7,0,0
"7090","COL","CGY",2018030173,18001,20182019,1,60,6,2,4,4.60825964110438,3.80201122464464,0.806248416459738,56,29,27,65,41,24,80,61,19,9,8,0,0
"7091","COL","CGY",2018030174,18003,20182019,1,70.3833333333333,3,2,1,7.52921468167915,4.23184064304587,3.29737403863328,52,37,15,65,45,20,84,61,23,5,4,0,0
"7092","COL","CGY",2018030175,18005,20182019,0,60,5,1,4,2.44141186381398,3.64430843079413,-1.20289656698014,32,29,3,43,42,1,53,59,-6,5,4,0,0
"7093","COL","S.J",2018030241,18012,20182019,0,60,2,5,-3,5.19352530319884,4.33745445005688,0.856070853141961,28,27,1,37,38,-1,59,54,5,3,3,0,0
"7094","COL","S.J",2018030242,18014,20182019,0,60,4,3,1,4.00161459457013,4.14175350659934,-0.140138912029215,32,34,-2,44,43,1,60,68,-8,2,3,0,0
"7095","COL","S.J",2018030243,18016,20182019,1,60,2,4,-2,2.94955545585253,5.47451184563767,-2.52495638978514,27,31,-4,31,41,-10,49,60,-11,4,4,0,0
"7096","COL","S.J",2018030244,18018,20182019,1,60,3,0,3,3.35445179507178,2.6140491308997,0.74040266417208,28,32,-4,40,48,-8,54,68,-14,6,3,0,0
"7097","COL","S.J",2018030245,18020,20182019,0,60,1,2,-1,3.54761367567698,5.0375578747915,-1.48994419911452,22,39,-17,35,52,-17,54,74,-20,3,5,0,0
"7098","COL","S.J",2018030246,18022,20182019,1,62.5333333333333,4,3,1,2.96920566674817,3.27152905261028,-0.30232338586211,26,22,4,37,38,-1,57,61,-4,3,1,0,0
"7099","COL","S.J",2018030247,18024,20182019,0,60,2,3,-1,1.90307777602777,3.70719015737592,-1.80411238134815,29,27,2,39,37,2,56,55,1,3,3,0,0
"7100","DAL","CBJ",2008020015,14162,20082009,1,64.65,4,5,-1,0,0,0,31,27,4,45,34,11,61,42,19,8,4,0,0
"7101","DAL","NSH",2008020024,14163,20082009,0,60,1,3,-2,0,0,0,20,32,-12,32,47,-15,41,64,-23,7,9,0,0
"7102","DAL","NSH",2008020047,14167,20082009,1,60,6,4,2,0,0,0,28,19,9,44,32,12,60,44,16,6,6,0,0
"7103","DAL","STL",2008020054,14168,20082009,0,60,1,6,-5,0,0,0,30,23,7,42,37,5,52,44,8,4,5,0,0
"7104","DAL","COL",2008020063,14170,20082009,1,60,4,5,-1,0,0,0,30,22,8,46,30,16,61,40,21,5,8,0,0
"7105","DAL","NYR",2008020079,14172,20082009,0,60,2,1,1,0,0,0,27,29,-2,39,43,-4,47,59,-12,4,3,0,0
"7106","DAL","N.J",2008020088,14174,20082009,0,60,0,5,-5,0,0,0,21,29,-8,25,38,-13,35,46,-11,5,5,0,0
"7107","DAL","NYI",2008020093,14175,20082009,0,60,5,3,2,0,0,0,29,27,2,43,42,1,51,60,-9,7,6,0,0
"7108","DAL","WSH",2008020114,14177,20082009,1,62.2833333333333,5,6,-1,0,0,0,33,30,3,45,40,5,55,55,0,4,4,0,0
"7109","DAL","MIN",2008020134,14181,20082009,1,60,4,2,2,0,0,0,33,21,12,42,32,10,52,45,7,5,4,0,0
"7110","DAL","CHI",2008020148,14183,20082009,0,60,2,5,-3,0,0,0,23,32,-9,27,41,-14,41,53,-12,7,5,0,0
"7111","DAL","BOS",2008020151,14184,20082009,0,60,1,5,-4,0,0,0,36,25,11,42,35,7,47,46,1,11,12,0,0
"7112","DAL","ANA",2008020195,14190,20082009,0,60,5,2,3,0,0,0,26,30,-4,35,46,-11,39,53,-14,7,7,0,0
"7113","DAL","S.J",2008020206,14191,20082009,0,60,1,2,-1,0,0,0,24,33,-9,35,52,-17,44,69,-25,4,3,0,0
"7114","DAL","L.A",2008020219,14194,20082009,0,65,2,2,0,0,0,0,21,26,-5,39,34,5,53,49,4,3,6,0,0
"7115","DAL","L.A",2008020233,14196,20082009,1,60,2,3,-1,0,0,0,26,29,-3,36,41,-5,48,57,-9,5,9,0,0
"7116","DAL","ARI",2008020249,14198,20082009,0,60,3,2,1,0,0,0,19,27,-8,31,32,-1,45,47,-2,4,4,0,0
"7117","DAL","CHI",2008020275,14203,20082009,1,60,3,6,-3,0,0,0,34,30,4,46,46,0,52,52,0,3,5,0,0
"7118","DAL","ANA",2008020293,14205,20082009,1,65,1,1,0,0,0,0,32,24,8,55,36,19,64,45,19,9,7,0,0
"7119","DAL","PHI",2008020300,14207,20082009,0,60,3,4,-1,0,0,0,25,25,0,41,31,10,58,41,17,5,1,0,0
"7120","DAL","MIN",2008020317,14209,20082009,0,60,4,3,1,0,0,0,30,28,2,42,45,-3,55,53,2,4,4,0,0
"7121","DAL","S.J",2008020333,14211,20082009,1,60,2,6,-4,0,0,0,27,30,-3,39,37,2,51,43,8,6,6,0,0
"7122","DAL","EDM",2008020348,14213,20082009,1,60,4,3,1,0,0,0,26,28,-2,37,41,-4,49,54,-5,5,3,0,0
"7123","DAL","CGY",2008020358,14215,20082009,0,60,3,1,2,0,0,0,23,37,-14,29,49,-20,36,64,-28,3,1,0,0
"7124","DAL","EDM",2008020365,14216,20082009,0,60,2,5,-3,0,0,0,25,22,3,38,29,9,52,42,10,4,5,0,0
"7125","DAL","COL",2008020378,14218,20082009,1,65,1,1,0,0,0,0,24,27,-3,30,44,-14,48,64,-16,3,3,0,0
"7126","DAL","ARI",2008020411,14223,20082009,1,60,3,5,-2,0,0,0,32,34,-2,49,45,4,54,60,-6,7,6,0,0
"7127","DAL","DET",2008020426,14225,20082009,1,60,3,1,2,0,0,0,24,38,-14,32,53,-21,43,69,-26,4,4,0,0
"7128","DAL","NSH",2008020437,14226,20082009,0,60,0,3,-3,0,0,0,27,38,-11,36,44,-8,52,53,-1,5,3,0,0
"7129","DAL","ARI",2008020452,14229,20082009,1,63.65,2,1,1,0,0,0,30,23,7,44,33,11,63,49,14,3,4,0,0
"7130","DAL","CBJ",2008020467,14231,20082009,1,65,5,5,0,0,0,0,17,28,-11,28,46,-18,39,67,-28,5,5,0,0
"7131","DAL","OTT",2008020477,14233,20082009,0,63.5,4,5,-1,0,0,0,29,33,-4,42,45,-3,53,58,-5,4,6,0,0
"7132","DAL","TOR",2008020499,14236,20082009,0,60,8,2,6,0,0,0,37,22,15,50,32,18,58,48,10,4,2,0,0
"7133","DAL","ANA",2008020522,14240,20082009,1,63.5666666666667,4,3,1,0,0,0,38,22,16,57,34,23,68,44,24,6,3,0,0
"7134","DAL","S.J",2008020535,14242,20082009,1,60,1,3,-2,0,0,0,29,19,10,45,24,21,57,32,25,6,4,0,0
"7135","DAL","N.J",2008020551,14244,20082009,1,60,4,2,2,0,0,0,44,27,17,62,37,25,69,46,23,4,4,0,0
"7136","DAL","EDM",2008020573,14247,20082009,0,60,1,4,-3,0,0,0,39,19,20,60,34,26,83,41,42,6,5,0,0
"7137","DAL","VAN",2008020582,14248,20082009,0,65,2,2,0,0,0,0,36,35,1,48,45,3,59,54,5,3,2,0,0
"7138","DAL","DET",2008020603,14252,20082009,0,60,1,6,-5,0,0,0,23,33,-10,35,41,-6,42,50,-8,4,9,0,0
"7139","DAL","ARI",2008020623,14254,20082009,0,65,0,0,0,0,0,0,38,28,10,48,37,11,65,51,14,3,4,0,0
"7140","DAL","DET",2008020629,14256,20082009,1,61.85,5,4,1,0,0,0,49,30,19,61,41,20,75,50,25,6,5,0,0
"7141","DAL","BUF",2008020652,14259,20082009,1,65,4,4,0,0,0,0,25,35,-10,38,47,-9,45,66,-21,3,4,0,0
"7142","DAL","L.A",2008020662,14261,20082009,1,65,2,2,0,0,0,0,34,22,12,46,44,2,58,60,-2,4,5,0,0
"7143","DAL","T.B",2008020680,14263,20082009,0,60,2,4,-2,0,0,0,25,20,5,39,27,12,52,39,13,7,2,0,0
"7144","DAL","FLA",2008020697,14265,20082009,0,60,4,1,3,0,0,0,25,28,-3,33,38,-5,44,53,-9,2,1,0,0
"7145","DAL","ATL",2008020708,14271,20082009,1,60,2,0,2,0,0,0,33,25,8,44,31,13,57,36,21,5,2,0,0
"7146","DAL","DET",2008020720,14273,20082009,0,60,4,2,2,0,0,0,23,24,-1,30,39,-9,36,48,-12,7,7,0,0
"7147","DAL","CBJ",2008020736,14275,20082009,0,60,7,3,4,0,0,0,31,38,-7,40,53,-13,45,65,-20,4,5,0,0
"7148","DAL","CGY",2008020756,14278,20082009,1,60,3,1,2,0,0,0,32,25,7,41,39,2,49,52,-3,5,3,0,0
"7149","DAL","COL",2008020769,14280,20082009,0,60,2,3,-1,0,0,0,24,21,3,40,33,7,60,48,12,4,3,0,0
"7150","DAL","NYR",2008020776,14281,20082009,1,60,10,2,8,0,0,0,39,22,17,56,33,23,65,43,22,10,6,0,0
"7151","DAL","NSH",2008020792,14283,20082009,1,60,4,1,3,0,0,0,22,26,-4,31,40,-9,37,55,-18,3,3,0,0
"7152","DAL","ARI",2008020808,14286,20082009,1,60,0,1,-1,0,0,0,33,29,4,44,36,8,68,41,27,4,4,0,0
"7153","DAL","VAN",2008020823,14288,20082009,1,60,2,1,1,0,0,0,30,33,-3,40,48,-8,49,61,-12,4,4,0,0
"7154","DAL","CHI",2008020832,14289,20082009,0,60,2,6,-4,0,0,0,18,36,-18,25,49,-24,29,61,-32,1,4,0,0
"7155","DAL","CBJ",2008020842,14291,20082009,0,65,2,2,0,0,0,0,22,43,-21,37,55,-18,44,63,-19,3,6,0,0
"7156","DAL","EDM",2008020868,14294,20082009,1,60,4,2,2,0,0,0,25,23,2,38,31,7,48,41,7,10,10,0,0
"7157","DAL","CHI",2008020876,14296,20082009,1,60,1,3,-2,0,0,0,31,36,-5,45,52,-7,65,67,-2,6,5,0,0
"7158","DAL","S.J",2008020892,14298,20082009,1,60,0,1,-1,0,0,0,29,24,5,47,29,18,64,45,19,4,3,0,0
"7159","DAL","STL",2008020916,14301,20082009,1,60,1,3,-2,0,0,0,42,22,20,58,32,26,77,38,39,7,4,0,0
"7160","DAL","ANA",2008020925,14303,20082009,1,60,3,4,-1,0,0,0,33,18,15,44,29,15,54,41,13,5,3,0,0
"7161","DAL","PIT",2008020937,14304,20082009,1,60,1,4,-3,0,0,0,21,23,-2,29,30,-1,40,43,-3,6,6,0,0
"7162","DAL","S.J",2008020952,14306,20082009,0,60,4,1,3,0,0,0,31,25,6,46,38,8,55,52,3,7,7,0,0
"7163","DAL","L.A",2008020962,14308,20082009,0,61.5166666666667,4,5,-1,0,0,0,23,40,-17,33,55,-22,42,69,-27,3,10,0,0
"7164","DAL","ANA",2008020968,14309,20082009,0,60,3,2,1,0,0,0,16,38,-22,22,51,-29,27,63,-36,5,4,0,0
"7165","DAL","MTL",2008020984,14311,20082009,1,60,1,3,-2,0,0,0,31,19,12,51,28,23,75,36,39,11,4,0,0
"7166","DAL","STL",2008020998,14313,20082009,0,60,2,5,-3,0,0,0,22,27,-5,33,34,-1,42,41,1,8,8,0,0
"7167","DAL","CAR",2008021013,14315,20082009,1,60,3,2,1,0,0,0,31,31,0,39,49,-10,47,62,-15,3,4,0,0
"7168","DAL","MIN",2008021027,14317,20082009,1,62.3833333333333,3,2,1,0,0,0,29,30,-1,45,47,-2,59,60,-1,3,3,0,0
"7169","DAL","VAN",2008021049,14320,20082009,0,60,2,4,-2,0,0,0,26,25,1,36,28,8,46,34,12,8,3,0,0
"7170","DAL","CGY",2008021053,14321,20082009,0,60,1,2,-1,0,0,0,19,31,-12,29,43,-14,34,66,-32,3,5,0,0
"7171","DAL","S.J",2008021070,14324,20082009,0,60,2,5,-3,0,0,0,25,30,-5,43,39,4,53,53,0,4,4,0,0
"7172","DAL","VAN",2008021094,14327,20082009,1,60,2,5,-3,0,0,0,37,22,15,61,37,24,80,46,34,7,10,0,0
"7173","DAL","L.A",2008021108,14329,20082009,1,65,0,0,0,0,0,0,29,30,-1,46,38,8,57,46,11,6,5,0,0
"7174","DAL","FLA",2008021123,14331,20082009,1,60,3,6,-3,0,0,0,35,33,2,52,47,5,69,63,6,6,4,0,0
"7175","DAL","ARI",2008021136,14333,20082009,0,60.8833333333333,5,6,-1,0,0,0,23,33,-10,33,45,-12,48,55,-7,4,6,0,0
"7176","DAL","L.A",2008021143,14334,20082009,0,60,3,2,1,0,0,0,35,28,7,42,44,-2,53,57,-4,5,2,0,0
"7177","DAL","CGY",2008021154,14336,20082009,1,60,1,2,-1,0,0,0,30,24,6,41,38,3,53,46,7,3,2,0,0
"7178","DAL","STL",2008021171,14338,20082009,1,60.2666666666667,5,4,1,0,0,0,24,26,-2,33,49,-16,47,65,-18,2,5,0,0
"7179","DAL","MIN",2008021192,14341,20082009,0,60,1,3,-2,0,0,0,28,32,-4,43,42,1,51,51,0,2,5,0,0
"7180","DAL","COL",2008021207,14343,20082009,0,65,2,2,0,0,0,0,39,27,12,48,36,12,63,44,19,2,5,0,0
"7181","DAL","ANA",2008021213,14344,20082009,0,65,3,3,0,0,0,0,45,39,6,59,53,6,68,65,3,4,4,0,0
"7182","DAL","NSH",2009020019,14520,20092010,1,65,2,2,0,0,0,0,40,26,14,64,32,32,79,45,34,6,4,0,0
"7183","DAL","EDM",2009020031,14523,20092010,0,65,4,4,0,0,0,0,34,24,10,52,35,17,69,52,17,7,5,0,0
"7184","DAL","CGY",2009020048,14526,20092010,0,60,5,2,3,0,0,0,30,23,7,43,38,5,53,48,5,3,5,0,0
"7185","DAL","VAN",2009020063,14528,20092010,0,65,3,3,0,0,0,0,35,25,10,40,34,6,52,46,6,5,4,0,0
"7186","DAL","NSH",2009020078,14531,20092010,1,60,6,0,6,0,0,0,26,29,-3,35,48,-13,45,59,-14,4,4,0,0
"7187","DAL","BOS",2009020090,14533,20092010,1,60,0,3,-3,0,0,0,27,29,-2,39,40,-1,63,56,7,3,1,0,0
"7188","DAL","CHI",2009020102,14534,20092010,0,60,4,3,1,0,0,0,25,32,-7,32,41,-9,47,54,-7,5,5,0,0
"7189","DAL","L.A",2009020107,14536,20092010,1,60,1,4,-3,0,0,0,30,32,-2,42,44,-2,53,50,3,4,5,0,0
"7190","DAL","ANA",2009020117,14538,20092010,0,60,4,2,2,0,0,0,38,26,12,43,45,-2,51,53,-2,3,1,0,0
"7191","DAL","L.A",2009020126,14539,20092010,0,60.9166666666667,4,5,-1,0,0,0,21,31,-10,33,46,-13,42,56,-14,5,6,0,0
"7192","DAL","STL",2009020138,14541,20092010,0,60,4,1,3,0,0,0,31,28,3,42,44,-2,53,58,-5,10,8,0,0
"7193","DAL","TOR",2009020162,14545,20092010,1,62.95,4,3,1,0,0,0,36,36,0,46,52,-6,61,65,-4,3,2,0,0
"7194","DAL","FLA",2009020177,14547,20092010,1,65,5,5,0,0,0,0,37,29,8,51,39,12,83,55,28,6,2,0,0
"7195","DAL","NSH",2009020188,14548,20092010,0,60,2,4,-2,0,0,0,29,33,-4,32,46,-14,49,60,-11,7,5,0,0
"7196","DAL","CGY",2009020207,14552,20092010,1,61.4166666666667,2,3,-1,0,0,0,40,23,17,52,34,18,67,55,12,6,4,0,0
"7197","DAL","VAN",2009020223,14554,20092010,1,60,2,1,1,0,0,0,47,33,14,69,45,24,79,53,26,3,2,0,0
"7198","DAL","MIN",2009020234,14555,20092010,0,60,2,3,-1,0,0,0,21,37,-16,33,48,-15,43,59,-16,7,6,0,0
"7199","DAL","S.J",2009020261,14560,20092010,0,65,2,2,0,0,0,0,36,32,4,48,45,3,62,69,-7,6,4,0,0
"7200","DAL","ARI",2009020278,14562,20092010,0,60,2,3,-1,0,0,0,28,31,-3,36,42,-6,47,61,-14,6,3,0,0
"7201","DAL","DET",2009020295,14566,20092010,0,60,3,1,2,0,0,0,32,32,0,47,45,2,54,57,-3,6,5,0,0
"7202","DAL","CBJ",2009020304,14567,20092010,1,60,1,4,-3,0,0,0,26,28,-2,33,41,-8,45,53,-8,7,7,0,0
"7203","DAL","N.J",2009020322,14569,20092010,1,60,5,3,2,0,0,0,26,34,-8,37,43,-6,60,56,4,4,5,0,0
"7204","DAL","CAR",2009020334,14571,20092010,1,60,2,0,2,0,0,0,29,22,7,38,29,9,57,42,15,9,5,0,0
"7205","DAL","STL",2009020347,14573,20092010,1,65,3,3,0,0,0,0,37,38,-1,54,53,1,64,67,-3,6,3,0,0
"7206","DAL","ARI",2009020366,14575,20092010,0,60,2,5,-3,0,0,0,32,29,3,42,38,4,51,49,2,5,2,0,0
"7207","DAL","T.B",2009020376,14576,20092010,1,62.2,4,3,1,0,0,0,38,28,10,49,36,13,58,43,15,7,4,0,0
"7208","DAL","DET",2009020388,14578,20092010,0,60,1,4,-3,0,0,0,30,32,-2,39,39,0,54,45,9,4,4,0,0
"7209","DAL","ANA",2009020405,14581,20092010,1,60,3,1,2,0,0,0,37,27,10,50,39,11,63,53,10,4,1,0,0
"7210","DAL","EDM",2009020414,14583,20092010,1,65,2,2,0,0,0,0,35,36,-1,53,52,1,69,72,-3,2,3,0,0
"7211","DAL","ANA",2009020441,14586,20092010,0,64.2166666666667,3,4,-1,0,0,0,22,42,-20,31,54,-23,47,70,-23,4,1,0,0
"7212","DAL","S.J",2009020465,14589,20092010,0,65,2,2,0,0,0,0,44,35,9,64,54,10,80,64,16,8,5,0,0
"7213","DAL","L.A",2009020477,14590,20092010,0,65,2,2,0,0,0,0,27,27,0,43,42,1,52,56,-4,5,3,0,0
"7214","DAL","CAR",2009020496,14594,20092010,0,60,3,5,-2,0,0,0,27,29,-2,38,37,1,51,50,1,3,5,0,0
"7215","DAL","ATL",2009020505,14595,20092010,0,61.2666666666667,5,6,-1,0,0,0,47,25,22,54,32,22,71,47,24,4,4,0,0
"7216","DAL","DET",2009020518,14597,20092010,1,60,4,3,1,0,0,0,21,33,-12,25,49,-24,33,63,-30,2,2,0,0
"7217","DAL","S.J",2009020539,14599,20092010,1,60,2,4,-2,0,0,0,38,32,6,58,44,14,66,53,13,6,1,0,0
"7218","DAL","CBJ",2009020554,14601,20092010,1,60,3,1,2,0,0,0,28,34,-6,41,54,-13,59,78,-19,6,6,0,0
"7219","DAL","COL",2009020567,14604,20092010,0,60,1,4,-3,0,0,0,40,33,7,55,42,13,70,57,13,1,3,0,0
"7220","DAL","CHI",2009020587,14607,20092010,1,60,5,4,1,0,0,0,24,37,-13,31,54,-23,41,73,-32,5,4,0,0
"7221","DAL","ANA",2009020606,14609,20092010,1,60,5,3,2,0,0,0,42,34,8,65,44,21,71,56,15,4,2,0,0
"7222","DAL","VAN",2009020612,14611,20092010,1,60,1,3,-2,0,0,0,32,27,5,47,43,4,58,57,1,2,2,0,0
"7223","DAL","N.J",2009020630,14614,20092010,0,60,0,4,-4,0,0,0,28,27,1,38,40,-2,49,48,1,4,5,0,0
"7224","DAL","NYR",2009020640,14615,20092010,0,60,2,5,-3,0,0,0,27,25,2,35,37,-2,51,47,4,6,6,0,0
"7225","DAL","CBJ",2009020674,14619,20092010,0,60,0,2,-2,0,0,0,26,41,-15,33,54,-21,43,65,-22,5,5,0,0
"7226","DAL","PHI",2009020683,14621,20092010,0,60,3,6,-3,0,0,0,30,28,2,41,34,7,59,43,16,5,4,0,0
"7227","DAL","MTL",2009020696,14623,20092010,0,60,3,5,-2,0,0,0,36,28,8,46,36,10,65,53,12,4,3,0,0
"7228","DAL","DET",2009020708,14625,20092010,1,65,2,2,0,0,0,0,30,28,2,43,45,-2,56,58,-2,3,1,0,0
"7229","DAL","MIN",2009020730,14627,20092010,1,60,4,3,1,0,0,0,29,25,4,41,41,0,51,51,0,5,4,0,0
"7230","DAL","VAN",2009020754,14630,20092010,0,60,3,4,-1,0,0,0,23,23,0,29,30,-1,41,47,-6,2,3,0,0
"7231","DAL","EDM",2009020759,14631,20092010,0,60,4,3,1,0,0,0,32,38,-6,44,55,-11,53,77,-24,4,4,0,0
"7232","DAL","COL",2009020774,14633,20092010,0,60,0,4,-4,0,0,0,27,36,-9,35,47,-12,43,55,-12,4,5,0,0
"7233","DAL","CGY",2009020791,14636,20092010,1,65,3,3,0,0,0,0,36,26,10,50,50,0,70,70,0,6,1,0,0
"7234","DAL","COL",2009020806,14638,20092010,1,60,3,2,1,0,0,0,31,26,5,46,41,5,59,64,-5,2,1,0,0
"7235","DAL","ARI",2009020821,14640,20092010,1,60,2,4,-2,0,0,0,40,31,9,57,41,16,73,52,21,2,1,0,0
"7236","DAL","MIN",2009020832,14642,20092010,1,60,4,2,2,0,0,0,18,42,-24,27,62,-35,37,77,-40,3,4,0,0
"7237","DAL","CBJ",2009020843,14644,20092010,0,60,1,2,-1,0,0,0,23,26,-3,30,34,-4,43,43,0,3,0,0,0
"7238","DAL","ARI",2009020858,14646,20092010,1,60,4,0,4,0,0,0,35,34,1,49,52,-3,58,68,-10,3,6,0,0
"7239","DAL","CHI",2009020882,14649,20092010,0,65,3,3,0,0,0,0,27,40,-13,37,49,-12,51,63,-12,5,3,0,0
"7240","DAL","CGY",2009020896,14651,20092010,0,60,3,1,2,0,0,0,23,34,-11,33,46,-13,40,66,-26,5,5,0,0
"7241","DAL","ARI",2009020912,14653,20092010,0,60,3,0,3,0,0,0,22,40,-18,26,55,-29,39,73,-34,3,4,0,0
"7242","DAL","L.A",2009020932,14670,20092010,1,60,1,5,-4,0,0,0,32,22,10,58,39,19,81,56,25,6,4,0,0
"7243","DAL","STL",2009020947,14672,20092010,1,60,1,6,-5,0,0,0,30,27,3,42,43,-1,57,62,-5,4,4,0,0
"7244","DAL","PIT",2009020955,14674,20092010,0,60,3,6,-3,0,0,0,30,34,-4,41,49,-8,55,69,-14,6,5,0,0
"7245","DAL","WSH",2009020974,14676,20092010,0,65,3,3,0,0,0,0,26,52,-26,40,69,-29,63,96,-33,2,3,0,0
"7246","DAL","BUF",2009020985,14678,20092010,0,60,3,5,-2,0,0,0,20,43,-23,29,54,-25,41,75,-34,2,2,0,0
"7247","DAL","L.A",2009021004,14680,20092010,1,65,1,1,0,0,0,0,30,28,2,51,42,9,62,52,10,5,5,0,0
"7248","DAL","COL",2009021016,14682,20092010,1,60,3,5,-2,0,0,0,51,22,29,64,34,30,77,41,36,5,3,0,0
"7249","DAL","S.J",2009021037,14684,20092010,1,60,8,2,6,0,0,0,31,47,-16,41,65,-24,50,80,-30,6,4,0,0
"7250","DAL","PHI",2009021050,14686,20092010,1,60,2,3,-1,0,0,0,29,31,-2,45,39,6,63,57,6,4,2,0,0
"7251","DAL","OTT",2009021058,14688,20092010,1,60,5,4,1,0,0,0,25,29,-4,30,40,-10,48,62,-14,4,5,0,0
"7252","DAL","ARI",2009021074,14689,20092010,1,65,2,2,0,0,0,0,32,35,-3,44,54,-10,57,70,-13,3,6,0,0
"7253","DAL","NSH",2009021085,14691,20092010,0,60,3,1,2,0,0,0,14,35,-21,22,46,-24,32,70,-38,4,6,0,0
"7254","DAL","S.J",2009021106,14693,20092010,0,60,0,3,-3,0,0,0,27,41,-14,38,53,-15,47,64,-17,4,8,0,0
"7255","DAL","L.A",2009021121,14695,20092010,0,60,4,1,3,0,0,0,26,30,-4,39,49,-10,43,60,-17,8,8,0,0
"7256","DAL","ANA",2009021132,14697,20092010,0,60,1,3,-2,0,0,0,31,46,-15,43,55,-12,50,66,-16,2,5,0,0
"7257","DAL","S.J",2009021146,14699,20092010,1,60,5,1,4,0,0,0,29,30,-1,46,45,1,58,54,4,7,6,0,0
"7258","DAL","EDM",2009021161,14701,20092010,1,60,6,3,3,0,0,0,35,28,7,51,45,6,61,57,4,3,6,0,0
"7259","DAL","STL",2009021172,14702,20092010,0,60,1,2,-1,0,0,0,25,23,2,36,31,5,48,46,2,6,7,0,0
"7260","DAL","CHI",2009021189,14705,20092010,1,60,2,5,-3,0,0,0,28,38,-10,46,51,-5,64,63,1,5,2,0,0
"7261","DAL","ANA",2009021203,14707,20092010,1,65,2,2,0,0,0,0,51,19,32,68,36,32,90,49,41,3,3,0,0
"7262","DAL","MIN",2009021220,14709,20092010,0,65,3,3,0,0,0,0,26,27,-1,35,40,-5,46,46,0,4,3,0,0
"7263","DAL","N.J",2010020007,14890,20102011,0,61.6,4,3,1,2.70482597217051,3.92179460213811,-1.2169686299676,28,30,-2,40,36,4,48,44,4,3,3,0,0
"7264","DAL","NYI",2010020015,14891,20102011,0,65,4,4,0,3.00816223930451,7.16903303560113,-4.16087079629662,22,47,-25,33,69,-36,49,82,-33,7,8,0,0
"7265","DAL","DET",2010020046,14896,20102011,1,60,4,1,3,3.40502981765793,5.57956453392399,-2.17453471626605,15,26,-11,28,45,-17,39,64,-25,3,5,0,0
"7266","DAL","STL",2010020062,14898,20102011,1,65,2,2,0,2.06581340441395,5.18374674688675,-3.1179333424728,25,43,-18,32,55,-23,42,72,-30,5,5,0,0
"7267","DAL","T.B",2010020072,14900,20102011,0,60,4,5,-1,2.20194305499535,3.1608460706193,-0.958903015623946,19,44,-25,26,54,-28,45,68,-23,5,5,0,0
"7268","DAL","FLA",2010020088,14903,20102011,0,60,4,1,3,3.70098315038194,3.63708569543451,0.0638974549474369,29,28,1,41,40,1,49,50,-1,2,3,0,0
"7269","DAL","NSH",2010020106,14905,20102011,1,60,0,1,-1,4.26663057434604,2.00235356795599,2.26427700639005,30,24,6,43,32,11,58,44,14,3,2,0,0
"7270","DAL","ANA",2010020121,14908,20102011,1,60,2,5,-3,2.71518343509524,2.96547862432931,-0.250295189234066,37,26,11,48,37,11,62,44,18,5,2,0,0
"7271","DAL","L.A",2010020135,14910,20102011,1,60,2,5,-3,3.23763825464994,2.95278914601658,0.284849108633352,32,24,8,51,30,21,66,43,23,7,4,0,0
"7272","DAL","BUF",2010020151,14912,20102011,1,60,4,0,4,7.01783568785322,5.81660094218387,1.20123474566935,41,34,7,67,46,21,74,59,15,7,2,0,0
"7273","DAL","PIT",2010020169,14916,20102011,1,60,5,2,3,4.68034154643829,5.6646065621147,-0.984265015676413,29,23,6,41,36,5,56,63,-7,8,6,0,0
"7274","DAL","ARI",2010020184,14918,20102011,1,60,6,3,3,3.89170982053474,2.49100234242894,1.4007074781058,31,28,3,41,35,6,56,48,8,6,5,0,0
"7275","DAL","COL",2010020195,14919,20102011,0,60,0,5,-5,0,0,0,31,45,-14,40,53,-13,50,60,-10,7,6,0,0
"7276","DAL","L.A",2010020225,14924,20102011,0,60,1,3,-2,2.62174992537695,4.27035178197548,-1.64860185659853,28,29,-1,44,44,0,55,53,2,6,7,0,0
"7277","DAL","ANA",2010020232,14925,20102011,0,60,2,4,-2,3.58511625826941,5.38815115419129,-1.80303489592188,29,37,-8,37,47,-10,47,54,-7,3,3,0,0
"7278","DAL","ANA",2010020256,14929,20102011,1,60,2,1,1,3.85397127052853,3.4054432362798,0.448528034248724,26,27,-1,40,38,2,55,50,5,6,7,0,0
"7279","DAL","S.J",2010020273,14931,20102011,1,62.8666666666667,5,4,1,4.39443488968391,6.66387239603383,-2.26943750634992,41,39,2,51,60,-9,62,71,-9,4,4,0,0
"7280","DAL","COL",2010020291,14933,20102011,1,65,3,3,0,3.49536221103699,5.89871008199088,-2.40334787095389,29,26,3,41,39,2,57,55,2,5,5,0,0
"7281","DAL","TOR",2010020298,14935,20102011,0,60,1,4,-3,3.85546382528264,5.01703825961704,-1.1615744343344,22,26,-4,40,40,0,67,58,9,2,1,0,0
"7282","DAL","OTT",2010020312,14937,20102011,0,60,2,1,1,3.8318116744922,2.46913148668165,1.36268018781055,26,19,7,38,30,8,49,46,3,5,3,0,0
"7283","DAL","STL",2010020332,14939,20102011,1,60,3,2,1,2.69035892962711,3.4754115783962,-0.785052648769096,22,27,-5,37,39,-2,53,52,1,3,1,0,0
"7284","DAL","STL",2010020339,14940,20102011,0,60,2,1,1,5.51757067305152,6.52223139220951,-1.00466071915798,23,36,-13,25,51,-26,30,68,-38,4,3,0,0
"7285","DAL","CAR",2010020349,14942,20102011,0,60,4,1,3,4.03004588740441,4.88055200286908,-0.850506115464668,33,28,5,41,44,-3,54,63,-9,6,8,0,0
"7286","DAL","WSH",2010020371,14945,20102011,1,60,2,1,1,2.10912845554371,3.85569079711195,-1.74656234156824,21,38,-17,32,60,-28,48,82,-34,6,3,0,0
"7287","DAL","MIN",2010020387,14947,20102011,1,63.6166666666667,4,3,1,5.9635991922114,4.30756772786845,1.65603146434296,33,31,2,51,48,3,66,66,0,7,4,0,0
"7288","DAL","CBJ",2010020400,14949,20102011,0,65,2,2,0,2.97715496303863,5.5611014708993,-2.58394650786067,18,29,-11,35,40,-5,53,49,4,4,3,0,0
"7289","DAL","CHI",2010020409,14951,20102011,0,60,3,5,-2,4.09097914683142,4.77223476086147,-0.68125561403005,31,25,6,37,36,1,47,51,-4,1,6,0,0
"7290","DAL","CAR",2010020422,14953,20102011,1,65,1,1,0,5.71437141182124,2.20768328910572,3.50668812271553,29,23,6,49,34,15,65,52,13,4,5,0,0
"7291","DAL","ARI",2010020434,14954,20102011,0,60,2,5,-3,3.96319141855929,3.9176586490132,0.0455327695460896,35,34,1,51,45,6,61,60,1,7,4,0,0
"7292","DAL","S.J",2010020446,14956,20102011,0,65,2,2,0,3.7331860292179,9.15771216223948,-5.42452613302157,31,33,-2,45,43,2,61,59,2,3,1,0,0
"7293","DAL","S.J",2010020466,14959,20102011,1,61.3333333333333,3,4,-1,2.64610473911807,5.99612456836621,-3.35001982924814,18,43,-25,25,60,-35,41,77,-36,2,6,0,0
"7294","DAL","CBJ",2010020478,14961,20102011,0,60,2,1,1,5.07393576902922,6.42140101705445,-1.34746524802523,23,36,-13,41,46,-5,49,58,-9,10,9,0,0
"7295","DAL","DET",2010020485,14962,20102011,0,64.3,4,3,1,6.52480044031205,2.48026695795349,4.04453348235856,32,31,1,44,47,-3,58,60,-2,6,4,0,0
"7296","DAL","MTL",2010020499,14964,20102011,1,60,5,2,3,2.68019871737147,4.7724480741017,-2.09224935673024,17,29,-12,28,53,-25,38,73,-35,3,5,0,0
"7297","DAL","CGY",2010020515,14966,20102011,1,65,2,2,0,3.99365121712123,3.44236692640698,0.55128429071425,16,33,-17,29,43,-14,44,55,-11,3,4,0,0
"7298","DAL","ARI",2010020527,14969,20102011,1,60,0,1,-1,4.91042793601719,3.5170628015585,1.39336513445869,30,25,5,45,35,10,61,52,9,2,3,0,0
"7299","DAL","NSH",2010020541,14971,20102011,0,60,4,2,2,4.33197512704646,4.94688735099044,-0.614912223943975,25,46,-21,28,52,-24,36,77,-41,5,7,0,0
"7300","DAL","DET",2010020549,14972,20102011,1,60,3,7,-4,3.35569810681045,5.84778467145225,-2.4920865646418,31,26,5,46,38,8,50,52,-2,4,3,0,0
"7301","DAL","VAN",2010020564,14974,20102011,1,60,1,4,-3,6.3683106500539,2.07779643051387,4.29051421954003,45,22,23,62,29,33,80,41,39,5,7,0,0
"7302","DAL","STL",2010020576,14976,20102011,0,60,4,2,2,3.12021590532731,3.23630033875816,-0.116084433430842,27,30,-3,40,40,0,56,60,-4,2,2,0,0
"7303","DAL","CHI",2010020594,14979,20102011,0,60,4,2,2,3.87562595144846,6.05113001605787,-2.17550406460941,22,37,-15,27,51,-24,36,71,-35,3,5,0,0
"7304","DAL","NYR",2010020608,14981,20102011,1,65,2,2,0,5.231823081827,3.97788192178086,1.25394116004613,30,31,-1,45,37,8,58,51,7,4,4,0,0
"7305","DAL","MIN",2010020625,14983,20102011,0,60,4,0,4,4.16203413989437,3.57190026774682,0.590133872147546,28,26,2,40,35,5,50,46,4,3,2,0,0
"7306","DAL","EDM",2010020640,14985,20102011,1,60,3,2,1,2.48661050561959,6.69400519980422,-4.20739469418463,20,41,-21,35,51,-16,42,66,-24,5,5,0,0
"7307","DAL","ATL",2010020668,14989,20102011,1,60,6,1,5,4.23618669854477,3.08955999937006,1.14662669917471,27,30,-3,41,41,0,54,55,-1,4,3,0,0
"7308","DAL","L.A",2010020682,14991,20102011,1,60,2,1,1,2.5974653797457,2.2903408514976,0.307124528248096,27,24,3,40,30,10,53,45,8,5,2,0,0
"7309","DAL","EDM",2010020705,14994,20102011,0,60,4,2,2,4.98457733122632,3.66499756937581,1.31957976185051,24,32,-8,30,43,-13,44,59,-15,3,4,0,0
"7310","DAL","CGY",2010020711,14995,20102011,0,60,4,7,-3,4.59488765889546,4.93129055102378,-0.336402892128319,21,19,2,35,29,6,41,41,0,3,3,0,0
"7311","DAL","VAN",2010020732,14998,20102011,0,60,1,7,-6,4.86608949188667,4.418361628226,0.447727863660665,26,36,-10,34,47,-13,45,61,-16,8,11,0,0
"7312","DAL","EDM",2010020746,15000,20102011,1,60,3,1,2,3.95043656689813,5.47925349770958,-1.52881693081144,21,35,-14,35,49,-14,50,65,-15,8,7,0,0
"7313","DAL","VAN",2010020762,15006,20102011,1,60,1,4,-3,4.95071253046626,3.39396442184412,1.55674810862214,26,26,0,46,39,7,62,55,7,5,3,0,0
"7314","DAL","BOS",2010020770,15008,20102011,0,60,3,6,-3,2.65038201385401,5.83781250659036,-3.18743049273635,33,35,-2,44,50,-6,57,63,-6,3,5,0,0
"7315","DAL","PHI",2010020787,15010,20102011,0,60,1,3,-2,3.08728425372101,4.14720103096114,-1.05991677724013,31,32,-1,37,42,-5,61,57,4,3,3,0,0
"7316","DAL","ARI",2010020812,15014,20102011,1,61.2166666666667,2,3,-1,5.39153983221331,4.36188108000351,1.0296587522098,18,35,-17,33,45,-12,51,61,-10,4,6,0,0
"7317","DAL","CHI",2010020827,15016,20102011,1,65,3,3,0,6.70887359662743,4.27770603063982,2.43116756598761,35,26,9,50,38,12,65,52,13,7,7,0,0
"7318","DAL","CBJ",2010020839,15018,20102011,1,60,1,2,-1,2.95617266307818,5.79209874181574,-2.83592607873756,30,39,-9,39,47,-8,54,60,-6,6,2,0,0
"7319","DAL","EDM",2010020854,15020,20102011,0,60,1,4,-3,3.88807694071255,2.2008291259408,1.68724781477175,25,30,-5,42,38,4,68,54,14,3,6,0,0
"7320","DAL","CGY",2010020861,15021,20102011,0,60,2,4,-2,4.18532634659277,3.55621000609244,0.629116340500332,24,31,-7,42,44,-2,60,60,0,2,3,0,0
"7321","DAL","VAN",2010020884,15024,20102011,0,60,2,5,-3,4.00903545803158,3.90245009658679,0.106585361444786,24,38,-14,39,49,-10,55,66,-11,4,3,0,0
"7322","DAL","N.J",2010020900,15027,20102011,1,60,0,1,-1,2.69305052374561,3.10346335959229,-0.41041283584668,19,23,-4,32,32,0,47,43,4,3,4,0,0
"7323","DAL","DET",2010020910,15029,20102011,0,60,4,1,3,4.6180654427983,5.51886534466757,-0.900799901869277,25,39,-14,32,58,-26,37,70,-33,6,9,0,0
"7324","DAL","NSH",2010020924,15031,20102011,1,60,3,2,1,2.84732858822467,1.65622914935238,1.19109943887228,25,27,-2,40,40,0,54,64,-10,5,3,0,0
"7325","DAL","ARI",2010020949,15034,20102011,0,60,3,2,1,5.42059099929202,4.98524737416301,0.435343625129008,30,27,3,46,43,3,58,57,1,5,2,0,0
"7326","DAL","ANA",2010020972,15037,20102011,0,64.9333333333333,3,4,-1,4.8863967579673,5.42915648929193,-0.542759731324622,26,29,-3,37,39,-2,47,49,-2,5,5,0,0
"7327","DAL","S.J",2010020982,15038,20102011,0,60,3,2,1,3.74180418847573,4.74614582244658,-1.00434163397085,28,31,-3,44,49,-5,56,73,-17,4,6,0,0
"7328","DAL","L.A",2010020991,15040,20102011,0,60.6333333333333,4,3,1,3.7690372902598,3.1280061276484,0.641031162611398,22,23,-1,35,37,-2,45,56,-11,5,4,0,0
"7329","DAL","CGY",2010021006,15042,20102011,1,65,3,3,0,5.34053438669753,6.13329681174332,-0.792762425045794,34,34,0,48,46,2,63,57,6,3,1,0,0
"7330","DAL","MIN",2010021021,15044,20102011,1,60,4,0,4,5.60344218073533,2.48639737709891,3.11704480363642,31,14,17,39,29,10,54,48,6,4,3,0,0
"7331","DAL","L.A",2010021035,15046,20102011,1,60,2,3,-1,4.11111629835796,3.67609944500146,0.435016853356501,23,30,-7,42,39,3,60,47,13,4,4,0,0
"7332","DAL","S.J",2010021049,15048,20102011,1,60,3,6,-3,6.4607620242366,9.82594818365578,-3.36518615941918,37,39,-2,57,54,3,78,67,11,4,3,0,0
"7333","DAL","CHI",2010021061,15050,20102011,1,60,5,0,5,4.36700060957128,4.16733742564067,0.19966318393061,27,23,4,37,33,4,48,47,1,5,3,0,0
"7334","DAL","PHI",2010021076,15052,20102011,1,65,2,2,0,6.13188677519793,2.84354311092271,3.28834366427522,30,30,0,50,39,11,73,51,22,5,2,0,0
"7335","DAL","ANA",2010021100,15056,20102011,1,61.7,3,4,-1,7.75909998309133,4.47306597593706,3.28603400715427,26,26,0,42,38,4,54,50,4,3,4,0,0
"7336","DAL","NSH",2010021123,15059,20102011,0,60,2,4,-2,4.55543624039274,4.86991661092907,-0.31448037053633,30,32,-2,44,42,2,56,54,2,4,2,0,0
"7337","DAL","ARI",2010021144,15062,20102011,0,65,1,1,0,6.85934242479561,3.38707448495552,3.47226793984009,45,27,18,59,41,18,72,55,17,2,1,0,0
"7338","DAL","S.J",2010021159,15064,20102011,0,60,0,6,-6,5.46991796027269,8.83072197460368,-3.36080401433099,29,52,-23,39,64,-25,56,83,-27,3,3,0,0
"7339","DAL","L.A",2010021167,15066,20102011,0,60,1,3,-2,6.46328721320606,7.55433691421786,-1.0910497010118,25,32,-7,46,45,1,55,62,-7,1,1,0,0
"7340","DAL","ANA",2010021181,15067,20102011,0,60,4,3,1,3.05535308574326,4.3435199605301,-1.28816687478684,31,27,4,40,38,2,57,49,8,6,3,0,0
"7341","DAL","CBJ",2010021191,15069,20102011,1,60,3,0,3,6.42474954598583,5.24048164737317,1.18426789861266,30,23,7,48,38,10,65,50,15,6,3,0,0
"7342","DAL","COL",2010021203,15071,20102011,1,60,4,2,2,3.88704001501901,2.4600024335976,1.42703758142142,37,23,14,50,31,19,60,46,14,5,1,0,0
"7343","DAL","COL",2010021211,15072,20102011,0,60,3,2,1,4.58525120018749,2.84061364317313,1.74463755701436,28,17,11,41,27,14,54,45,9,3,1,0,0
"7344","DAL","MIN",2010021230,15074,20102011,0,60,3,5,-2,4.64282597834244,4.00511622773558,0.637709750606859,29,23,6,38,32,6,48,46,2,5,2,0,0
"7345","DAL","CHI",2011020008,15254,20112012,1,60,2,1,1,0,0,0,33,38,-5,42,54,-12,56,68,-12,2,4,0,0
"7346","DAL","CHI",2011020017,15255,20112012,0,60,2,5,-3,2.94187077259862,7.4496888415888,-4.50781806899018,21,31,-10,30,44,-14,43,51,-8,5,7,0,0
"7347","DAL","ARI",2011020031,15257,20112012,1,65,1,1,0,4.08770621968128,7.90985790431932,-3.82215168463804,25,41,-16,39,65,-26,56,85,-29,7,7,0,0
"7348","DAL","STL",2011020046,15260,20112012,1,60,3,2,1,1.73170340781987,6.26428706875677,-4.5325836609369,24,38,-14,34,57,-23,42,77,-35,8,7,0,0
"7349","DAL","CBJ",2011020059,15262,20112012,1,60,4,2,2,2.04099578152056,1.5618496017162,0.479146179804369,33,15,18,44,24,20,58,41,17,5,6,0,0
"7350","DAL","CBJ",2011020071,15265,20112012,0,60,3,2,1,4.74963992967969,3.96741323731158,0.782226692368113,18,40,-22,26,52,-26,27,59,-32,2,5,0,0
"7351","DAL","ANA",2011020094,15268,20112012,0,60,3,1,2,3.81696816440672,5.21388661941091,-1.3969184550042,19,36,-17,28,52,-24,37,69,-32,2,5,0,0
"7352","DAL","L.A",2011020108,15269,20112012,0,60,0,1,-1,6.02764497778844,3.16917171334353,2.85847326444491,28,24,4,46,34,12,57,60,-3,3,3,0,0
"7353","DAL","ARI",2011020120,15272,20112012,0,65,2,2,0,4.66454806004185,4.15508437722472,0.509463682817135,36,35,1,44,48,-4,57,69,-12,4,3,0,0
"7354","DAL","L.A",2011020133,15274,20112012,1,60,3,5,-2,2.77061120734137,3.42958393640242,-0.65897272906105,33,29,4,48,42,6,59,67,-8,6,7,0,0
"7355","DAL","N.J",2011020149,15276,20112012,1,60,3,1,2,3.81770613228967,3.15791991274455,0.659786219545126,23,32,-9,36,42,-6,51,60,-9,3,4,0,0
"7356","DAL","COL",2011020183,15282,20112012,1,63.9166666666667,7,6,1,5.7583245858109,6.62979976368524,-0.871475177874345,29,40,-11,48,53,-5,61,69,-8,7,6,0,0
"7357","DAL","CAR",2011020195,15284,20112012,0,60,5,2,3,3.28124139213469,3.5299780772184,-0.248736685083713,27,32,-5,36,52,-16,45,72,-27,4,9,0,0
"7358","DAL","WSH",2011020205,15286,20112012,0,60,5,2,3,4.11649574995031,3.68517585654627,0.431319893404044,36,32,4,45,40,5,54,55,-1,6,5,0,0
"7359","DAL","PIT",2011020224,15289,20112012,0,60,1,3,-2,3.87701768702482,4.81172827417389,-0.934710587149068,20,32,-12,37,42,-5,47,57,-10,3,7,0,0
"7360","DAL","DET",2011020233,15290,20112012,0,60,2,5,-3,2.45064162563528,6.52780505484725,-4.07716342921196,27,40,-13,36,54,-18,45,70,-25,2,4,0,0
"7361","DAL","FLA",2011020254,15293,20112012,1,60,0,6,-6,2.6039083446376,3.19265220632587,-0.588743861688272,25,30,-5,33,43,-10,40,72,-32,3,5,0,0
"7362","DAL","COL",2011020272,15296,20112012,0,60,0,3,-3,6.07768332719123,5.49600949776323,0.581673829428009,24,45,-21,32,55,-23,48,66,-18,1,5,0,0
"7363","DAL","S.J",2011020284,15297,20112012,1,60,1,4,-3,4.56529192843016,4.65503605338745,-0.0897441249572921,31,38,-7,53,51,2,66,60,6,6,9,0,0
"7364","DAL","EDM",2011020296,15299,20112012,1,60,4,1,3,4.87447928800975,3.89765803969219,0.976821248317567,35,18,17,45,32,13,57,45,12,3,6,0,0
"7365","DAL","L.A",2011020309,15301,20112012,1,62.9333333333333,3,2,1,6.5767760080338,6.42926921118396,0.147506796849832,38,24,14,54,36,18,72,54,18,3,3,0,0
"7366","DAL","TOR",2011020324,15303,20112012,1,65,3,3,0,4.42568850006,3.8143395591178,0.611348940942197,29,23,6,56,36,20,71,55,16,4,4,0,0
"7367","DAL","ARI",2011020334,15304,20112012,0,60,0,3,-3,3.35401543949308,4.22215202844914,-0.86813658895606,26,39,-13,39,54,-15,49,68,-19,2,2,0,0
"7368","DAL","COL",2011020342,15306,20112012,0,60,3,1,2,7.09538368811059,3.7273121799477,3.36807150816289,35,36,-1,42,48,-6,51,59,-8,4,3,0,0
"7369","DAL","OTT",2011020361,15309,20112012,1,60,3,2,1,6.0943306730187,5.77854598150589,0.315784691512818,32,35,-3,47,41,6,66,57,9,3,1,0,0
"7370","DAL","NYI",2011020381,15311,20112012,1,60,4,5,-1,6.01333531794826,5.43880097841611,0.574534339532152,34,27,7,48,43,5,76,50,26,4,5,0,0
"7371","DAL","S.J",2011020416,15316,20112012,0,60,2,5,-3,1.84991311827999,3.77767490612132,-1.92776178784133,20,36,-16,31,42,-11,55,54,1,6,6,0,0
"7372","DAL","L.A",2011020432,15318,20112012,0,60,2,1,1,2.67368604944204,5.18544047813447,-2.51175442869243,28,27,1,43,43,0,58,63,-5,9,5,0,0
"7373","DAL","NYR",2011020439,15321,20112012,0,60,1,0,1,2.9858175466361,4.7603640595022,-1.7745465128661,28,34,-6,37,47,-10,50,63,-13,3,5,0,0
"7374","DAL","NYI",2011020451,15323,20112012,0,60,3,2,1,0,0,0,29,27,2,39,36,3,50,50,0,8,5,0,0
"7375","DAL","N.J",2011020461,15324,20112012,0,60,3,6,-3,4.74155848739611,4.72459518071514,0.0169633066809638,36,31,5,41,33,8,44,37,7,4,2,0,0
"7376","DAL","ANA",2011020483,15327,20112012,1,60,5,3,2,3.06355649209114,5.45044460120574,-2.38688810911459,33,28,5,45,39,6,59,52,7,5,3,0,0
"7377","DAL","PHI",2011020496,15329,20112012,1,60,1,4,-3,4.70935675737832,3.5678466626144,1.14151009476392,31,30,1,51,43,8,71,57,14,4,6,0,0
"7378","DAL","NSH",2011020514,15331,20112012,1,60,6,3,3,3.60657707151404,4.55151636343208,-0.944939291918041,29,37,-8,43,48,-5,62,61,1,3,5,0,0
"7379","DAL","STL",2011020523,15334,20112012,0,60,3,5,-2,2.65966044775269,4.13236335511726,-1.47270290736458,23,38,-15,31,52,-21,42,69,-27,3,3,0,0
"7380","DAL","CBJ",2011020548,15337,20112012,1,60,1,4,-3,3.42506061134918,4.22354009181413,-0.798479480464948,37,29,8,48,37,11,61,56,5,4,3,0,0
"7381","DAL","BOS",2011020565,15339,20112012,1,60,4,2,2,4.33249194230302,3.78973642703204,0.542755515270983,27,20,7,38,33,5,49,53,-4,6,3,0,0
"7382","DAL","DET",2011020579,15342,20112012,1,60,4,5,-1,3.88703596462437,4.06588457236148,-0.178848607737109,29,31,-2,39,38,1,51,57,-6,1,0,0,0
"7383","DAL","NSH",2011020590,15344,20112012,0,60,4,1,3,5.43847715412267,3.57917735905409,1.85929979506858,30,25,5,43,37,6,57,50,7,5,4,0,0
"7384","DAL","EDM",2011020600,15346,20112012,1,60,4,1,3,7.36194941098802,5.42981140757911,1.93213800340891,34,26,8,54,40,14,64,55,9,2,2,0,0
"7385","DAL","ANA",2011020628,15349,20112012,0,60,2,5,-3,4.11204170068959,6.16940413287375,-2.05736243218416,28,26,2,46,39,7,63,52,11,3,3,0,0
"7386","DAL","L.A",2011020641,15351,20112012,0,65,4,4,0,4.33923256209678,5.81086050937553,-1.47162794727875,38,41,-3,56,51,5,67,63,4,8,9,0,0
"7387","DAL","COL",2011020648,15353,20112012,1,60,1,2,-1,4.98318511340767,3.35949069270282,1.62369442070485,22,23,-1,40,28,12,53,46,7,4,4,0,0
"7388","DAL","STL",2011020669,15355,20112012,0,60,0,1,-1,6.27348135958891,8.75847938517109,-2.48499802558217,22,32,-10,34,49,-15,53,61,-8,4,5,0,0
"7389","DAL","DET",2011020678,15356,20112012,1,65,2,2,0,3.19684943248285,7.89021002131631,-4.69336058883346,27,32,-5,40,50,-10,50,72,-22,2,4,0,0
"7390","DAL","T.B",2011020698,15359,20112012,1,60,1,2,-1,3.03959269501502,3.9457680139385,-0.906175318923488,28,22,6,41,37,4,52,54,-2,4,3,0,0
"7391","DAL","MIN",2011020710,15360,20112012,0,60,2,5,-3,3.83961673174053,3.01498199952766,0.824634732212871,25,26,-1,34,33,1,53,44,9,2,4,0,0
"7392","DAL","ANA",2011020730,15363,20112012,1,60,1,0,1,1.43247320971932,5.23696796153672,-3.8044947518174,16,27,-11,20,42,-22,33,69,-36,1,3,0,0
"7393","DAL","ANA",2011020752,15371,20112012,0,60,6,2,4,2.70091531437958,5.23611041231197,-2.53519509793239,26,35,-9,35,45,-10,46,56,-10,3,4,0,0
"7394","DAL","S.J",2011020761,15372,20112012,0,60,2,5,-3,3.04061752077541,4.09321068006102,-1.05259315928561,21,37,-16,30,52,-22,41,73,-32,3,6,0,0
"7395","DAL","MIN",2011020776,15374,20112012,1,65,1,1,0,3.68005598491116,3.7902307938366,-0.110174808925436,26,34,-8,38,48,-10,59,63,-4,2,4,0,0
"7396","DAL","ARI",2011020795,15377,20112012,1,60,1,4,-3,1.64464891779062,2.92632413458882,-1.2816752167982,29,24,5,42,40,2,59,56,3,3,1,0,0
"7397","DAL","CBJ",2011020806,15379,20112012,0,60,4,2,2,6.87960729093174,3.4668828958529,3.41272439507884,35,28,7,41,36,5,60,47,13,3,3,0,0
"7398","DAL","BUF",2011020812,15380,20112012,0,65,2,2,0,4.56347517791437,10.2708134292664,-5.70733825135198,26,32,-6,36,46,-10,47,58,-11,4,2,0,0
"7399","DAL","L.A",2011020831,15382,20112012,1,60,2,4,-2,3.56224675719242,3.57262465483005,-0.0103778976376248,28,16,12,40,24,16,53,34,19,5,4,0,0
"7400","DAL","DET",2011020841,15384,20112012,0,60,1,3,-2,4.0199364563523,2.46832771977643,1.55160873657587,21,37,-16,36,46,-10,47,54,-7,3,6,0,0
"7401","DAL","CGY",2011020856,15386,20112012,1,62.0166666666667,3,2,1,5.25060681845401,3.35993614025756,1.89067067819645,32,27,5,49,35,14,70,48,22,3,5,0,0
"7402","DAL","ARI",2011020871,15388,20112012,0,61.25,1,2,-1,4.64667285509523,4.86449308245892,-0.217820227363688,31,33,-2,45,41,4,65,53,12,5,5,0,0
"7403","DAL","NSH",2011020880,15389,20112012,1,60,2,3,-1,5.82069277790288,4.21646439174401,1.60422838615887,24,21,3,41,29,12,63,41,22,1,2,0,0
"7404","DAL","MTL",2011020889,15391,20112012,0,60,3,0,3,5.37890369399322,4.06605014613888,1.31285354785435,36,31,5,48,38,10,60,54,6,1,4,0,0
"7405","DAL","CHI",2011020905,15393,20112012,0,60,3,1,2,4.27693640406142,1.43538522045128,2.84155118361014,25,27,-2,39,32,7,50,47,3,0,1,0,0
"7406","DAL","MIN",2011020913,15394,20112012,1,60,4,1,3,0,0,0,25,29,-4,34,47,-13,52,69,-17,2,6,0,0
"7407","DAL","VAN",2011020927,15396,20112012,1,63.8666666666667,3,2,1,5.17316501445021,6.26448577280886,-1.09132075835865,28,26,2,43,42,1,56,57,-1,2,2,0,0
"7408","DAL","EDM",2011020963,15401,20112012,0,60,3,1,2,3.66347617597785,3.31399484933354,0.349481326644309,15,20,-5,28,33,-5,45,50,-5,2,0,0,0
"7409","DAL","CGY",2011020978,15403,20112012,0,65,2,2,0,6.99615500433326,4.53369647826185,2.46245852607142,40,38,2,50,49,1,62,59,3,4,4,0,0
"7410","DAL","VAN",2011020994,15405,20112012,0,60,5,2,3,4.91816549413488,5.04151437051587,-0.123348876380987,29,31,-2,42,38,4,58,60,-2,4,5,0,0
"7411","DAL","S.J",2011021006,15407,20112012,1,65,3,3,0,6.30871185335855,7.09214456076734,-0.783432707408792,35,48,-13,52,66,-14,65,88,-23,2,3,0,0
"7412","DAL","ANA",2011021022,15409,20112012,1,60,2,0,2,3.42402558158938,1.96270447748248,1.4613211041069,23,21,2,28,35,-7,53,53,0,6,5,0,0
"7413","DAL","MIN",2011021042,15412,20112012,0,60,1,0,1,4.01263561074347,6.42511905395804,-2.41248344321457,25,25,0,35,36,-1,53,52,1,3,5,0,0
"7414","DAL","WPG",2011021048,15413,20112012,0,60,2,5,-3,3.76842015375047,3.22245680808555,0.545963345664916,30,28,2,41,38,3,52,51,1,2,5,0,0
"7415","DAL","CHI",2011021062,15415,20112012,1,60,1,4,-3,6.07593659194911,7.22162747502443,-1.14569088307532,22,31,-9,39,47,-8,59,62,-3,1,3,0,0
"7416","DAL","ARI",2011021094,15419,20112012,1,65,3,3,0,7.50013082940131,7.01261196687119,0.487518862530123,33,30,3,45,47,-2,55,64,-9,7,7,0,0
"7417","DAL","VAN",2011021106,15421,20112012,1,60,1,2,-1,2.84603163796055,4.4283291155948,-1.58229747763425,26,28,-2,37,40,-3,45,48,-3,7,8,0,0
"7418","DAL","CGY",2011021116,15423,20112012,1,60,4,1,3,3.31634872424013,6.8723625500279,-3.55601382578777,20,36,-16,36,57,-21,50,70,-20,6,7,0,0
"7419","DAL","CGY",2011021137,15425,20112012,0,60,4,5,-1,4.44460089795728,3.17430450096128,1.27029639699599,39,35,4,49,48,1,59,66,-7,6,8,0,0
"7420","DAL","EDM",2011021151,15427,20112012,0,60,3,1,2,2.73165575080202,3.94261521204163,-1.21095946123961,25,32,-7,32,41,-9,49,52,-3,5,4,0,0
"7421","DAL","VAN",2011021168,15429,20112012,0,60,2,5,-3,3.708403942524,3.23705884787887,0.47134509464513,30,34,-4,38,41,-3,53,52,1,1,3,0,0
"7422","DAL","S.J",2011021180,15430,20112012,0,60,0,3,-3,3.05168720302117,3.19099357072264,-0.139306367701472,22,34,-12,33,42,-9,46,57,-11,3,6,0,0
"7423","DAL","S.J",2011021196,15433,20112012,1,60,2,5,-3,4.93547536830951,5.66881123952044,-0.733335871210926,31,26,5,44,41,3,66,61,5,2,3,0,0
"7424","DAL","NSH",2011021209,15435,20112012,0,60,0,2,-2,3.48335051828053,3.62406142638065,-0.140710908100118,28,31,-3,36,38,-2,59,48,11,4,2,0,0
"7425","DAL","STL",2011021227,15437,20112012,1,60,2,3,-1,4.84898740740375,6.20547180301037,-1.35648439560662,35,35,0,43,51,-8,62,68,-6,6,7,0,0
"7426","DAL","ARI",2012020011,15724,20122013,1,60,4,3,1,4.41580240573485,5.73507484054063,-1.31927243480578,26,40,-14,49,50,-1,64,67,-3,4,5,0,0
"7427","DAL","MIN",2012020017,15725,20122013,0,60,0,1,-1,4.02797990229737,5.12222049858974,-1.09424059629237,24,32,-8,36,40,-4,62,51,11,5,4,0,0
"7428","DAL","DET",2012020031,15727,20122013,0,60,2,1,1,3.2973061358533,3.3874235992904,-0.0901174634371031,32,40,-8,40,53,-13,51,64,-13,3,5,0,0
"7429","DAL","CHI",2012020046,15729,20122013,1,61.6833333333333,2,3,-1,2.83485400306076,6.85669376819715,-4.02183976513638,23,41,-18,35,53,-18,42,77,-35,2,7,0,0
"7430","DAL","STL",2012020061,15731,20122013,1,60,3,4,-1,5.08617485794821,3.84821044122649,1.23796441672172,23,32,-9,34,41,-7,48,51,-3,4,3,0,0
"7431","DAL","CBJ",2012020074,15733,20122013,0,60,1,2,-1,2.85252300187275,4.58553477082023,-1.73301176894748,25,27,-2,34,32,2,44,46,-2,5,8,0,0
"7432","DAL","DET",2012020085,15734,20122013,0,60,1,4,-3,2.6137978026818,3.99239448449373,-1.37859668181193,26,27,-1,34,43,-9,47,55,-8,6,5,0,0
"7433","DAL","ARI",2012020105,15737,20122013,1,65,3,3,0,2.58835599808026,4.99384017434204,-2.40548417626178,24,34,-10,35,44,-9,53,61,-8,3,4,0,0
"7434","DAL","ARI",2012020115,15738,20122013,0,60,0,2,-2,3.05603080645432,4.41204115097935,-1.35601034452503,17,34,-17,28,47,-19,44,66,-22,2,8,0,0
"7435","DAL","COL",2012020124,15740,20122013,0,60,3,2,1,3.55026990016046,2.78412048737774,0.76614941278272,26,31,-5,42,37,5,62,46,16,5,5,0,0
"7436","DAL","EDM",2012020140,15742,20122013,0,61.7666666666667,3,2,1,3.35143439966464,2.98254875149114,0.368885648173496,28,29,-1,43,39,4,64,51,13,3,4,0,0
"7437","DAL","ANA",2012020153,15744,20122013,1,60,3,1,2,3.76549233679509,3.71669490746444,0.0487974293306479,28,21,7,40,36,4,55,48,7,5,5,0,0
"7438","DAL","EDM",2012020186,15748,20122013,0,60,4,1,3,6.05631789925224,4.10536013281671,1.95095776643552,29,36,-7,42,46,-4,56,59,-3,5,7,0,0
"7439","DAL","CGY",2012020190,15749,20122013,0,60,4,7,-3,5.2566217663134,4.49160180689069,0.765019959422716,34,23,11,46,36,10,60,42,18,5,3,0,0
"7440","DAL","VAN",2012020203,15751,20122013,0,60,4,3,1,4.51568696650532,4.34207680037798,0.173610166127341,29,28,1,36,37,-1,47,50,-3,4,3,0,0
"7441","DAL","CGY",2012020215,15753,20122013,1,60,3,4,-1,4.15389022878064,6.28470722906059,-2.13081700027995,30,26,4,43,42,1,58,51,7,3,5,0,0
"7442","DAL","VAN",2012020245,15757,20122013,1,60,3,4,-1,3.86511702824112,4.94168111188453,-1.07656408364342,25,22,3,35,32,3,56,42,14,5,5,0,0
"7443","DAL","S.J",2012020260,15759,20122013,1,60,3,1,2,4.93645939507454,5.83296966936539,-0.896510274290852,28,32,-4,46,52,-6,60,59,1,8,8,0,0
"7444","DAL","NSH",2012020272,15761,20122013,0,60.4666666666667,4,5,-1,2.40158023004551,4.80145320785232,-2.39987297780681,24,31,-7,33,36,-3,53,46,7,4,5,0,0
"7445","DAL","CBJ",2012020277,15762,20122013,0,63.05,5,4,1,8.13057509076316,4.28351818607189,3.84705690469127,39,20,19,50,24,26,62,30,32,2,2,0,0
"7446","DAL","EDM",2012020295,15764,20122013,1,60,1,5,-4,6.09819274104639,7.59765969960404,-1.49946695855764,34,38,-4,49,47,2,71,57,14,7,9,0,0
"7447","DAL","STL",2012020314,15767,20122013,1,60,4,1,3,6.09176573657896,3.222630712892,2.86913502368697,27,26,1,43,41,2,58,61,-3,3,1,0,0
"7448","DAL","L.A",2012020349,15771,20122013,0,60,5,2,3,4.75072621530853,5.51993030248237,-0.769204087173836,22,33,-11,33,46,-13,41,56,-15,3,1,0,0
"7449","DAL","ARI",2012020363,15773,20122013,0,60,1,2,-1,3.37663567693186,3.22021542847506,0.156420248456802,21,21,0,31,34,-3,61,46,15,5,2,0,0
"7450","DAL","NSH",2012020385,15776,20122013,1,60,0,4,-4,3.55800067956778,2.05571952310856,1.50228115645922,32,21,11,50,28,22,72,42,30,5,6,0,0
"7451","DAL","ANA",2012020399,15778,20122013,1,65,1,1,0,2.1705403077649,4.18395224034767,-2.01341193258278,34,30,4,50,50,0,70,70,0,5,3,0,0
"7452","DAL","CHI",2012020415,15780,20122013,1,60,1,8,-7,2.42404857728707,6.3329930951586,-3.90894451787153,19,34,-15,26,55,-29,36,69,-33,3,7,0,0
"7453","DAL","CGY",2012020424,15782,20122013,1,60,4,3,1,2.77336906918208,4.47926200967049,-1.70589294048841,24,19,5,38,33,5,52,53,-1,5,5,0,0
"7454","DAL","COL",2012020440,15784,20122013,0,60,3,4,-1,3.29654169638525,4.42825626661209,-1.13171457022684,32,34,-2,45,42,3,63,50,13,7,3,0,0
"7455","DAL","L.A",2012020451,15785,20122013,0,60,2,0,2,3.93038147551124,5.26535690648598,-1.33497543097474,21,40,-19,31,59,-28,44,69,-25,2,3,0,0
"7456","DAL","COL",2012020463,15787,20122013,1,60,5,2,3,2.84261087918276,5.99063536242307,-3.14802448324031,31,35,-4,39,51,-12,52,75,-23,4,3,0,0
"7457","DAL","MIN",2012020476,15789,20122013,1,60,4,7,-3,3.62723059489508,4.29868183445035,-0.671451239555267,26,42,-16,38,54,-16,51,66,-15,4,3,0,0
"7458","DAL","MIN",2012020504,15793,20122013,1,60,5,3,2,3.91124482362648,4.31426598534325,-0.403021161716779,33,33,0,38,53,-15,51,71,-20,7,5,0,0
"7459","DAL","L.A",2012020520,15795,20122013,1,60,2,3,-1,2.58282257278915,5.5508465813673,-2.96802400857814,15,40,-25,35,49,-14,51,65,-14,2,1,0,0
"7460","DAL","ANA",2012020528,15796,20122013,1,60,0,4,-4,4.41570923372637,4.62133524964156,-0.205626015915186,26,30,-4,39,41,-2,53,55,-2,4,2,0,0
"7461","DAL","ANA",2012020541,15798,20122013,0,60,2,5,-3,2.93520970281679,5.04465768090449,-2.1094479780877,25,27,-2,35,34,1,50,40,10,0,1,0,0
"7462","DAL","ANA",2012020557,15800,20122013,0,60,3,1,2,4.10207885492127,2.69518270141742,1.40689615350385,25,28,-3,37,44,-7,50,59,-9,6,4,0,0
"7463","DAL","S.J",2012020570,15802,20122013,0,65,4,4,0,3.45975079954371,5.56377884165327,-2.10402804210956,34,36,-2,49,49,0,73,63,10,3,3,0,0
"7464","DAL","L.A",2012020590,15804,20122013,1,60,5,1,4,5.80874684116307,6.13309215072405,-0.324345309560975,31,30,1,41,52,-11,55,70,-15,4,6,0,0
"7465","DAL","NSH",2012020607,15807,20122013,0,60,5,2,3,2.76203791542503,3.56998087879037,-0.807942963365349,18,28,-10,26,37,-11,31,55,-24,2,3,0,0
"7466","DAL","S.J",2012020618,15808,20122013,1,60,2,1,1,2.57643931484199,6.75137740001082,-4.17493808516883,19,32,-13,25,53,-28,35,83,-48,5,2,0,0
"7467","DAL","CHI",2012020627,15810,20122013,0,60,2,5,-3,4.65001631947234,3.23267945951739,1.41733685995496,18,28,-10,26,41,-15,37,57,-20,3,5,0,0
"7468","DAL","VAN",2012020651,15813,20122013,1,60,5,1,4,3.50793949963027,5.15807497205275,-1.65013547242248,30,38,-8,47,60,-13,56,71,-15,7,4,0,0
"7469","DAL","STL",2012020656,15814,20122013,0,60,1,2,-1,2.51130666691461,3.15131154515257,-0.64000487823796,22,20,2,30,27,3,45,37,8,2,3,0,0
"7470","DAL","L.A",2012020675,15816,20122013,0,64.1333333333333,3,4,-1,3.26517466077105,6.64858942705964,-3.38341476628859,27,31,-4,42,64,-22,49,83,-34,6,8,0,0
"7471","DAL","S.J",2012020689,15818,20122013,0,60,2,3,-1,4.14396755091103,7.23711274961352,-3.09314519870249,26,37,-11,40,53,-13,63,81,-18,3,3,0,0
"7472","DAL","CBJ",2012020702,15820,20122013,1,60,1,3,-2,4.81344383506359,4.43456540067439,0.378878434389208,32,35,-3,48,43,5,73,50,23,4,5,0,0
"7473","DAL","DET",2012020717,15822,20122013,1,60,0,3,-3,1.56412154214922,5.18472098843549,-3.62059944628627,17,37,-20,28,59,-31,46,74,-28,4,6,0,0
"7474","DAL","FLA",2013020012,15981,20132014,1,60,2,4,-2,2.27471499246894,7.58179518933089,-5.30708019686195,27,39,-12,37,46,-9,61,56,5,3,4,0,0
"7475","DAL","WSH",2013020028,15983,20132014,1,60,2,1,1,4.00511996838031,3.84677885492306,0.158341113457254,21,26,-5,41,35,6,51,49,2,2,3,0,0
"7476","DAL","WPG",2013020062,15989,20132014,0,60,4,1,3,4.87948099042394,4.90079287101901,-0.0213118805950643,31,44,-13,41,59,-18,50,78,-28,5,5,0,0
"7477","DAL","MIN",2013020072,15990,20132014,0,60,1,5,-4,4.02836064720577,5.41841324417055,-1.39005259696478,19,36,-17,28,47,-19,38,61,-23,3,4,0,0
"7478","DAL","COL",2013020092,15993,20132014,0,60,2,3,-1,4.52618407225236,1.98762901894224,2.53855505331012,41,26,15,50,31,19,68,44,24,5,3,0,0
"7479","DAL","S.J",2013020106,15995,20132014,1,65,3,3,0,7.42868841708221,6.78551506960503,0.643173347477187,31,35,-4,47,62,-15,65,86,-21,2,5,0,0
"7480","DAL","L.A",2013020122,15997,20132014,0,60,2,5,-3,3.49335209542187,5.23968806033372,-1.74633596491185,29,34,-5,44,52,-8,50,70,-20,6,4,0,0
"7481","DAL","ANA",2013020125,15998,20132014,0,60,3,6,-3,4.18351696077152,7.37077442044968,-3.18725745967816,36,47,-11,49,60,-11,62,71,-9,7,8,0,0
"7482","DAL","CGY",2013020146,16002,20132014,1,60,5,1,4,5.78971537978214,4.46056734999914,1.329148029783,34,29,5,58,41,17,68,62,6,4,2,0,0
"7483","DAL","WPG",2013020161,16004,20132014,1,65,1,1,0,5.69509778096881,4.23347074202195,1.46162703894686,36,38,-2,56,57,-1,75,72,3,4,2,0,0
"7484","DAL","BUF",2013020171,16006,20132014,0,60,4,3,1,4.52673178243776,3.11554282745527,1.41118895498249,29,25,4,40,34,6,54,49,5,4,4,0,0
"7485","DAL","MTL",2013020178,16007,20132014,0,60,1,2,-1,3.25930661798463,2.71391217492055,0.545394443064083,27,24,3,35,39,-4,64,50,14,2,4,0,0
"7486","DAL","COL",2013020197,16010,20132014,1,63.6,2,3,-1,4.2225623811828,4.92924540824606,-0.706683027063264,29,29,0,44,40,4,64,54,10,2,4,0,0
"7487","DAL","OTT",2013020212,16012,20132014,0,65,3,3,0,4.80470999896806,5.34993067926067,-0.545220680292601,39,36,3,50,47,3,61,62,-1,4,4,0,0
"7488","DAL","BOS",2013020217,16014,20132014,0,65,2,2,0,4.49917917902349,3.88536475342198,0.613814425601504,36,36,0,48,46,2,57,66,-9,5,6,0,0
"7489","DAL","DET",2013020236,16016,20132014,0,64.6833333333333,4,3,1,5.42424164921977,5.94549893203657,-0.521257282816805,28,29,-1,37,36,1,44,41,3,2,0,0,0
"7490","DAL","CHI",2013020252,16018,20132014,1,60,2,5,-3,2.96712330868468,3.87542264114063,-0.908299332455951,33,31,2,47,35,12,68,47,21,6,2,0,0
"7491","DAL","EDM",2013020276,16022,20132014,0,60,3,0,3,5.43196601083037,3.62378114270814,1.80818486812223,26,22,4,49,32,17,64,44,20,7,5,0,0
"7492","DAL","CGY",2013020282,16023,20132014,0,60,7,3,4,4.52611563458777,3.97175829477707,0.554357339810696,32,28,4,47,45,2,66,59,7,3,3,0,0
"7493","DAL","VAN",2013020308,16026,20132014,0,60,2,1,1,2.64046131586656,6.53953266181634,-3.89907134594978,23,43,-20,32,61,-29,42,83,-41,3,5,0,0
"7494","DAL","NYR",2013020331,16030,20132014,1,60,2,3,-1,5.36830712723895,7.00930077249037,-1.64099364525142,43,27,16,70,49,21,91,58,33,5,3,0,0
"7495","DAL","STL",2013020347,16032,20132014,0,60,1,6,-5,3.93359135590834,3.54110813834268,0.392483217565662,35,25,10,50,37,13,62,45,17,3,3,0,0
"7496","DAL","ANA",2013020364,16035,20132014,1,60,6,3,3,5.73286999232726,6.01077946704231,-0.277909474715053,33,31,2,48,48,0,58,66,-8,3,2,0,0
"7497","DAL","CHI",2013020391,16038,20132014,1,65,1,1,0,3.96372750721218,3.81710310102587,0.146624406186313,29,26,3,43,35,8,56,60,-4,3,2,0,0
"7498","DAL","EDM",2013020405,16040,20132014,1,65,2,2,0,7.14692648025277,4.49580973914614,2.65111674110663,45,32,13,55,48,7,76,68,8,4,6,0,0
"7499","DAL","CHI",2013020415,16042,20132014,0,60,4,3,1,2.84986917191168,2.91452367807506,-0.0646545061633788,18,50,-32,28,60,-32,35,85,-50,3,5,0,0
"7500","DAL","TOR",2013020423,16044,20132014,0,64.3,2,3,-1,8.56635964326247,4.02526230667718,4.5410973365853,50,24,26,73,35,38,95,45,50,5,3,0,0
"7501","DAL","PHI",2013020446,16046,20132014,1,60,5,1,4,6.53049982537868,2.50579839010458,4.0247014352741,34,28,6,45,41,4,54,65,-11,5,5,0,0
"7502","DAL","CHI",2013020465,16049,20132014,1,60,2,6,-4,3.88675699935993,4.0275549293458,-0.140797929985865,29,33,-4,45,45,0,66,57,9,6,7,0,0
"7503","DAL","NSH",2013020478,16051,20132014,0,60,1,3,-2,4.45759917574469,3.35771631685202,1.09988285889267,34,30,4,46,34,12,69,42,27,3,3,0,0
"7504","DAL","WPG",2013020489,16053,20132014,0,60,6,4,2,3.8251235227799,5.53880327536059,-1.71367975258069,32,38,-6,40,54,-14,57,71,-14,4,6,0,0
"7505","DAL","COL",2013020508,16055,20132014,0,60,2,6,-4,5.21041370006424,7.60232082666645,-2.39190712660221,33,48,-15,46,59,-13,60,74,-14,5,5,0,0
"7506","DAL","COL",2013020519,16056,20132014,1,60,3,2,1,2.7701276082953,3.73145022242898,-0.961322614133678,28,27,1,43,36,7,61,52,9,6,7,0,0
"7507","DAL","VAN",2013020531,16058,20132014,1,60,4,1,3,4.21298244793434,2.56569283080171,1.64728961713263,26,28,-2,37,43,-6,54,56,-2,4,3,0,0
"7508","DAL","S.J",2013020550,16060,20132014,0,65,2,2,0,5.11717328499071,2.62826527362824,2.48890801136247,46,39,7,59,48,11,71,61,10,2,3,0,0
"7509","DAL","L.A",2013020565,16062,20132014,0,60,5,2,3,4.96468860073946,7.24707413059617,-2.2823855298567,24,32,-8,35,56,-21,46,68,-22,4,2,0,0
"7510","DAL","NSH",2013020574,16066,20132014,1,60,4,1,3,3.57257633961854,5.0065857999426,-1.43400946032407,34,34,0,51,53,-2,65,70,-5,7,6,0,0
"7511","DAL","STL",2013020588,16068,20132014,1,64.8166666666667,2,3,-1,5.9638439520495,5.12249535217416,0.841348599875346,30,22,8,48,32,16,73,46,27,5,2,0,0
"7512","DAL","L.A",2013020605,16070,20132014,1,60,3,2,1,4.26736016469658,3.68569627625402,0.581663888442563,32,25,7,44,46,-2,58,63,-5,6,3,0,0
"7513","DAL","MTL",2013020618,16072,20132014,1,60,4,6,-2,2.97841393642011,5.38320354582905,-2.40478960940894,32,28,4,51,42,9,72,56,16,5,5,0,0
"7514","DAL","DET",2013020634,16074,20132014,1,60,1,5,-4,5.32340131451812,1.27913217082096,4.04426914369716,45,27,18,67,39,28,85,51,34,7,5,0,0
"7515","DAL","NYI",2013020643,16076,20132014,0,60,3,7,-4,3.16765195316839,4.04045901160748,-0.872807058439093,23,43,-20,30,52,-22,39,67,-28,4,6,0,0
"7516","DAL","N.J",2013020661,16079,20132014,0,60,0,1,-1,2.28965093709864,3.69682842520372,-1.40717748810508,26,34,-8,33,42,-9,51,47,4,2,2,0,0
"7517","DAL","NYR",2013020669,16080,20132014,0,60,2,3,-1,3.31955294511044,3.85107101709582,-0.531518071985374,26,34,-8,47,44,3,61,60,1,2,3,0,0
"7518","DAL","NYI",2013020686,16082,20132014,1,60,2,4,-2,4.33299265793175,7.04944617854198,-2.71645352061023,31,31,0,48,49,-1,60,73,-13,2,2,0,0
"7519","DAL","EDM",2013020706,16084,20132014,1,60,5,2,3,5.24665882636915,3.54690141455376,1.69975741181539,30,33,-3,44,50,-6,58,68,-10,1,2,0,0
"7520","DAL","BOS",2013020717,16086,20132014,1,60,2,4,-2,4.11718236534361,7.38127111300182,-3.26408874765821,34,41,-7,47,60,-13,61,77,-16,8,6,0,0
"7521","DAL","MIN",2013020734,16088,20132014,0,62.7,2,3,-1,7.64039294637041,2.20444934087573,5.43594360549469,35,19,16,51,28,23,73,40,33,4,3,0,0
"7522","DAL","NSH",2013020743,16090,20132014,0,60,1,4,-3,8.12326984629181,3.09643077524015,5.02683907105165,36,23,13,50,30,20,63,44,19,2,2,0,0
"7523","DAL","MIN",2013020752,16091,20132014,1,60,4,0,4,5.97957862598389,3.86698666324378,2.11259196274011,36,18,18,50,30,20,72,44,28,10,5,0,0
"7524","DAL","TOR",2013020765,16093,20132014,1,60,7,1,6,4.68352182498074,4.19280387321487,0.490717951765873,28,25,3,43,32,11,55,46,9,5,6,0,0
"7525","DAL","COL",2013020792,16097,20132014,1,60,3,4,-1,4.96212998921746,3.64734527294058,1.31478471627688,44,21,23,52,28,24,71,41,30,4,3,0,0
"7526","DAL","N.J",2013020813,16100,20132014,1,60.6666666666667,2,3,-1,0.877340031618587,1.99793193663675,-1.12059190501816,16,24,-8,25,36,-11,43,46,-3,5,5,0,0
"7527","DAL","ANA",2013020833,16102,20132014,0,60,2,0,2,4.78762142314631,2.94730910323767,1.84031231990864,27,26,1,46,40,6,56,53,3,4,4,0,0
"7528","DAL","ARI",2013020852,16105,20132014,0,60,3,1,2,6.57053928777987,5.9983546713629,0.572184616416962,40,28,12,49,46,3,61,66,-5,4,2,0,0
"7529","DAL","S.J",2013020855,16106,20132014,0,61.8666666666667,1,2,-1,1.02607284335977,7.84174017002806,-6.81566732666829,20,21,-1,30,36,-6,48,57,-9,1,3,0,0
"7530","DAL","ARI",2013020881,16109,20132014,1,60,2,1,1,3.79710874567536,3.73985901040191,0.0572497352734445,33,27,6,56,43,13,74,55,19,5,4,0,0
"7531","DAL","CAR",2013020895,16128,20132014,1,60,4,1,3,3.73361325592123,2.86316793739616,0.870445318525071,34,30,4,46,39,7,60,57,3,9,5,0,0
"7532","DAL","T.B",2013020907,16130,20132014,1,60,2,4,-2,2.52479467383819,5.39449794902288,-2.86970327518469,41,21,20,58,31,27,83,40,43,4,3,0,0
"7533","DAL","BUF",2013020921,16132,20132014,1,60,3,2,1,6.00250545435119,1.59340203727811,4.40910341707308,39,23,16,59,38,21,78,46,32,6,1,0,0
"7534","DAL","CBJ",2013020926,16133,20132014,0,60,2,4,-2,4.58769883355126,5.15881048439769,-0.571111650846433,33,20,13,42,29,13,57,38,19,4,3,0,0
"7535","DAL","VAN",2013020944,16135,20132014,1,60,6,1,5,3.46134310570051,3.83591452026536,-0.374571414564848,22,33,-11,31,47,-16,48,63,-15,4,6,0,0
"7536","DAL","MIN",2013020960,16137,20132014,1,60,4,3,1,6.4774176758726,8.5147597474544,-2.0373420715818,38,35,3,53,51,2,69,64,5,3,4,0,0
"7537","DAL","CBJ",2013020971,16169,20132014,1,60,1,2,-1,3.77694735630968,3.44532095783507,0.331626398474619,34,25,9,53,33,20,76,45,31,4,3,0,0
"7538","DAL","STL",2013020982,16140,20132014,0,63.7,3,2,1,6.67040759063093,6.67019257848733,0.000215012143598869,30,30,0,42,42,0,52,57,-5,3,4,0,0
"7539","DAL","CGY",2013021002,16143,20132014,1,65,3,3,0,4.71237941757136,6.88331886999367,-2.17093945242232,25,30,-5,39,53,-14,51,74,-23,1,2,0,0
"7540","DAL","WPG",2013021021,16145,20132014,0,60,2,7,-5,2.63120361467751,5.96562308428111,-3.33441946960359,27,34,-7,32,41,-9,48,59,-11,2,7,0,0
"7541","DAL","PHI",2013021043,16149,20132014,0,60,2,4,-2,5.9668377324578,5.57653270463925,0.390305027818556,35,29,6,45,42,3,69,65,4,3,2,0,0
"7542","DAL","OTT",2013021058,16151,20132014,1,60,3,1,2,4.17613832827692,3.27673926022474,0.899399068052183,44,27,17,54,46,8,70,60,10,9,9,0,0
"7543","DAL","WPG",2013021077,16153,20132014,1,60,2,1,1,3.4364173338945,6.74240615113762,-3.30598881724312,27,33,-6,38,49,-11,49,66,-17,5,4,0,0
"7544","DAL","CHI",2013021086,16154,20132014,0,60,2,4,-2,6.50600809181628,6.75063775897797,-0.244629667161689,27,42,-15,39,48,-9,49,54,-5,2,3,0,0
"7545","DAL","NSH",2013021105,16157,20132014,1,60,7,3,4,3.19568925746717,5.10792625353497,-1.9122369960678,29,28,1,35,48,-13,51,67,-16,1,1,0,0
"7546","DAL","STL",2013021115,16158,20132014,0,60,4,2,2,4.18209152016789,5.056338442173,-0.874246922005113,27,35,-8,38,42,-4,48,57,-9,5,6,0,0
"7547","DAL","WSH",2013021133,16161,20132014,0,60,5,0,5,6.10330545803299,4.68296687287511,1.42033858515788,36,35,1,48,48,0,59,68,-9,4,5,0,0
"7548","DAL","CAR",2013021146,16163,20132014,0,60,1,4,-3,4.89185149427794,3.73405266230111,1.15779883197683,34,32,2,45,41,4,60,54,6,3,5,0,0
"7549","DAL","T.B",2013021165,16165,20132014,0,60,5,2,3,3.63033752511546,2.10571458105654,1.52462294405893,28,29,-1,37,44,-7,50,52,-2,3,4,0,0
"7550","DAL","FLA",2013021171,16166,20132014,0,60,2,3,-1,5.11301649491622,2.75319616248427,2.35982033243195,37,24,13,51,33,18,60,46,14,5,1,0,0
"7551","DAL","NSH",2013021188,16168,20132014,1,65,2,2,0,5.9610263038694,4.40907477756264,1.55195152630677,30,29,1,44,43,1,63,62,1,2,1,0,0
"7552","DAL","STL",2013021209,16171,20132014,1,60,3,0,3,7.78702432897836,2.5223808802628,5.26464344871556,40,22,18,60,33,27,75,45,30,7,4,0,0
"7553","DAL","ARI",2013021230,16173,20132014,0,60,1,2,-1,2.18261520841667,4.65085300111241,-2.46823779269574,17,31,-14,25,45,-20,33,55,-22,3,6,0,0
"7554","DAL","ANA",2013030171,16176,20132014,0,60,3,4,-1,6.07412949000025,6.55409727622464,-0.479967786224393,35,35,0,48,49,-1,69,61,8,5,5,0,0
"7555","DAL","ANA",2013030172,16178,20132014,0,60,2,3,-1,7.5565144567357,1.5497389050401,6.0067755516956,36,19,17,61,29,32,73,45,28,6,3,0,0
"7556","DAL","ANA",2013030173,16181,20132014,1,60,3,0,3,4.26792577572633,7.1695301180313,-2.90160434230497,22,37,-15,35,51,-16,51,70,-19,6,8,0,0
"7557","DAL","ANA",2013030174,16183,20132014,1,60,4,2,2,4.51515323737112,7.8139082192406,-3.29875498186948,26,23,3,39,41,-2,61,58,3,6,5,0,0
"7558","DAL","ANA",2013030175,16185,20132014,0,60,2,6,-4,4.89931043332763,3.68873664429884,1.21057378902879,36,23,13,53,30,23,68,36,32,10,7,0,0
"7559","DAL","ANA",2013030176,16187,20132014,1,62.7833333333333,4,5,-1,3.6173326585031,3.72247613751097,-0.105143479007864,24,30,-6,48,39,9,66,64,2,8,6,0,0
"7560","DAL","CHI",2014020013,16352,20142015,1,65,2,2,0,4.93395653400371,4.88328545651166,0.0506710774920514,34,26,8,57,42,15,73,68,5,7,6,0,0
"7561","DAL","NSH",2014020027,16354,20142015,0,60,1,4,-3,3.81519423809368,5.78888736892259,-1.97369313082891,18,33,-15,30,45,-15,44,62,-18,2,4,0,0
"7562","DAL","CBJ",2014020042,16357,20142015,0,60,4,2,2,9.72857578557571,6.00603767918983,3.72253810638588,35,35,0,48,45,3,61,56,5,1,4,0,0
"7563","DAL","PHI",2014020070,16361,20142015,1,62.8166666666667,5,6,-1,3.43261913987953,7.10666955879424,-3.6740504189147,23,37,-14,38,58,-20,47,83,-36,3,5,0,0
"7564","DAL","VAN",2014020086,16364,20142015,1,60,6,3,3,4.87370854151478,3.63437613778589,1.23933240372889,28,46,-18,37,59,-22,47,69,-22,6,4,0,0
"7565","DAL","N.J",2014020101,16367,20142015,0,65,2,2,0,4.97969982496579,2.782462180957,2.19723764400879,37,27,10,44,36,8,50,44,6,2,0,0,0
"7566","DAL","NYI",2014020110,16368,20142015,0,60,5,7,-2,3.28435464727954,4.70451705095365,-1.42016240367411,31,29,2,41,40,1,54,49,5,5,2,0,0
"7567","DAL","STL",2014020132,16371,20142015,1,61.4666666666667,3,4,-1,2.66037624241267,3.28202209485015,-0.621645852437487,28,27,1,39,34,5,53,48,5,4,5,0,0
"7568","DAL","ANA",2014020150,16374,20142015,1,62.5,1,2,-1,2.08755393097557,2.96625017177541,-0.87869624079984,22,24,-2,34,34,0,50,47,3,7,5,0,0
"7569","DAL","MIN",2014020162,16375,20142015,0,60,1,4,-3,2.8984203574073,4.27384662269073,-1.37542626528342,20,30,-10,30,44,-14,53,54,-1,4,4,0,0
"7570","DAL","L.A",2014020181,16378,20142015,1,60,1,3,-2,7.17233126925504,6.09043532997021,1.08189593928483,34,30,4,46,38,8,64,50,14,5,6,0,0
"7571","DAL","NSH",2014020193,16380,20142015,1,60,2,3,-1,5.97706101788883,7.16105309376871,-1.18399207587989,35,33,2,61,56,5,73,76,-3,1,3,0,0
"7572","DAL","S.J",2014020211,16382,20142015,1,60,3,5,-2,5.20011053998314,4.9507299592442,0.249380580738944,40,29,11,56,43,13,78,67,11,7,4,0,0
"7573","DAL","ARI",2014020229,16385,20142015,0,60,4,3,1,1.59996013323689,4.8998829886259,-3.29992285538901,32,37,-5,38,53,-15,55,78,-23,4,6,0,0
"7574","DAL","L.A",2014020241,16387,20142015,0,60,2,0,2,2.09907717406168,4.45840843501274,-2.35933126095106,27,27,0,34,45,-11,48,55,-7,4,3,0,0
"7575","DAL","MIN",2014020249,16389,20142015,1,60,1,2,-1,3.97449540911839,4.19775250426028,-0.223257095141889,28,22,6,43,34,9,71,50,21,2,1,0,0
"7576","DAL","CHI",2014020263,16390,20142015,0,60,2,6,-4,2.89828128765657,3.13994509284385,-0.241663805187272,24,47,-23,32,59,-27,46,77,-31,1,4,0,0
"7577","DAL","CAR",2014020274,16392,20142015,1,60,4,6,-2,3.49628132586031,4.04691822769337,-0.550636901833059,27,25,2,44,42,2,55,54,1,3,4,0,0
"7578","DAL","ARI",2014020285,16394,20142015,1,60,3,1,2,4.68549943260587,4.04818248740048,0.637316945205384,27,27,0,47,40,7,58,56,2,2,2,0,0
"7579","DAL","L.A",2014020303,16396,20142015,1,60,5,4,1,3.71387205690792,3.48565217661758,0.228219880290343,23,41,-18,37,57,-20,48,71,-23,6,5,0,0
"7580","DAL","EDM",2014020319,16399,20142015,1,60,3,2,1,4.20717822905863,5.71842585564002,-1.51124762658139,34,37,-3,49,44,5,65,67,-2,4,2,0,0
"7581","DAL","MIN",2014020343,16402,20142015,1,62.0666666666667,4,5,-1,7.58552700548898,7.11970270397217,0.465824301516818,45,34,11,58,48,10,77,61,16,4,2,0,0
"7582","DAL","COL",2014020352,16403,20142015,0,60,2,5,-3,5.89983593154466,7.57108175155615,-1.67124582001149,24,47,-23,38,61,-23,54,77,-23,4,8,0,0
"7583","DAL","TOR",2014020367,16406,20142015,0,60,3,5,-2,4.88249598679484,5.41127075438999,-0.528774767595152,38,40,-2,55,57,-2,71,67,4,5,7,0,0
"7584","DAL","DET",2014020380,16408,20142015,0,60,2,5,-3,2.66764514340153,4.45353688517946,-1.78589174177793,24,29,-5,30,38,-8,33,49,-16,3,3,0,0
"7585","DAL","MTL",2014020399,16410,20142015,1,60,4,1,3,4.46127840146801,3.33748971793102,1.12378868353699,29,17,12,51,26,25,67,44,23,7,3,0,0
"7586","DAL","WPG",2014020416,16413,20142015,1,60,2,5,-3,2.94192228668908,6.92442346030896,-3.98250117361988,28,32,-4,40,46,-6,60,66,-6,6,5,0,0
"7587","DAL","N.J",2014020443,16417,20142015,1,60,4,3,1,5.82628432213096,5.3159904149652,0.51029390716576,36,31,5,55,51,4,74,65,9,2,2,0,0
"7588","DAL","VAN",2014020466,16421,20142015,0,60,2,0,2,4.26350163107804,2.11456982319942,2.14893180787862,29,27,2,40,38,2,54,48,6,3,5,0,0
"7589","DAL","CGY",2014020478,16423,20142015,0,60,2,1,1,4.60438204884122,4.26689557665389,0.337486472187324,21,22,-1,34,33,1,58,44,14,2,5,0,0
"7590","DAL","EDM",2014020492,16425,20142015,0,65,5,5,0,5.54948356495879,3.95081231340423,1.59867125155456,45,29,16,65,38,27,83,50,33,4,2,0,0
"7591","DAL","TOR",2014020512,16427,20142015,1,60,0,4,-4,0,0,0,43,26,17,69,35,34,86,46,40,7,8,0,0
"7592","DAL","STL",2014020521,16431,20142015,0,60,4,3,1,4.35188816589653,5.08186012255464,-0.729971956658119,24,33,-9,35,50,-15,47,69,-22,6,5,0,0
"7593","DAL","NYR",2014020538,16433,20142015,1,60,3,2,1,3.56794735282892,4.38948453075585,-0.821537177926928,27,30,-3,38,41,-3,55,58,-3,5,3,0,0
"7594","DAL","ARI",2014020553,16435,20142015,1,60,6,0,6,6.9404910449684,3.69205846083581,3.24843258413259,31,32,-1,51,40,11,62,56,6,2,3,0,0
"7595","DAL","MIN",2014020572,16438,20142015,1,60,7,1,6,4.46215945261065,1.30483622496104,3.15732322764961,35,22,13,55,29,26,72,46,26,6,5,0,0
"7596","DAL","CHI",2014020579,16439,20142015,0,61.2833333333333,4,5,-1,4.24755922888653,5.95898913947167,-1.71142991058514,34,38,-4,35,49,-14,46,76,-30,0,3,0,0
"7597","DAL","CBJ",2014020590,16441,20142015,1,60,2,4,-2,3.74706736971712,3.02479296951788,0.72227440019924,26,20,6,38,32,6,53,38,15,5,5,0,0
"7598","DAL","NSH",2014020602,16443,20142015,0,60.2833333333333,2,3,-1,3.44534677634363,5.34094549692236,-1.89559872057873,20,24,-4,27,35,-8,42,56,-14,3,2,0,0
"7599","DAL","COL",2014020615,16445,20142015,0,60,3,4,-1,5.11859925964382,6.68590646694423,-1.56730720730041,40,30,10,58,38,20,84,43,41,6,3,0,0
"7600","DAL","OTT",2014020638,16448,20142015,1,60,5,4,1,5.26344170517632,8.0287128444761,-2.76527113929978,29,41,-12,42,52,-10,54,73,-19,3,3,0,0
"7601","DAL","WPG",2014020651,16450,20142015,1,60,1,2,-1,9.51423284014163,2.22650485099439,7.28772798914724,47,22,25,70,28,42,97,37,60,8,3,0,0
"7602","DAL","WSH",2014020668,16452,20142015,1,60,5,4,1,3.47489128825488,6.46721437938993,-2.99232309113505,26,32,-6,40,42,-2,51,68,-17,5,3,0,0
"7603","DAL","CHI",2014020673,16453,20142015,0,60,6,3,3,5.39682362662643,4.69298736152996,0.70383626509647,34,41,-7,43,57,-14,53,77,-24,2,3,0,0
"7604","DAL","BOS",2014020690,16455,20142015,1,60,1,3,-2,6.2641889587976,4.62537387375505,1.63881508504255,37,27,10,61,41,20,83,57,26,6,4,0,0
"7605","DAL","MTL",2014020702,16462,20142015,0,60,2,3,-1,7.97060346871717,5.77846385502471,2.19213961369246,42,26,16,58,34,24,79,46,33,4,5,0,0
"7606","DAL","OTT",2014020715,16464,20142015,0,60,6,3,3,5.7047191275295,3.72464791790139,1.98007120962811,41,28,13,56,35,21,65,54,11,4,6,0,0
"7607","DAL","WPG",2014020734,16466,20142015,0,60,5,2,3,5.43474087553841,8.31473242283391,-2.8799915472955,32,40,-8,44,63,-19,55,94,-39,10,4,0,0
"7608","DAL","COL",2014020753,16469,20142015,1,65,2,2,0,5.54581162173872,4.88840595993679,0.657405661801931,32,24,8,45,37,8,68,55,13,3,2,0,0
"7609","DAL","T.B",2014020764,16471,20142015,1,60,3,5,-2,6.94296057670726,5.17264984665235,1.77031073005492,36,29,7,63,43,20,74,68,6,5,4,0,0
"7610","DAL","BUF",2014020776,16473,20142015,0,60,2,3,-1,5.24968063922324,2.63117458403576,2.61850605518748,40,24,16,58,29,29,86,37,49,2,2,0,0
"7611","DAL","NYR",2014020789,16474,20142015,0,61.0333333333333,3,2,1,0,0,0,25,36,-11,37,50,-13,48,68,-20,3,3,0,0
"7612","DAL","BOS",2014020797,16476,20142015,0,60,5,3,2,7.09614198138752,6.05888829799369,1.03725368339383,32,44,-12,43,54,-11,51,69,-18,2,3,0,0
"7613","DAL","FLA",2014020820,16479,20142015,1,60,2,0,2,6.38994827368151,5.46516978085856,0.924778492822952,28,37,-9,50,51,-1,61,65,-4,4,4,0,0
"7614","DAL","COL",2014020830,16480,20142015,0,60,1,4,-3,2.70612573903054,5.06817157430851,-2.36204583527797,25,30,-5,36,41,-5,59,59,0,1,3,0,0
"7615","DAL","STL",2014020851,16483,20142015,0,60,4,1,3,2.7688557600819,4.10878269715403,-1.33992693707213,22,28,-6,35,39,-4,43,57,-14,4,3,0,0
"7616","DAL","S.J",2014020865,16485,20142015,1,60,2,5,-3,6.22572062027029,4.78923811968343,1.43648250058686,39,28,11,60,42,18,84,55,29,3,2,0,0
"7617","DAL","DET",2014020881,16487,20142015,1,60.6,6,7,-1,4.4622810691053,4.78502134639712,-0.322740277291814,34,36,-2,45,52,-7,65,66,-1,2,3,0,0
"7618","DAL","MIN",2014020891,16488,20142015,0,60,2,6,-4,4.86438047062997,4.34722801880494,0.517152451825027,20,35,-15,26,42,-16,35,51,-16,3,2,0,0
"7619","DAL","WPG",2014020902,16490,20142015,0,60,2,4,-2,5.49951802153373,5.38062965298377,0.11888836854996,28,25,3,49,39,10,66,45,21,3,3,0,0
"7620","DAL","COL",2014020921,16493,20142015,1,65,4,4,0,4.4750053123862,3.20684494015586,1.26816037223034,36,23,13,57,41,16,76,55,21,3,3,0,0
"7621","DAL","ANA",2014020937,16495,20142015,1,60,1,3,-2,4.69595472237691,4.8430641352731,-0.147109412896185,40,22,18,53,32,21,80,42,38,3,1,0,0
"7622","DAL","NYI",2014020948,16497,20142015,1,62.3,3,2,1,3.96840768179391,6.68522650838368,-2.71681882658978,35,37,-2,62,54,8,85,73,12,4,3,0,0
"7623","DAL","FLA",2014020960,16499,20142015,0,65,3,3,0,6.1616915083232,2.83914173222729,3.32254977609591,32,24,8,45,31,14,65,38,27,2,2,0,0
"7624","DAL","T.B",2014020972,16501,20142015,0,60,4,5,-1,3.8780959378345,3.70801197557012,0.170083962264385,35,28,7,45,38,7,55,51,4,2,4,0,0
"7625","DAL","PHI",2014020992,16504,20142015,0,60,2,1,1,5.13407472465597,3.95058796204535,1.18348676261062,39,26,13,49,40,9,63,57,6,3,3,0,0
"7626","DAL","CAR",2014021004,16506,20142015,0,60,5,3,2,5.83115052868379,3.807041998356,2.02410853032779,32,18,14,44,30,14,58,48,10,2,3,0,0
"7627","DAL","WSH",2014021014,16507,20142015,0,60,4,2,2,0,0,0,31,20,11,41,35,6,57,48,9,7,4,0,0
"7628","DAL","STL",2014021032,16509,20142015,1,60,0,3,-3,2.95701071954136,3.33170170080402,-0.37469098126266,28,21,7,41,28,13,59,37,22,7,3,0,0
"7629","DAL","CHI",2014021076,16515,20142015,1,60,4,0,4,0,0,0,29,33,-4,39,44,-5,46,62,-16,3,3,0,0
"7630","DAL","BUF",2014021087,16517,20142015,1,60,4,3,1,9.73927543456715,4.67494280466053,5.06433262990662,39,28,11,58,39,19,101,49,52,3,3,0,0
"7631","DAL","CGY",2014021100,16519,20142015,0,65,3,3,0,3.66346230143079,5.21599826756808,-1.55253596613729,30,34,-4,45,45,0,69,57,12,6,4,0,0
"7632","DAL","EDM",2014021114,16521,20142015,0,60,0,4,-4,2.89623528749507,3.62199984036852,-0.725764552873443,29,28,1,50,34,16,75,42,33,4,3,0,0
"7633","DAL","VAN",2014021127,16522,20142015,0,64.2166666666667,4,3,1,10.7188078550971,3.73955948077491,6.9792483743222,40,36,4,52,49,3,63,58,5,2,4,0,0
"7634","DAL","CGY",2014021139,16524,20142015,1,60,3,5,-2,8.81260472166468,5.40103976102546,3.41156496063923,36,25,11,68,38,30,100,47,53,4,3,0,0
"7635","DAL","STL",2014021164,16528,20142015,1,60,5,7,-2,0,0,0,32,21,11,47,27,20,65,41,24,6,4,0,0
"7636","DAL","NSH",2014021176,16529,20142015,0,64.0666666666667,4,3,1,3.59033879554318,6.11744508688935,-2.52710629134617,24,36,-12,34,52,-18,48,71,-23,2,2,0,0
"7637","DAL","S.J",2014021189,16531,20142015,0,60,5,1,4,4.63086021691561,3.80451911673072,0.826341100184891,25,24,1,33,39,-6,61,60,1,6,5,0,0
"7638","DAL","ANA",2014021202,16533,20142015,0,60,4,0,4,6.03092341148295,3.08470300811936,2.94622040336359,32,19,13,50,34,16,61,43,18,3,1,0,0
"7639","DAL","NSH",2014021227,16536,20142015,1,60,4,1,3,6.0667340009386,2.53789534161115,3.52883865932745,25,25,0,41,37,4,59,60,-1,3,2,0,0
"7640","DAL","COL",2015020027,16718,20152016,0,60,3,6,-3,3.50253073239081,3.66874681495417,-0.166216082563353,33,28,5,42,40,2,66,57,9,5,5,0,0
"7641","DAL","EDM",2015020043,16721,20152016,1,60,4,2,2,7.02619663177757,4.25264961065216,2.77354702112541,52,28,24,62,35,27,87,48,39,5,2,0,0
"7642","DAL","T.B",2015020054,16723,20152016,0,60,5,3,2,1.95706698174763,4.18447632336814,-2.22740934162051,22,33,-11,29,56,-27,37,70,-33,2,3,0,0
"7643","DAL","FLA",2015020068,16725,20152016,0,60,4,2,2,4.44509027896311,4.85800894454587,-0.412918665582765,37,26,11,45,38,7,58,48,10,3,2,0,0
"7644","DAL","PHI",2015020082,16728,20152016,0,60,2,1,1,3.75361424785695,4.83769122455851,-1.08407697670156,32,35,-3,45,47,-2,62,59,3,5,7,0,0
"7645","DAL","FLA",2015020113,16732,20152016,1,60,2,6,-4,4.11821039636561,5.25293644293561,-1.13472604656999,35,30,5,45,50,-5,67,64,3,5,3,0,0
"7646","DAL","ANA",2015020132,16735,20152016,1,60,4,3,1,3.26518028086971,2.00050547223509,1.26467480863462,34,20,14,49,29,20,59,47,12,3,4,0,0
"7647","DAL","VAN",2015020143,16737,20152016,1,62.4666666666667,4,3,1,5.22496296622558,2.80985459082876,2.41510837539681,29,32,-3,41,45,-4,75,60,15,4,4,0,0
"7648","DAL","S.J",2015020155,16739,20152016,1,60,5,3,2,5.17307606154645,3.88708421238933,1.28599184915713,25,29,-4,44,40,4,56,46,10,5,4,0,0
"7649","DAL","TOR",2015020169,16741,20152016,0,60,1,4,-3,3.47726527274566,3.54907758056652,-0.0718123078208563,44,26,18,60,47,13,76,54,22,3,5,0,0
"7650","DAL","BOS",2015020172,16742,20152016,0,60,5,3,2,3.45613650534125,5.93661096605229,-2.48047446071103,19,39,-20,33,56,-23,44,77,-33,4,4,0,0
"7651","DAL","CAR",2015020196,16745,20152016,0,60,4,1,3,3.37275362515356,4.28481551434379,-0.912061889190227,29,31,-2,50,47,3,63,58,5,1,0,0,0
"7652","DAL","DET",2015020211,16747,20152016,0,60,4,1,3,7.3098694636908,3.72844302739042,3.58142643630038,26,22,4,33,37,-4,40,50,-10,3,5,0,0
"7653","DAL","TOR",2015020225,16749,20152016,1,60,2,3,-1,6.66893413488287,5.62303027376217,1.04590386112071,38,30,8,52,47,5,67,55,12,1,1,0,0
"7654","DAL","WPG",2015020239,16751,20152016,1,60,6,3,3,5.50250292245619,3.92925569306681,1.57324722938938,34,38,-4,46,42,4,68,67,1,4,4,0,0
"7655","DAL","MIN",2015020257,16753,20152016,1,63.3,3,2,1,4.83896177184852,5.45959045150382,-0.6206286796553,36,24,12,49,47,2,66,66,0,6,6,0,0
"7656","DAL","BUF",2015020268,16756,20152016,0,60,3,1,2,6.58612955968804,4.65446386300027,1.93166569668777,29,25,4,45,38,7,60,52,8,1,3,0,0
"7657","DAL","WSH",2015020281,16758,20152016,0,60,3,2,1,3.55773824911739,4.82069197353081,-1.26295372441342,31,35,-4,43,49,-6,60,68,-8,2,0,0,0
"7658","DAL","BUF",2015020301,16760,20152016,1,60,3,0,3,5.09085875882158,3.91021245140587,1.18064630741571,32,22,10,53,37,16,72,49,23,5,3,0,0
"7659","DAL","OTT",2015020315,16763,20152016,1,60,4,7,-3,6.29404339672055,3.99149750493234,2.30254589178821,37,20,17,50,35,15,65,49,16,2,3,0,0
"7660","DAL","VAN",2015020340,16766,20152016,1,65,2,2,0,3.66122126119747,6.36358292323712,-2.70236166203964,25,36,-11,35,53,-18,49,68,-19,5,7,0,0
"7661","DAL","MIN",2015020349,16767,20152016,0,63.95,4,3,1,4.67738474910584,5.7148960880877,-1.03751133898186,44,26,18,55,39,16,71,47,24,2,2,0,0
"7662","DAL","CGY",2015020366,16770,20152016,0,65,3,3,0,5.69198504536325,6.76328642427817,-1.07130137891492,29,32,-3,43,55,-12,60,72,-12,2,3,0,0
"7663","DAL","VAN",2015020380,16772,20152016,0,60,4,2,2,5.14965266664512,2.41893880139833,2.7307138652468,34,16,18,48,28,20,60,44,16,5,3,0,0
"7664","DAL","EDM",2015020386,16773,20152016,0,60.75,1,2,-1,4.95132257824298,3.85412175561942,1.09720082262356,43,24,19,58,33,25,77,47,30,4,3,0,0
"7665","DAL","CAR",2015020415,16777,20152016,1,60,6,5,1,2.93934164359234,5.12897660414819,-2.18963496055585,20,30,-10,30,49,-19,40,68,-28,3,3,0,0
"7666","DAL","PHI",2015020431,16780,20152016,1,60,3,1,2,9.87425223307218,3.88793604809325,5.98631618497893,44,20,24,62,32,30,86,46,40,6,2,0,0
"7667","DAL","STL",2015020440,16781,20152016,0,60,0,3,-3,3.89381315627203,2.22865768796444,1.66515546830759,26,26,0,32,37,-5,53,44,9,5,6,0,0
"7668","DAL","CBJ",2015020463,16784,20152016,1,60,5,1,4,5.76015971253219,4.62528575316537,1.13487395936681,34,35,-1,54,45,9,60,58,2,4,3,0,0
"7669","DAL","CGY",2015020474,16786,20152016,1,60,1,3,-2,6.45343395532988,4.11413875184371,2.33929520348617,36,27,9,54,39,15,83,50,33,3,3,0,0
"7670","DAL","MTL",2015020489,16788,20152016,1,60,6,2,4,3.55760734231444,5.56099926318529,-2.00339192087085,27,23,4,40,37,3,53,50,3,8,6,0,0
"7671","DAL","MIN",2015020504,16790,20152016,0,60,6,3,3,4.92167185028666,8.63682840869296,-3.71515655840631,34,35,-1,43,44,-1,58,55,3,3,1,0,0
"7672","DAL","CHI",2015020513,16791,20152016,1,60,4,0,4,3.95892023254214,5.60145734702746,-1.64253711448532,32,20,12,44,31,13,66,49,17,5,3,0,0
"7673","DAL","STL",2015020521,16795,20152016,0,65,2,2,0,3.96473757656713,5.39405966539744,-1.4293220888303,24,37,-13,28,48,-20,37,68,-31,1,4,0,0
"7674","DAL","STL",2015020529,16796,20152016,1,60,3,0,3,6.32208178460132,2.94454385437943,3.3775379302219,38,22,16,58,35,23,79,48,31,5,4,0,0
"7675","DAL","CBJ",2015020544,16798,20152016,0,60,3,6,-3,3.59639922215206,6.36991986662906,-2.773520644477,43,33,10,57,45,12,72,61,11,4,3,0,0
"7676","DAL","NSH",2015020561,16800,20152016,1,60,5,1,4,0,0,0,32,34,-2,44,44,0,61,56,5,1,1,0,0
"7677","DAL","N.J",2015020573,16802,20152016,0,61.7833333333333,2,3,-1,5.1529942326769,3.15995839540847,1.99303583726843,31,30,1,37,43,-6,43,48,-5,3,4,0,0
"7678","DAL","NYI",2015020579,16803,20152016,0,60,5,6,-1,4.80245283076249,5.25309953330361,-0.450646702541123,41,44,-3,52,56,-4,68,66,2,4,4,0,0
"7679","DAL","NYR",2015020590,16805,20152016,0,60,2,6,-4,2.84824024746194,3.95546253563191,-1.10722228816996,23,29,-6,32,40,-8,53,57,-4,3,3,0,0
"7680","DAL","WPG",2015020604,16807,20152016,1,65,1,1,0,4.37252356205681,3.32814921369572,1.04437434836109,24,33,-9,37,42,-5,57,62,-5,3,4,0,0
"7681","DAL","MIN",2015020620,16809,20152016,1,60,1,2,-1,5.79852263249859,2.87858658810728,2.91993604439131,35,25,10,56,32,24,82,43,39,3,2,0,0
"7682","DAL","ANA",2015020659,16815,20152016,0,60,2,4,-2,4.96852819311607,2.5537935810392,2.41473461207687,24,35,-11,39,51,-12,61,64,-3,4,3,0,0
"7683","DAL","S.J",2015020669,16816,20152016,0,61.2,3,4,-1,5.05472192871443,3.80067416126985,1.25404776744458,35,39,-4,43,45,-2,63,59,4,2,2,0,0
"7684","DAL","L.A",2015020689,16819,20152016,0,60,2,3,-1,4.48963430541335,4.12419764441438,0.365436660998967,29,29,0,44,41,3,58,56,2,2,2,0,0
"7685","DAL","EDM",2015020700,16821,20152016,1,60,3,2,1,4.50820146753904,4.50114776485134,0.00705370268769911,35,25,10,53,41,12,65,65,0,2,3,0,0
"7686","DAL","COL",2015020717,16823,20152016,1,60,1,3,-2,8.69594706150383,1.00558956401073,7.6903574974931,43,15,28,74,23,51,106,32,74,5,1,0,0
"7687","DAL","CGY",2015020729,16825,20152016,1,60,2,1,1,3.85504213784425,4.58580025838455,-0.730758120540305,30,24,6,48,36,12,69,55,14,3,6,0,0
"7688","DAL","WPG",2015020751,16833,20152016,0,60,5,3,2,5.55596818121421,3.26765832704889,2.28830985416532,27,24,3,41,32,9,55,47,8,5,4,0,0
"7689","DAL","COL",2015020767,16835,20152016,0,60.5833333333333,4,3,1,5.88760291816083,3.19142385310624,2.69617906505458,44,24,20,57,30,27,85,34,51,4,6,0,0
"7690","DAL","CHI",2015020784,16837,20152016,1,60,1,5,-4,5.20515637449646,1.54562203137903,3.65953434311744,37,26,11,53,34,19,71,39,32,6,6,0,0
"7691","DAL","MIN",2015020802,16840,20152016,0,62.65,4,3,1,4.40022623690311,5.54050587612437,-1.14027963922126,30,40,-10,46,49,-3,60,68,-8,3,3,0,0
"7692","DAL","CHI",2015020815,16842,20152016,0,60,4,2,2,3.96079930354426,7.94454163170774,-3.98374232816347,32,46,-14,39,51,-12,51,62,-11,3,3,0,0
"7693","DAL","WSH",2015020831,16844,20152016,1,60,4,3,1,5.25619234115584,4.86087393481284,0.395318406342994,35,23,12,48,39,9,65,53,12,4,3,0,0
"7694","DAL","NSH",2015020843,16846,20152016,0,63.8166666666667,3,2,1,6.61102266752278,4.82213239616249,1.78889027136029,32,26,6,45,39,6,62,48,14,2,2,0,0
"7695","DAL","STL",2015020853,16847,20152016,0,61.1833333333333,1,2,-1,2.52434922917746,4.57676933940778,-2.05242011023032,18,22,-4,32,38,-6,48,46,2,7,5,0,0
"7696","DAL","ARI",2015020867,16849,20152016,0,60,3,6,-3,6.28725170157304,8.26838274343027,-1.98113104185722,39,42,-3,54,55,-1,70,64,6,3,4,0,0
"7697","DAL","BOS",2015020880,16851,20152016,1,60,3,7,-4,4.21611320991391,6.2626622164367,-2.04654900652279,29,42,-13,48,59,-11,57,75,-18,1,6,0,0
"7698","DAL","WPG",2015020899,16854,20152016,0,60,5,3,2,3.93359127411593,5.0543655740538,-1.12077429993788,27,25,2,37,40,-3,49,62,-13,5,4,0,0
"7699","DAL","WPG",2015020912,16856,20152016,1,60,3,6,-3,3.13935144518499,5.23381350381533,-2.09446205863034,30,28,2,44,37,7,54,49,5,6,4,0,0
"7700","DAL","NYR",2015020925,16858,20152016,1,60,2,3,-1,10.4677095619845,5.80067380162654,4.66703576035798,38,29,9,59,43,16,85,61,24,1,3,0,0
"7701","DAL","DET",2015020941,16860,20152016,1,62.55,2,3,-1,5.75431360247603,5.0812936713337,0.673019931142335,41,33,8,59,47,12,72,60,12,4,4,0,0
"7702","DAL","NSH",2015020947,16861,20152016,0,60,3,5,-2,7.32778626459185,6.79534421246557,0.532442052126285,38,34,4,46,48,-2,65,60,5,4,5,0,0
"7703","DAL","N.J",2015020968,16864,20152016,1,60,4,2,2,4.85417633858742,4.37099582905648,0.483180509530939,25,20,5,43,36,7,60,53,7,3,3,0,0
"7704","DAL","OTT",2015020980,16866,20152016,0,60,2,1,1,5.54347328887025,3.16635760224017,2.37711568663008,25,24,1,35,33,2,47,56,-9,2,3,0,0
"7705","DAL","MTL",2015020997,16868,20152016,0,61.9833333333333,3,4,-1,4.91876750008669,6.46187121151888,-1.5431037114322,33,28,5,43,38,5,61,58,3,3,2,0,0
"7706","DAL","CHI",2015021016,16871,20152016,1,60,5,2,3,3.64607191435061,3.73663182351447,-0.0905599091638578,31,23,8,43,35,8,52,61,-9,6,5,0,0
"7707","DAL","STL",2015021025,16872,20152016,1,62.1833333333333,4,5,-1,6.01060376076202,3.34288126108004,2.66772249968199,38,36,2,45,54,-9,54,72,-18,4,5,0,0
"7708","DAL","L.A",2015021045,16875,20152016,1,60,2,5,-3,4.08439853312103,4.69939167186385,-0.614993138742818,27,22,5,42,29,13,55,43,12,3,1,0,0
"7709","DAL","T.B",2015021058,16877,20152016,1,60,4,3,1,6.18032461043913,3.05707620381145,3.12324840662768,33,20,13,48,34,14,58,54,4,1,1,0,0
"7710","DAL","NYI",2015021074,16879,20152016,1,60,3,0,3,5.47705981289721,3.30076058309101,2.1762992298062,36,27,9,56,39,17,75,65,10,4,2,0,0
"7711","DAL","CHI",2015021096,16882,20152016,0,60,6,2,4,4.8919159951547,5.05075579294916,-0.158839797794457,33,32,1,37,46,-9,46,72,-26,3,3,0,0
"7712","DAL","ARI",2015021110,16884,20152016,0,60,1,3,-2,6.42729721902694,5.71224205527725,0.715055163749688,38,30,8,55,50,5,70,76,-6,3,6,0,0
"7713","DAL","S.J",2015021118,16886,20152016,0,60,4,2,2,4.22339580132393,5.11639512698457,-0.892999325660639,17,36,-19,25,60,-35,33,80,-47,5,8,0,0
"7714","DAL","NSH",2015021147,16889,20152016,1,60,5,2,3,5.64870338790934,5.04259440027818,0.60610898763116,25,30,-5,34,51,-17,50,68,-18,5,4,0,0
"7715","DAL","ARI",2015021159,16891,20152016,1,60,4,1,3,0,0,0,33,32,1,56,37,19,69,48,21,4,3,0,0
"7716","DAL","L.A",2015021169,16893,20152016,0,60,3,2,1,6.50263136658759,4.43269015615806,2.06994121042953,39,26,13,55,42,13,68,53,15,4,3,0,0
"7717","DAL","ANA",2015021182,16894,20152016,0,60,1,3,-2,4.79264739849168,6.10198070988727,-1.30933331139559,25,25,0,40,45,-5,62,53,9,5,3,0,0
"7718","DAL","COL",2015021211,16898,20152016,1,60,4,2,2,5.84238565037958,4.2122640144903,1.63012163588928,31,19,12,45,27,18,65,51,14,3,4,0,0
"7719","DAL","NSH",2015021227,16900,20152016,1,60,3,2,1,4.07916505825597,6.53322379804422,-2.45405873978825,24,30,-6,40,47,-7,68,63,5,4,4,0,0
"7720","DAL","MIN",2015030151,16905,20152016,1,60,4,0,4,5.40737201838056,2.00845008050906,3.39892193787149,32,22,10,41,27,14,62,46,16,6,2,0,0
"7721","DAL","MIN",2015030152,16907,20152016,1,60,2,1,1,4.07007986211623,2.06189577516488,2.00818408695135,28,26,2,51,40,11,77,54,23,5,5,0,0
"7722","DAL","MIN",2015030153,16909,20152016,0,60,3,5,-2,3.59572503876552,5.87782331221388,-2.28209827344836,17,25,-8,23,37,-14,47,54,-7,3,3,0,0
"7723","DAL","MIN",2015030154,16911,20152016,0,60,3,2,1,4.66764446924208,4.98409256676188,-0.316448097519803,22,30,-8,38,40,-2,51,56,-5,3,4,0,0
"7724","DAL","MIN",2015030155,16913,20152016,1,64.9166666666667,4,5,-1,6.68243866274133,5.57033113574569,1.11210752699564,41,24,17,59,33,26,93,47,46,3,1,0,0
"7725","DAL","MIN",2015030156,16915,20152016,0,60,5,4,1,3.05501124738657,4.10748547152616,-1.05247422413959,24,29,-5,30,37,-7,49,54,-5,2,4,0,0
"7726","DAL","STL",2015030231,16920,20152016,1,60,2,1,1,5.9354378846474,7.4971463949671,-1.5617085103197,42,32,10,61,46,15,72,68,4,4,3,0,0
"7727","DAL","STL",2015030232,16922,20152016,1,70.9666666666667,3,4,-1,5.34734804744767,6.35538646648553,-1.00803841903786,34,25,9,47,35,12,70,58,12,4,5,0,0
"7728","DAL","STL",2015030233,16924,20152016,0,60,1,6,-5,3.27080640655188,2.67228112289911,0.598525283652771,26,39,-13,38,51,-13,53,59,-6,5,8,0,0
"7729","DAL","STL",2015030234,16926,20152016,0,62.9666666666667,3,2,1,4.89762210444098,3.75556088908343,1.14206121535756,28,26,2,36,40,-4,44,44,0,4,4,0,0
"7730","DAL","STL",2015030235,16928,20152016,1,60,1,4,-3,5.14061677581049,4.30854756454937,0.832069211261114,28,22,6,45,31,14,65,46,19,3,2,0,0
"7731","DAL","STL",2015030236,16930,20152016,0,60,3,2,1,4.3679716661527,5.05569213305716,-0.687720466904466,14,37,-23,23,56,-33,25,75,-50,1,2,0,0
"7732","DAL","STL",2015030237,16932,20152016,1,60,1,6,-5,6.16109531064285,4.38991867656637,1.77117663407648,32,19,13,53,33,20,87,38,49,3,2,0,0
"7733","DAL","ANA",2016020013,17087,20162017,1,60,4,2,2,6.36983854882419,5.89775325608798,0.47208529273621,20,35,-15,36,54,-18,49,64,-15,4,5,0,0
"7734","DAL","COL",2016020027,17089,20162017,0,60,5,6,-1,8.09643922647007,7.17632979334215,0.920109433127926,28,33,-5,40,44,-4,54,60,-6,4,3,0,0
"7735","DAL","NSH",2016020043,17092,20162017,0,60,2,1,1,7.39487019123044,2.37238075515623,5.02248943607421,37,28,9,52,36,16,70,56,14,3,4,0,0
"7736","DAL","L.A",2016020058,17094,20162017,1,61.3333333333333,3,4,-1,4.68464566334171,6.33574253802362,-1.65109687468191,20,39,-19,32,58,-26,47,78,-31,5,7,0,0
"7737","DAL","CBJ",2016020074,17096,20162017,1,60,0,3,-3,5.6721664413999,6.01356397117706,-0.341397529777169,32,26,6,52,47,5,64,65,-1,5,3,0,0
"7738","DAL","WPG",2016020090,17099,20162017,1,60,3,2,1,4.96783834383389,6.48061106954182,-1.51277272570793,26,30,-4,36,45,-9,53,65,-12,7,5,0,0
"7739","DAL","WPG",2016020104,17101,20162017,0,60,1,4,-3,7.93565645139968,3.26691629976267,4.66874015163701,39,36,3,54,46,8,71,55,16,6,7,0,0
"7740","DAL","MIN",2016020119,17103,20162017,0,60,0,4,-4,6.89455549680133,4.970434208808,1.92412128799333,29,15,14,43,24,19,64,36,28,3,2,0,0
"7741","DAL","CBJ",2016020133,17106,20162017,0,60.7666666666667,2,3,-1,6.13792026125157,3.58334173240291,2.55457852884865,38,28,10,55,39,16,73,55,18,4,2,0,0
"7742","DAL","STL",2016020154,17108,20162017,1,60,6,2,4,5.21649858658202,5.17541669837613,0.0410818882058948,27,30,-3,38,43,-5,51,60,-9,7,7,0,0
"7743","DAL","CHI",2016020171,17110,20162017,1,60,2,3,-1,8.79672761852464,6.90210551525524,1.8946221032694,33,32,1,56,40,16,74,53,21,6,8,0,0
"7744","DAL","CHI",2016020178,17111,20162017,0,64.5166666666667,3,4,-1,5.03052697136449,3.281497903532,1.7490290678325,35,33,2,43,49,-6,59,59,0,4,4,0,0
"7745","DAL","WPG",2016020191,17113,20162017,0,60,2,8,-6,5.91525129438378,4.9495266917329,0.96572460265088,30,31,-1,45,40,5,61,59,2,6,6,0,0
"7746","DAL","CGY",2016020204,17115,20162017,0,60,4,2,2,3.56455375293081,3.15943259701089,0.405121155919915,22,31,-9,28,41,-13,38,59,-21,4,3,0,0
"7747","DAL","EDM",2016020211,17116,20162017,0,60,3,2,1,5.26961806169592,4.49941253031706,0.770205531378863,30,42,-12,36,56,-20,39,73,-34,4,3,0,0
"7748","DAL","VAN",2016020224,17118,20162017,0,61.45,4,5,-1,1.25017867577697,4.12101266949321,-2.87083399371625,21,30,-9,31,43,-12,40,57,-17,2,3,0,0
"7749","DAL","N.J",2016020239,17120,20162017,1,60.7333333333333,1,2,-1,4.14096001951111,4.09965456434293,0.0413054551681853,24,33,-9,40,45,-5,57,72,-15,2,1,0,0
"7750","DAL","COL",2016020251,17122,20162017,1,60,3,2,1,3.02101644250797,5.05311456597386,-2.03209812346589,22,36,-14,29,52,-23,46,77,-31,7,2,0,0
"7751","DAL","EDM",2016020266,17124,20162017,1,60,2,5,-3,4.92680276888655,6.80267706539962,-1.87587429651308,33,30,3,51,47,4,62,62,0,6,3,0,0
"7752","DAL","MIN",2016020280,17126,20162017,1,61.3833333333333,3,2,1,5.43542461880861,4.31496587841119,1.12045874039742,32,29,3,52,46,6,73,63,10,2,3,0,0
"7753","DAL","NSH",2016020295,17128,20162017,0,60,2,5,-3,3.88747597092879,3.625688834627,0.261787136301791,35,21,14,39,32,7,50,52,-2,2,4,0,0
"7754","DAL","VAN",2016020311,17130,20162017,1,60,2,1,1,4.48308552835078,6.01216574374484,-1.52908021539406,28,31,-3,42,45,-3,52,69,-17,1,2,0,0
"7755","DAL","STL",2016020329,17133,20162017,0,63.4,3,4,-1,1.62432729720604,4.30663221153343,-2.68230491432739,21,31,-10,28,42,-14,44,61,-17,3,4,0,0
"7756","DAL","DET",2016020334,17134,20162017,0,60,1,3,-2,6.46664715814404,3.54276137900888,2.92388577913516,35,20,15,47,25,22,60,37,23,6,5,0,0
"7757","DAL","PIT",2016020347,17136,20162017,0,60,2,6,-4,4.97098572464893,7.14998776093125,-2.17900203628233,35,40,-5,46,46,0,62,63,-1,3,5,0,0
"7758","DAL","COL",2016020369,17138,20162017,0,60,3,0,3,5.30318286948862,3.18909323448315,2.11408963500547,33,23,10,42,36,6,57,45,12,4,4,0,0
"7759","DAL","CGY",2016020390,17141,20162017,1,60,1,2,-1,3.27527484034363,3.91493130462572,-0.639656464282098,30,20,10,50,34,16,68,50,18,2,2,0,0
"7760","DAL","NSH",2016020402,17143,20162017,1,60,5,2,3,4.22452463441386,5.4410815499723,-1.21655691555844,37,36,1,52,50,2,68,69,-1,6,5,0,0
"7761","DAL","PHI",2016020411,17145,20162017,0,60,2,4,-2,4.23296733789418,4.61210123085493,-0.379133892960752,23,22,1,33,37,-4,49,49,0,4,6,0,0
"7762","DAL","CHI",2016020427,17146,20162017,0,60,1,3,-2,2.14630260628473,4.87047721815179,-2.72417461186706,24,27,-3,36,37,-1,51,51,0,2,3,0,0
"7763","DAL","ANA",2016020439,17148,20162017,1,60,6,2,4,4.86127615666373,6.70673548520491,-1.84545932854117,27,36,-9,45,56,-11,56,74,-18,5,6,0,0
"7764","DAL","NYR",2016020452,17150,20162017,1,60,0,2,-2,4.33069297541806,5.14848685658674,-0.817793881168683,27,30,-3,47,43,4,61,56,5,6,3,0,0
"7765","DAL","PHI",2016020460,17152,20162017,1,60,3,1,2,6.22729233586142,4.36303461300849,1.86425772285293,28,32,-4,47,51,-4,64,66,-2,1,1,0,0
"7766","DAL","STL",2016020490,17155,20162017,1,61.9166666666667,2,3,-1,5.56913743512558,4.62889349879697,0.940243936328613,38,22,16,55,29,26,73,49,24,4,2,0,0
"7767","DAL","L.A",2016020513,17158,20162017,1,61.1166666666667,3,2,1,5.986244194962,8.52904989232775,-2.54280569736575,31,31,0,45,46,-1,57,64,-7,3,3,0,0
"7768","DAL","ARI",2016020525,17162,20162017,0,60,3,2,1,4.51877851716752,5.1303972362075,-0.611618719039984,29,37,-8,43,48,-5,55,66,-11,4,4,0,0
"7769","DAL","COL",2016020540,17164,20162017,1,60,4,2,2,6.16341133326182,5.11760809307452,1.04580324018729,34,19,15,59,35,24,74,42,32,7,5,0,0
"7770","DAL","FLA",2016020554,17166,20162017,1,60,1,3,-2,8.85159988765372,4.8372853709443,4.01431451670942,36,38,-2,63,46,17,89,54,35,4,2,0,0
"7771","DAL","MTL",2016020574,17170,20162017,1,60.3166666666667,3,4,-1,5.87877369274645,3.53204404108692,2.34672965165953,42,33,9,56,45,11,74,62,12,2,3,0,0
"7772","DAL","STL",2016020599,17173,20162017,0,60,3,4,-1,3.21388874255354,3.50862835190492,-0.294739609351382,28,22,6,34,34,0,48,47,1,5,4,0,0
"7773","DAL","L.A",2016020612,17175,20162017,0,60,6,4,2,3.31759330056957,2.37795395072317,0.939639349846402,26,22,4,34,41,-7,44,64,-20,1,3,0,0
"7774","DAL","ANA",2016020619,17176,20162017,0,60,0,2,-2,5.70650887674037,5.19107350074762,0.515435375992752,34,38,-4,51,58,-7,59,71,-12,3,4,0,0
"7775","DAL","DET",2016020629,17178,20162017,1,60,5,2,3,3.01397134496074,4.48266745929141,-1.46869611433067,21,33,-12,40,53,-13,53,77,-24,1,5,0,0
"7776","DAL","MIN",2016020648,17180,20162017,1,60,4,5,-1,7.37172746661301,3.50460926538199,3.86711820123102,38,32,6,53,41,12,70,59,11,3,4,0,0
"7777","DAL","BUF",2016020657,17182,20162017,0,60,1,4,-3,6.40569168336095,6.43191193870734,-0.0262202553463986,32,29,3,46,39,7,61,56,5,1,3,0,0
"7778","DAL","NYR",2016020663,17183,20162017,0,60,7,6,1,6.36655459103162,6.01194860815303,0.354605982878581,31,40,-9,42,51,-9,54,71,-17,2,3,0,0
"7779","DAL","NYI",2016020677,17185,20162017,0,60,0,3,-3,2.38931795535609,6.05575983809467,-3.66644188273858,23,36,-13,33,44,-11,51,59,-8,3,8,0,0
"7780","DAL","WSH",2016020697,17187,20162017,1,60.3166666666667,3,4,-1,3.22481894741213,3.33207589465019,-0.107256947238056,35,22,13,45,36,9,61,50,11,7,3,0,0
"7781","DAL","MIN",2016020723,17190,20162017,1,65,2,2,0,7.18815196634665,4.28027034793922,2.90788161840743,37,33,4,57,48,9,72,59,13,5,4,0,0
"7782","DAL","BUF",2016020738,17192,20162017,1,60,4,3,1,4.72748028336881,5.03926726008618,-0.311786976717366,38,27,11,57,39,18,74,52,22,5,2,0,0
"7783","DAL","TOR",2016020750,17197,20162017,1,60,6,3,3,4.92757361880649,6.47114346880699,-1.54356985000049,20,43,-23,32,61,-29,47,81,-34,1,2,0,0
"7784","DAL","WPG",2016020763,17199,20162017,1,60,3,4,-1,8.28006186107541,2.68821041510091,5.5918514459745,42,29,13,54,36,18,83,43,40,2,2,0,0
"7785","DAL","CHI",2016020781,17201,20162017,1,60,3,5,-2,5.18508221723141,3.78114913147874,1.40393308575267,34,36,-2,48,44,4,57,64,-7,3,2,0,0
"7786","DAL","TOR",2016020794,17204,20162017,0,60,1,3,-2,5.28830341832509,3.50181394874835,1.78648946957674,40,34,6,59,48,11,75,62,13,4,5,0,0
"7787","DAL","OTT",2016020809,17206,20162017,0,60,2,3,-1,6.22201403772488,3.63113811738873,2.59087592033614,33,27,6,45,35,10,64,51,13,6,3,0,0
"7788","DAL","CAR",2016020819,17208,20162017,1,60,5,2,3,4.39179537145537,2.69223053629685,1.69956483515853,27,24,3,38,39,-1,50,54,-4,4,2,0,0
"7789","DAL","NSH",2016020831,17209,20162017,0,60,3,5,-2,4.91138475027401,6.62257069138286,-1.71118594110885,21,36,-15,35,55,-20,47,77,-30,9,6,0,0
"7790","DAL","WPG",2016020841,17211,20162017,0,60,2,5,-3,5.71892677137316,4.8705277926087,0.848398978764465,36,24,12,52,35,17,77,51,26,5,4,0,0
"7791","DAL","MIN",2016020852,17213,20162017,0,60,1,3,-2,5.19189721872681,2.88902011721189,2.30287710151492,35,26,9,54,36,18,80,47,33,3,3,0,0
"7792","DAL","T.B",2016020864,17215,20162017,1,63.7833333333333,4,3,1,5.15998896176461,4.57773861463972,0.582250347124889,28,37,-9,44,56,-12,57,79,-22,2,2,0,0
"7793","DAL","ARI",2016020903,17221,20162017,1,60,5,2,3,5.29081101913471,2.60260391581301,2.6882071033217,37,27,10,53,39,14,80,55,25,6,4,0,0
"7794","DAL","BOS",2016020912,17223,20162017,1,60,3,6,-3,4.93890514813793,3.98535017512404,0.953554973013892,36,28,8,41,39,2,62,51,11,2,2,0,0
"7795","DAL","PIT",2016020930,17225,20162017,1,60,3,2,1,3.87524310003937,1.65491074498487,2.2203323550545,32,20,12,44,37,7,57,60,-3,1,1,0,0
"7796","DAL","NYI",2016020943,17227,20162017,1,60,4,5,-1,5.69127125889606,7.94784770611295,-2.2565764472169,25,33,-8,40,50,-10,55,69,-14,1,2,0,0
"7797","DAL","FLA",2016020955,17229,20162017,0,60,2,1,1,4.50403144840539,6.33094330737367,-1.82691185896829,34,42,-8,38,56,-18,52,63,-11,3,3,0,0
"7798","DAL","WSH",2016020969,17231,20162017,0,60,4,2,2,4.46685859678526,5.89566885615932,-1.42881025937406,22,44,-22,29,60,-31,48,82,-34,2,4,0,0
"7799","DAL","OTT",2016020983,17233,20162017,1,60,2,5,-3,6.84053620533086,2.41353722815984,4.42699897717102,37,23,14,64,31,33,86,42,44,6,5,0,0
"7800","DAL","S.J",2016021015,17237,20162017,0,60,1,5,-4,6.56753119945131,4.35317754941751,2.2143536500338,30,26,4,47,37,10,62,47,15,2,5,0,0
"7801","DAL","EDM",2016021030,17239,20162017,0,60,1,7,-6,3.15173814387526,6.00287101735739,-2.85113287348213,23,29,-6,35,44,-9,62,57,5,1,2,0,0
"7802","DAL","VAN",2016021045,17241,20162017,0,60,4,2,2,6.17379429602443,4.08245865009667,2.09133564592776,36,28,8,40,39,1,49,59,-10,1,2,0,0
"7803","DAL","CGY",2016021051,17242,20162017,0,60,1,3,-2,3.48883812980785,3.78079640827491,-0.291958278467064,25,24,1,40,32,8,57,46,11,2,0,0,0
"7804","DAL","S.J",2016021073,17245,20162017,1,60,1,0,1,4.58207030809717,4.1421345140011,0.439935794096073,20,30,-10,34,51,-17,50,72,-22,2,2,0,0
"7805","DAL","CHI",2016021098,17248,20162017,0,65,2,2,0,5.71568057657942,2.95689433952793,2.75878623705148,44,26,18,51,34,17,64,50,14,3,4,0,0
"7806","DAL","S.J",2016021103,17249,20162017,1,60,6,1,5,3.63617617960517,3.64366459075609,-0.00748841115091636,29,21,8,39,41,-2,58,62,-4,2,3,0,0
"7807","DAL","N.J",2016021118,17251,20162017,0,60.3333333333333,2,1,1,3.78304349184327,2.68060958356364,1.10243390827964,32,21,11,43,27,16,58,33,25,4,0,0,0
"7808","DAL","MTL",2016021132,17253,20162017,0,60,1,4,-3,2.16669608947996,5.26927517983131,-3.10257909035136,28,36,-8,35,47,-12,51,73,-22,1,1,0,0
"7809","DAL","BOS",2016021141,17255,20162017,0,60,0,2,-2,4.74364889375283,3.44321034233144,1.30043855142139,27,24,3,41,31,10,58,51,7,2,3,0,0
"7810","DAL","CAR",2016021162,17257,20162017,0,60,3,0,3,6.6059015567145,4.64536612475058,1.96053543196392,24,25,-1,32,35,-3,38,51,-13,0,1,0,0
"7811","DAL","T.B",2016021168,17258,20162017,0,60,3,6,-3,2.48946332815103,4.42522797640413,-1.9357646482531,26,25,1,33,40,-7,51,55,-4,2,3,0,0
"7812","DAL","ARI",2016021187,17260,20162017,1,63.75,3,2,1,5.34078989647878,4.41013258995008,0.930657306528701,31,26,5,52,35,17,68,47,21,3,3,0,0
"7813","DAL","NSH",2016021200,17262,20162017,1,60,3,7,-4,5.32136210560043,4.14955726531116,1.17180484028927,33,34,-1,51,47,4,66,66,0,2,5,0,0
"7814","DAL","COL",2016021216,17264,20162017,1,65,3,3,0,7.62682145257713,3.18109316266055,4.44572828991659,45,24,21,54,35,19,65,52,13,1,1,0,0
"7815","DAL","VGK",2017020015,17445,20172018,1,60,1,2,-1,5.64809380153073,4.00585791841149,1.64223588311924,46,30,16,57,41,16,75,61,14,5,8,0,0
"7816","DAL","STL",2017020024,17446,20172018,0,60,2,4,-2,4.15224739525001,1.62012250185384,2.53212489339617,40,21,19,44,26,18,59,38,21,5,3,0,0
"7817","DAL","DET",2017020043,17449,20172018,1,60,4,2,2,7.42545302666258,3.63900972729846,3.78644329936412,33,25,8,56,39,17,74,56,18,4,5,0,0
"7818","DAL","NSH",2017020053,17451,20172018,0,60,1,4,-3,4.62613268006341,4.59592255475582,0.0302101253075904,31,31,0,45,44,1,59,53,6,1,2,0,0
"7819","DAL","COL",2017020069,17453,20172018,1,60,3,1,2,7.62571682295814,3.77584172591355,3.84987509704458,36,23,13,54,33,21,69,42,27,6,4,0,0
"7820","DAL","ARI",2017020088,17456,20172018,1,60,3,1,2,6.59482990938704,3.28926738773589,3.30556252165115,34,28,6,46,37,9,58,52,6,1,2,0,0
"7821","DAL","ARI",2017020103,17458,20172018,0,60,5,4,1,5.16264643505201,5.12374728335999,0.0388991516920214,31,31,0,45,42,3,57,55,2,2,4,0,0
"7822","DAL","CAR",2017020118,17460,20172018,1,60,4,3,1,2.49804119962209,6.07461248447046,-3.57657128484837,26,39,-13,38,51,-13,46,72,-26,2,3,0,0
"7823","DAL","COL",2017020134,17463,20172018,0,60,3,5,-2,5.0186545973777,4.01181677263317,1.00683782474453,37,33,4,52,41,11,67,52,15,2,3,0,0
"7824","DAL","EDM",2017020147,17465,20172018,0,60,4,5,-1,5.7718111905146,5.08845138491537,0.683359805599228,32,35,-3,46,51,-5,68,76,-8,5,3,0,0
"7825","DAL","CGY",2017020154,17466,20172018,0,60,2,1,1,4.07392685313243,4.95476645918461,-0.880839606052177,24,30,-6,37,42,-5,50,59,-9,4,3,0,0
"7826","DAL","VAN",2017020176,17469,20172018,0,62.5333333333333,2,1,1,2.34769744478004,4.37129099352839,-2.02359354874835,29,39,-10,34,50,-16,40,65,-25,5,4,0,0
"7827","DAL","WPG",2017020193,17472,20172018,0,60,2,5,-3,6.78797827825877,4.68926454774919,2.09871373050958,23,27,-4,35,40,-5,49,53,-4,1,5,0,0
"7828","DAL","BUF",2017020207,17474,20172018,1,60,5,1,4,3.34850028801406,2.37423026189208,0.97427002612198,22,28,-6,34,41,-7,52,55,-3,2,5,0,0
"7829","DAL","WPG",2017020221,17476,20172018,1,60,1,4,-3,3.83521697719698,5.42522832844406,-1.59001135124709,34,26,8,36,40,-4,51,54,-3,4,3,0,0
"7830","DAL","NYI",2017020246,17480,20172018,1,60,5,0,5,4.17263180219105,2.51636110472473,1.65627069746632,29,14,15,45,26,19,68,36,32,4,4,0,0
"7831","DAL","CAR",2017020265,17483,20172018,0,60,1,5,-4,7.99797186949329,5.46438696467521,2.53358490481807,26,28,-2,37,42,-5,56,58,-2,3,4,0,0
"7832","DAL","FLA",2017020269,17484,20172018,0,65,3,3,0,5.22164557657618,5.24457009122125,-0.0229245146450703,43,29,14,49,41,8,57,49,8,3,6,0,0
"7833","DAL","T.B",2017020282,17486,20172018,0,60,1,6,-5,3.5462643992505,3.72028587566456,-0.174021476414055,28,28,0,35,34,1,51,46,5,3,4,0,0
"7834","DAL","EDM",2017020294,17488,20172018,1,60,6,3,3,2.34128835464607,2.97697561050203,-0.635687255855959,21,30,-9,32,38,-6,41,57,-16,9,6,0,0
"7835","DAL","MTL",2017020318,17491,20172018,1,60,3,1,2,0,0,0,29,30,-1,44,47,-3,61,56,5,4,6,0,0
"7836","DAL","COL",2017020330,17492,20172018,0,60,0,3,-3,3.9526772041267,3.91842152789468,0.0342556762320214,28,32,-4,36,40,-4,46,52,-6,2,3,0,0
"7837","DAL","CGY",2017020345,17494,20172018,1,60,6,4,2,5.90644248967874,3.76301636919379,2.14342612048495,41,38,3,47,47,0,63,61,2,5,4,0,0
"7838","DAL","VGK",2017020376,17498,20172018,0,60,3,0,3,3.62797517864965,3.84632638312011,-0.218351204470459,30,34,-4,37,42,-5,48,54,-6,4,3,0,0
"7839","DAL","CHI",2017020385,17500,20172018,0,60.85,4,3,1,4.42634971288669,3.20320971659385,1.22313999629284,35,22,13,44,32,12,57,51,6,4,6,0,0
"7840","DAL","CHI",2017020406,17502,20172018,1,65,2,2,0,2.543495903069,4.37104026459221,-1.82754436152321,35,34,1,47,44,3,69,58,11,6,4,0,0
"7841","DAL","COL",2017020410,17503,20172018,0,60,7,2,5,0,0,0,28,27,1,32,37,-5,42,57,-15,4,3,0,0
"7842","DAL","NSH",2017020421,17505,20172018,1,60,2,5,-3,6.81362886322313,4.40083915881252,2.41278970441061,45,32,13,57,38,19,75,44,31,3,4,0,0
"7843","DAL","STL",2017020435,17507,20172018,0,60,0,3,-3,4.33027301471157,5.70301839301828,-1.37274537830672,29,27,2,36,38,-2,55,48,7,2,7,0,0
"7844","DAL","VGK",2017020452,17509,20172018,1,60,3,5,-2,4.39904687027501,3.3645138231857,1.03453304708931,39,39,0,45,43,2,70,60,10,3,2,0,0
"7845","DAL","NYR",2017020461,17511,20172018,0,65,1,1,0,4.35809839043941,5.5798898018877,-1.22179141144829,45,25,20,63,34,29,90,45,45,3,0,0,0
"7846","DAL","NYI",2017020476,17513,20172018,0,60,5,2,3,2.64428869925905,3.61518291146785,-0.970894212208805,27,34,-7,35,45,-10,44,53,-9,2,3,0,0
"7847","DAL","N.J",2017020492,17515,20172018,0,60,2,5,-3,5.96652866108343,4.28516737735481,1.68136128372862,30,26,4,44,33,11,57,41,16,4,5,0,0
"7848","DAL","PHI",2017020500,17516,20172018,0,63.8333333333333,1,2,-1,5.79051269167034,4.34600116388901,1.44451152778133,28,30,-2,40,41,-1,54,62,-8,3,7,0,0
"7849","DAL","WSH",2017020522,17519,20172018,1,61.85,3,4,-1,5.13864271136117,3.66163677471286,1.47700593664831,36,28,8,49,41,8,70,56,14,7,6,0,0
"7850","DAL","CHI",2017020535,17521,20172018,1,60,4,0,4,2.99784776075338,4.10451126953916,-1.10666350878578,22,24,-2,35,46,-11,54,75,-21,4,2,0,0
"7851","DAL","NSH",2017020553,17523,20172018,1,65,3,3,0,4.21243508416228,4.01727425822264,0.195160825939638,28,32,-4,48,49,-1,65,67,-2,4,4,0,0
"7852","DAL","MIN",2017020565,17527,20172018,0,60,2,4,-2,4.49406144607201,4.17525832129468,0.318803124777332,26,31,-5,42,34,8,57,45,12,4,3,0,0
"7853","DAL","STL",2017020583,17529,20172018,1,60,4,2,2,4.91361651986934,3.73149209378416,1.18212442608518,31,37,-6,52,49,3,79,67,12,5,5,0,0
"7854","DAL","S.J",2017020596,17531,20172018,1,60,6,0,6,4.90056503243977,3.1655844778324,1.73498055460738,32,26,6,48,37,11,60,52,8,4,4,0,0
"7855","DAL","CBJ",2017020609,17533,20172018,1,60,1,2,-1,3.65535075360603,3.86532590372371,-0.209975150117682,22,26,-4,26,37,-11,43,50,-7,0,1,0,0
"7856","DAL","N.J",2017020623,17535,20172018,1,60,4,3,1,4.20995352886545,6.69478715690639,-2.48483362804094,33,42,-9,38,48,-10,58,65,-7,4,5,0,0
"7857","DAL","EDM",2017020634,17537,20172018,1,60,5,1,4,5.25653062824586,4.79846788328723,0.458062744958625,33,38,-5,48,51,-3,67,67,0,3,4,0,0
"7858","DAL","COL",2017020675,17544,20172018,1,60,1,4,-3,4.45707198500168,2.91740753232989,1.53966445267179,28,23,5,48,33,15,62,47,15,5,2,0,0
"7859","DAL","BOS",2017020683,17546,20172018,0,62.9833333333333,3,2,1,1.88204735146081,4.70225514925551,-2.82020779779469,32,32,0,39,42,-3,48,55,-7,2,4,0,0
"7860","DAL","DET",2017020690,17547,20172018,0,60,4,2,2,4.20380729913131,1.56395344590055,2.63985385323076,26,15,11,36,23,13,51,45,6,3,3,0,0
"7861","DAL","CBJ",2017020699,17549,20172018,0,65,1,1,0,3.29495693183068,3.05935962722882,0.235597304601859,36,26,10,52,39,13,73,48,25,5,3,0,0
"7862","DAL","BUF",2017020708,17551,20172018,0,60,7,1,6,4.26891465169383,6.53831258753897,-2.26939793584514,32,27,5,38,42,-4,48,52,-4,3,5,0,0
"7863","DAL","FLA",2017020738,17554,20172018,1,60,6,1,5,3.79172145229581,6.30133561518018,-2.50961416288437,39,34,5,50,57,-7,58,78,-20,7,7,0,0
"7864","DAL","TOR",2017020754,17556,20172018,1,60,1,4,-3,7.50614834915905,4.28570805827443,3.22044029088462,40,29,11,59,41,18,74,56,18,3,2,0,0
"7865","DAL","L.A",2017020770,17561,20172018,1,60,0,3,-3,3.50117772168596,4.90267460476025,-1.40149688307429,28,42,-14,38,51,-13,57,82,-25,4,3,0,0
"7866","DAL","ARI",2017020786,17563,20172018,0,60,4,1,3,5.77530425106488,3.25486179478617,2.52044245627872,25,18,7,37,36,1,49,60,-11,7,6,0,0
"7867","DAL","MIN",2017020801,17565,20172018,1,60,6,1,5,3.98887094361862,2.63778674142668,1.35108420219194,38,31,7,47,37,10,68,55,13,2,2,0,0
"7868","DAL","NYR",2017020810,17567,20172018,1,60,2,1,1,5.20279159935308,6.82475456834072,-1.62196296898765,41,32,9,57,42,15,85,55,30,5,3,0,0
"7869","DAL","CHI",2017020833,17570,20172018,0,60,4,2,2,5.10321335300978,5.11382326965395,-0.0106099166441709,30,39,-9,39,50,-11,52,82,-30,1,4,0,0
"7870","DAL","PIT",2017020841,17571,20172018,1,65,3,3,0,4.63464165586447,6.70399601363893,-2.06935435777446,36,37,-1,47,50,-3,61,72,-11,4,3,0,0
"7871","DAL","VAN",2017020855,17573,20172018,1,60,0,6,-6,4.39104484435144,4.79060856792057,-0.399563723569128,30,41,-11,40,49,-9,60,67,-7,1,6,0,0
"7872","DAL","STL",2017020893,17578,20172018,1,60,2,1,1,2.23143293047095,2.73252884334813,-0.501095912877175,16,29,-13,24,42,-18,37,65,-28,4,6,0,0
"7873","DAL","S.J",2017020911,17580,20172018,0,60,2,5,-3,4.27146971668117,4.49289731564932,-0.221427598968148,28,28,0,40,40,0,65,49,16,0,2,0,0
"7874","DAL","ANA",2017020928,17583,20172018,0,60,0,2,-2,9.26687198445597,4.1624930288354,5.10437895562058,41,17,24,60,27,33,73,39,34,5,3,0,0
"7875","DAL","L.A",2017020940,17584,20172018,0,60,2,0,2,6.71388511326222,4.69365040100092,2.0202347122613,28,18,10,43,31,12,60,47,13,1,2,0,0
"7876","DAL","WPG",2017020955,17586,20172018,1,60,3,5,-2,3.45219855445248,2.17656096923535,1.27563758521713,36,27,9,50,37,13,71,50,21,4,3,0,0
"7877","DAL","CGY",2017020975,17589,20172018,1,60,2,0,2,2.47991735732846,6.17536862913272,-3.69545127180426,26,38,-12,37,57,-20,52,80,-28,7,7,0,0
"7878","DAL","T.B",2017020986,17591,20172018,1,64.3166666666667,4,5,-1,4.05719055930967,1.87810404033371,2.17908651897596,35,25,10,55,34,21,68,51,17,3,3,0,0
"7879","DAL","STL",2017021001,17593,20172018,1,63.0666666666667,3,2,1,0,0,0,34,37,-3,48,46,2,61,59,2,2,5,0,0
"7880","DAL","OTT",2017021017,17595,20172018,1,62.6833333333333,2,3,-1,3.53766276780516,5.39509357373026,-1.85743080592511,33,30,3,44,48,-4,65,71,-6,4,2,0,0
"7881","DAL","NSH",2017021025,17596,20172018,0,60,0,2,-2,3.83443919216643,7.47410685701939,-3.63966766485296,26,34,-8,37,51,-14,48,64,-16,5,6,0,0
"7882","DAL","ANA",2017021046,17599,20172018,1,60,2,1,1,3.60800133745382,2.85273946486996,0.755261872583865,37,27,10,47,34,13,70,55,15,2,3,0,0
"7883","DAL","PIT",2017021061,17601,20172018,0,60,1,3,-2,2.55409638907086,4.66630029238877,-2.11220390331791,18,30,-12,23,37,-14,38,51,-13,4,5,0,0
"7884","DAL","MTL",2017021072,17603,20172018,0,60,2,4,-2,6.10358489945065,3.65313932867139,2.45044557077927,38,26,12,49,35,14,68,53,15,5,5,0,0
"7885","DAL","TOR",2017021078,17604,20172018,0,65,5,5,0,3.44230108754709,6.835587283655,-3.39328619610791,35,33,2,44,53,-9,58,70,-12,2,2,0,0
"7886","DAL","OTT",2017021093,17606,20172018,0,63.4333333333333,2,3,-1,4.13580334981089,3.12845922660199,1.0073441232089,25,25,0,40,40,0,53,52,1,1,3,0,0
"7887","DAL","WPG",2017021114,17608,20172018,0,60,2,4,-2,4.12842911854993,5.79720881622052,-1.66877969767059,30,24,6,44,43,1,58,59,-1,3,4,0,0
"7888","DAL","WSH",2017021123,17610,20172018,0,60,3,4,-1,4.35925149382092,5.61973843634277,-1.26048694252185,27,32,-5,38,40,-2,59,51,8,5,4,0,0
"7889","DAL","BOS",2017021150,17613,20172018,1,60,2,3,-1,3.26240523813267,4.82783564834995,-1.56543041021728,42,36,6,48,49,-1,67,74,-7,4,3,0,0
"7890","DAL","VAN",2017021164,17615,20172018,1,60,1,4,-3,4.00460186473699,4.89113298945267,-0.886531124715681,31,27,4,50,41,9,63,53,10,3,6,0,0
"7891","DAL","PHI",2017021183,17617,20172018,1,60.6666666666667,3,2,1,3.88879551843274,4.47010777576361,-0.581312257330865,23,33,-10,34,53,-19,49,67,-18,3,3,0,0
"7892","DAL","MIN",2017021195,17619,20172018,0,60,2,5,-3,3.08889793887853,3.02857240923913,0.0603255296393943,31,22,9,40,29,11,58,37,21,4,4,0,0
"7893","DAL","MIN",2017021214,17621,20172018,1,60,4,1,3,4.46338178405858,6.5783642920513,-2.11498250799272,36,34,2,48,51,-3,55,65,-10,3,3,0,0
"7894","DAL","S.J",2017021237,17624,20172018,0,60,4,2,2,4.29149287900407,4.43168835920968,-0.140195480205608,23,31,-8,37,42,-5,58,57,1,1,1,0,0
"7895","DAL","ANA",2017021256,17627,20172018,0,60,3,5,-2,3.17505499494638,5.20904720155522,-2.03399220660884,26,33,-7,38,44,-6,51,57,-6,1,4,0,0
"7896","DAL","L.A",2017021270,17628,20172018,0,60,4,2,2,0.991305456031114,4.8273454332957,-3.83603997726459,18,36,-18,26,48,-22,32,63,-31,1,3,0,0
"7897","DAL","ARI",2018020012,17808,20182019,1,60,3,0,3,2.51848673660663,4.10594748822041,-1.58746075161378,25,30,-5,37,39,-2,51,54,-3,4,4,0,0
"7898","DAL","WPG",2018020023,17810,20182019,1,60,5,1,4,3.93518021896294,4.28420824152458,-0.34902802256164,35,33,2,42,43,-1,63,58,5,6,4,0,0
"7899","DAL","TOR",2018020041,17813,20182019,1,60,4,7,-3,3.13334829953965,4.70263056448312,-1.56928226494347,34,30,4,45,51,-6,56,66,-10,1,3,0,0
"7900","DAL","ANA",2018020067,17817,20182019,1,60,5,3,2,9.00487838382833,4.39860393399031,4.60627444983802,51,25,26,60,30,30,84,45,39,3,2,0,0
"7901","DAL","OTT",2018020076,17819,20182019,0,60,1,4,-3,3.69308062965865,3.4546004374409,0.23848019221775,38,24,14,53,35,18,68,47,21,4,2,0,0
"7902","DAL","N.J",2018020078,17820,20182019,0,60,0,3,-3,1.60325134077279,6.29887907166267,-4.69562773088987,24,34,-10,34,51,-17,41,58,-17,4,7,0,0
"7903","DAL","MIN",2018020100,17823,20182019,1,60,1,3,-2,2.47938574405271,4.96933625921183,-2.48995051515912,34,36,-2,41,48,-7,62,67,-5,3,2,0,0
"7904","DAL","L.A",2018020128,17827,20182019,1,60,4,2,2,4.41864953521872,5.82992441016904,-1.41127487495032,23,33,-10,34,51,-17,43,70,-27,3,3,0,0
"7905","DAL","ANA",2018020140,17829,20182019,1,60,5,2,3,2.92099032807164,3.48071834315314,-0.559728015081504,41,25,16,47,35,12,67,52,15,6,6,0,0
"7906","DAL","DET",2018020160,17832,20182019,0,60,2,4,-2,4.98927019264386,4.49890784209128,0.490362350552573,30,23,7,33,36,-3,41,46,-5,1,3,0,0
"7907","DAL","MTL",2018020171,17834,20182019,0,60,4,1,3,4.0600023534389,3.32777548937388,0.732226864065025,22,35,-13,31,48,-17,40,63,-23,7,6,0,0
"7908","DAL","TOR",2018020179,17836,20182019,0,60,2,1,1,1.68554257255164,4.0249405201921,-2.33939794764046,19,32,-13,30,51,-21,39,64,-25,2,5,0,0
"7909","DAL","WSH",2018020200,17838,20182019,0,63.2833333333333,4,3,1,3.90621622603887,2.97026402740524,0.935952198633631,37,32,5,44,49,-5,49,69,-20,3,3,0,0
"7910","DAL","BOS",2018020210,17840,20182019,0,64.4833333333333,1,2,-1,5.82718973405281,8.82749775357661,-3.0003080195238,25,35,-10,34,60,-26,38,73,-35,1,3,0,0
"7911","DAL","CBJ",2018020217,17841,20182019,0,60,1,4,-3,6.07548198409495,4.97655493607454,1.09892704802041,28,34,-6,40,40,0,53,54,-1,2,3,0,0
"7912","DAL","S.J",2018020234,17843,20182019,1,60,4,3,1,2.47330275055337,8.91664166641931,-6.44333891586594,22,36,-14,36,59,-23,47,77,-30,1,3,0,0
"7913","DAL","NSH",2018020244,17845,20182019,1,62.45,4,5,-1,1.6874330452265,7.45003676735723,-5.76260372213073,24,34,-10,31,50,-19,40,61,-21,3,5,0,0
"7914","DAL","CBJ",2018020262,17847,20182019,1,60,1,2,-1,1.98751327187347,3.56529947879318,-1.57778620691971,27,28,-1,39,34,5,63,58,5,5,4,0,0
"7915","DAL","BOS",2018020286,17851,20182019,1,61.5666666666667,1,0,1,3.44464486830884,4.28535591585432,-0.840711047545483,37,23,14,53,33,20,69,45,24,9,7,0,0
"7916","DAL","NYI",2018020303,17853,20182019,0,60,6,2,4,5.49961014627479,4.26054648772219,1.2390636585526,33,39,-6,38,50,-12,51,61,-10,2,2,0,0
"7917","DAL","NYR",2018020309,17854,20182019,0,60,1,2,-1,1.99226983324201,4.77351615051157,-2.78124631726956,17,23,-6,27,29,-2,45,40,5,4,2,0,0
"7918","DAL","PIT",2018020321,17856,20182019,0,60,1,5,-4,2.55026658628049,2.88413570215926,-0.33386911587877,19,30,-11,27,41,-14,37,51,-14,2,3,0,0
"7919","DAL","OTT",2018020344,17858,20182019,1,60,6,4,2,10.1064305819201,3.19522585271886,6.91120472920124,54,33,21,69,36,33,90,54,36,5,4,0,0
"7920","DAL","COL",2018020355,17859,20182019,0,60,2,3,-1,2.36679140808269,3.06006102214815,-0.693269614065457,29,36,-7,36,45,-9,45,64,-19,2,4,0,0
"7921","DAL","EDM",2018020375,17862,20182019,0,62.7,0,1,-1,4.80419808214953,4.89253263825958,-0.0883345561100555,28,31,-3,39,45,-6,51,61,-10,2,2,0,0
"7922","DAL","CGY",2018020380,17863,20182019,0,60.4,4,3,1,2.82354379654862,4.3677580809035,-1.54421428435488,28,33,-5,33,45,-12,39,71,-32,2,5,0,0
"7923","DAL","VAN",2018020396,17866,20182019,0,60,2,1,1,6.10498845398251,3.42924810857585,2.67574034540667,27,25,2,41,39,2,54,56,-2,4,5,0,0
"7924","DAL","EDM",2018020415,17868,20182019,1,60,4,1,3,6.38443725598336,7.65464992327907,-1.27021266729571,25,29,-4,35,48,-13,52,65,-13,4,5,0,0
"7925","DAL","S.J",2018020440,17872,20182019,1,60,3,2,1,4.05136669566855,4.907551093027,-0.856184397358447,30,43,-13,36,56,-20,45,69,-24,2,2,0,0
"7926","DAL","VGK",2018020460,17874,20182019,0,60,2,4,-2,2.71544920210231,2.97854540688443,-0.263096204782122,24,28,-4,30,45,-15,39,65,-26,3,5,0,0
"7927","DAL","ANA",2018020478,17877,20182019,0,60,3,6,-3,3.7177682663314,5.65878647757927,-1.94101821124787,29,36,-7,41,56,-15,52,70,-18,3,1,0,0
"7928","DAL","S.J",2018020486,17878,20182019,0,60,2,3,-1,2.85635226688464,4.3491981800471,-1.49284591316245,22,24,-2,30,34,-4,40,51,-11,0,1,0,0
"7929","DAL","COL",2018020503,17880,20182019,0,60,4,6,-2,5.54534676353462,4.81578783854815,0.729558924986472,42,37,5,49,42,7,60,56,4,3,7,0,0
"7930","DAL","CGY",2018020523,17883,20182019,1,60,2,0,2,2.95636668117117,4.32670805958332,-1.37034137841215,28,24,4,39,36,3,50,49,1,2,4,0,0
"7931","DAL","CHI",2018020536,17885,20182019,1,60,2,5,-3,4.34702348879364,5.81591318242442,-1.46888969363079,28,29,-1,51,39,12,65,53,12,1,1,0,0
"7932","DAL","MIN",2018020556,17887,20182019,0,64.8333333333333,2,1,1,5.89383614200051,4.16028056728508,1.73355557471543,27,31,-4,43,46,-3,52,65,-13,4,3,0,0
"7933","DAL","NYI",2018020564,17888,20182019,1,60,1,3,-2,3.31506163524318,5.45873451919761,-2.14367288395442,20,28,-8,29,45,-16,38,59,-21,3,5,0,0
"7934","DAL","NSH",2018020573,17892,20182019,0,60,2,0,2,4.5058805593435,9.63985738470172,-5.13397682535822,30,49,-19,41,71,-30,57,89,-32,3,3,0,0
"7935","DAL","DET",2018020594,17894,20182019,1,60,5,1,4,5.5420662292081,3.8381273575942,1.7039388716139,42,34,8,51,40,11,70,62,8,2,4,0,0
"7936","DAL","MTL",2018020608,17896,20182019,1,60.2333333333333,2,3,-1,4.48111423212108,5.38536805848531,-0.904253826364235,47,38,9,54,47,7,76,72,4,2,2,0,0
"7937","DAL","N.J",2018020618,17898,20182019,1,60,5,4,1,3.75068844374461,4.24754349706927,-0.496855053324662,40,34,6,43,40,3,60,54,6,2,6,0,0
"7938","DAL","WSH",2018020632,17900,20182019,1,63.6166666666667,2,1,1,3.41127037802607,6.61721449596098,-3.20594411793491,29,37,-8,38,52,-14,57,63,-6,4,4,0,0
"7939","DAL","WPG",2018020649,17902,20182019,0,60,1,5,-4,3.36451974738156,4.16563692945419,-0.80111718207263,27,30,-3,38,44,-6,50,55,-5,3,3,0,0
"7940","DAL","STL",2018020664,17904,20182019,0,60,3,1,2,2.77871226996649,3.2986250521717,-0.519912782205211,17,27,-10,27,41,-14,37,64,-27,2,2,0,0
"7941","DAL","PHI",2018020674,17906,20182019,0,60,1,2,-1,4.31556269427529,2.74251202218403,1.57305067209126,38,22,16,49,35,14,67,51,16,3,3,0,0
"7942","DAL","STL",2018020695,17908,20182019,1,60,1,3,-2,1.71843547612661,2.3611310878623,-0.642695611735689,22,28,-6,26,33,-7,39,46,-7,1,2,0,0
"7943","DAL","T.B",2018020719,17911,20182019,1,60,0,2,-2,4.38204219174077,3.92410362395458,0.457938567786186,35,21,14,49,32,17,67,40,27,7,4,0,0
"7944","DAL","L.A",2018020732,17913,20182019,1,60,1,2,-1,6.8657237153966,3.73908017587462,3.12664353952198,30,19,11,57,32,25,81,54,27,2,1,0,0
"7945","DAL","WPG",2018020746,17915,20182019,1,60,4,2,2,5.06958163230934,4.49956906201544,0.570012570293898,39,29,10,53,45,8,72,57,15,7,6,0,0
"7946","DAL","BUF",2018020777,17926,20182019,1,60,1,0,1,2.13916942111973,4.98083057358539,-2.84166115246566,27,30,-3,38,46,-8,48,65,-17,1,1,0,0
"7947","DAL","MIN",2018020788,17928,20182019,1,60,3,1,2,5.73388752502875,4.55465087004995,1.1792366549788,32,22,10,42,32,10,59,45,14,1,1,0,0
"7948","DAL","NSH",2018020798,17929,20182019,0,60,3,1,2,2.67506445608888,4.02882215737964,-1.35375770129076,26,39,-13,34,54,-20,45,70,-25,2,4,0,0
"7949","DAL","ARI",2018020808,17931,20182019,1,60,5,4,1,2.84825119831481,5.00212416195791,-2.1538729636431,29,42,-13,36,52,-16,57,69,-12,5,4,0,0
"7950","DAL","NSH",2018020832,17934,20182019,0,60.7166666666667,2,3,-1,7.32492802079651,4.5922977725507,2.7326302482458,29,24,5,44,36,8,51,45,6,3,2,0,0
"7951","DAL","ARI",2018020845,17936,20182019,0,60,2,3,-1,5.47872710209257,5.7610248404817,-0.282297738389122,35,39,-4,53,44,9,71,54,17,3,3,0,0
"7952","DAL","FLA",2018020865,17939,20182019,0,60,3,0,3,2.57417389150942,2.5018603684257,0.0723135230837215,19,30,-11,30,39,-9,45,59,-14,2,4,0,0
"7953","DAL","T.B",2018020880,17941,20182019,0,60,0,6,-6,3.30120963604983,3.8145416379557,-0.513332001905872,32,26,6,46,36,10,55,47,8,3,6,0,0
"7954","DAL","CAR",2018020899,17943,20182019,0,60,0,3,-3,5.00293724745279,7.28820860596898,-2.28527135851618,33,27,6,48,42,6,73,50,23,2,1,0,0
"7955","DAL","NSH",2018020923,17946,20182019,1,60,3,5,-2,3.55191186688173,8.25820954252413,-4.7062976756424,39,47,-8,48,55,-7,62,75,-13,3,3,0,0
"7956","DAL","STL",2018020937,17948,20182019,1,60,5,2,3,5.96561926830327,8.08413706579785,-2.11851779749458,25,45,-20,29,55,-26,42,75,-33,4,4,0,0
"7957","DAL","CAR",2018020950,17950,20182019,1,60,0,3,-3,5.27149392483989,6.93717848258336,-1.66568455774348,24,31,-7,40,48,-8,53,63,-10,3,3,0,0
"7958","DAL","CHI",2018020958,17951,20182019,0,60,4,3,1,5.37587116516079,6.05057099787518,-0.674699832714396,29,47,-18,36,51,-15,48,63,-15,2,4,0,0
"7959","DAL","VGK",2018020978,17953,20182019,0,60,1,4,-3,2.96349958002247,10.0491647088929,-7.08566512887046,24,48,-24,33,65,-32,51,95,-44,3,4,0,0
"7960","DAL","L.A",2018020990,17955,20182019,0,63.3166666666667,4,3,1,4.5927653954196,6.14053695172075,-1.54777155630115,33,30,3,44,47,-3,58,62,-4,4,3,0,0
"7961","DAL","STL",2018021006,17957,20182019,0,60,4,1,3,1.92751623844561,4.45734791741779,-2.52983167897219,21,30,-9,27,39,-12,40,52,-12,1,3,0,0
"7962","DAL","NYR",2018021025,17960,20182019,1,60,1,0,1,2.8442608031459,3.99794628504549,-1.15368548189959,32,28,4,39,37,2,56,55,1,6,6,0,0
"7963","DAL","COL",2018021039,17962,20182019,1,60,4,0,4,4.60016921580214,3.79817355443894,0.8019956613632,33,31,2,41,44,-3,54,63,-9,1,2,0,0
"7964","DAL","CHI",2018021057,17964,20182019,1,60,1,2,-1,3.58925387577619,3.80089184214012,-0.211637966363924,27,39,-12,39,49,-10,60,77,-17,0,3,0,0
"7965","DAL","BUF",2018021072,17967,20182019,0,60,2,0,2,2.76837061847127,3.70195281822453,-0.933582199753261,27,35,-8,33,45,-12,37,61,-24,3,3,0,0
"7966","DAL","MIN",2018021088,17969,20182019,0,60,4,1,3,6.06797038760851,1.76973176655883,4.29823862104968,31,22,9,40,28,12,53,41,12,1,1,0,0
"7967","DAL","VGK",2018021095,17970,20182019,1,60,1,2,-1,2.98908173026223,3.78523609524018,-0.796154364977951,41,37,4,51,49,2,69,68,1,5,3,0,0
"7968","DAL","VAN",2018021114,17972,20182019,1,65,2,2,0,6.39329235056112,5.18395122420043,1.20934112636069,46,27,19,62,40,22,87,58,29,2,3,0,0
"7969","DAL","FLA",2018021130,17974,20182019,1,60,4,2,2,7.53745792874315,4.45605716970749,3.08140075903566,37,22,15,55,31,24,70,47,23,3,3,0,0
"7970","DAL","COL",2018021143,17976,20182019,1,60,1,3,-2,5.88752753197332,6.27823584547878,-0.390708313505456,45,32,13,56,42,14,81,54,27,2,3,0,0
"7971","DAL","PIT",2018021160,17978,20182019,1,60,2,3,-1,4.92034606364905,6.02386700734496,-1.10352094369591,31,30,1,45,43,2,60,60,0,3,1,0,0
"7972","DAL","WPG",2018021175,17980,20182019,0,60,5,2,3,6.80363092810512,3.58045352630415,3.22317740180097,37,23,14,45,35,10,65,44,21,4,2,0,0
"7973","DAL","CGY",2018021187,17982,20182019,0,60,2,1,1,3.21057396463584,3.11448895404195,0.096085010593896,23,36,-13,31,49,-18,44,76,-32,2,2,0,0
"7974","DAL","EDM",2018021194,17983,20182019,0,65,2,2,0,2.6147446623072,3.87510084862379,-1.26035618631659,22,42,-20,29,53,-24,47,64,-17,3,2,0,0
"7975","DAL","VAN",2018021213,17985,20182019,0,65,2,2,0,6.3897557198249,4.09015583642758,2.29959988339732,40,31,9,53,44,9,70,53,17,3,4,0,0
"7976","DAL","PHI",2018021235,17988,20182019,1,60,6,2,4,3.84777674470013,4.31584108172427,-0.468064337024146,30,34,-4,42,43,-1,58,55,3,6,4,0,0
"7977","DAL","CHI",2018021255,17991,20182019,0,60,1,6,-5,2.95392739840463,3.0869460151298,-0.133018616725167,35,32,3,45,41,4,62,61,1,1,3,0,0
"7978","DAL","MIN",2018021267,17992,20182019,1,60,3,0,3,6.48310874158051,3.21378989130608,3.26931885027443,44,24,20,58,32,26,68,49,19,4,3,0,0
"7979","DAL","NSH",2018030151,17996,20182019,0,60,3,2,1,3.26174440025352,5.24951989687747,-1.98777549662395,29,32,-3,38,45,-7,56,64,-8,4,5,0,0
"7980","DAL","NSH",2018030152,17999,20182019,0,65,1,2,-1,3.65995707231662,6.8469505785326,-3.18699350621599,23,42,-19,38,55,-17,51,76,-25,7,4,0,0
"7981","DAL","NSH",2018030153,18001,20182019,1,60,2,3,-1,7.15540215079091,2.78810279881873,4.36729935197218,42,28,14,61,34,27,89,47,42,4,1,0,0
"7982","DAL","NSH",2018030154,18003,20182019,1,60,5,1,4,4.61668541516394,3.31152069075802,1.30516472440592,29,35,-6,34,40,-6,49,71,-22,7,3,0,0
"7983","DAL","NSH",2018030155,18006,20182019,0,60,5,3,2,4.1431024333906,7.95441051363741,-3.81130808024682,26,33,-7,35,50,-15,44,65,-21,3,2,0,0
"7984","DAL","NSH",2018030156,18008,20182019,1,77.0333333333333,2,1,1,8.43907462628026,8.26104356954716,0.178031056733097,51,48,3,64,64,0,100,89,11,1,4,0,0
"7985","DAL","STL",2018030231,18011,20182019,0,60,2,3,-1,4.13814321017708,3.46242091194108,0.675722298235996,29,20,9,43,28,15,59,41,18,5,5,0,0
"7986","DAL","STL",2018030232,18013,20182019,0,60,4,2,2,4.87001855912968,5.22010018976266,-0.350081630632985,35,34,1,43,49,-6,48,67,-19,4,7,0,0
"7987","DAL","STL",2018030233,18015,20182019,1,60,3,4,-1,4.28806485695532,3.97631147009088,0.311753386864439,31,34,-3,40,44,-4,68,60,8,5,3,0,0
"7988","DAL","STL",2018030234,18017,20182019,1,60,4,2,2,3.47065627440285,3.30550932232291,0.165146952079947,31,29,2,40,43,-3,50,63,-13,3,4,0,0
"7989","DAL","STL",2018030235,18019,20182019,0,60,2,1,1,3.5260523092421,5.31920106709003,-1.79314875784793,27,39,-12,38,46,-8,46,65,-19,2,4,0,0
"7990","DAL","STL",2018030236,18021,20182019,1,60,1,4,-3,2.51378572248359,3.57449494901994,-1.06070922653635,23,25,-2,33,37,-4,43,46,-3,3,4,0,0
"7991","DAL","STL",2018030237,18023,20182019,0,80,1,1,0,3.19123835122446,6.25133751872454,-3.06009916750008,27,52,-25,40,71,-31,48,99,-51,0,2,0,0
"7992","DET","TOR",2008020005,14161,20082009,1,60,2,3,-1,0,0,0,37,29,8,49,33,16,60,42,18,3,2,0,0
"7993","DET","OTT",2008020017,14163,20082009,0,60,3,2,1,0,0,0,41,22,19,53,29,24,66,36,30,6,6,0,0
"7994","DET","CAR",2008020037,14165,20082009,0,60,3,1,2,0,0,0,36,28,8,48,36,12,68,47,21,6,4,0,0
"7995","DET","VAN",2008020053,14168,20082009,1,60.45,3,4,-1,0,0,0,35,29,6,52,39,13,70,50,20,6,5,0,0
"7996","DET","NYR",2008020070,14170,20082009,1,60.3833333333333,5,4,1,0,0,0,45,32,13,62,38,24,72,47,25,3,2,0,0
"7997","DET","STL",2008020090,14174,20082009,0,60,4,3,1,0,0,0,34,24,10,46,40,6,57,51,6,5,7,0,0
"7998","DET","ATL",2008020103,14176,20082009,1,60,5,3,2,0,0,0,46,33,13,51,46,5,61,51,10,4,7,0,0
"7999","DET","CHI",2008020115,14177,20082009,0,65,5,5,0,0,0,0,44,41,3,47,49,-2,53,56,-3,3,8,0,0
"8000","DET","L.A",2008020125,14179,20082009,0,65,3,3,0,0,0,0,37,19,18,55,35,20,63,47,16,6,7,0,0
"8001","DET","ANA",2008020135,14181,20082009,0,61.65,4,5,-1,0,0,0,38,34,4,50,45,5,60,57,3,8,9,0,0
"8002","DET","S.J",2008020147,14182,20082009,0,60,2,4,-2,0,0,0,27,33,-6,34,44,-10,51,58,-7,4,4,0,0
"8003","DET","VAN",2008020167,14185,20082009,0,60,3,2,1,0,0,0,23,27,-4,36,37,-1,51,51,0,5,7,0,0
"8004","DET","N.J",2008020201,14191,20082009,1,60,3,1,2,0,0,0,31,25,6,43,33,10,53,38,15,4,3,0,0
"8005","DET","PIT",2008020216,14194,20082009,1,63.8166666666667,6,7,-1,0,0,0,34,34,0,43,47,-4,53,58,-5,5,5,0,0
"8006","DET","T.B",2008020231,14196,20082009,0,60,4,3,1,0,0,0,39,18,21,54,22,32,66,29,37,5,4,0,0
"8007","DET","FLA",2008020239,14197,20082009,0,60,3,2,1,0,0,0,32,27,5,49,36,13,63,44,19,4,3,0,0
"8008","DET","EDM",2008020260,14200,20082009,1,60,4,0,4,0,0,0,41,21,20,56,32,24,67,45,22,5,5,0,0
"8009","DET","EDM",2008020277,14203,20082009,0,60,4,3,1,0,0,0,35,34,1,51,53,-2,64,64,0,6,6,0,0
"8010","DET","CGY",2008020294,14205,20082009,0,60,5,2,3,0,0,0,37,33,4,42,47,-5,56,59,-3,4,5,0,0
"8011","DET","VAN",2008020304,14207,20082009,0,62.55,2,3,-1,0,0,0,34,24,10,48,33,15,64,38,26,3,3,0,0
"8012","DET","MTL",2008020316,14209,20082009,1,60,1,3,-2,0,0,0,33,25,8,40,31,9,53,36,17,3,3,0,0
"8013","DET","CBJ",2008020332,14211,20082009,1,60,5,3,2,0,0,0,35,16,19,47,24,23,60,31,29,7,8,0,0
"8014","DET","BOS",2008020336,14212,20082009,0,60,1,4,-3,0,0,0,30,19,11,41,27,14,56,30,26,4,2,0,0
"8015","DET","ANA",2008020352,14214,20082009,1,60,2,1,1,0,0,0,47,16,31,67,26,41,73,41,32,4,2,0,0
"8016","DET","VAN",2008020372,14217,20082009,1,60,6,5,1,0,0,0,38,25,13,64,35,29,72,42,30,7,4,0,0
"8017","DET","CHI",2008020386,14219,20082009,1,65,4,4,0,0,0,0,30,32,-2,42,39,3,51,50,1,3,3,0,0
"8018","DET","DAL",2008020426,14225,20082009,0,60,1,3,-2,0,0,0,38,24,14,53,32,21,69,43,26,4,4,0,0
"8019","DET","ARI",2008020438,14226,20082009,0,65,4,4,0,0,0,0,38,28,10,59,42,17,74,53,21,4,6,0,0
"8020","DET","COL",2008020444,14228,20082009,1,60,2,3,-1,0,0,0,36,27,9,45,33,12,61,35,26,6,6,0,0
"8021","DET","S.J",2008020466,14231,20082009,1,60,6,0,6,0,0,0,28,24,4,37,33,4,47,40,7,4,3,0,0
"8022","DET","L.A",2008020480,14233,20082009,1,60,6,4,2,0,0,0,36,26,10,47,35,12,66,42,24,3,3,0,0
"8023","DET","STL",2008020502,14236,20082009,1,60,4,1,3,0,0,0,41,34,7,55,49,6,68,58,10,8,7,0,0
"8024","DET","NSH",2008020512,14239,20082009,0,60,2,3,-1,0,0,0,40,31,9,53,41,12,72,50,22,3,3,0,0
"8025","DET","COL",2008020524,14240,20082009,0,65,3,3,0,0,0,0,44,32,12,58,37,21,80,48,32,5,6,0,0
"8026","DET","CHI",2008020543,14243,20082009,1,60,4,0,4,0,0,0,39,36,3,45,50,-5,53,59,-6,6,6,0,0
"8027","DET","CHI",2008020554,14245,20082009,0,60,6,4,2,0,0,0,43,37,6,54,40,14,60,51,9,5,6,0,0
"8028","DET","MIN",2008020571,14247,20082009,0,65,2,2,0,0,0,0,37,35,2,51,53,-2,67,63,4,2,4,0,0
"8029","DET","CBJ",2008020591,14250,20082009,1,60,3,0,3,0,0,0,40,23,17,52,37,15,70,42,28,7,6,0,0
"8030","DET","DAL",2008020603,14252,20082009,1,60,6,1,5,0,0,0,33,23,10,41,35,6,50,42,8,9,4,0,0
"8031","DET","BUF",2008020620,14254,20082009,1,60,3,1,2,0,0,0,48,22,26,64,30,34,74,37,37,3,1,0,0
"8032","DET","DAL",2008020629,14256,20082009,0,61.85,4,5,-1,0,0,0,30,49,-19,41,61,-20,50,75,-25,5,6,0,0
"8033","DET","ANA",2008020645,14258,20082009,0,60,4,3,1,0,0,0,33,28,5,54,40,14,63,52,11,4,4,0,0
"8034","DET","L.A",2008020654,14259,20082009,0,60,4,0,4,0,0,0,31,23,8,47,36,11,60,48,12,7,5,0,0
"8035","DET","S.J",2008020672,14261,20082009,0,60,5,6,-1,0,0,0,34,41,-7,40,55,-15,52,67,-15,6,6,0,0
"8036","DET","ARI",2008020690,14264,20082009,0,60,3,6,-3,0,0,0,37,27,10,50,35,15,75,44,31,6,6,0,0
"8037","DET","CBJ",2008020703,14271,20082009,0,63.45,2,3,-1,0,0,0,23,23,0,33,30,3,42,41,1,3,4,0,0
"8038","DET","DAL",2008020720,14273,20082009,1,60,2,4,-2,0,0,0,24,23,1,39,30,9,48,36,12,7,7,0,0
"8039","DET","WSH",2008020730,14275,20082009,0,60,2,4,-2,0,0,0,29,27,2,48,35,13,73,42,31,7,3,0,0
"8040","DET","STL",2008020745,14277,20082009,1,65,3,3,0,0,0,0,21,33,-12,33,43,-10,48,50,-2,3,5,0,0
"8041","DET","ARI",2008020762,14279,20082009,1,60,5,4,1,0,0,0,33,27,6,49,31,18,62,38,24,6,4,0,0
"8042","DET","EDM",2008020778,14282,20082009,1,60,8,3,5,0,0,0,35,26,9,45,35,10,55,38,17,5,3,0,0
"8043","DET","PIT",2008020789,14283,20082009,0,60,3,0,3,0,0,0,29,25,4,46,32,14,64,48,16,4,5,0,0
"8044","DET","NSH",2008020800,14285,20082009,0,60,5,3,2,0,0,0,51,21,30,62,32,30,77,40,37,7,3,0,0
"8045","DET","MIN",2008020814,14287,20082009,1,60,4,2,2,0,0,0,43,23,20,65,32,33,79,40,39,5,3,0,0
"8046","DET","CBJ",2008020819,14288,20082009,0,60,2,3,-1,0,0,0,34,25,9,42,36,6,60,43,17,5,5,0,0
"8047","DET","COL",2008020837,14290,20082009,1,65,5,5,0,0,0,0,45,28,17,64,35,29,88,42,46,6,2,0,0
"8048","DET","NSH",2008020857,14293,20082009,1,60,6,2,4,0,0,0,41,25,16,51,37,14,60,49,11,7,6,0,0
"8049","DET","ANA",2008020873,14295,20082009,1,60,5,2,3,0,0,0,34,26,8,49,39,10,62,50,12,5,4,0,0
"8050","DET","MIN",2008020884,14296,20082009,0,60,2,5,-3,0,0,0,37,29,8,53,39,14,76,47,29,5,3,0,0
"8051","DET","S.J",2008020907,14300,20082009,1,60,4,1,3,0,0,0,33,35,-2,45,45,0,58,55,3,9,8,0,0
"8052","DET","L.A",2008020919,14302,20082009,1,60,2,1,1,0,0,0,41,31,10,48,40,8,62,59,3,2,2,0,0
"8053","DET","NSH",2008020931,14303,20082009,0,60,0,8,-8,0,0,0,30,23,7,48,29,19,67,36,31,2,3,0,0
"8054","DET","STL",2008020950,14306,20082009,0,60,5,0,5,0,0,0,36,22,14,50,27,23,63,36,27,8,3,0,0
"8055","DET","COL",2008020954,14307,20082009,0,60,3,2,1,0,0,0,30,27,3,46,37,9,68,51,17,2,1,0,0
"8056","DET","ARI",2008020995,14313,20082009,1,63.5833333333333,3,2,1,0,0,0,43,25,18,54,38,16,70,47,23,1,3,0,0
"8057","DET","CGY",2008021010,14315,20082009,1,65,5,5,0,0,0,0,45,33,12,63,46,17,75,53,22,9,7,0,0
"8058","DET","STL",2008021020,14317,20082009,0,60,5,2,3,0,0,0,27,32,-5,30,44,-14,43,53,-10,4,4,0,0
"8059","DET","PHI",2008021046,14320,20082009,1,60,3,2,1,0,0,0,48,26,22,60,33,27,83,37,46,6,3,0,0
"8060","DET","ATL",2008021067,14323,20082009,0,60,6,3,3,0,0,0,38,34,4,46,38,8,55,43,12,7,9,0,0
"8061","DET","CGY",2008021087,14326,20082009,0,60,3,5,-2,0,0,0,33,27,6,49,39,10,58,48,10,1,4,0,0
"8062","DET","EDM",2008021095,14327,20082009,0,60,3,2,1,0,0,0,44,26,18,61,35,26,85,48,37,6,6,0,0
"8063","DET","NYI",2008021112,14330,20082009,1,60,0,2,-2,0,0,0,42,30,12,66,36,30,80,37,43,6,3,0,0
"8064","DET","NSH",2008021127,14332,20082009,1,60,3,4,-1,0,0,0,36,26,10,52,34,18,67,38,29,4,3,0,0
"8065","DET","STL",2008021153,14336,20082009,1,60,4,5,-1,0,0,0,38,33,5,53,43,10,79,54,25,5,4,0,0
"8066","DET","MIN",2008021177,14339,20082009,1,60,3,2,1,0,0,0,44,23,21,57,25,32,70,32,38,2,2,0,0
"8067","DET","NSH",2008021206,14343,20082009,1,65,3,3,0,0,0,0,26,25,1,38,37,1,57,50,7,4,6,0,0
"8068","DET","CHI",2008021216,14345,20082009,1,60,2,4,-2,0,0,0,23,26,-3,34,37,-3,45,44,1,2,5,0,0
"8069","DET","CHI",2008021230,14346,20082009,0,60,0,3,-3,0,0,0,37,23,14,51,31,20,59,37,22,5,3,0,0
"8070","DET","CBJ",2008030161,14350,20082009,1,60,4,1,3,0,0,0,34,21,13,42,29,13,58,46,12,4,5,0,0
"8071","DET","CBJ",2008030162,14352,20082009,1,60,4,0,4,0,0,0,39,25,14,56,36,20,76,48,28,12,4,0,0
"8072","DET","CBJ",2008030163,14355,20082009,0,60,4,1,3,0,0,0,26,32,-6,35,46,-11,43,58,-15,2,4,0,0
"8073","DET","CBJ",2008030164,14357,20082009,0,60,6,5,1,0,0,0,41,32,9,52,46,6,65,55,10,7,3,0,0
"8074","DET","ANA",2008030231,14365,20082009,1,60,3,2,1,0,0,0,37,24,13,52,36,16,67,43,24,5,5,0,0
"8075","DET","ANA",2008030232,14367,20082009,1,80,3,3,0,0,0,0,47,35,12,72,47,25,86,61,25,3,4,0,0
"8076","DET","ANA",2008030233,14369,20082009,0,60,1,2,-1,0,0,0,46,23,23,61,30,31,77,38,39,7,6,0,0
"8077","DET","ANA",2008030234,14371,20082009,0,60,6,3,3,0,0,0,40,28,12,57,41,16,71,46,25,5,3,0,0
"8078","DET","ANA",2008030235,14374,20082009,1,60,4,1,3,0,0,0,38,17,21,57,25,32,65,39,26,4,3,0,0
"8079","DET","ANA",2008030236,14376,20082009,0,60,1,2,-1,0,0,0,39,28,11,52,36,16,65,40,25,8,5,0,0
"8080","DET","ANA",2008030237,14378,20082009,1,60,4,3,1,0,0,0,40,27,13,58,35,23,74,52,22,5,5,0,0
"8081","DET","CHI",2008030321,14381,20082009,1,60,5,2,3,0,0,0,43,32,11,54,37,17,74,44,30,5,3,0,0
"8082","DET","CHI",2008030322,14383,20082009,1,65.2333333333333,3,2,1,0,0,0,38,39,-1,55,54,1,75,67,8,5,6,0,0
"8083","DET","CHI",2008030323,14386,20082009,0,61.8666666666667,3,4,-1,0,0,0,30,27,3,36,32,4,51,41,10,5,4,0,0
"8084","DET","CHI",2008030324,14388,20082009,0,60,6,1,5,0,0,0,33,28,5,44,36,8,50,47,3,13,7,0,0
"8085","DET","CHI",2008030325,14391,20082009,1,63.9666666666667,2,1,1,0,0,0,46,31,15,55,42,13,67,55,12,4,4,0,0
"8086","DET","PIT",2008030411,14394,20082009,1,60,3,1,2,0,0,0,30,32,-2,48,43,5,62,54,8,1,2,0,0
"8087","DET","PIT",2008030412,14395,20082009,1,60,3,1,2,0,0,0,26,32,-6,35,39,-4,45,49,-4,3,1,0,0
"8088","DET","PIT",2008030413,14397,20082009,0,60,2,4,-2,0,0,0,29,21,8,39,34,5,57,39,18,2,3,0,0
"8089","DET","PIT",2008030414,14399,20082009,0,60,2,4,-2,0,0,0,39,31,8,54,34,20,69,43,26,5,4,0,0
"8090","DET","PIT",2008030415,14401,20082009,1,60,5,0,5,0,0,0,29,22,7,39,29,10,51,35,16,9,2,0,0
"8091","DET","PIT",2008030416,14404,20082009,0,60,1,2,-1,0,0,0,26,31,-5,43,38,5,63,50,13,2,2,0,0
"8092","DET","PIT",2008030417,14407,20082009,1,60,1,2,-1,0,0,0,24,18,6,41,24,17,61,27,34,3,2,0,0
"8093","DET","STL",2009020008,14519,20092010,1,60,3,4,-1,0,0,0,34,23,11,45,38,7,65,50,15,4,4,0,0
"8094","DET","STL",2009020020,14520,20092010,0,60,3,5,-2,0,0,0,33,32,1,48,40,8,68,55,13,6,6,0,0
"8095","DET","CHI",2009020041,14525,20092010,1,60,3,2,1,0,0,0,23,34,-11,31,49,-18,48,64,-16,5,5,0,0
"8096","DET","L.A",2009020084,14532,20092010,1,60,5,2,3,0,0,0,32,26,6,46,35,11,61,45,16,7,5,0,0
"8097","DET","COL",2009020099,14534,20092010,1,65,3,3,0,0,0,0,31,29,2,45,37,8,65,48,17,3,3,0,0
"8098","DET","COL",2009020141,14541,20092010,0,60,1,3,-2,0,0,0,49,23,26,62,28,34,82,41,41,7,2,0,0
"8099","DET","VAN",2009020154,14544,20092010,0,60,5,4,1,0,0,0,42,26,16,52,38,14,64,51,13,3,4,0,0
"8100","DET","EDM",2009020170,14546,20092010,0,65,5,5,0,0,0,0,45,33,12,55,37,18,70,40,30,3,3,0,0
"8101","DET","CGY",2009020190,14548,20092010,0,60,3,1,2,0,0,0,30,21,9,38,35,3,55,43,12,4,2,0,0
"8102","DET","BOS",2009020198,14551,20092010,1,60,2,0,2,0,0,0,26,29,-3,39,39,0,49,59,-10,4,4,0,0
"8103","DET","S.J",2009020212,14553,20092010,1,65,1,1,0,0,0,0,36,34,2,57,43,14,74,51,23,3,4,0,0
"8104","DET","TOR",2009020227,14555,20092010,0,60,1,5,-4,0,0,0,36,28,8,57,41,16,75,58,17,5,4,0,0
"8105","DET","VAN",2009020258,14560,20092010,1,60,3,1,2,0,0,0,29,32,-3,41,47,-6,57,58,-1,3,6,0,0
"8106","DET","ANA",2009020273,14562,20092010,1,60,7,4,3,0,0,0,37,23,14,56,33,23,72,46,26,7,5,0,0
"8107","DET","DAL",2009020295,14566,20092010,1,60,1,3,-2,0,0,0,32,32,0,45,47,-2,57,54,3,5,6,0,0
"8108","DET","FLA",2009020309,14568,20092010,1,60.6666666666667,1,2,-1,0,0,0,40,20,20,63,29,34,76,39,37,4,3,0,0
"8109","DET","MTL",2009020315,14569,20092010,0,65,2,2,0,0,0,0,34,18,16,55,35,20,84,43,41,6,1,0,0
"8110","DET","NSH",2009020328,14571,20092010,0,60,1,3,-2,0,0,0,31,25,6,49,33,16,71,43,28,2,4,0,0
"8111","DET","ATL",2009020345,14573,20092010,1,60,0,2,-2,0,0,0,40,25,15,51,30,21,66,39,27,3,4,0,0
"8112","DET","CGY",2009020363,14575,20092010,1,60,0,3,-3,0,0,0,40,17,23,58,24,34,75,31,44,6,2,0,0
"8113","DET","STL",2009020374,14576,20092010,0,65,3,3,0,0,0,0,36,35,1,58,46,12,72,54,18,1,2,0,0
"8114","DET","DAL",2009020388,14578,20092010,1,60,4,1,3,0,0,0,32,30,2,39,39,0,45,54,-9,4,4,0,0
"8115","DET","EDM",2009020404,14581,20092010,1,60,1,4,-3,0,0,0,28,36,-8,41,46,-5,58,54,4,2,2,0,0
"8116","DET","N.J",2009020418,14583,20092010,0,65,3,3,0,0,0,0,31,26,5,39,40,-1,48,47,1,3,2,0,0
"8117","DET","NYR",2009020427,14584,20092010,0,60,3,1,2,0,0,0,31,29,2,42,40,2,61,50,11,3,4,0,0
"8118","DET","STL",2009020447,14587,20092010,1,60,0,1,-1,0,0,0,42,26,16,63,32,31,85,44,41,6,4,0,0
"8119","DET","ANA",2009020461,14589,20092010,1,61.1166666666667,3,2,1,0,0,0,31,27,4,51,31,20,66,40,26,10,4,0,0
"8120","DET","NSH",2009020474,14590,20092010,0,60.4,3,2,1,0,0,0,29,35,-6,40,42,-2,56,51,5,4,4,0,0
"8121","DET","T.B",2009020507,14595,20092010,1,60,3,0,3,0,0,0,22,30,-8,29,47,-18,36,58,-22,3,6,0,0
"8122","DET","DAL",2009020518,14597,20092010,0,60,3,4,-1,0,0,0,33,21,12,49,25,24,63,33,30,2,2,0,0
"8123","DET","CHI",2009020529,14598,20092010,0,60,0,3,-3,0,0,0,20,35,-15,25,47,-22,38,63,-25,3,5,0,0
"8124","DET","CHI",2009020553,14601,20092010,1,60,0,3,-3,0,0,0,33,31,2,44,37,7,55,53,2,7,5,0,0
"8125","DET","COL",2009020600,14609,20092010,1,60,4,2,2,0,0,0,35,22,13,43,30,13,57,38,19,4,7,0,0
"8126","DET","ANA",2009020638,14614,20092010,0,60,1,4,-3,0,0,0,39,35,4,52,47,5,57,57,0,8,8,0,0
"8127","DET","L.A",2009020654,14616,20092010,0,60,2,1,1,0,0,0,24,52,-28,39,62,-23,52,76,-24,3,5,0,0
"8128","DET","S.J",2009020672,14618,20092010,0,60,4,1,3,0,0,0,22,32,-10,26,41,-15,37,58,-21,1,2,0,0
"8129","DET","NYI",2009020681,14621,20092010,0,60,0,6,-6,0,0,0,16,31,-15,29,44,-15,44,74,-30,3,3,0,0
"8130","DET","CAR",2009020698,14623,20092010,1,60,3,1,2,0,0,0,35,38,-3,50,49,1,69,56,13,6,2,0,0
"8131","DET","DAL",2009020708,14625,20092010,0,65,2,2,0,0,0,0,28,30,-2,45,43,2,58,56,2,1,3,0,0
"8132","DET","CHI",2009020720,14626,20092010,1,65,3,3,0,0,0,0,38,29,9,51,45,6,67,58,9,3,4,0,0
"8133","DET","MIN",2009020751,14630,20092010,0,65,3,3,0,0,0,0,29,30,-1,50,41,9,63,53,10,3,1,0,0
"8134","DET","L.A",2009020766,14632,20092010,1,60,2,3,-1,0,0,0,33,33,0,44,45,-1,52,60,-8,3,3,0,0
"8135","DET","MIN",2009020790,14636,20092010,0,60,2,5,-3,0,0,0,28,25,3,36,39,-3,52,50,2,4,8,0,0
"8136","DET","NSH",2009020805,14638,20092010,1,60,4,2,2,0,0,0,29,48,-19,40,64,-24,51,81,-30,4,4,0,0
"8137","DET","PIT",2009020817,14640,20092010,0,65,1,1,0,0,0,0,24,47,-23,39,65,-26,52,76,-24,5,3,0,0
"8138","DET","S.J",2009020835,14642,20092010,0,60,4,2,2,0,0,0,37,34,3,51,44,7,74,65,9,6,3,0,0
"8139","DET","ANA",2009020840,14643,20092010,0,60,1,3,-2,0,0,0,47,30,17,64,36,28,78,41,37,3,3,0,0
"8140","DET","L.A",2009020857,14646,20092010,0,60,3,4,-1,0,0,0,23,27,-4,39,37,2,49,46,3,4,3,0,0
"8141","DET","STL",2009020881,14649,20092010,0,65,3,3,0,0,0,0,42,45,-3,49,56,-7,68,73,-5,4,5,0,0
"8142","DET","S.J",2009020895,14651,20092010,1,65,2,2,0,0,0,0,52,26,26,66,36,30,80,45,35,7,3,0,0
"8143","DET","OTT",2009020910,14653,20092010,1,60,4,1,3,0,0,0,40,30,10,52,37,15,63,49,14,4,2,0,0
"8144","DET","COL",2009020922,14669,20092010,0,60,3,2,1,0,0,0,30,24,6,37,31,6,53,45,8,5,3,0,0
"8145","DET","VAN",2009020937,14671,20092010,1,60,3,6,-3,0,0,0,31,33,-2,51,39,12,63,42,21,3,5,0,0
"8146","DET","NSH",2009020951,14673,20092010,1,60,5,2,3,0,0,0,32,22,10,45,34,11,57,50,7,3,4,0,0
"8147","DET","CHI",2009020971,14675,20092010,0,60,5,4,1,0,0,0,25,32,-7,30,43,-13,44,58,-14,3,5,0,0
"8148","DET","CGY",2009020980,14677,20092010,1,60,2,4,-2,0,0,0,30,32,-2,38,41,-3,53,57,-4,5,2,0,0
"8149","DET","MIN",2009020996,14679,20092010,1,60,5,1,4,0,0,0,30,22,8,42,34,8,56,40,16,6,5,0,0
"8150","DET","CGY",2009021027,14683,20092010,0,60,2,1,1,0,0,0,28,23,5,40,32,8,45,45,0,3,5,0,0
"8151","DET","EDM",2009021055,14687,20092010,0,65,2,2,0,0,0,0,33,24,9,53,32,21,76,44,32,2,1,0,0
"8152","DET","VAN",2009021066,14688,20092010,0,64.9833333333333,4,3,1,0,0,0,54,32,22,64,43,21,81,49,32,2,2,0,0
"8153","DET","PIT",2009021077,14690,20092010,1,60,3,1,2,0,0,0,33,27,6,47,36,11,63,43,20,7,5,0,0
"8154","DET","STL",2009021093,14692,20092010,1,60,4,2,2,0,0,0,24,32,-8,37,41,-4,53,60,-7,2,2,0,0
"8155","DET","MIN",2009021108,14694,20092010,1,60,6,2,4,0,0,0,42,27,15,59,33,26,74,37,37,10,5,0,0
"8156","DET","NSH",2009021118,14695,20092010,0,65,0,0,0,0,0,0,38,33,5,51,45,6,67,56,11,2,3,0,0
"8157","DET","EDM",2009021138,14698,20092010,1,60,5,4,1,0,0,0,44,26,18,71,32,39,86,41,45,3,4,0,0
"8158","DET","NSH",2009021166,14702,20092010,1,60.2666666666667,3,4,-1,0,0,0,31,24,7,38,38,0,49,50,-1,3,2,0,0
"8159","DET","PHI",2009021175,14703,20092010,0,60,3,4,-1,0,0,0,34,25,9,44,35,9,63,45,18,6,5,0,0
"8160","DET","CHI",2009021225,14710,20092010,0,63.1833333333333,3,2,1,0,0,0,21,29,-8,28,44,-16,46,59,-13,2,4,0,0
"8161","DET","ARI",2009030181,14713,20092010,0,60,2,3,-1,0,0,0,40,35,5,57,47,10,72,55,17,7,5,0,0
"8162","DET","ARI",2009030182,14715,20092010,0,60,7,4,3,0,0,0,39,31,8,55,39,16,69,53,16,3,4,0,0
"8163","DET","ARI",2009030183,14717,20092010,1,60,2,4,-2,0,0,0,31,33,-2,40,43,-3,51,51,0,5,3,0,0
"8164","DET","ARI",2009030184,14719,20092010,1,60,3,0,3,0,0,0,35,29,6,43,41,2,57,49,8,4,7,0,0
"8165","DET","ARI",2009030185,14722,20092010,0,60,4,1,3,0,0,0,29,31,-2,36,40,-4,46,56,-10,6,5,0,0
"8166","DET","ARI",2009030186,14724,20092010,1,60,2,5,-3,0,0,0,33,29,4,53,35,18,69,49,20,6,7,0,0
"8167","DET","ARI",2009030187,14726,20092010,0,60,6,1,5,0,0,0,50,33,17,63,42,21,70,53,17,7,6,0,0
"8168","DET","S.J",2009030231,14728,20092010,0,60,3,4,-1,0,0,0,23,27,-4,45,42,3,66,59,7,7,8,0,0
"8169","DET","S.J",2009030232,14731,20092010,0,60,3,4,-1,0,0,0,31,45,-14,43,57,-14,58,71,-13,4,10,0,0
"8170","DET","S.J",2009030233,14733,20092010,1,67.1166666666667,3,4,-1,0,0,0,35,33,2,53,47,6,72,60,12,3,6,0,0
"8171","DET","S.J",2009030234,14735,20092010,1,60,7,1,6,0,0,0,37,29,8,46,42,4,60,49,11,12,9,0,0
"8172","DET","S.J",2009030235,14737,20092010,0,60,1,2,-1,0,0,0,34,32,2,46,45,1,63,56,7,4,4,0,0
"8173","DET","ANA",2010020009,14890,20102011,1,60,4,0,4,7.94009270339302,4.88431488923379,3.05577781415923,43,21,22,54,35,19,74,43,31,8,3,0,0
"8174","DET","CHI",2010020021,14891,20102011,0,60,3,2,1,2.09033987772145,4.39890222075155,-2.3085623430301,26,28,-2,34,40,-6,50,54,-4,4,5,0,0
"8175","DET","COL",2010020034,14894,20102011,1,65,4,4,0,4.28717226546723,3.9307735717739,0.356398693693336,28,38,-10,39,45,-6,65,56,9,1,4,0,0
"8176","DET","DAL",2010020046,14896,20102011,0,60,1,4,-3,5.57956453392399,3.40502981765793,2.17453471626605,26,15,11,45,28,17,64,39,25,5,3,0,0
"8177","DET","CGY",2010020085,14903,20102011,1,60,4,2,2,3.83719484333924,4.1934158090844,-0.356220965745155,30,36,-6,40,46,-6,55,62,-7,5,6,0,0
"8178","DET","ANA",2010020104,14905,20102011,1,60,5,4,1,4.46366027486511,3.83147233142518,0.632187943439931,41,25,16,56,34,22,73,45,28,3,1,0,0
"8179","DET","NSH",2010020148,14912,20102011,1,60,5,2,3,2.9953562004157,3.03593184080546,-0.0405756403897612,28,25,3,37,36,1,50,51,-1,5,5,0,0
"8180","DET","CGY",2010020170,14916,20102011,0,60,2,1,1,3.99442794439532,2.91073587490246,1.08369206949286,33,17,16,50,28,22,67,34,33,7,7,0,0
"8181","DET","EDM",2010020185,14918,20102011,0,60,3,1,2,5.47241222834191,3.1786068575575,2.29380537078441,30,30,0,52,46,6,69,53,16,4,6,0,0
"8182","DET","VAN",2010020197,14919,20102011,0,60,4,6,-2,2.64121457813931,4.467855978015,-1.82664139987569,28,34,-6,36,47,-11,59,59,0,4,5,0,0
"8183","DET","EDM",2010020222,14924,20102011,1,60,6,2,4,3.26524577827485,2.96144652880321,0.303799249471645,34,25,9,43,30,13,56,42,14,2,3,0,0
"8184","DET","COL",2010020239,14926,20102011,1,60,3,1,2,3.85818727266087,4.16232785838656,-0.30414058572569,25,22,3,38,36,2,45,47,-2,4,5,0,0
"8185","DET","STL",2010020263,14930,20102011,1,60,7,3,4,5.58161710872082,5.15800294551957,0.423614163201254,31,36,-5,44,53,-9,57,68,-11,6,4,0,0
"8186","DET","MIN",2010020275,14932,20102011,1,64.3,3,4,-1,4.76316211159496,3.67459183512256,1.0885702764724,44,27,17,64,34,30,76,45,31,4,3,0,0
"8187","DET","CGY",2010020295,14934,20102011,1,61.6333333333333,5,4,1,3.75704074237728,3.48761312199572,0.26942762038157,38,27,11,52,33,19,72,42,30,10,5,0,0
"8188","DET","ATL",2010020310,14937,20102011,0,60,1,5,-4,3.81962218583794,4.05216689668905,-0.232544710851106,33,38,-5,43,46,-3,56,60,-4,4,3,0,0
"8189","DET","S.J",2010020357,14943,20102011,0,60,5,3,2,5.045019197074,2.156283829936,2.888735367138,29,28,1,44,38,6,56,52,4,4,2,0,0
"8190","DET","ANA",2010020378,14946,20102011,0,60,4,0,4,4.24915156312636,3.98639661056222,0.262754952564137,29,41,-12,41,48,-7,48,57,-9,1,3,0,0
"8191","DET","L.A",2010020390,14947,20102011,0,64.0666666666667,2,3,-1,5.98510374425678,5.10518477356527,0.879918970691506,29,25,4,42,31,11,58,42,16,2,2,0,0
"8192","DET","S.J",2010020399,14949,20102011,1,60,2,5,-3,2.57310735003707,6.46499025333273,-3.89188290329566,27,35,-8,42,49,-7,50,63,-13,6,4,0,0
"8193","DET","NSH",2010020408,14951,20102011,1,60,2,3,-1,3.41218908315568,2.17419983398293,1.23798924917276,37,24,13,48,30,18,61,36,25,4,3,0,0
"8194","DET","MTL",2010020419,14953,20102011,1,60,4,2,2,8.08793168608099,4.41378725187678,3.67414443420421,32,38,-6,49,42,7,60,53,7,6,1,0,0
"8195","DET","N.J",2010020428,14954,20102011,0,60,4,1,3,4.70748896268196,5.0834895251046,-0.376000562422632,23,34,-11,33,41,-8,41,50,-9,3,5,0,0
"8196","DET","L.A",2010020441,14956,20102011,1,60,0,5,-5,4.66421944562819,4.1928608622984,0.471358583329792,51,26,25,68,38,30,84,44,40,3,1,0,0
"8197","DET","STL",2010020453,14958,20102011,1,60,5,2,3,6.66123732872074,3.38029871580147,3.28093861291927,37,21,16,51,33,18,65,46,19,5,3,0,0
"8198","DET","CHI",2010020471,14960,20102011,0,60,1,4,-3,2.53804745298112,3.12098570552189,-0.582938252540771,30,31,-1,43,41,2,67,53,14,0,1,0,0
"8199","DET","DAL",2010020485,14962,20102011,1,64.3,3,4,-1,2.48026695795349,6.52480044031205,-4.04453348235856,31,32,-1,47,44,3,60,58,2,4,6,0,0
"8200","DET","VAN",2010020504,14965,20102011,1,62.9833333333333,5,4,1,6.9525359114341,4.06676433616667,2.88577157526743,45,39,6,54,47,7,63,53,10,4,3,0,0
"8201","DET","STL",2010020513,14966,20102011,0,60,3,4,-1,6.40834429999813,2.94274288195368,3.46560141804446,38,25,13,55,40,15,65,49,16,4,4,0,0
"8202","DET","MIN",2010020526,14969,20102011,0,60,4,1,3,4.94877042146982,2.22076991170525,2.72800050976457,27,17,10,42,26,16,48,35,13,7,7,0,0
"8203","DET","COL",2010020533,14970,20102011,0,63.7,4,3,1,3.88428306672722,6.45392216340099,-2.56963909667377,30,49,-19,41,60,-19,52,79,-27,6,7,0,0
"8204","DET","DAL",2010020549,14972,20102011,0,60,7,3,4,5.84778467145225,3.35569810681045,2.4920865646418,26,31,-5,38,46,-8,52,50,2,3,4,0,0
"8205","DET","NYI",2010020560,14974,20102011,1,63.95,3,4,-1,7.23079226745176,4.54971092526102,2.68108134219074,41,23,18,55,35,20,78,41,37,5,2,0,0
"8206","DET","PHI",2010020575,14976,20102011,1,60,2,3,-1,0,0,0,27,32,-5,41,39,2,51,48,3,3,2,0,0
"8207","DET","EDM",2010020589,14978,20102011,0,60,5,3,2,5.62454360490322,2.13630608177664,3.48823752312659,37,25,12,49,34,15,60,53,7,2,3,0,0
"8208","DET","CGY",2010020609,14981,20102011,0,65,4,4,0,7.41942862484094,3.63096622258968,3.78846240225126,27,39,-12,37,58,-21,53,66,-13,6,5,0,0
"8209","DET","VAN",2010020621,14982,20102011,0,65,1,1,0,3.4587989513002,6.80312038138452,-3.34432143008433,33,35,-2,41,61,-20,57,82,-25,5,5,0,0
"8210","DET","COL",2010020630,14984,20102011,0,60,4,5,-1,4.43162971147103,2.41139418181547,2.02023552965557,30,26,4,49,32,17,66,47,19,3,5,0,0
"8211","DET","PIT",2010020685,14992,20102011,0,60,1,4,-3,2.58180212332809,4.54301203862997,-1.96120991530188,37,29,8,52,41,11,69,48,21,5,3,0,0
"8212","DET","STL",2010020703,14994,20102011,0,61.85,4,3,1,4.6923412686956,6.19503208560151,-1.50269081690591,29,29,0,50,44,6,69,57,12,1,2,0,0
"8213","DET","CHI",2010020713,14996,20102011,1,60,1,4,-3,4.61060536408331,5.05725111560605,-0.446645751522738,37,33,4,56,42,14,73,50,23,2,3,0,0
"8214","DET","N.J",2010020745,15000,20102011,1,60,3,1,2,3.11393371246648,3.98638510872115,-0.872451396254671,29,24,5,44,35,9,52,50,2,2,3,0,0
"8215","DET","OTT",2010020764,15007,20102011,0,60,7,5,2,7.43993635648803,6.84639960994673,0.593536746541304,38,34,4,47,44,3,60,54,6,3,2,0,0
"8216","DET","NSH",2010020790,15010,20102011,0,60,0,3,-3,7.34285525982,2.69333767478625,4.64951758503375,35,29,6,51,40,11,61,53,8,6,5,0,0
"8217","DET","NYR",2010020797,15012,20102011,1,60,3,2,1,4.35849520705233,6.61605319842873,-2.2575579913764,35,47,-12,44,59,-15,58,70,-12,2,4,0,0
"8218","DET","NSH",2010020809,15014,20102011,1,60,1,4,-3,6.22109102677496,2.67081469116965,3.5502763356053,35,30,5,57,40,17,77,50,27,3,2,0,0
"8219","DET","BOS",2010020821,15016,20102011,0,60,6,1,5,7.34022590608924,3.6543605739061,3.68586533218314,34,26,8,45,33,12,57,46,11,7,3,0,0
"8220","DET","BOS",2010020842,15018,20102011,1,60,4,2,2,4.09451596258602,3.49752064125278,0.596995321333246,36,25,11,47,35,12,55,41,14,3,3,0,0
"8221","DET","T.B",2010020865,15022,20102011,0,60,6,2,4,3.11207758460695,7.61665218527196,-4.50457460066501,31,40,-9,43,53,-10,54,66,-12,3,4,0,0
"8222","DET","FLA",2010020874,15023,20102011,0,60,4,3,1,2.3940911343052,6.20973551931618,-3.81564438501098,30,32,-2,33,47,-14,42,58,-16,3,4,0,0
"8223","DET","MIN",2010020889,15025,20102011,0,65,1,1,0,9.49387455871797,4.38224365512879,5.11163090358918,39,26,13,57,36,21,71,43,28,2,3,0,0
"8224","DET","S.J",2010020897,15027,20102011,1,60,3,4,-1,4.82745607892866,6.46333361347206,-1.6358775345434,38,43,-5,44,54,-10,54,61,-7,2,3,0,0
"8225","DET","DAL",2010020910,15029,20102011,1,60,1,4,-3,5.51886534466757,4.6180654427983,0.900799901869277,39,25,14,58,32,26,70,37,33,9,6,0,0
"8226","DET","L.A",2010020941,15033,20102011,0,60,7,4,3,4.04134653488609,9.26556704846681,-5.22422051358072,27,39,-12,38,57,-19,45,68,-23,4,4,0,0
"8227","DET","ANA",2010020956,15035,20102011,0,62.8333333333333,1,2,-1,5.02776797511615,3.10652473385593,1.92124324126021,29,28,1,47,38,9,60,46,14,9,5,0,0
"8228","DET","S.J",2010020967,15036,20102011,0,60,1,3,-2,5.33797638447845,4.75471893080976,0.583257453668693,27,28,-1,39,45,-6,60,61,-1,5,5,0,0
"8229","DET","L.A",2010021003,15042,20102011,1,60,1,2,-1,2.75620671152137,3.97717506357003,-1.22096835204866,29,26,3,42,33,9,57,43,14,2,3,0,0
"8230","DET","EDM",2010021017,15044,20102011,1,64.3,2,1,1,3.85840963202989,2.36534299480263,1.49306663722726,44,27,17,63,31,32,78,39,39,6,3,0,0
"8231","DET","STL",2010021029,15045,20102011,0,60,5,3,2,3.2310153250267,6.05913565547962,-2.82812033045292,27,29,-2,40,47,-7,50,57,-7,2,4,0,0
"8232","DET","NSH",2010021075,15052,20102011,0,60,1,3,-2,6.87588740168394,8.26663819476139,-1.39075079307745,40,39,1,62,48,14,78,57,21,3,2,0,0
"8233","DET","PIT",2010021086,15054,20102011,1,65,4,4,0,5.37082530152179,6.07454554320893,-0.703720241687137,41,25,16,53,44,9,64,56,8,4,3,0,0
"8234","DET","VAN",2010021098,15056,20102011,1,60,1,2,-1,6.58794119862978,3.64183796270663,2.94610323592315,40,33,7,56,41,15,60,50,10,4,4,0,0
"8235","DET","TOR",2010021122,15059,20102011,1,60,4,2,2,6.17241756990438,3.76036341304462,2.41205415685977,29,24,5,40,35,5,60,43,17,2,4,0,0
"8236","DET","CHI",2010021132,15061,20102011,1,60.85,2,3,-1,4.93624362474657,3.89841544885602,1.03782817589054,35,41,-6,48,53,-5,69,67,2,6,4,0,0
"8237","DET","STL",2010021148,15063,20102011,1,60,3,10,-7,5.14422228680633,7.10611602015251,-1.96189373334619,44,47,-3,56,58,-2,67,68,-1,4,5,0,0
"8238","DET","NSH",2010021166,15066,20102011,0,62.9666666666667,4,3,1,7.0781997199233,3.79661179834511,3.28158792157819,41,34,7,49,42,7,58,56,2,4,9,0,0
"8239","DET","MIN",2010021177,15067,20102011,1,60,4,2,2,7.0118171115605,3.80571821113699,3.20609890042351,34,29,5,44,42,2,60,56,4,4,5,0,0
"8240","DET","CAR",2010021196,15070,20102011,0,60,0,3,-3,7.28443776210042,4.94439615801093,2.34004160408949,42,32,10,63,49,14,79,64,15,2,4,0,0
"8241","DET","CHI",2010021206,15072,20102011,1,60,2,4,-2,4.57387789385393,4.76407565346869,-0.190197759614762,28,29,-1,40,39,1,61,46,15,2,1,0,0
"8242","DET","CHI",2010021229,15074,20102011,0,60,4,3,1,0,0,0,31,36,-5,40,45,-5,51,53,-2,1,4,0,0
"8243","DET","ARI",2010030171,15077,20102011,1,60,4,2,2,4.22890687606027,3.04709400044521,1.18181287561506,36,28,8,51,43,8,59,61,-2,3,6,0,0
"8244","DET","ARI",2010030172,15080,20102011,1,60,4,3,1,4.02356416701514,6.35565772780683,-2.33209356079169,31,33,-2,48,38,10,59,51,8,7,9,0,0
"8245","DET","ARI",2010030173,15082,20102011,0,60,4,2,2,3.84138815443099,4.96655167106015,-1.12516351662915,34,30,4,53,50,3,66,65,1,5,4,0,0
"8246","DET","ARI",2010030174,15084,20102011,0,60,6,3,3,8.75317635035481,3.28178080404177,5.47139554631303,40,27,13,58,43,15,71,56,15,3,2,0,0
"8247","DET","S.J",2010030241,15093,20102011,0,67.05,1,2,-1,3.22170597861987,7.75819559862248,-4.53648962000261,25,46,-21,36,65,-29,57,92,-35,4,7,0,0
"8248","DET","S.J",2010030242,15095,20102011,0,60,1,2,-1,3.89796416190984,4.55184710721836,-0.653882945308524,34,37,-3,47,47,0,71,70,1,7,7,0,0
"8249","DET","S.J",2010030243,15098,20102011,1,69.35,3,4,-1,7.73596875404473,6.78591723667394,0.950051517370797,41,38,3,57,49,8,81,60,21,4,4,0,0
"8250","DET","S.J",2010030244,15100,20102011,1,60,4,3,1,9.17934030672768,3.94022146059433,5.23911884613335,40,28,12,50,35,15,62,42,20,6,4,0,0
"8251","DET","S.J",2010030245,15102,20102011,0,60,4,3,1,2.88026491063647,7.38068843929796,-4.50042352866149,22,42,-20,29,56,-27,49,73,-24,3,5,0,0
"8252","DET","S.J",2010030246,15104,20102011,1,60,3,1,2,7.6463351844842,3.49357541010249,4.15275977438171,45,25,20,60,35,25,72,52,20,9,8,0,0
"8253","DET","S.J",2010030247,15106,20102011,0,60,2,3,-1,5.72123429432895,3.34241086013935,2.3788234341896,40,30,10,51,36,15,76,56,20,4,3,0,0
"8254","DET","OTT",2011020005,15254,20112012,1,60,5,3,2,6.49609846977535,4.96355029587097,1.53254817390438,39,32,7,59,41,18,67,56,11,5,3,0,0
"8255","DET","COL",2011020018,15255,20112012,0,60,3,0,3,7.72889872803353,5.20650450086396,2.52239422716957,39,29,10,50,40,10,56,59,-3,4,3,0,0
"8256","DET","VAN",2011020042,15260,20112012,1,60,2,0,2,4.44991853927872,1.76194261782803,2.6879759214507,37,25,12,52,33,19,61,48,13,8,5,0,0
"8257","DET","MIN",2011020058,15262,20112012,0,64.1833333333333,3,2,1,3.3327722111535,1.79618190697511,1.53659030417839,41,14,27,52,23,29,77,31,46,3,1,0,0
"8258","DET","S.J",2011020137,15275,20112012,1,60,2,4,-2,4.03591279659304,4.79536825560945,-0.759455459016408,32,30,2,47,34,13,64,44,20,5,4,0,0
"8259","DET","MIN",2011020148,15276,20112012,0,60,0,1,-1,5.64403527615286,2.96021457596161,2.68382070019125,36,20,16,45,28,17,54,40,14,3,5,0,0
"8260","DET","MIN",2011020163,15279,20112012,1,61.55,1,2,-1,4.20698062062751,2.50863055328955,1.69835006733796,37,27,10,49,31,18,60,46,14,4,9,0,0
"8261","DET","CGY",2011020173,15281,20112012,1,60,1,4,-3,4.12740819186001,2.58000202197582,1.5474061698842,29,22,7,36,32,4,56,42,14,3,4,0,0
"8262","DET","ANA",2011020190,15283,20112012,1,60,5,0,5,5.73423298946,4.06353201959064,1.67070096986936,50,22,28,63,29,34,77,33,44,4,5,0,0
"8263","DET","COL",2011020207,15286,20112012,1,60,5,2,3,4.69137488456909,5.02922214673708,-0.337847262167998,30,26,4,43,35,8,49,48,1,6,3,0,0
"8264","DET","EDM",2011020226,15289,20112012,1,60,3,0,3,3.09179164713714,5.57988300322904,-2.4880913560919,30,24,6,42,32,10,60,44,16,6,3,0,0
"8265","DET","DAL",2011020233,15290,20112012,1,60,5,2,3,6.52780505484725,2.45064162563528,4.07716342921196,40,27,13,54,36,18,70,45,25,4,2,0,0
"8266","DET","STL",2011020252,15293,20112012,0,60,1,2,-1,4.83996665553423,2.56767215306172,2.2722945024725,22,37,-15,38,47,-9,58,57,1,5,4,0,0
"8267","DET","S.J",2011020270,15295,20112012,0,60,2,5,-3,4.83867586161068,3.83375948863032,1.00491637298036,42,28,14,60,34,26,84,41,43,3,1,0,0
"8268","DET","L.A",2011020275,15297,20112012,0,60,4,1,3,6.60494035088517,3.44722723925952,3.15771311162565,38,24,14,47,37,10,54,50,4,5,5,0,0
"8269","DET","ANA",2011020288,15298,20112012,0,60,4,2,2,4.08152324176626,4.14975207718089,-0.0682288354146294,30,34,-4,44,46,-2,60,55,5,6,5,0,0
"8270","DET","CGY",2011020306,15301,20112012,1,60,5,3,2,5.7113968724244,4.29678633585741,1.41461053656699,30,22,8,44,29,15,55,37,18,5,5,0,0
"8271","DET","BOS",2011020313,15303,20112012,0,65,2,2,0,3.49895879952237,8.64181193199693,-5.14285313247456,31,43,-12,45,55,-10,61,71,-10,3,3,0,0
"8272","DET","NSH",2011020333,15304,20112012,1,60,4,1,3,6.8276939651696,3.43478846963262,3.39290549553698,37,19,18,50,26,24,60,33,27,2,3,0,0
"8273","DET","T.B",2011020354,15308,20112012,1,60,4,2,2,3.69007240883211,3.07097548388026,0.619096924951854,35,23,12,43,30,13,57,49,8,4,4,0,0
"8274","DET","COL",2011020384,15312,20112012,0,60,2,4,-2,4.67738854294294,5.65733100608833,-0.979942463145392,29,35,-6,43,49,-6,60,57,3,5,3,0,0
"8275","DET","STL",2011020395,15314,20112012,0,60,2,3,-1,3.94347642172215,3.80682051694021,0.136655904781948,29,26,3,39,34,5,49,49,0,8,9,0,0
"8276","DET","WPG",2011020426,15318,20112012,1,60,7,1,6,3.09034442715347,2.4458287454172,0.644515681736266,29,30,-1,45,35,10,57,47,10,3,2,0,0
"8277","DET","NSH",2011020457,15323,20112012,0,60,3,4,-1,7.03535039253711,2.42334311141167,4.61200728112544,40,21,19,50,31,19,67,40,27,2,1,0,0
"8278","DET","L.A",2011020471,15325,20112012,1,60,8,2,6,6.27270741411485,4.14939995704481,2.12330745707004,27,29,-2,39,42,-3,49,60,-11,3,4,0,0
"8279","DET","EDM",2011020485,15327,20112012,0,60,3,2,1,4.15781963884365,3.53421486847794,0.62360477036571,28,23,5,37,31,6,48,49,-1,2,5,0,0
"8280","DET","VAN",2011020498,15329,20112012,0,60,2,4,-2,4.61743293600739,3.860371658433,0.757061277574394,40,25,15,50,30,20,68,40,28,4,0,0,0
"8281","DET","CGY",2011020505,15330,20112012,0,60,2,3,-1,3.83678404046441,4.45822009840049,-0.62143605793608,31,27,4,38,36,2,56,47,9,2,3,0,0
"8282","DET","NSH",2011020524,15334,20112012,0,60,4,1,3,2.38747628224307,4.96445582769229,-2.57697954544922,22,32,-10,30,44,-14,39,57,-18,2,5,0,0
"8283","DET","STL",2011020534,15335,20112012,1,60,3,2,1,7.03206552820396,4.37847879225592,2.65358673594804,32,31,1,47,39,8,62,57,5,6,6,0,0
"8284","DET","CHI",2011020555,15338,20112012,0,60,2,3,-1,5.92683998012217,3.47508309484738,2.45175688527479,28,28,0,39,36,3,47,52,-5,1,6,0,0
"8285","DET","STL",2011020563,15339,20112012,1,60,3,0,3,4.72456150143989,4.38348673296114,0.34107476847875,31,31,0,48,46,2,61,60,1,4,3,0,0
"8286","DET","DAL",2011020579,15342,20112012,0,60,5,4,1,4.06588457236148,3.88703596462437,0.178848607737109,31,29,2,38,39,-1,57,51,6,0,1,0,0
"8287","DET","TOR",2011020603,15346,20112012,0,60,3,4,-1,3.77918473765021,1.79291412804559,1.98627060960462,40,18,22,65,28,37,85,39,46,1,1,0,0
"8288","DET","CHI",2011020612,15347,20112012,0,63.1333333333333,3,2,1,3.89764857053569,2.43787008797517,1.45977848256052,27,31,-4,40,39,1,53,62,-9,2,6,0,0
"8289","DET","NYI",2011020618,15349,20112012,0,60,1,5,-4,5.55485496883193,3.71406903778552,1.84078593104641,24,30,-6,46,42,4,67,52,15,3,3,0,0
"8290","DET","CHI",2011020647,15353,20112012,1,64.35,3,2,1,4.62463872439525,3.76232138788328,0.862317336511978,43,27,16,52,38,14,59,52,7,1,2,0,0
"8291","DET","DAL",2011020678,15356,20112012,0,65,2,2,0,7.89021002131631,3.19684943248285,4.69336058883346,32,27,5,50,40,10,72,50,22,4,2,0,0
"8292","DET","CBJ",2011020704,15360,20112012,1,65,2,2,0,3.45371170339058,3.12018090251513,0.333530800875451,31,19,12,40,31,9,57,49,8,4,2,0,0
"8293","DET","STL",2011020718,15362,20112012,1,60,3,1,2,2.59050290306914,1.38979625111097,1.20070665195817,28,22,6,41,31,10,54,41,13,7,3,0,0
"8294","DET","MTL",2011020735,15364,20112012,0,60,2,7,-5,5.26559464843012,3.19143036473542,2.0741642836947,28,25,3,35,38,-3,59,54,5,4,3,0,0
"8295","DET","CGY",2011020744,15370,20112012,0,60,3,1,2,4.31341166315415,5.82867421132671,-1.51526254817256,25,29,-4,32,43,-11,50,59,-9,5,4,0,0
"8296","DET","VAN",2011020760,15372,20112012,0,65,3,3,0,3.81076906631642,3.91459021270566,-0.103821146389237,43,25,18,59,34,25,75,44,31,4,1,0,0
"8297","DET","EDM",2011020778,15374,20112012,0,65,4,4,0,7.65757965513266,5.13958314398769,2.51799651114496,39,32,7,50,46,4,72,53,19,5,4,0,0
"8298","DET","EDM",2011020798,15378,20112012,1,60,4,2,2,4.68160578556738,4.3108207745513,0.37078501101608,30,17,13,43,26,17,51,33,18,4,7,0,0
"8299","DET","ANA",2011020813,15380,20112012,1,65,1,1,0,4.05770690480464,4.70431445079157,-0.646607545986932,24,30,-6,35,39,-4,45,47,-2,6,7,0,0
"8300","DET","PHI",2011020829,15382,20112012,1,60,4,3,1,4.57761937915348,3.4955500112843,1.08206936786917,25,29,-4,39,44,-5,48,54,-6,6,3,0,0
"8301","DET","DAL",2011020841,15384,20112012,1,60,3,1,2,2.46832771977643,4.0199364563523,-1.55160873657587,37,21,16,46,36,10,54,47,7,6,3,0,0
"8302","DET","NSH",2011020862,15387,20112012,1,60,2,1,1,1.89481498580426,1.82372623444826,0.071088751356001,31,21,10,36,29,7,45,36,9,1,2,0,0
"8303","DET","S.J",2011020874,15389,20112012,1,60,3,2,1,3.25098344691912,4.40377393806557,-1.15279049114645,28,33,-5,32,45,-13,40,57,-17,3,4,0,0
"8304","DET","CHI",2011020893,15391,20112012,0,60,1,2,-1,4.34547006437788,3.27125093691484,1.07421912746304,32,29,3,41,39,2,48,53,-5,3,3,0,0
"8305","DET","VAN",2011020902,15393,20112012,1,65,3,3,0,3.59691366954939,4.77300430430244,-1.17609063475304,36,43,-7,43,56,-13,52,65,-13,5,4,0,0
"8306","DET","COL",2011020922,15395,20112012,1,60,3,4,-1,1.81693601195002,4.51730988911004,-2.70037387716002,31,27,4,41,31,10,52,41,11,3,2,0,0
"8307","DET","CBJ",2011020941,15398,20112012,0,60,5,2,3,4.08437686807883,4.40284852459677,-0.318471656517939,25,30,-5,39,37,2,50,52,-2,6,5,0,0
"8308","DET","MIN",2011020962,15401,20112012,1,60,6,0,6,5.90629629380055,3.98399736784603,1.92229892595452,35,19,16,56,28,28,71,36,35,7,4,0,0
"8309","DET","CHI",2011020976,15403,20112012,1,60,1,2,-1,3.8859582511941,2.79286809964964,1.09309015154446,24,18,6,40,29,11,53,34,19,4,3,0,0
"8310","DET","PHI",2011020986,15405,20112012,0,60,2,3,-1,6.1726810812433,2.620160017583,3.55252106366029,39,23,16,54,37,17,78,47,31,4,2,0,0
"8311","DET","L.A",2011021011,15408,20112012,1,60,4,3,1,5.17612977593427,4.59960348403547,0.576526291898801,15,24,-9,28,32,-4,37,41,-4,3,4,0,0
"8312","DET","NSH",2011021021,15409,20112012,0,60,2,3,-1,7.30063858124322,1.89741858629156,5.40321999495166,37,20,17,47,27,20,63,38,25,4,4,0,0
"8313","DET","L.A",2011021045,15412,20112012,0,60,2,5,-3,4.5531399527099,2.48754860219196,2.06559135051793,24,27,-3,38,36,2,48,43,5,4,2,0,0
"8314","DET","ANA",2011021051,15413,20112012,0,60,0,4,-4,2.80717346878822,2.26970961775098,0.537463851037245,23,24,-1,37,41,-4,54,53,1,3,2,0,0
"8315","DET","S.J",2011021075,15416,20112012,0,63.3833333333333,2,3,-1,2.33706636310671,5.13619133844622,-2.79912497533951,28,35,-7,40,52,-12,59,70,-11,2,3,0,0
"8316","DET","NYR",2011021099,15420,20112012,0,62.7,1,2,-1,3.18369080412208,3.440587180492,-0.256896376369923,27,34,-7,37,46,-9,55,66,-11,1,3,0,0
"8317","DET","CAR",2011021123,15423,20112012,1,60,5,4,1,7.77999217942124,4.40963612556601,3.37035605385523,50,24,26,71,31,40,79,44,35,3,3,0,0
"8318","DET","CBJ",2011021135,15425,20112012,1,60,7,2,5,2.77475887734909,5.14508760084823,-2.37032872349914,39,26,13,46,34,12,64,41,23,6,4,0,0
"8319","DET","CBJ",2011021149,15427,20112012,0,60,2,4,-2,6.85783975791128,4.7925027099541,2.06533704795718,31,31,0,40,46,-6,62,60,2,5,4,0,0
"8320","DET","NSH",2011021165,15429,20112012,1,60,1,4,-3,4.32877768011531,4.78364812479765,-0.454870444682342,32,27,5,47,38,9,61,47,14,3,2,0,0
"8321","DET","FLA",2011021183,15431,20112012,1,65,1,1,0,6.40795057287755,3.85452288863598,2.55342768424157,32,28,4,45,37,8,56,43,13,4,4,0,0
"8322","DET","STL",2011021200,15434,20112012,0,65,2,2,0,4.67186313768616,4.7656487874774,-0.0937856497912435,28,29,-1,40,41,-1,64,45,19,3,2,0,0
"8323","DET","N.J",2011021208,15435,20112012,1,60,1,2,-1,3.0362808290738,3.01865213605925,0.0176286930145579,24,21,3,34,25,9,46,34,12,1,2,0,0
"8324","DET","CHI",2011021220,15437,20112012,1,65,2,2,0,4.42154068673194,5.99266942785471,-1.57112874112277,32,33,-1,46,41,5,55,52,3,3,4,0,0
"8325","DET","NSH",2011030181,15441,20112012,0,60,2,3,-1,5.5301871207588,3.35740348135346,2.17278363940535,37,26,11,45,35,10,61,45,16,10,7,0,0
"8326","DET","NSH",2011030182,15443,20112012,0,60,3,2,1,1.09769769327249,5.28887961208238,-4.19118191880989,17,26,-9,26,40,-14,36,56,-20,2,6,0,0
"8327","DET","NSH",2011030183,15445,20112012,1,60,2,3,-1,6.08259546640329,3.32255643705139,2.7600390293519,43,22,21,58,32,26,77,41,36,6,6,0,0
"8328","DET","NSH",2011030184,15447,20112012,1,60,1,3,-2,5.7990997107845,0.952909150425597,4.84619056035891,41,17,24,58,21,37,74,29,45,7,3,0,0
"8329","DET","NSH",2011030185,15450,20112012,0,60,1,2,-1,5.27866835979512,3.40020255069248,1.87846580910264,22,25,-3,36,35,1,48,52,-4,2,3,0,0
"8330","DET","STL",2012020009,15724,20122013,0,60,0,6,-6,1.58109066369669,4.86590661119222,-3.28481594749552,14,36,-22,27,52,-25,39,65,-26,4,5,0,0
"8331","DET","CBJ",2012020025,15726,20122013,0,65,3,3,0,4.10316229831369,3.92554560376448,0.177616694549215,42,33,9,57,38,19,72,45,27,9,9,0,0
"8332","DET","DAL",2012020031,15727,20122013,1,60,1,2,-1,3.3874235992904,3.2973061358533,0.0901174634371031,40,32,8,53,40,13,64,51,13,5,3,0,0
"8333","DET","MIN",2012020054,15730,20122013,1,60,5,3,2,0,0,0,27,26,1,39,36,3,44,60,-16,5,8,0,0
"8334","DET","CHI",2012020069,15732,20122013,0,62.75,1,2,-1,2.16791270609247,2.54106955094217,-0.373156844849701,30,27,3,38,34,4,58,48,10,6,3,0,0
"8335","DET","DAL",2012020085,15734,20122013,1,60,4,1,3,3.99239448449373,2.6137978026818,1.37859668181193,27,26,1,43,34,9,55,47,8,5,6,0,0
"8336","DET","STL",2012020104,15737,20122013,1,60,5,3,2,4.724973080582,3.54791123546053,1.17706184512148,31,26,5,35,37,-2,51,48,3,6,5,0,0
"8337","DET","CBJ",2012020114,15738,20122013,0,60,2,4,-2,5.84635766754792,4.52941606498393,1.31694160256399,34,28,6,44,37,7,60,42,18,5,3,0,0
"8338","DET","CGY",2012020134,15741,20122013,1,60,1,4,-3,2.8945844352711,3.48726889188401,-0.592684456612915,26,23,3,41,30,11,61,44,17,4,6,0,0
"8339","DET","STL",2012020149,15743,20122013,0,60,5,1,4,2.19904927865306,4.65539846126921,-2.45634918261615,29,27,2,40,41,-1,47,55,-8,3,2,0,0
"8340","DET","EDM",2012020158,15745,20122013,1,60,2,1,1,4.78834137270967,2.47903183682453,2.30930953588514,30,24,6,45,34,11,61,49,12,7,8,0,0
"8341","DET","L.A",2012020166,15746,20122013,1,60,3,2,1,3.68513143190666,4.94290823818301,-1.25777680627635,31,47,-16,37,59,-22,44,68,-24,4,3,0,0
"8342","DET","STL",2012020189,15749,20122013,1,60.8666666666667,3,4,-1,1.70681713573867,4.08166444543167,-2.374847309693,18,25,-7,27,33,-6,51,46,5,5,4,0,0
"8343","DET","ANA",2012020200,15751,20122013,1,60,2,5,-3,5.61982579945834,5.88118503743148,-0.26135923797314,28,37,-9,47,45,2,59,59,0,4,3,0,0
"8344","DET","MIN",2012020216,15753,20122013,0,60,2,3,-1,4.76560413773404,2.84331153941594,1.92229259831811,31,24,7,47,35,12,63,41,22,2,2,0,0
"8345","DET","NSH",2012020231,15755,20122013,0,60.7333333333333,3,4,-1,4.45617282453895,5.91815931913607,-1.46198649459711,29,25,4,46,38,8,61,47,14,2,6,0,0
"8346","DET","CBJ",2012020244,15757,20122013,1,60,2,3,-1,4.07003606902435,4.10239650971926,-0.0323604406949016,30,24,6,37,34,3,46,47,-1,5,4,0,0
"8347","DET","NSH",2012020258,15759,20122013,1,60,4,0,4,3.84858580020955,4.09474215416049,-0.246156353950937,27,33,-6,34,45,-11,42,57,-15,2,2,0,0
"8348","DET","VAN",2012020264,15760,20122013,1,60,8,3,5,5.31521117407829,3.78436114145279,1.53085003262549,28,21,7,40,26,14,48,36,12,6,3,0,0
"8349","DET","L.A",2012020287,15763,20122013,0,60,1,2,-1,4.43651414051419,5.87431605090387,-1.43780191038968,33,29,4,48,42,6,60,50,10,3,5,0,0
"8350","DET","S.J",2012020298,15764,20122013,0,65,1,1,0,5.4295318685472,3.79677226830972,1.63275960023748,34,26,8,50,37,13,75,60,15,2,1,0,0
"8351","DET","CHI",2012020311,15767,20122013,1,65,1,1,0,4.1942284317254,5.72115085769474,-1.52692242596934,33,33,0,41,49,-8,53,65,-12,2,4,0,0
"8352","DET","COL",2012020331,15769,20122013,1,60,2,1,1,4.10461161494459,5.2472045783361,-1.14259296339151,33,37,-4,37,43,-6,47,54,-7,2,1,0,0
"8353","DET","EDM",2012020347,15771,20122013,1,60,3,0,3,3.57611386486678,3.24461758858524,0.331496276281541,28,22,6,42,28,14,63,42,21,1,0,0,0
"8354","DET","CBJ",2012020357,15773,20122013,0,60,0,3,-3,5.26659482121475,2.59070993582645,2.6758848853883,30,24,6,41,34,7,51,46,5,4,7,0,0
"8355","DET","CBJ",2012020366,15774,20122013,1,65,2,2,0,3.11505198079072,4.83802228270179,-1.72297030191106,23,21,2,34,29,5,51,42,9,6,5,0,0
"8356","DET","CGY",2012020390,15777,20122013,0,60,2,5,-3,3.55438710372255,3.22914774466393,0.325239359058614,38,22,16,55,32,23,73,38,35,2,2,0,0
"8357","DET","EDM",2012020404,15779,20122013,0,63.65,3,2,1,7.68001740443287,3.82227176056767,3.8577456438652,29,32,-3,44,38,6,64,45,19,5,3,0,0
"8358","DET","VAN",2012020416,15780,20122013,0,60,5,2,3,0,0,0,26,35,-9,34,46,-12,46,58,-12,3,7,0,0
"8359","DET","MIN",2012020439,15784,20122013,1,60,2,4,-2,3.21872814653034,2.86150736256968,0.357220783960656,38,19,19,50,22,28,59,29,30,6,3,0,0
"8360","DET","ANA",2012020455,15786,20122013,0,60,5,1,4,4.34320487704827,5.83979581121821,-1.49659093416994,23,34,-11,37,40,-3,52,56,-4,2,3,0,0
"8361","DET","ANA",2012020471,15788,20122013,0,60,2,1,1,2.45701681388164,3.54194721992826,-1.08493040604662,21,34,-13,28,49,-21,41,63,-22,6,3,0,0
"8362","DET","ARI",2012020477,15789,20122013,0,60,3,2,1,4.65658487109613,3.24373344847415,1.41285142262198,35,30,5,52,48,4,62,58,4,5,3,0,0
"8363","DET","S.J",2012020501,15792,20122013,0,60,0,2,-2,4.43174377066316,3.72152729630761,0.710216474355548,27,24,3,43,36,7,66,52,14,1,0,0,0
"8364","DET","CHI",2012020517,15795,20122013,1,60,1,7,-6,4.10999446857022,5.12552693815087,-1.01553246958065,34,26,8,50,32,18,62,46,16,2,0,0,0
"8365","DET","COL",2012020525,15796,20122013,1,60,3,2,1,4.20034704357386,3.19086373254208,1.00948331103177,20,24,-4,33,30,3,37,37,0,2,3,0,0
"8366","DET","ARI",2012020551,15799,20122013,0,60,2,4,-2,4.77814297773466,4.35824181798239,0.419901159752277,36,38,-2,47,44,3,67,50,17,7,5,0,0
"8367","DET","COL",2012020556,15800,20122013,0,64.7333333333333,3,2,1,5.50811789420459,2.99600762916227,2.51211026504232,31,35,-4,43,45,-2,63,67,-4,4,3,0,0
"8368","DET","STL",2012020569,15802,20122013,1,60,0,1,-1,4.57893013593275,2.83476764475228,1.74416249118048,28,25,3,43,30,13,56,37,19,4,3,0,0
"8369","DET","S.J",2012020601,15806,20122013,1,65,2,2,0,3.74684649005636,6.45177219862671,-2.70492570857035,29,30,-1,42,45,-3,59,55,4,4,4,0,0
"8370","DET","CHI",2012020608,15807,20122013,0,65,2,2,0,5.1896374119533,3.52091373665806,1.66872367529524,29,28,1,41,37,4,58,50,8,5,3,0,0
"8371","DET","NSH",2012020623,15809,20122013,0,60,3,0,3,5.20321059493123,3.95589778451399,1.24731281041724,32,22,10,48,30,18,70,41,29,2,2,0,0
"8372","DET","CGY",2012020642,15812,20122013,0,60,2,3,-1,5.47499217167206,2.53628735022023,2.93870482145182,38,17,21,56,25,31,70,33,37,5,1,0,0
"8373","DET","VAN",2012020667,15815,20122013,0,65,1,1,0,4.18822413077578,3.4521864419803,0.736037688795477,34,14,20,42,26,16,53,38,15,4,5,0,0
"8374","DET","ARI",2012020678,15817,20122013,1,60,4,0,4,3.80341376781871,4.97364403191023,-1.17023026409151,23,34,-11,39,44,-5,48,55,-7,6,5,0,0
"8375","DET","L.A",2012020691,15819,20122013,1,60,3,1,2,5.40430966505164,2.90994277852587,2.49436688652577,36,24,12,52,33,19,64,38,26,4,3,0,0
"8376","DET","NSH",2012020699,15820,20122013,1,60,5,2,3,4.28437328433633,5.70336810988374,-1.41899482554741,38,22,16,52,30,22,65,34,31,4,5,0,0
"8377","DET","DAL",2012020717,15822,20122013,0,60,3,0,3,5.18472098843549,1.56412154214922,3.62059944628627,37,17,20,59,28,31,74,46,28,6,4,0,0
"8378","DET","ANA",2012030161,15825,20122013,0,60,1,3,-2,5.70427612750791,4.759534285462,0.944741842045914,22,27,-5,38,35,3,55,50,5,4,4,0,0
"8379","DET","ANA",2012030162,15827,20122013,0,61.35,5,4,1,3.9287441061897,2.23305498624168,1.69568911994801,32,32,0,45,45,0,61,69,-8,6,5,0,0
"8380","DET","ANA",2012030163,15829,20122013,1,60,0,4,-4,4.72071801790526,2.98755920362782,1.73315881427743,23,29,-6,34,35,-1,48,43,5,7,5,0,0
"8381","DET","ANA",2012030164,15831,20122013,1,75.1666666666667,3,2,1,8.56960647179085,5.63087334874103,2.93873312304981,49,33,16,68,45,23,89,52,37,1,3,0,0
"8382","DET","ANA",2012030165,15833,20122013,0,61.9,2,3,-1,5.09936373005621,3.08064194420513,2.01872178585108,31,34,-3,51,49,2,68,63,5,3,4,0,0
"8383","DET","ANA",2012030166,15835,20122013,1,61.0666666666667,4,3,1,5.99660810796195,2.87271865098587,3.12388945697608,29,37,-8,49,48,1,63,61,2,3,0,0,0
"8384","DET","ANA",2012030167,15837,20122013,0,60,3,2,1,4.33401981188217,7.08295054471034,-2.74893073282817,32,33,-1,47,46,1,58,59,-1,3,5,0,0
"8385","DET","CHI",2012030231,15840,20122013,0,60,1,4,-3,2.50944612291642,6.22650938739298,-3.71706326447656,21,42,-21,33,53,-20,46,68,-22,5,5,0,0
"8386","DET","CHI",2012030232,15843,20122013,0,60,4,1,3,4.42148145174724,1.63065610096237,2.79082535078487,30,20,10,44,26,18,55,41,14,5,3,0,0
"8387","DET","CHI",2012030233,15845,20122013,1,60,3,1,2,3.00063771350688,5.18139758910734,-2.18075987560046,30,40,-10,36,51,-15,48,66,-18,6,5,0,0
"8388","DET","CHI",2012030234,15848,20122013,1,60,2,0,2,3.32265956752531,4.85464807839583,-1.53198851087052,27,28,-1,33,38,-5,44,49,-5,5,5,0,0
"8389","DET","CHI",2012030235,15850,20122013,0,60,1,4,-3,2.24305495119188,3.51433341664032,-1.27127846544844,26,45,-19,32,55,-23,40,66,-26,6,5,0,0
"8390","DET","CHI",2012030236,15852,20122013,1,60,3,4,-1,6.29545644548489,3.55166359369448,2.74379285179041,38,28,10,49,39,10,60,49,11,5,7,0,0
"8391","DET","CHI",2012030237,15854,20122013,0,63.5833333333333,1,2,-1,4.95813496329356,6.37605862856506,-1.4179236652715,27,35,-8,37,45,-8,52,58,-6,3,5,0,0
"8392","DET","CAR",2013020017,15982,20132014,0,63.2166666666667,3,2,1,5.94453266127675,4.87865283372423,1.06587982755252,38,25,13,53,40,13,76,55,21,3,3,0,0
"8393","DET","BOS",2013020021,15983,20132014,0,60,1,4,-3,3.90118587721372,4.78656145046494,-0.885375573251224,26,37,-11,34,50,-16,45,59,-14,2,4,0,0
"8394","DET","ARI",2013020051,15988,20132014,1,60,2,4,-2,3.7676377442549,6.02772565809579,-2.26008791384089,30,38,-8,38,50,-12,51,56,-5,3,3,0,0
"8395","DET","PHI",2013020065,15990,20132014,1,60,5,2,3,8.56742845408735,4.55712644508458,4.01030200900277,30,34,-4,39,40,-1,47,55,-8,7,4,0,0
"8396","DET","BOS",2013020079,15992,20132014,0,60,3,2,1,3.33771908058574,5.07184791727923,-1.73412883669349,27,30,-3,38,47,-9,42,69,-27,1,6,0,0
"8397","DET","CBJ",2013020087,15993,20132014,1,60,2,1,1,2.97812688574777,4.25719826840213,-1.27907138265437,32,37,-5,45,42,3,56,52,4,4,3,0,0
"8398","DET","COL",2013020107,15995,20132014,0,60,4,2,2,4.97771810353152,4.86674522593967,0.110972877591848,28,40,-12,36,50,-14,52,68,-16,3,6,0,0
"8399","DET","ARI",2013020120,15997,20132014,0,60,2,5,-3,3.01483187076519,4.35107192202122,-1.33624005125603,33,33,0,45,46,-1,53,63,-10,3,3,0,0
"8400","DET","S.J",2013020126,15999,20132014,1,65,0,0,0,4.58287735155318,4.26419974325108,0.318677608302096,24,27,-3,39,31,8,50,45,5,2,3,0,0
"8401","DET","OTT",2013020137,16001,20132014,1,60,1,6,-5,5.20867753610946,3.55432746204315,1.65435007406631,32,28,4,42,41,1,53,52,1,3,3,0,0
"8402","DET","NYR",2013020158,16004,20132014,1,64.7833333333333,2,3,-1,4.75461127927304,4.58661421727447,0.167997061998562,34,40,-6,46,49,-3,53,54,-1,4,3,0,0
"8403","DET","VAN",2013020186,16008,20132014,0,60,2,1,1,4.23941727547117,3.48557790828636,0.753839367184809,27,20,7,39,30,9,58,45,13,3,4,0,0
"8404","DET","CGY",2013020198,16010,20132014,0,60,4,3,1,3.85340526981388,4.28365570434835,-0.430250434534463,22,25,-3,33,39,-6,47,53,-6,3,5,0,0
"8405","DET","EDM",2013020210,16011,20132014,0,60,5,0,5,4.53162740173866,2.03744024772536,2.4941871540133,31,14,17,48,24,24,63,37,26,5,3,0,0
"8406","DET","WPG",2013020216,16013,20132014,0,60,2,4,-2,3.64596387126949,4.17298763107101,-0.527023759801523,28,47,-19,37,55,-18,50,76,-26,3,6,0,0
"8407","DET","DAL",2013020236,16016,20132014,1,64.6833333333333,3,4,-1,5.94549893203657,5.42424164921977,0.521257282816805,29,28,1,36,37,-1,41,44,-3,0,2,0,0
"8408","DET","T.B",2013020248,16018,20132014,1,63.85,2,3,-1,2.57513195657702,4.93736344860736,-2.36223149203033,27,34,-7,34,50,-16,51,62,-11,3,3,0,0
"8409","DET","WPG",2013020270,16021,20132014,1,65,2,2,0,5.83831235791328,2.8816339305049,2.95667842740838,43,21,22,56,29,27,62,41,21,4,3,0,0
"8410","DET","NYI",2013020297,16025,20132014,0,65,4,4,0,2.94645799315913,5.48701209793944,-2.54055410478031,23,41,-18,32,49,-17,41,69,-28,1,5,0,0
"8411","DET","NSH",2013020316,16028,20132014,1,60,0,2,-2,2.61014134934279,4.22850034335943,-1.61835899401664,27,25,2,34,36,-2,49,46,3,3,6,0,0
"8412","DET","CAR",2013020329,16030,20132014,1,60,4,3,1,7.44192450241826,5.82075610554283,1.62116839687543,47,27,20,56,37,19,67,45,22,4,4,0,0
"8413","DET","OTT",2013020345,16032,20132014,1,60,2,4,-2,4.78230842079211,2.97971101902658,1.80259740176552,36,29,7,49,39,10,59,48,11,9,8,0,0
"8414","DET","BOS",2013020370,16036,20132014,1,60,6,1,5,4.13455300383339,3.36776190967066,0.766791094162727,28,17,11,38,25,13,43,38,5,5,4,0,0
"8415","DET","NYI",2013020382,16038,20132014,0,60,5,0,5,6.0072446570266,5.22660661219561,0.780638044830994,30,29,1,40,42,-2,50,59,-9,2,1,0,0
"8416","DET","OTT",2013020404,16040,20132014,0,60,4,2,2,4.33477853694811,4.17311153973671,0.161666997211402,23,32,-9,27,46,-19,39,67,-28,1,4,0,0
"8417","DET","PHI",2013020420,16043,20132014,1,60,3,6,-3,4.67784485276206,6.1901928730794,-1.51234802031734,35,34,1,42,44,-2,47,56,-9,10,4,0,0
"8418","DET","N.J",2013020432,16045,20132014,0,60,3,1,2,0,0,0,21,11,10,28,19,9,31,26,5,5,4,0,0
"8419","DET","FLA",2013020441,16046,20132014,1,60,1,2,-1,2.70616258800313,8.41402853444727,-5.70786594644414,23,37,-14,33,46,-13,40,58,-18,3,2,0,0
"8420","DET","FLA",2013020462,16049,20132014,0,65,2,2,0,4.1267685656203,4.53178078017663,-0.405012214556336,26,27,-1,36,38,-2,54,51,3,4,3,0,0
"8421","DET","T.B",2013020476,16051,20132014,0,65,1,1,0,3.20642790388973,2.96479842128929,0.241629482600445,29,27,2,45,46,-1,58,59,-1,4,4,0,0
"8422","DET","T.B",2013020500,16054,20132014,1,60,0,3,-3,3.77177553992078,7.44244435435394,-3.67066881443316,28,27,1,40,39,1,55,50,5,3,3,0,0
"8423","DET","ANA",2013020514,16056,20132014,1,60,2,5,-3,2.09242012619507,3.25488045944076,-1.16246033324569,18,30,-12,25,39,-14,32,52,-20,2,2,0,0
"8424","DET","CGY",2013020528,16058,20132014,1,61.05,3,2,1,6.11391913497937,1.64285891488797,4.47106022009139,38,22,16,52,25,27,67,36,31,4,5,0,0
"8425","DET","TOR",2013020542,16060,20132014,0,65,4,4,0,5.6012202726525,2.94933933671564,2.65188093593686,38,23,15,63,35,28,78,43,35,1,4,0,0
"8426","DET","NYI",2013020558,16062,20132014,1,60,0,3,-3,4.37149199933629,2.34529311132444,2.02619888801185,23,19,4,36,24,12,47,33,14,1,1,0,0
"8427","DET","FLA",2013020579,16067,20132014,0,60,4,3,1,3.53160369582474,3.56448730583683,-0.0328836100120853,31,33,-2,33,48,-15,45,70,-25,5,6,0,0
"8428","DET","NSH",2013020597,16069,20132014,0,60,4,6,-2,3.39311587907423,3.47932206920814,-0.0862061901339075,25,29,-4,39,41,-2,55,51,4,2,4,0,0
"8429","DET","TOR",2013020610,16071,20132014,1,65,2,2,0,4.9950196085847,3.68069909459155,1.31432051399315,43,26,17,52,32,20,63,40,23,4,2,0,0
"8430","DET","DAL",2013020634,16074,20132014,0,60,5,1,4,1.27913217082096,5.32340131451812,-4.04426914369716,27,45,-18,39,67,-28,51,85,-34,5,7,0,0
"8431","DET","S.J",2013020668,16079,20132014,0,60,1,4,-3,4.12661581486464,5.27428574235819,-1.14766992749355,25,26,-1,36,45,-9,54,59,-5,7,7,0,0
"8432","DET","L.A",2013020683,16081,20132014,0,60,3,1,2,4.03037513064919,6.9449162781566,-2.91454114750741,26,45,-19,37,66,-29,44,83,-39,5,5,0,0
"8433","DET","ANA",2013020691,16082,20132014,0,60,0,1,-1,4.87922193759005,2.64352148983485,2.23570044775519,22,23,-1,42,32,10,63,44,19,5,4,0,0
"8434","DET","NYR",2013020710,16086,20132014,0,60,0,1,-1,4.35516596633413,4.74421525756588,-0.389049291231759,38,48,-10,49,56,-7,58,71,-13,2,2,0,0
"8435","DET","L.A",2013020728,16088,20132014,1,65,2,2,0,3.53827503183857,4.19543908315245,-0.657164051313885,35,32,3,50,39,11,67,51,16,5,6,0,0
"8436","DET","STL",2013020742,16090,20132014,1,60,1,4,-3,3.07000736249847,5.26950134746181,-2.19949398496334,23,39,-16,37,49,-12,50,64,-14,6,5,0,0
"8437","DET","CHI",2013020757,16092,20132014,1,65,4,4,0,3.07387783252852,6.76970288811509,-3.69582505558657,31,35,-4,48,43,5,61,52,9,4,4,0,0
"8438","DET","MTL",2013020771,16094,20132014,1,60,4,1,3,3.13363721807036,3.83208753775671,-0.698450319686344,26,31,-5,39,41,-2,48,51,-3,7,5,0,0
"8439","DET","FLA",2013020785,16096,20132014,1,65,4,4,0,2.72136498201871,6.16741617082153,-3.44605118880281,30,37,-7,39,42,-3,55,47,8,4,4,0,0
"8440","DET","PHI",2013020797,16098,20132014,0,60,0,5,-5,4.71828489508516,4.62627961605273,0.0920052790324348,33,28,5,45,37,8,65,46,19,6,4,0,0
"8441","DET","VAN",2013020839,16104,20132014,1,60,2,0,2,2.15882937638645,2.88416052830871,-0.725331151922262,30,24,6,46,32,14,56,37,19,4,7,0,0
"8442","DET","FLA",2013020863,16107,20132014,0,60,3,1,2,4.68088889855426,3.19477850710973,1.48611039144453,33,24,9,47,34,13,56,42,14,7,3,0,0
"8443","DET","T.B",2013020877,16109,20132014,0,60,2,4,-2,3.97867828773451,6.54561423413907,-2.56693594640456,33,28,5,47,37,10,60,48,12,3,3,0,0
"8444","DET","MTL",2013020883,16127,20132014,0,64.5333333333333,2,1,1,4.81881921715103,3.76573034690227,1.05308887024876,30,20,10,42,31,11,62,53,9,2,3,0,0
"8445","DET","OTT",2013020891,16128,20132014,0,60,6,1,5,2.78696140274405,4.02620948031836,-1.2392480775743,26,38,-12,30,53,-23,37,66,-29,5,7,0,0
"8446","DET","N.J",2013020925,16133,20132014,0,60,3,4,-1,2.41121477517481,3.48394361266401,-1.07272883748919,23,29,-6,29,35,-6,35,41,-6,5,4,0,0
"8447","DET","COL",2013020940,16135,20132014,1,64.4666666666667,2,3,-1,5.86710906674853,5.68189160151633,0.185217465232199,37,25,12,45,31,14,58,42,16,2,2,0,0
"8448","DET","N.J",2013020949,16136,20132014,1,60,7,4,3,4.42632593980664,1.66639807185857,2.75992786794808,33,25,8,41,30,11,47,44,3,3,3,0,0
"8449","DET","NYR",2013020965,16138,20132014,0,60,0,3,-3,0,0,0,30,31,-1,34,40,-6,43,57,-14,3,3,0,0
"8450","DET","CBJ",2013020979,16140,20132014,0,60,1,4,-3,5.97253356131114,5.05690371931996,0.915629841991176,40,37,3,48,42,6,60,55,5,5,4,0,0
"8451","DET","EDM",2013020998,16143,20132014,1,65,1,1,0,3.67184397915844,2.10411242669215,1.56773155246628,23,22,1,43,27,16,58,42,16,5,3,0,0
"8452","DET","CHI",2013021020,16145,20132014,0,60,1,4,-3,4.78394092456438,4.76490527734859,0.0190356472157873,20,30,-10,36,35,1,47,53,-6,5,4,0,0
"8453","DET","TOR",2013021032,16147,20132014,1,60,3,2,1,3.8905558947758,6.97319894470274,-3.08264304992694,31,33,-2,45,43,2,58,57,1,4,4,0,0
"8454","DET","MIN",2013021057,16151,20132014,0,60,3,2,1,7.06079646537546,3.67483501430252,3.38596145107294,30,30,0,40,41,-1,46,58,-12,3,4,0,0
"8455","DET","MIN",2013021070,16152,20132014,1,62.25,3,4,-1,2.95414215541737,2.51780644063547,0.436335714781901,16,25,-9,28,37,-9,36,49,-13,2,3,0,0
"8456","DET","CBJ",2013021085,16154,20132014,0,60,2,4,-2,3.4230406247807,4.22434861784495,-0.801307993064256,33,28,5,41,37,4,53,49,4,3,4,0,0
"8457","DET","MTL",2013021095,16156,20132014,1,60,4,5,-1,2.23404240819218,5.10214040928986,-2.86809800109768,30,29,1,42,37,5,52,47,5,3,4,0,0
"8458","DET","TOR",2013021111,16158,20132014,0,60,4,2,2,4.82420404699224,3.11460475384433,1.7095992931479,28,27,1,38,38,0,54,51,3,5,4,0,0
"8459","DET","T.B",2013021120,16159,20132014,1,60,3,2,1,4.15582479997829,4.63083895658201,-0.47501415660372,30,28,2,36,37,-1,44,46,-2,3,4,0,0
"8460","DET","BOS",2013021141,16162,20132014,1,60,3,2,1,2.00250745945746,3.13882900973476,-1.1363215502773,20,35,-15,26,45,-19,29,56,-27,2,4,0,0
"8461","DET","MTL",2013021164,16165,20132014,0,60,3,5,-2,5.07388874148558,4.32925778767094,0.744630953814641,37,26,11,49,31,18,67,43,24,6,4,0,0
"8462","DET","CAR",2013021206,16171,20132014,1,60,1,2,-1,2.26078051200602,3.29782089384994,-1.03704038184392,29,19,10,38,24,14,46,32,14,3,3,0,0
"8463","DET","STL",2013021224,16173,20132014,0,60,3,0,3,4.44627765554469,2.20848772650805,2.23778992903664,21,23,-2,36,28,8,46,40,6,4,3,0,0
"8464","DET","BOS",2013030111,16178,20132014,0,60,1,0,1,3.25295304807969,5.8618766738673,-2.60892362578761,24,25,-1,35,31,4,54,42,12,2,1,0,0
"8465","DET","BOS",2013030112,16180,20132014,0,60,1,4,-3,4.59817126800772,5.08633530774296,-0.488164039735238,35,29,6,44,36,8,58,43,15,7,7,0,0
"8466","DET","BOS",2013030113,16182,20132014,1,60,0,3,-3,3.51320674279123,5.94090397101911,-2.42769722822788,23,34,-11,33,46,-13,46,56,-10,4,4,0,0
"8467","DET","BOS",2013030114,16184,20132014,1,73.5333333333333,2,3,-1,7.38916971907281,7.69234063285694,-0.303170913784129,37,40,-3,50,51,-1,63,77,-14,4,3,0,0
"8468","DET","BOS",2013030115,16186,20132014,0,60,2,4,-2,4.97477399429397,4.19015256271907,0.784621431574902,33,33,0,42,38,4,58,51,7,7,6,0,0
"8469","DET","BOS",2014020009,16352,20142015,1,60,2,1,1,3.7641060640949,2.37758468026827,1.38652138382663,24,17,7,33,23,10,46,29,17,5,5,0,0
"8470","DET","ANA",2014020020,16354,20142015,1,60,2,3,-1,3.11801785428088,2.78969704220071,0.328320812080165,29,26,3,35,30,5,51,43,8,3,4,0,0
"8471","DET","BOS",2014020047,16358,20142015,1,65,2,2,0,3.33588533336297,5.50339942087612,-2.16751408751315,20,39,-19,28,48,-20,40,65,-25,5,3,0,0
"8472","DET","TOR",2014020059,16360,20142015,0,60,4,1,3,5.34829151257873,4.52993442063161,0.818357091947121,35,24,11,47,40,7,66,48,18,6,3,0,0
"8473","DET","TOR",2014020066,16361,20142015,1,64.8333333333333,1,0,1,5.18089569550239,5.31255958245312,-0.131663886950736,32,30,2,47,45,2,53,55,-2,6,6,0,0
"8474","DET","MTL",2014020082,16364,20142015,0,60.9333333333333,1,2,-1,3.54244971470325,8.16241275283392,-4.61996303813066,28,36,-8,36,43,-7,55,60,-5,4,2,0,0
"8475","DET","PHI",2014020111,16368,20142015,0,60,2,4,-2,5.41527788032811,4.79784866096452,0.617429219363586,37,17,20,44,27,17,75,42,33,4,6,0,0
"8476","DET","L.A",2014020149,16374,20142015,1,60,5,2,3,3.55213476243769,4.6779106668665,-1.1257759044288,35,30,5,43,42,1,55,52,3,6,4,0,0
"8477","DET","OTT",2014020178,16378,20142015,0,60,1,3,-2,5.91268781041435,3.96182071868793,1.95086709172642,32,32,0,49,43,6,62,57,5,3,4,0,0
"8478","DET","NYR",2014020185,16379,20142015,0,61.8333333333333,3,4,-1,5.12939840409672,2.85077288839966,2.27862551569706,28,30,-2,48,37,11,65,50,15,8,5,0,0
"8479","DET","N.J",2014020199,16381,20142015,1,60,4,2,2,5.86862211399421,3.03865129838406,2.82997081561015,31,17,14,37,25,12,41,45,-4,5,4,0,0
"8480","DET","T.B",2014020214,16383,20142015,1,65,3,3,0,3.5161396212643,2.78407596994657,0.732063651317731,20,30,-10,28,40,-12,44,50,-6,4,5,0,0
"8481","DET","CHI",2014020245,16388,20142015,1,60,4,1,3,4.3154705435154,4.40704641974298,-0.09157587622758,37,26,11,40,35,5,49,47,2,3,4,0,0
"8482","DET","MTL",2014020262,16390,20142015,1,60,1,4,-3,3.44773258343048,4.69033129280433,-1.24259870937385,29,19,10,43,31,12,56,37,19,7,5,0,0
"8483","DET","CBJ",2014020270,16392,20142015,0,60,5,0,5,7.04944413473928,3.57693505141424,3.47250908332504,40,28,12,50,38,12,63,54,9,5,3,0,0
"8484","DET","WPG",2014020284,16394,20142015,0,60,4,3,1,2.72362541381924,4.49891935645142,-1.77529394263217,27,31,-4,34,44,-10,48,60,-12,4,3,0,0
"8485","DET","TOR",2014020297,16396,20142015,0,60,1,4,-3,4.49129970848778,3.95136917836498,0.539930530122792,27,28,-1,44,37,7,61,51,10,3,4,0,0
"8486","DET","OTT",2014020314,16398,20142015,1,60,4,3,1,6.31088973009446,5.43745861267263,0.873431117421831,43,26,17,54,36,18,62,52,10,6,4,0,0
"8487","DET","PHI",2014020325,16400,20142015,1,60,5,2,3,4.40497494159354,5.64046346023679,-1.23548851864325,25,24,1,31,36,-5,40,47,-7,3,4,0,0
"8488","DET","N.J",2014020338,16402,20142015,0,65,4,4,0,4.73098190090968,4.77211780348443,-0.0411359025747515,32,25,7,42,36,6,54,43,11,6,6,0,0
"8489","DET","VAN",2014020356,16404,20142015,1,60,5,3,2,6.70863781147636,7.05113883753074,-0.342501026054379,30,33,-3,38,42,-4,54,51,3,5,4,0,0
"8490","DET","FLA",2014020368,16406,20142015,1,60,3,4,-1,3.42844904376433,3.8533616542268,-0.424912610462469,41,31,10,49,38,11,63,46,17,4,1,0,0
"8491","DET","DAL",2014020380,16408,20142015,1,60,5,2,3,4.45353688517946,2.66764514340153,1.78589174177793,29,24,5,38,30,8,49,33,16,3,3,0,0
"8492","DET","NYR",2014020393,16410,20142015,1,60,3,2,1,5.23667672724939,2.18014640716101,3.05653032008838,34,29,5,45,44,1,57,55,2,2,6,0,0
"8493","DET","CAR",2014020403,16411,20142015,0,60,3,1,2,2.16431671107537,6.05420639662816,-3.88988968555279,22,35,-13,30,47,-17,38,65,-27,2,4,0,0
"8494","DET","TOR",2014020419,16414,20142015,1,65,1,1,0,7.76486858841599,3.39356491209708,4.37130367631892,42,19,23,62,25,37,74,33,41,4,4,0,0
"8495","DET","FLA",2014020433,16416,20142015,1,65,2,2,0,4.60026500536088,3.35064163635252,1.24962336900836,31,26,5,46,39,7,59,45,14,4,5,0,0
"8496","DET","TOR",2014020438,16417,20142015,0,60,1,4,-3,3.53542146119535,5.29756559372618,-1.76214413253083,28,41,-13,43,58,-15,58,72,-14,3,6,0,0
"8497","DET","CBJ",2014020456,16420,20142015,1,65,0,0,0,6.85687480584238,5.35285683799884,1.50401796784354,30,29,1,39,37,2,48,48,0,1,3,0,0
"8498","DET","NYI",2014020476,16423,20142015,1,60,1,2,-1,2.05116375671351,4.00526441276998,-1.95410065605646,18,32,-14,29,38,-9,44,48,-4,2,3,0,0
"8499","DET","COL",2014020491,16425,20142015,1,65,1,1,0,5.41732734551624,1.8826622182969,3.53466512721934,35,23,12,51,27,24,71,32,39,3,2,0,0
"8500","DET","OTT",2014020515,16431,20142015,0,64.2,3,2,1,3.54944898222311,4.0775809159386,-0.528131933715486,27,33,-6,40,48,-8,47,68,-21,4,6,0,0
"8501","DET","BOS",2014020529,16433,20142015,0,60,2,5,-3,3.60713657247834,4.88607647270672,-1.27893990022839,30,45,-15,36,54,-18,49,61,-12,4,1,0,0
"8502","DET","N.J",2014020550,16435,20142015,1,60,3,1,2,3.3312003293513,1.92576013866346,1.40544019068784,28,13,15,39,20,19,50,31,19,4,3,0,0
"8503","DET","VAN",2014020574,16438,20142015,0,60,1,4,-3,2.14992131711006,3.90683363221433,-1.75691231510427,30,24,6,42,35,7,54,45,9,6,7,0,0
"8504","DET","EDM",2014020592,16441,20142015,0,60,4,2,2,6.38448698120555,4.36227195696483,2.02221502424072,41,23,18,59,34,25,76,40,36,5,3,0,0
"8505","DET","MIN",2014020687,16455,20142015,1,65,4,4,0,3.88305309231509,3.78562259528553,0.0974304970295634,24,38,-14,35,41,-6,47,52,-5,2,5,0,0
"8506","DET","T.B",2014020716,16464,20142015,0,60,1,5,-4,3.53354945735191,5.58450515783625,-2.05095570048434,28,32,-4,41,44,-3,49,55,-6,3,3,0,0
"8507","DET","NYI",2014020728,16466,20142015,1,60,4,1,3,2.73764930063869,3.30322544772279,-0.565576147084103,19,23,-4,27,35,-8,39,46,-7,5,5,0,0
"8508","DET","COL",2014020765,16471,20142015,0,60,3,0,3,7.6195843479436,2.87917774566449,4.74040660227911,29,28,1,35,39,-4,50,55,-5,2,3,0,0
"8509","DET","ARI",2014020781,16473,20142015,0,60,3,1,2,4.26446056523127,3.06724695753235,1.19721360769893,26,23,3,37,36,1,53,50,3,6,5,0,0
"8510","DET","WPG",2014020825,16480,20142015,1,65,4,4,0,3.23937914615286,6.38609129463873,-3.14671214848587,29,38,-9,37,50,-13,44,57,-13,5,4,0,0
"8511","DET","MTL",2014020840,16482,20142015,1,60,0,2,-2,5.71915539697511,4.9926515663974,0.726503830577713,25,29,-4,35,35,0,54,43,11,4,3,0,0
"8512","DET","CHI",2014020854,16484,20142015,0,65,2,2,0,3.90376790208393,6.19760760845566,-2.29383970637173,28,34,-6,34,51,-17,54,74,-20,1,4,0,0
"8513","DET","DAL",2014020881,16487,20142015,0,60.6,7,6,1,4.78502134639712,4.4622810691053,0.322740277291814,36,34,2,52,45,7,66,65,1,3,2,0,0
"8514","DET","ANA",2014020893,16489,20142015,0,65,3,3,0,4.74924097567323,2.84385289833881,1.90538807733443,38,25,13,54,41,13,68,59,9,5,4,0,0
"8515","DET","L.A",2014020904,16490,20142015,0,60,0,1,-1,2.56181848341657,5.34701688273344,-2.78519839931687,20,27,-7,29,43,-14,41,51,-10,6,5,0,0
"8516","DET","S.J",2014020916,16492,20142015,0,60,3,2,1,5.70458404836245,2.96705800871881,2.73752603964364,35,22,13,51,34,17,74,51,23,6,6,0,0
"8517","DET","NYR",2014020953,16498,20142015,1,61.15,2,1,1,4.18374400371977,7.87766943697352,-3.69392543325375,31,40,-9,36,55,-19,50,61,-11,3,4,0,0
"8518","DET","BOS",2014020984,16502,20142015,0,60,3,5,-2,4.81315319717669,3.76063583767973,1.05251735949696,39,30,9,49,41,8,63,48,15,5,5,0,0
"8519","DET","EDM",2014020987,16503,20142015,1,60,5,2,3,5.62249477510341,5.20415499073301,0.41833978437039,26,38,-12,39,46,-7,51,50,1,3,5,0,0
"8520","DET","CBJ",2014021006,16506,20142015,1,60,1,3,-2,4.42403485160321,2.02868969144814,2.39534516015507,42,26,16,57,34,23,72,46,26,5,3,0,0
"8521","DET","PHI",2014021018,16508,20142015,0,60,2,7,-5,4.31701551257133,3.02997609528409,1.28703941728724,33,36,-3,42,45,-3,60,67,-7,3,4,0,0
"8522","DET","T.B",2014021064,16514,20142015,0,60,1,3,-2,4.45674098748714,4.88567906990102,-0.428938082413879,31,32,-1,41,40,1,47,51,-4,4,4,0,0
"8523","DET","ARI",2014021094,16518,20142015,1,63.1333333333333,4,5,-1,4.49313165541389,2.03491071678349,2.4582209386304,37,22,15,48,30,18,62,40,22,5,4,0,0
"8524","DET","S.J",2014021108,16520,20142015,1,60,4,6,-2,5.23618487562635,6.24371367069779,-1.00752879507144,34,30,4,53,39,14,70,47,23,5,2,0,0
"8525","DET","T.B",2014021120,16522,20142015,1,60,4,0,4,4.39750924908731,4.07477449820726,0.322734750880045,23,23,0,38,35,3,48,45,3,5,7,0,0
"8526","DET","NYI",2014021130,16523,20142015,0,60,4,5,-1,3.61869243971887,2.82551912488051,0.793173314838363,25,27,-2,34,36,-2,51,53,-2,4,5,0,0
"8527","DET","OTT",2014021146,16525,20142015,1,65,1,1,0,3.09808456871576,5.32801427850791,-2.22992970979215,17,34,-17,26,51,-25,33,67,-34,5,7,0,0
"8528","DET","BOS",2014021156,16527,20142015,1,60,2,3,-1,5.44659462157324,2.76840721502435,2.67818740654889,37,25,12,54,30,24,62,38,24,5,4,0,0
"8529","DET","MIN",2014021175,16529,20142015,0,65,2,2,0,3.94600646781013,2.23048819692485,1.71551827088528,22,24,-2,44,35,9,64,47,17,2,6,0,0
"8530","DET","CAR",2014021193,16532,20142015,1,60,3,2,1,5.01389972712786,5.53176931085181,-0.51786958372395,25,32,-7,30,43,-13,40,54,-14,1,1,0,0
"8531","DET","MTL",2014021205,16534,20142015,0,61.35,3,4,-1,2.57455585265733,7.43721960327821,-4.86266375062088,27,26,1,38,36,2,49,44,5,5,4,0,0
"8532","DET","CAR",2014021224,16536,20142015,0,60,2,0,2,5.75936202595767,5.76594072215812,-0.00657869620044949,29,35,-6,37,54,-17,58,66,-8,1,2,0,0
"8533","DET","T.B",2014030121,16541,20142015,0,60,3,2,1,2.9926472754305,5.61902792713954,-2.62638065170904,14,46,-32,20,55,-35,28,68,-40,4,7,0,0
"8534","DET","T.B",2014030122,16543,20142015,0,60,1,5,-4,2.60980155791503,3.67348214029334,-1.06368058237831,24,30,-6,37,38,-1,58,48,10,6,6,0,0
"8535","DET","T.B",2014030123,16546,20142015,1,60,3,0,3,3.71621492190752,2.56540800095536,1.15080692095216,21,22,-1,29,31,-2,34,41,-7,5,7,0,0
"8536","DET","T.B",2014030124,16548,20142015,1,62.4166666666667,2,3,-1,3.30010549814815,3.97260291831057,-0.672497420162419,24,29,-5,32,36,-4,44,46,-2,6,6,0,0
"8537","DET","T.B",2014030125,16550,20142015,0,60,4,0,4,5.05608854512684,3.71035613166168,1.34573241346516,30,28,2,36,45,-9,46,59,-13,4,4,0,0
"8538","DET","T.B",2014030126,16552,20142015,1,60,2,5,-3,4.0142318324506,4.15625622710832,-0.14202439465771,24,28,-4,40,35,5,53,43,10,11,6,0,0
"8539","DET","T.B",2014030127,16554,20142015,0,60,0,2,-2,1.65712895914476,2.36475934928475,-0.707630390139997,31,17,14,40,25,15,56,33,23,4,5,0,0
"8540","DET","TOR",2015020014,16717,20152016,1,60,4,0,4,4.44362809204904,4.29138581050938,0.152242281539657,22,22,0,30,33,-3,42,41,1,5,4,0,0
"8541","DET","CAR",2015020023,16718,20152016,0,60,4,3,1,4.21634613536298,10.9689701202587,-6.75262398489576,19,47,-28,25,74,-49,35,89,-54,2,7,0,0
"8542","DET","T.B",2015020042,16721,20152016,1,60,3,1,2,5.8811122461334,3.59693738802889,2.28417485810451,24,21,3,40,34,6,57,44,13,3,3,0,0
"8543","DET","CAR",2015020060,16724,20152016,1,60,3,5,-2,2.96301113197114,4.00800054822906,-1.04498941625792,20,36,-16,27,50,-23,38,56,-18,2,3,0,0
"8544","DET","MTL",2015020065,16725,20152016,0,60,1,4,-3,3.71949284019065,8.67592760397989,-4.95643476378924,22,41,-19,32,52,-20,44,69,-25,3,5,0,0
"8545","DET","EDM",2015020090,16729,20152016,0,60,1,3,-2,4.02384314878327,2.89463948102835,1.12920366775492,29,28,1,46,35,11,70,43,27,6,3,0,0
"8546","DET","VAN",2015020116,16732,20152016,0,63.8333333333333,3,2,1,3.808366512676,4.22924995061887,-0.420883437942869,28,32,-4,37,47,-10,46,58,-12,6,4,0,0
"8547","DET","CAR",2015020127,16735,20152016,1,60,1,3,-2,1.6949011630004,3.5725294159638,-1.8776282529634,26,21,5,33,27,6,39,39,0,3,4,0,0
"8548","DET","OTT",2015020149,16738,20152016,1,60,1,3,-2,3.82208794882553,6.03395704255643,-2.2118690937309,30,35,-5,45,43,2,58,49,9,5,4,0,0
"8549","DET","OTT",2015020158,16739,20152016,0,60,5,3,2,5.6655689324087,5.71602643687811,-0.0504575044694135,28,36,-8,43,50,-7,51,73,-22,5,5,0,0
"8550","DET","T.B",2015020176,16742,20152016,1,60,2,1,1,3.807164542377,5.07748069474474,-1.27031615236774,29,30,-1,34,36,-2,40,49,-9,4,5,0,0
"8551","DET","TOR",2015020194,16745,20152016,0,62.2833333333333,2,1,1,2.2982515883632,4.42442376009734,-2.12617217173414,24,33,-9,33,52,-19,43,69,-26,3,4,0,0
"8552","DET","DAL",2015020211,16747,20152016,1,60,1,4,-3,3.72844302739042,7.3098694636908,-3.58142643630038,22,26,-4,37,33,4,50,40,10,5,3,0,0
"8553","DET","S.J",2015020244,16752,20152016,1,60,2,3,-1,5.45856405493851,1.86369398465857,3.59487007027994,28,14,14,37,24,13,53,27,26,3,2,0,0
"8554","DET","BOS",2015020247,16753,20152016,0,60,1,3,-2,4.55527427975903,2.39424150778996,2.16103277196908,23,31,-8,41,38,3,57,49,8,3,1,0,0
"8555","DET","OTT",2015020264,16755,20152016,0,62.0666666666667,4,3,1,7.39163013399229,5.63985479653275,1.75177533745955,37,25,12,50,39,11,65,57,8,2,2,0,0
"8556","DET","L.A",2015020289,16759,20152016,1,60,3,2,1,4.34094763093162,4.7153694635781,-0.374421832646476,29,37,-8,38,53,-15,44,66,-22,4,4,0,0
"8557","DET","BOS",2015020325,16764,20152016,1,63.5333333333333,2,3,-1,6.66529339569388,4.91809519328763,1.74719820240625,34,22,12,41,26,15,53,33,20,3,3,0,0
"8558","DET","EDM",2015020338,16766,20152016,1,60.4333333333333,4,3,1,3.79160214619651,4.68620385392569,-0.89460170772918,32,24,8,42,40,2,57,50,7,2,2,0,0
"8559","DET","ARI",2015020377,16772,20152016,1,60,5,1,4,5.70885452850052,2.99209800660174,2.71675652189879,44,27,17,53,30,23,67,38,29,4,1,0,0
"8560","DET","MTL",2015020421,16779,20152016,1,60,3,2,1,0,0,0,29,25,4,42,31,11,57,41,16,7,3,0,0
"8561","DET","N.J",2015020428,16780,20152016,0,64.3333333333333,2,3,-1,3.238523565582,5.73385889451311,-2.49533532893111,29,38,-9,37,47,-10,41,56,-15,3,4,0,0
"8562","DET","VAN",2015020481,16787,20152016,1,65,3,3,0,6.27358984270749,5.3884876280724,0.885102214635095,28,40,-12,34,43,-9,45,55,-10,4,3,0,0
"8563","DET","N.J",2015020509,16791,20152016,1,60,3,4,-1,3.5876470180113,3.84830920553122,-0.260662187519927,28,17,11,38,24,14,48,27,21,8,8,0,0
"8564","DET","MIN",2015020538,16797,20152016,0,60,1,3,-2,4.58116184691607,4.2667978527752,0.314363994140876,29,35,-6,36,40,-4,59,45,14,3,3,0,0
"8565","DET","WPG",2015020547,16798,20152016,0,60,1,4,-3,3.94941617568111,5.40769559678353,-1.45827942110242,34,25,9,48,36,12,64,42,22,6,3,0,0
"8566","DET","PIT",2015020557,16800,20152016,1,60,2,5,-3,4.31064780271845,4.77647285816784,-0.465825055449386,35,37,-2,39,44,-5,56,51,5,6,6,0,0
"8567","DET","N.J",2015020583,16804,20152016,0,60,1,0,1,1.26671553877532,2.43180329374445,-1.16508775496914,21,22,-1,25,33,-8,35,48,-13,1,2,0,0
"8568","DET","S.J",2015020607,16807,20152016,0,60,2,1,1,4.70790313698263,4.88347298228473,-0.175569845302102,25,36,-11,33,53,-20,46,67,-21,5,4,0,0
"8569","DET","ANA",2015020628,16810,20152016,0,60,2,1,1,4.57311509832056,4.22652787432953,0.346587223991028,25,31,-6,44,52,-8,60,66,-6,3,2,0,0
"8570","DET","L.A",2015020633,16811,20152016,0,60,2,4,-2,7.70144533483835,6.30611219801358,1.39533313682477,27,31,-4,41,50,-9,54,64,-10,2,3,0,0
"8571","DET","ARI",2015020652,16814,20152016,0,62.1333333333333,3,2,1,6.75380694924388,5.4267724529559,1.32703449628798,25,29,-4,46,43,3,56,51,5,4,4,0,0
"8572","DET","PHI",2015020675,16817,20152016,1,65,1,1,0,3.15691276328289,4.31868895296233,-1.16177618967944,30,31,-1,53,40,13,69,49,20,4,6,0,0
"8573","DET","ANA",2015020713,16823,20152016,1,60,3,4,-1,3.6330675688223,5.5741639699263,-1.94109640110401,27,35,-8,32,41,-9,44,52,-8,4,4,0,0
"8574","DET","NYI",2015020725,16825,20152016,0,60,4,2,2,4.72217937234382,2.9155740395654,1.80660533277842,26,29,-3,38,40,-2,47,58,-11,1,2,0,0
"8575","DET","T.B",2015020757,16834,20152016,0,60,1,3,-2,3.7296703827451,2.63541654020082,1.09425384254428,25,23,2,39,36,3,55,43,12,4,5,0,0
"8576","DET","NYI",2015020778,16837,20152016,1,60,5,1,4,3.75904582469097,3.3516749514452,0.407370873245775,20,29,-9,30,43,-13,40,57,-17,4,6,0,0
"8577","DET","OTT",2015020806,16841,20152016,1,60,3,1,2,2.67092003717005,1.88113791501382,0.789782122156225,29,23,6,35,34,1,42,45,-3,2,7,0,0
"8578","DET","COL",2015020821,16843,20152016,1,65,2,2,0,6.95492592627852,3.87164925728712,3.0832766689914,45,21,24,62,31,31,87,35,52,5,3,0,0
"8579","DET","BOS",2015020837,16845,20152016,1,60,6,5,1,4.06261551787611,4.01736679871101,0.0452487191651016,35,22,13,52,27,25,64,34,30,6,3,0,0
"8580","DET","NYI",2015020840,16846,20152016,0,60,1,4,-3,4.89540732240857,4.01194242811784,0.883464894290733,29,32,-3,39,40,-1,61,57,4,4,5,0,0
"8581","DET","PIT",2015020859,16849,20152016,0,60,3,6,-3,2.94557337948936,5.04941237150342,-2.10383899201406,38,39,-1,53,47,6,64,57,7,1,1,0,0
"8582","DET","OTT",2015020876,16851,20152016,0,65,2,2,0,5.52242099077557,6.4580736110961,-0.935652620320525,31,27,4,42,31,11,50,42,8,3,3,0,0
"8583","DET","NYR",2015020885,16852,20152016,0,61.9833333333333,0,1,-1,4.03913835569983,3.03881925276073,1.0003191029391,22,30,-8,34,46,-12,52,58,-6,5,6,0,0
"8584","DET","CBJ",2015020896,16854,20152016,1,65,1,1,0,5.81648847404608,5.51653907822993,0.299949395816157,28,29,-1,43,38,5,52,45,7,1,3,0,0
"8585","DET","COL",2015020927,16858,20152016,0,60,5,3,2,4.59265883313492,4.68228714397446,-0.0896283108395437,28,27,1,42,40,2,61,51,10,5,4,0,0
"8586","DET","DAL",2015020941,16860,20152016,0,62.55,3,2,1,5.0812936713337,5.75431360247603,-0.673019931142335,33,41,-8,47,59,-12,60,72,-12,4,4,0,0
"8587","DET","CHI",2015020952,16862,20152016,1,60,2,5,-3,4.51075314667833,4.72681548912078,-0.216062342442456,33,33,0,44,39,5,56,52,4,5,4,0,0
"8588","DET","CHI",2015020983,16866,20152016,0,60,1,4,-3,4.02364800686701,3.31171386204996,0.711934144817051,34,26,8,43,39,4,63,55,8,4,4,0,0
"8589","DET","CBJ",2015020996,16868,20152016,0,60,3,5,-2,8.58749353112307,4.3687023638704,4.21879116725268,35,32,3,54,38,16,74,51,23,7,7,0,0
"8590","DET","WPG",2015021009,16870,20152016,1,60,3,2,1,4.5045902194106,3.43765025096945,1.06693996844115,35,25,10,44,30,14,64,38,26,5,6,0,0
"8591","DET","NYR",2015021019,16872,20152016,1,63.05,3,2,1,5.76623204178759,3.58029810226526,2.18593393952233,43,25,18,61,38,23,77,45,32,5,4,0,0
"8592","DET","TOR",2015021032,16873,20152016,1,60,0,1,-1,5.14520309569457,2.72067303798394,2.42453005771063,38,27,11,48,42,6,60,47,13,3,2,0,0
"8593","DET","PHI",2015021039,16875,20152016,0,60,3,4,-1,5.47523923734384,4.56444173310259,0.910797504241252,37,46,-9,48,59,-11,69,77,-8,2,6,0,0
"8594","DET","CBJ",2015021055,16877,20152016,0,60,3,1,2,2.09043622022728,3.01647710657539,-0.926040886348119,22,28,-6,31,36,-5,46,54,-8,3,3,0,0
"8595","DET","T.B",2015021093,16882,20152016,0,60,2,6,-4,2.68307062408712,4.72944847820327,-2.04637785411614,25,34,-9,35,48,-13,49,51,-2,3,6,0,0
"8596","DET","MTL",2015021105,16884,20152016,1,60,4,3,1,5.17575198868872,4.73365249490777,0.442099493780944,40,29,11,58,36,22,70,43,27,7,4,0,0
"8597","DET","PIT",2015021115,16886,20152016,1,60,2,7,-5,3.55576833034473,4.6432890940705,-1.08752076372576,23,41,-18,33,54,-21,38,64,-26,4,7,0,0
"8598","DET","MTL",2015021143,16889,20152016,0,60,3,4,-1,8.72800462389266,4.22444290739077,4.50356171650189,42,27,15,56,41,15,83,48,35,3,6,0,0
"8599","DET","MIN",2015021162,16892,20152016,1,60,3,2,1,5.96080608309421,3.80824476567796,2.15256131741626,29,22,7,45,32,13,54,40,14,3,2,0,0
"8600","DET","TOR",2015021170,16893,20152016,0,60,3,2,1,3.43971275741751,5.08536771246526,-1.64565495504775,26,34,-8,42,53,-11,53,83,-30,4,4,0,0
"8601","DET","PHI",2015021200,16897,20152016,1,60,3,0,3,4.26525782824501,5.52675040803172,-1.2614925797867,26,30,-4,34,38,-4,44,59,-15,7,7,0,0
"8602","DET","BOS",2015021202,16898,20152016,0,60,2,5,-3,3.49134213162324,3.36719978084464,0.124142350778598,15,34,-19,22,44,-22,37,56,-19,4,4,0,0
"8603","DET","NYR",2015021217,16900,20152016,0,60,2,3,-1,6.5274361639531,3.50988043780671,3.01755572614638,33,20,13,45,33,12,59,40,19,4,2,0,0
"8604","DET","T.B",2015030121,16904,20152016,0,60,2,3,-1,4.29669838330241,2.98645151379606,1.31024686950636,36,34,2,46,46,0,61,56,5,9,9,0,0
"8605","DET","T.B",2015030122,16906,20152016,0,60,2,5,-3,3.30837136578339,4.40902824337172,-1.10065687758834,32,31,1,36,44,-8,51,58,-7,8,9,0,0
"8606","DET","T.B",2015030123,16908,20152016,1,60,2,0,2,4.48245757693076,1.45697866009505,3.02547891683571,30,16,14,45,22,23,63,36,27,10,5,0,0
"8607","DET","T.B",2015030124,16910,20152016,1,60,2,3,-1,3.3646694323761,6.14082669757772,-2.77615726520162,28,33,-5,37,46,-9,52,58,-6,5,6,0,0
"8608","DET","T.B",2015030125,16912,20152016,0,60,0,1,-1,4.17530630449266,4.54558245372027,-0.370276149227607,34,24,10,47,39,8,66,51,15,4,4,0,0
"8609","DET","T.B",2016020009,17087,20162017,0,60,4,6,-2,3.31833235718659,6.62145291393972,-3.30312055675313,32,36,-4,38,54,-16,47,74,-27,5,9,0,0
"8610","DET","OTT",2016020035,17091,20162017,1,60,5,1,4,2.84934634877573,6.20076772806351,-3.35142137928779,25,32,-7,31,44,-13,41,59,-18,6,5,0,0
"8611","DET","NYR",2016020049,17093,20162017,0,60,2,1,1,1.29329391522151,5.79359222182757,-4.50029830660606,18,33,-15,30,54,-24,44,74,-30,4,4,0,0
"8612","DET","S.J",2016020067,17096,20162017,1,60,2,0,2,4.06501127028605,2.9403151832521,1.12469608703395,20,18,2,26,25,1,33,34,-1,3,4,0,0
"8613","DET","CAR",2016020088,17099,20162017,1,60,4,2,2,2.68401788339428,2.91283197726443,-0.228814093870155,25,31,-6,29,38,-9,36,51,-15,3,4,0,0
"8614","DET","BOS",2016020115,17103,20162017,1,60,0,1,-1,3.54093902512977,4.82471145630188,-1.28377243117211,24,36,-12,29,45,-16,43,60,-17,6,6,0,0
"8615","DET","PHI",2016020144,17107,20162017,0,61.6833333333333,3,4,-1,6.3740206103224,6.91845907730749,-0.544438466985085,25,40,-15,38,54,-16,57,69,-12,2,2,0,0
"8616","DET","WPG",2016020159,17109,20162017,1,60,3,5,-2,1.53324139781762,6.90188270729323,-5.36864130947561,33,31,2,37,41,-4,49,50,-1,4,1,0,0
"8617","DET","EDM",2016020174,17111,20162017,1,60,1,2,-1,4.01529702590778,2.37905313192459,1.63624389398319,23,28,-5,30,36,-6,47,44,3,2,2,0,0
"8618","DET","PHI",2016020185,17113,20162017,0,65,2,2,0,6.55545619512122,4.46197935682721,2.09347683829401,35,25,10,51,43,8,70,60,10,3,2,0,0
"8619","DET","VAN",2016020200,17115,20162017,1,60,3,1,2,4.05802805001798,4.81199339987063,-0.753965349852649,27,37,-10,39,44,-5,49,56,-7,4,3,0,0
"8620","DET","MTL",2016020212,17117,20162017,0,60,0,5,-5,4.14341356849026,5.69526233434942,-1.55184876585916,25,37,-12,35,53,-18,59,68,-9,5,4,0,0
"8621","DET","T.B",2016020235,17120,20162017,1,60,3,4,-1,5.53454108290969,3.12305224165902,2.41148884125067,28,22,6,40,32,8,50,38,12,5,4,0,0
"8622","DET","N.J",2016020310,17130,20162017,0,63.3,5,4,1,1.99757819275874,2.38385509874206,-0.386276905983323,33,19,14,39,32,7,49,41,8,3,4,0,0
"8623","DET","MTL",2016020315,17131,20162017,1,63.6166666666667,1,2,-1,5.47760449160705,4.89509444879513,0.582510042811919,33,24,9,46,37,9,58,50,8,4,2,0,0
"8624","DET","DAL",2016020334,17134,20162017,1,60,3,1,2,3.54276137900888,6.46664715814404,-2.92388577913516,20,35,-15,25,47,-22,37,60,-23,5,6,0,0
"8625","DET","PIT",2016020365,17138,20162017,0,60,3,5,-2,2.35370758273348,6.22028867660993,-3.86658109387645,31,37,-6,43,49,-6,56,64,-8,2,2,0,0
"8626","DET","NYI",2016020372,17139,20162017,0,61.0333333333333,4,3,1,3.41660963074828,7.19170421428862,-3.77509458354034,34,35,-1,45,47,-2,61,63,-2,1,2,0,0
"8627","DET","WPG",2016020388,17141,20162017,0,65,3,3,0,6.53326225635101,4.15413999696466,2.37912225938635,30,34,-4,40,40,0,51,55,-4,2,3,0,0
"8628","DET","CBJ",2016020406,17144,20162017,1,60,1,4,-3,3.74380351553555,4.24211304585333,-0.498309530317783,33,25,8,46,33,13,66,43,23,3,0,0,0
"8629","DET","PHI",2016020422,17146,20162017,1,62.7333333333333,0,1,-1,3.08886484200048,4.66725715761487,-1.57839231561439,28,36,-8,37,48,-11,53,60,-7,5,4,0,0
"8630","DET","ARI",2016020436,17148,20162017,1,60,1,4,-3,5.68418563572777,3.6049935631728,2.07919207255497,38,19,19,52,25,27,63,36,27,4,2,0,0
"8631","DET","L.A",2016020448,17150,20162017,1,60,1,4,-3,4.6819117696723,5.24531603523326,-0.563404265560962,18,31,-13,26,46,-20,39,61,-22,6,5,0,0
"8632","DET","ANA",2016020464,17152,20162017,1,60,6,4,2,4.60556535977794,4.74846281868219,-0.142897458904244,32,25,7,50,34,16,56,43,13,3,2,0,0
"8633","DET","CAR",2016020477,17252,20162017,0,61.9833333333333,4,3,1,5.32405041004677,4.21341417351505,1.11063623653172,27,42,-15,38,56,-18,50,75,-25,3,3,0,0
"8634","DET","T.B",2016020486,17155,20162017,0,60,1,4,-3,2.14657918106195,3.94054173292193,-1.79396255185998,27,31,-4,36,42,-6,48,53,-5,6,7,0,0
"8635","DET","TOR",2016020559,17167,20162017,0,63.6666666666667,4,5,-1,7.01064650781336,4.59975482130413,2.41089168650923,37,28,9,47,47,0,62,60,2,3,2,0,0
"8636","DET","ANA",2016020577,17170,20162017,0,60,0,2,-2,5.28669772331341,4.0086608332583,1.27803689005511,23,24,-1,37,41,-4,47,56,-9,4,5,0,0
"8637","DET","L.A",2016020583,17171,20162017,0,60,4,0,4,3.37499667465454,6.84682286833413,-3.47182619367959,22,34,-12,29,50,-21,42,69,-27,2,1,0,0
"8638","DET","S.J",2016020602,17173,20162017,0,60,3,6,-3,5.65370435599471,3.74824136527513,1.90546299071957,35,35,0,50,45,5,64,63,1,1,2,0,0
"8639","DET","CHI",2016020617,17176,20162017,0,60.6333333333333,3,4,-1,6.1457210773151,5.38819234550465,0.757528731810453,36,43,-7,43,50,-7,55,71,-16,2,7,0,0
"8640","DET","DAL",2016020629,17178,20162017,0,60,2,5,-3,4.48266745929141,3.01397134496074,1.46869611433067,33,21,12,53,40,13,77,53,24,5,1,0,0
"8641","DET","PIT",2016020644,17180,20162017,1,60,6,3,3,5.26493765926429,3.17839049647658,2.08654716278771,34,32,2,42,42,0,57,53,4,5,5,0,0
"8642","DET","MTL",2016020658,17182,20162017,1,60,1,0,1,3.31245748422828,2.4477463416988,0.864711142529472,20,18,2,33,27,6,42,41,1,4,1,0,0
"8643","DET","BOS",2016020674,17184,20162017,1,65,5,5,0,4.49299556481856,5.21643263979058,-0.723437074972026,25,33,-8,37,49,-12,44,61,-17,4,2,0,0
"8644","DET","NYR",2016020703,17188,20162017,1,61.9333333333333,0,1,-1,4.08584260160637,1.51111411209649,2.57472848950988,21,19,2,39,30,9,56,41,15,3,4,0,0
"8645","DET","BOS",2016020714,17190,20162017,0,64.2166666666667,3,4,-1,3.90688844164833,6.29274770948894,-2.3858592678406,26,49,-23,35,63,-28,45,78,-33,2,3,0,0
"8646","DET","TOR",2016020724,17191,20162017,1,60,0,4,-4,4.22402212159524,2.4940023305835,1.73001979101174,22,28,-6,34,34,0,46,45,1,2,2,0,0
"8647","DET","N.J",2016020746,17197,20162017,1,60,3,4,-1,4.72148416195705,2.21218826752152,2.50929589443553,30,24,6,43,31,12,59,38,21,5,1,0,0
"8648","DET","NYI",2016020767,17200,20162017,1,60,5,4,1,4.8236551721933,6.71289362400421,-1.88923845181091,24,36,-12,37,49,-12,43,59,-16,2,5,0,0
"8649","DET","CBJ",2016020796,17204,20162017,1,63.3666666666667,2,3,-1,4.6546230243371,3.78629832930164,0.868324695035461,26,27,-1,36,42,-6,41,53,-12,4,4,0,0
"8650","DET","CBJ",2016020820,17208,20162017,0,60,1,2,-1,6.26504350580217,5.06536980927922,1.19967369652295,36,39,-3,52,54,-2,65,68,-3,3,2,0,0
"8651","DET","MIN",2016020829,17209,20162017,0,60,3,6,-3,5.536645955787,6.02763455329114,-0.490988597504135,34,30,4,48,38,10,61,48,13,2,5,0,0
"8652","DET","PIT",2016020870,17216,20162017,0,60,5,2,3,4.38496304949422,3.92975607845437,0.455206971039843,24,26,-2,36,37,-1,46,46,0,6,6,0,0
"8653","DET","NYI",2016020886,17218,20162017,1,60,1,3,-2,4.79548564656807,5.60882096033311,-0.813335313765037,27,22,5,43,37,6,54,46,8,5,3,0,0
"8654","DET","VAN",2016020932,17225,20162017,0,62.5166666666667,3,2,1,2.49793375204899,2.56148253356514,-0.0635487815161468,28,27,1,33,33,0,43,52,-9,4,3,0,0
"8655","DET","EDM",2016020960,17229,20162017,0,60,3,4,-1,3.63235981277669,6.49775802622025,-2.86539821344356,25,38,-13,35,52,-17,50,66,-16,1,2,0,0
"8656","DET","TOR",2016020975,17232,20162017,0,60,2,3,-1,4.60584054638639,3.68923107157138,0.916609474815012,24,28,-4,37,38,-1,48,47,1,2,4,0,0
"8657","DET","BOS",2016020982,17233,20162017,0,60,1,6,-5,2.76286837391879,4.5075327874365,-1.74466441351771,27,29,-2,39,47,-8,50,57,-7,5,4,0,0
"8658","DET","CHI",2016020996,17235,20162017,1,60,4,2,2,4.54535045234966,2.97071059579685,1.57463985655281,29,26,3,39,29,10,51,35,16,4,3,0,0
"8659","DET","NYR",2016021011,17237,20162017,1,60,1,4,-3,4.07212159235496,2.85898183134287,1.21313976101209,24,31,-7,40,36,4,47,43,4,4,2,0,0
"8660","DET","COL",2016021035,17240,20162017,0,60,1,3,-2,4.29637434696087,3.38384176484387,0.912532582117006,28,29,-1,42,40,2,56,61,-5,1,5,0,0
"8661","DET","ARI",2016021046,17241,20162017,0,65,4,4,0,5.73312888694394,5.4226950037496,0.310433883194349,33,26,7,52,44,8,72,57,15,9,5,0,0
"8662","DET","COL",2016021053,17243,20162017,1,60,5,1,4,5.9365884559229,4.74326332448982,1.19332513143308,23,24,-1,37,38,-1,44,48,-4,3,2,0,0
"8663","DET","MTL",2016021079,17246,20162017,0,64.1666666666667,2,1,1,4.93245281570125,6.23964447889011,-1.30719166318886,36,36,0,44,53,-9,57,73,-16,1,3,0,0
"8664","DET","T.B",2016021102,17249,20162017,1,63.4666666666667,1,2,-1,3.80102601148701,4.84757349499586,-1.04654748350885,30,32,-2,37,46,-9,51,55,-4,7,6,0,0
"8665","DET","MIN",2016021119,17251,20162017,1,61.8666666666667,3,2,1,2.07932635759062,4.10055572027341,-2.02122936268279,19,26,-7,28,36,-8,34,51,-17,2,2,0,0
"8666","DET","CAR",2016021129,17253,20162017,0,60,1,4,-3,5.64637137480895,4.99911695721676,0.647254417592194,22,32,-10,37,44,-7,50,59,-9,2,3,0,0
"8667","DET","T.B",2016021145,17255,20162017,0,60,3,5,-2,5.17330850870349,5.66400417888781,-0.490695670184323,34,32,2,54,43,11,62,50,12,3,3,0,0
"8668","DET","TOR",2016021159,17257,20162017,1,60,4,5,-1,5.13393703665497,2.33385149808601,2.80008553856896,42,27,15,52,34,18,62,49,13,2,2,0,0
"8669","DET","MTL",2016021212,17264,20162017,1,61.7,2,3,-1,2.01160189275106,2.32499065890443,-0.313388766153366,27,30,-3,36,35,1,44,48,-4,0,1,0,0
"8670","DET","N.J",2016021221,17265,20162017,1,60,4,1,3,3.57146329055627,5.48106279096828,-1.90959950041201,35,25,10,38,37,1,46,50,-4,3,3,0,0
"8671","DET","MIN",2017020009,17444,20172018,1,60,4,2,2,4.07590954020327,4.14160282874047,-0.0656932885372044,31,39,-8,44,49,-5,54,60,-6,5,4,0,0
"8672","DET","DAL",2017020043,17449,20172018,0,60,2,4,-2,3.63900972729846,7.42545302666258,-3.78644329936412,25,33,-8,39,56,-17,56,74,-18,5,4,0,0
"8673","DET","ARI",2017020056,17451,20172018,0,60,4,2,2,7.79606375037426,3.91199697690899,3.88406677346526,33,35,-2,46,47,-1,52,64,-12,3,6,0,0
"8674","DET","VGK",2017020062,17452,20172018,0,60,6,3,3,4.67685186478775,3.60558960778872,1.07126225699903,27,27,0,36,45,-9,46,55,-9,2,4,0,0
"8675","DET","T.B",2017020080,17455,20172018,1,60,2,3,-1,3.47618381384001,4.40128647969604,-0.925102665856031,31,26,5,44,34,10,54,40,14,7,5,0,0
"8676","DET","TOR",2017020092,17457,20172018,0,60,3,6,-3,5.32671890713391,3.97306370778824,1.35365519934567,33,26,7,44,34,10,56,38,18,4,3,0,0
"8677","DET","VAN",2017020122,17461,20172018,1,60,1,4,-3,5.17778899794198,5.23732903034409,-0.059540032402106,21,37,-16,37,46,-9,49,56,-7,1,2,0,0
"8678","DET","T.B",2017020144,17465,20172018,0,60,2,3,-1,2.95897412644331,5.80613003784674,-2.84715591140343,31,38,-7,37,55,-18,46,69,-23,6,7,0,0
"8679","DET","ARI",2017020179,17470,20172018,1,60,5,3,2,4.93562964174841,4.87379363176569,0.0618360099827218,40,33,7,55,43,12,65,56,9,1,2,0,0
"8680","DET","EDM",2017020213,17475,20172018,0,60,4,0,4,6.2672926780437,6.96312115900218,-0.695828480958482,35,36,-1,48,54,-6,56,74,-18,2,2,0,0
"8681","DET","VAN",2017020222,17476,20172018,0,60,3,2,1,4.94584724622837,3.27357997710351,1.67226726912486,30,28,2,43,36,7,52,55,-3,3,3,0,0
"8682","DET","CBJ",2017020253,17481,20172018,1,65,1,1,0,3.54835677022788,7.59477303780659,-4.04641626757871,33,32,1,40,46,-6,53,56,-3,0,3,0,0
"8683","DET","COL",2017020306,17489,20172018,1,62.9166666666667,3,4,-1,2.74540626388359,5.00420211365054,-2.25879584976694,24,37,-13,34,48,-14,45,62,-17,3,6,0,0
"8684","DET","EDM",2017020320,17492,20172018,1,60,2,6,-4,2.42892883762761,3.36308064276818,-0.934151805140573,22,28,-6,33,35,-2,48,45,3,2,1,0,0
"8685","DET","NYR",2017020341,17494,20172018,0,60.6166666666667,1,2,-1,5.58720574112249,2.93361627752893,2.65358946359357,41,31,10,61,42,19,76,65,11,4,2,0,0
"8686","DET","N.J",2017020351,17495,20172018,1,62.5333333333333,3,4,-1,5.06880182184182,3.59209928204655,1.47670253979527,34,32,2,39,38,1,49,47,2,2,3,0,0
"8687","DET","L.A",2017020372,17498,20172018,1,60,1,4,-3,3.75324463049891,4.02112489036517,-0.267880259866266,24,36,-12,33,45,-12,42,52,-10,3,4,0,0
"8688","DET","MTL",2017020382,17500,20172018,1,60,3,6,-3,4.68863969446145,3.70432119312864,0.984318501332812,31,25,6,42,28,14,57,41,16,4,4,0,0
"8689","DET","MTL",2017020398,17502,20172018,0,60,1,10,-9,6.04934795189263,2.77773540775524,3.27161254413738,23,34,-11,34,39,-5,48,54,-6,2,3,0,0
"8690","DET","WPG",2017020419,17505,20172018,1,60,5,1,4,5.51919195286478,3.4709962427186,2.04819571014618,32,26,6,50,42,8,61,54,7,6,6,0,0
"8691","DET","BOS",2017020477,17513,20172018,1,60.5833333333333,2,3,-1,4.20416891453564,6.67104027594905,-2.46687136141342,33,32,1,39,40,-1,47,60,-13,3,3,0,0
"8692","DET","TOR",2017020494,17515,20172018,1,60,3,1,2,2.68277423359905,2.9051920673428,-0.222417833743748,29,26,3,46,45,1,52,59,-7,4,3,0,0
"8693","DET","NYI",2017020518,17519,20172018,0,60,6,3,3,5.2403023664765,5.40030555140766,-0.160003184931156,22,37,-15,41,41,0,59,51,8,1,3,0,0
"8694","DET","PHI",2017020527,17520,20172018,0,60,3,4,-1,2.76926162255404,3.49294162009028,-0.723679997536237,28,31,-3,35,39,-4,50,65,-15,3,2,0,0
"8695","DET","BOS",2017020543,17523,20172018,0,60,1,3,-2,2.7883049644297,4.46692563926217,-1.67862067483247,31,26,5,42,36,6,54,52,2,2,2,0,0
"8696","DET","N.J",2017020559,17527,20172018,0,60,1,3,-2,3.55569329884987,4.79076311194446,-1.2350698130946,32,32,0,48,40,8,57,53,4,5,2,0,0
"8697","DET","NYR",2017020578,17529,20172018,1,65,2,2,0,4.41538933731499,7.76639141885437,-3.35100208153938,35,39,-4,41,50,-9,49,62,-13,5,5,0,0
"8698","DET","PIT",2017020595,17531,20172018,1,60,4,1,3,4.69244839416933,5.28780663006182,-0.59535823589249,23,38,-15,34,49,-15,43,61,-18,1,2,0,0
"8699","DET","T.B",2017020649,17538,20172018,1,60,2,5,-3,5.88771586306393,3.62909175502136,2.25862410804257,36,24,12,52,33,19,68,46,22,5,1,0,0
"8700","DET","PIT",2017020671,17544,20172018,0,60,1,4,-3,2.3205269773091,4.16424048718244,-1.84371350987334,30,36,-6,41,52,-11,55,68,-13,7,5,0,0
"8701","DET","CHI",2017020681,17545,20172018,0,60,4,0,4,4.70074377168203,2.70718181475248,1.99356195692955,26,27,-1,35,41,-6,51,67,-16,4,3,0,0
"8702","DET","DAL",2017020690,17547,20172018,1,60,2,4,-2,1.56395344590055,4.20380729913131,-2.63985385323076,15,26,-11,23,36,-13,45,51,-6,3,3,0,0
"8703","DET","CAR",2017020714,17551,20172018,1,60,1,3,-2,3.10337102477206,5.28208628666471,-2.17871526189265,24,30,-6,41,42,-1,52,57,-5,2,3,0,0
"8704","DET","N.J",2017020727,17553,20172018,0,60,3,0,3,6.06131506734528,3.93865884339448,2.1226562239508,30,37,-7,42,51,-9,49,64,-15,2,5,0,0
"8705","DET","PHI",2017020735,17554,20172018,1,60.45,2,3,-1,3.92824843908602,5.21272951595824,-1.28448107687223,21,31,-10,35,46,-11,52,53,-1,2,2,0,0
"8706","DET","CHI",2017020751,17556,20172018,1,60,1,5,-4,2.59411559186879,3.60912307383842,-1.01500748196963,24,28,-4,42,42,0,58,61,-3,1,2,0,0
"8707","DET","S.J",2017020774,17562,20172018,1,65,1,1,0,6.55828265467545,4.59668410714869,1.96159854752676,44,31,13,54,49,5,67,62,5,3,2,0,0
"8708","DET","CAR",2017020789,17564,20172018,0,60,4,1,3,6.39363601640798,4.45853566310836,1.93510035329962,38,37,1,50,50,0,62,68,-6,3,2,0,0
"8709","DET","BOS",2017020817,17568,20172018,1,60,2,3,-1,4.92567631543086,3.01273180686235,1.91294450856851,28,31,-3,37,40,-3,50,55,-5,3,3,0,0
"8710","DET","NYI",2017020835,17571,20172018,0,63.25,6,7,-1,7.10495094256461,6.0081423620577,1.09680858050692,39,29,10,48,41,7,63,52,11,2,2,0,0
"8711","DET","ANA",2017020870,17575,20172018,1,60,2,1,1,3.56412225995825,5.61687539855484,-2.05275313859659,16,33,-17,28,46,-18,42,66,-24,2,4,0,0
"8712","DET","T.B",2017020883,17577,20172018,0,60,1,4,-3,4.69429814963223,3.55209451382906,1.14220363580317,39,32,7,46,46,0,55,62,-7,3,4,0,0
"8713","DET","TOR",2017020909,17580,20172018,1,60,2,3,-1,3.7482510318514,4.48138158233492,-0.733130550483523,29,34,-5,41,47,-6,47,60,-13,1,2,0,0
"8714","DET","CAR",2017020950,17586,20172018,1,60,3,1,2,1.9524155932015,3.78390051554015,-1.83148492233865,22,29,-7,34,39,-5,43,70,-27,4,4,0,0
"8715","DET","NYR",2017020960,17587,20172018,0,64.9,3,2,1,6.1644486477453,5.10894582749461,1.05550282025069,34,38,-4,46,58,-12,61,75,-14,3,2,0,0
"8716","DET","WPG",2017020994,17592,20172018,0,60,3,4,-1,6.40267322762071,7.64192314192769,-1.23924991430698,33,42,-9,43,59,-16,53,80,-27,1,3,0,0
"8717","DET","MIN",2017021013,17594,20172018,0,60,1,4,-3,3.0503888425792,4.81202513648896,-1.76163629390976,29,27,2,42,41,1,54,56,-2,3,4,0,0
"8718","DET","BOS",2017021020,17596,20172018,0,60.5666666666667,5,6,-1,3.18497140501972,4.52050603143875,-1.33553462641903,35,37,-2,47,49,-2,62,61,1,6,5,0,0
"8719","DET","VGK",2017021036,17598,20172018,1,60,0,4,-4,3.86311861744048,3.34227462191484,0.520843995525638,28,32,-4,44,43,1,52,53,-1,3,4,0,0
"8720","DET","CBJ",2017021044,17599,20172018,0,60,2,3,-1,2.83088213101323,5.44771572438185,-2.61683359336862,24,36,-12,34,46,-12,47,60,-13,2,2,0,0
"8721","DET","S.J",2017021070,17602,20172018,0,60,3,5,-2,2.94614290903883,5.42476873843749,-2.47862582939866,26,34,-8,35,49,-14,48,60,-12,2,3,0,0
"8722","DET","L.A",2017021091,17605,20172018,0,60,1,4,-3,2.45636774052018,5.22291170164873,-2.76654396112855,21,22,-1,32,35,-3,46,48,-2,3,5,0,0
"8723","DET","ANA",2017021096,17606,20172018,0,60,2,4,-2,3.27166929020314,2.73500492605831,0.536664364144826,30,36,-6,49,49,0,62,60,2,5,2,0,0
"8724","DET","COL",2017021108,17608,20172018,0,60,1,5,-4,3.85711505531644,3.71732398628956,0.139791069026878,38,31,7,48,41,7,65,55,10,3,4,0,0
"8725","DET","PHI",2017021126,17610,20172018,1,65,4,4,0,0,0,0,31,31,0,40,46,-6,52,71,-19,1,4,0,0
"8726","DET","TOR",2017021153,17614,20172018,0,60,3,4,-1,4.64769938915158,4.50632192622288,0.141377462928702,41,29,12,54,46,8,65,65,0,1,4,0,0
"8727","DET","MTL",2017021172,17616,20172018,0,60,2,4,-2,3.23244435840752,5.88027078291634,-2.64782642450882,28,31,-3,38,44,-6,53,64,-11,3,5,0,0
"8728","DET","PIT",2017021179,17617,20172018,1,60,5,2,3,4.58283928599468,3.41726193844806,1.16557734754662,26,24,2,39,34,5,48,59,-11,2,2,0,0
"8729","DET","CBJ",2017021231,17624,20172018,0,62.9166666666667,4,5,-1,3.97541752621109,5.74777529538551,-1.77235776917442,27,41,-14,35,56,-21,48,70,-22,3,5,0,0
"8730","DET","MTL",2017021246,17626,20172018,1,60,3,4,-1,2.48330542305484,4.28700549752102,-1.80370007446618,26,28,-2,35,37,-2,43,49,-6,3,1,0,0
"8731","DET","NYI",2017021260,17628,20172018,1,63.2666666666667,3,4,-1,6.57193415699294,9.65064499127948,-3.07871083428654,39,40,-1,51,56,-5,70,68,2,1,2,0,0
"8732","DET","CBJ",2018020010,17808,20182019,1,62.1833333333333,2,3,-1,2.95568564834684,5.15744251082651,-2.20175686247967,20,39,-19,28,56,-28,45,76,-31,3,6,0,0
"8733","DET","L.A",2018020031,17811,20182019,0,60,2,4,-2,4.5083335408126,3.40592044906225,1.10241309175035,38,25,13,55,33,22,73,47,26,6,4,0,0
"8734","DET","ANA",2018020035,17812,20182019,0,65,2,2,0,4.53555473725817,5.73738946665484,-1.20183472939667,21,27,-6,44,47,-3,58,59,-1,2,3,0,0
"8735","DET","TOR",2018020052,17815,20182019,1,60,3,5,-2,4.22431320526823,4.86539767332525,-0.641084468057016,29,35,-6,46,47,-1,57,54,3,4,5,0,0
"8736","DET","BOS",2018020061,17817,20182019,0,60,2,8,-6,2.94758286087708,4.11232299230684,-1.16474013142976,34,39,-5,41,51,-10,50,63,-13,7,7,0,0
"8737","DET","MTL",2018020075,17819,20182019,0,60,3,7,-4,2.72072520980146,7.61766853230073,-4.89694332249927,28,35,-7,46,40,6,66,60,6,3,7,0,0
"8738","DET","T.B",2018020093,17822,20182019,0,60,1,3,-2,1.69097496921057,6.1784794087507,-4.48750443954013,30,31,-1,37,46,-9,52,65,-13,6,5,0,0
"8739","DET","CAR",2018020119,17826,20182019,1,60,1,3,-2,3.71823045272322,4.96092634258093,-1.24269588985771,21,39,-18,30,51,-21,42,69,-27,4,3,0,0
"8740","DET","WPG",2018020145,17830,20182019,1,60,1,2,-1,2.39988808317804,6.22744055443764,-3.82755247125959,28,40,-12,41,54,-13,55,70,-15,3,5,0,0
"8741","DET","DAL",2018020160,17832,20182019,1,60,4,2,2,4.49890784209128,4.98927019264386,-0.490362350552573,23,30,-7,36,33,3,46,41,5,3,1,0,0
"8742","DET","CBJ",2018020170,17834,20182019,0,60,5,3,2,5.42793233297584,3.50298331215099,1.92494902082485,32,37,-5,47,56,-9,55,74,-19,2,5,0,0
"8743","DET","N.J",2018020184,17836,20182019,1,60,4,3,1,5.29304825076099,4.58353779884055,0.709510451920437,31,28,3,41,45,-4,58,56,2,5,5,0,0
"8744","DET","EDM",2018020197,17838,20182019,1,60,3,4,-1,2.26206280500628,4.25788514269344,-1.99582233768716,26,42,-16,36,56,-20,47,64,-17,2,1,0,0
"8745","DET","VAN",2018020219,17841,20182019,1,65,2,2,0,3.58319936095005,5.31943854840938,-1.73623918745933,30,42,-12,42,56,-14,57,67,-10,2,3,0,0
"8746","DET","NYR",2018020238,17844,20182019,1,64.9,3,2,1,2.76000618451924,4.82418429841346,-2.06417811389422,31,30,1,47,45,2,62,49,13,2,3,0,0
"8747","DET","CAR",2018020250,17845,20182019,0,65,3,3,0,6.15577985128039,7.85341386368964,-1.69763401240925,32,52,-20,42,72,-30,54,92,-38,2,5,0,0
"8748","DET","ARI",2018020268,17848,20182019,1,60,6,1,5,3.60992984427139,3.46282294657431,0.147106897697086,26,25,1,32,45,-13,44,64,-20,5,6,0,0
"8749","DET","N.J",2018020292,17852,20182019,0,64.15,3,2,1,6.75070297264028,5.46320035954705,1.28750261309324,30,40,-10,42,57,-15,55,73,-18,4,2,0,0
"8750","DET","BOS",2018020324,17856,20182019,1,60.8166666666667,3,2,1,3.19555298710071,7.75600272079464,-4.56044973369393,27,36,-9,37,45,-8,43,56,-13,0,1,0,0
"8751","DET","CBJ",2018020366,17861,20182019,1,60,5,7,-2,3.92680592248622,4.6728768358004,-0.746070913314184,32,32,0,40,42,-2,45,48,-3,3,4,0,0
"8752","DET","BOS",2018020397,17866,20182019,0,60,4,2,2,3.60966760428946,5.83143158198982,-2.22176397770036,27,40,-13,39,51,-12,48,67,-19,5,7,0,0
"8753","DET","COL",2018020410,17867,20182019,1,60,0,2,-2,2.81527161192935,7.87267308144146,-5.05740146951211,24,29,-5,29,36,-7,45,45,0,2,1,0,0
"8754","DET","T.B",2018020422,17869,20182019,1,65,5,5,0,3.35509188543074,6.29439087748415,-2.93929899205341,24,35,-11,31,57,-26,41,68,-27,3,3,0,0
"8755","DET","TOR",2018020429,17871,20182019,0,62.8,5,4,1,5.73898931183794,5.54719223629218,0.191797075545765,32,31,1,48,52,-4,60,82,-22,2,4,0,0
"8756","DET","NYI",2018020448,17873,20182019,1,60,2,3,-1,4.01101840343622,4.02483316080179,-0.0138147573655738,25,19,6,36,29,7,47,43,4,4,5,0,0
"8757","DET","L.A",2018020462,17875,20182019,1,60,3,1,2,2.6002305546614,5.14746628438648,-2.54723572972508,21,43,-22,35,63,-28,43,81,-38,1,1,0,0
"8758","DET","NYI",2018020498,17880,20182019,0,65,3,3,0,4.07647601334838,5.71925236075185,-1.64277634740347,21,48,-27,25,59,-34,37,71,-34,1,6,0,0
"8759","DET","PHI",2018020520,17883,20182019,0,60,2,3,-1,3.68817624845542,5.65425015714573,-1.9660739086903,22,33,-11,33,46,-13,51,59,-8,3,2,0,0
"8760","DET","CAR",2018020534,17885,20182019,0,60,4,1,3,7.49189844632929,6.30713029635081,1.18476814997848,24,39,-15,33,63,-30,38,80,-42,1,2,0,0
"8761","DET","TOR",2018020563,17888,20182019,0,61.8833333333333,4,5,-1,3.78047055989737,5.05218191051245,-1.27171135061508,30,24,6,44,44,0,52,53,-1,3,2,0,0
"8762","DET","PIT",2018020569,17892,20182019,0,60,2,5,-3,6.13092949497513,5.21067137013911,0.920258124836021,29,40,-11,37,52,-15,50,66,-16,1,3,0,0
"8763","DET","DAL",2018020594,17894,20182019,0,60,1,5,-4,3.8381273575942,5.5420662292081,-1.7039388716139,34,42,-8,40,51,-11,62,70,-8,4,2,0,0
"8764","DET","MTL",2018020662,17904,20182019,1,60,2,3,-1,5.2120903717182,3.18121827605864,2.03087209565956,32,25,7,44,33,11,63,42,21,5,2,0,0
"8765","DET","WPG",2018020684,17907,20182019,0,60,2,4,-2,5.7460655735922,5.04321241356956,0.702853160022642,35,27,8,51,32,19,71,41,30,4,3,0,0
"8766","DET","MIN",2018020693,17908,20182019,0,60,5,2,3,4.6486739784068,2.43297654320108,2.21569743520573,37,18,19,45,27,18,61,35,26,4,3,0,0
"8767","DET","ANA",2018020715,17911,20182019,1,60,3,1,2,3.60373329254799,1.67094489890223,1.93278839364575,25,24,1,39,32,7,52,40,12,0,2,0,0
"8768","DET","EDM",2018020764,17918,20182019,0,60,3,2,1,4.21265678037889,4.03407252910517,0.178584251273727,27,34,-7,37,43,-6,45,59,-14,3,3,0,0
"8769","DET","TOR",2018020786,17928,20182019,1,62.6833333333333,3,2,1,4.943450835524,3.72319616636202,1.22025466916199,33,21,12,41,32,9,49,45,4,4,5,0,0
"8770","DET","VGK",2018020830,17934,20182019,1,60,3,4,-1,6.14742561539424,7.37169244387769,-1.22426682848345,39,32,7,52,44,8,69,52,17,4,2,0,0
"8771","DET","CHI",2018020857,17937,20182019,0,60,2,5,-3,6.17923200553103,4.64437934447778,1.53485266105325,45,36,9,57,42,15,77,58,19,2,2,0,0
"8772","DET","PHI",2018020892,17943,20182019,0,61.45,5,6,-1,4.37550382827877,2.7309104136358,1.64459341464297,38,32,6,44,41,3,60,59,1,2,3,0,0
"8773","DET","PHI",2018020907,17944,20182019,1,60,1,3,-2,3.30632283563318,4.8679235074087,-1.56160067177552,38,23,15,54,32,22,74,48,26,2,1,0,0
"8774","DET","CHI",2018020925,17947,20182019,1,62.7,4,5,-1,4.94789090598351,1.7068547620438,3.24103614393971,35,20,15,45,25,20,51,37,14,4,1,0,0
"8775","DET","MIN",2018020941,17949,20182019,1,60,2,3,-1,4.54883962984726,4.27579178429005,0.273047845557208,28,35,-7,37,40,-3,51,47,4,2,3,0,0
"8776","DET","S.J",2018020957,17951,20182019,1,60,3,5,-2,1.58673564925266,5.58561558250608,-3.99887993325342,23,37,-14,26,46,-20,35,63,-28,2,3,0,0
"8777","DET","MTL",2018020974,17953,20182019,1,60,1,8,-7,4.11621636521886,7.43460893659441,-3.31839257137555,29,34,-5,45,46,-1,62,57,5,6,1,0,0
"8778","DET","ARI",2018021007,17957,20182019,0,60,1,3,-2,5.68735433812253,9.30940136572463,-3.62204702760209,23,44,-21,35,63,-28,55,73,-18,2,4,0,0
"8779","DET","COL",2018021026,17960,20182019,0,62.4833333333333,3,4,-1,3.59966442611767,5.1610546346139,-1.56139020849623,23,34,-11,30,41,-11,48,54,-6,3,3,0,0
"8780","DET","NYR",2018021036,17962,20182019,1,65,2,2,0,5.52162653740379,2.34940925704164,3.17221728036215,45,34,11,65,41,24,84,50,34,4,2,0,0
"8781","DET","T.B",2018021051,17964,20182019,0,60,2,3,-1,2.28734957455612,5.82556607056087,-3.53821649600475,24,33,-9,33,47,-14,43,59,-16,6,4,0,0
"8782","DET","MTL",2018021075,17967,20182019,0,60,1,3,-2,2.28646629711147,8.48291953100467,-6.19645323389319,21,36,-15,31,58,-27,42,82,-40,2,2,0,0
"8783","DET","T.B",2018021087,17969,20182019,1,60,4,5,-1,5.16018962248563,5.60742708825273,-0.447237465767103,27,39,-12,35,58,-23,50,76,-26,3,3,0,0
"8784","DET","NYI",2018021100,17971,20182019,1,60,2,1,1,3.55433725223338,4.8867302616145,-1.33239300938112,22,42,-20,31,58,-27,40,66,-26,3,2,0,0
"8785","DET","NYR",2018021124,17974,20182019,0,60,3,2,1,5.86538675349919,5.19985292712227,0.665533826376926,30,43,-13,38,59,-21,48,76,-28,1,3,0,0
"8786","DET","VGK",2018021162,17978,20182019,0,60.3166666666667,3,2,1,2.0239072645487,3.6271281912741,-1.6032209267254,30,30,0,36,43,-7,49,58,-9,2,3,0,0
"8787","DET","S.J",2018021177,17980,20182019,0,60,3,2,1,4.26981243394505,9.34542347391834,-5.0756110399733,23,41,-18,32,62,-30,43,87,-44,1,4,0,0
"8788","DET","N.J",2018021199,17984,20182019,1,60,4,0,4,5.20355014789675,4.07596485397439,1.12758529392236,33,28,5,42,40,2,55,49,6,1,1,0,0
"8789","DET","BOS",2018021219,17986,20182019,1,60,6,3,3,6.03480140925725,4.27574649252934,1.75905491672791,28,34,-6,35,48,-13,51,62,-11,5,4,0,0
"8790","DET","PIT",2018021233,17988,20182019,1,60,4,1,3,4.7960183700895,4.15772074693814,0.63829762315136,26,39,-13,39,51,-12,49,69,-20,1,2,0,0
"8791","DET","PIT",2018021245,17990,20182019,0,60,1,4,-3,4.22377724322655,4.62066146982124,-0.396884226594693,34,47,-13,50,57,-7,63,75,-12,3,5,0,0
"8792","EDM","COL",2008020029,14164,20082009,1,60,3,2,1,0,0,0,19,33,-14,29,48,-19,41,60,-19,3,4,0,0
"8793","EDM","ANA",2008020048,14167,20082009,0,60,3,2,1,0,0,0,28,35,-7,41,49,-8,47,61,-14,4,2,0,0
"8794","EDM","CGY",2008020060,14169,20082009,0,60,4,3,1,0,0,0,35,29,6,46,43,3,61,52,9,7,4,0,0
"8795","EDM","CGY",2008020074,14170,20082009,1,60,3,2,1,0,0,0,27,33,-6,38,49,-11,48,76,-28,5,8,0,0
"8796","EDM","CHI",2008020091,14174,20082009,0,60,0,3,-3,0,0,0,23,30,-7,28,37,-9,39,50,-11,5,4,0,0
"8797","EDM","COL",2008020097,14175,20082009,0,60,1,4,-3,0,0,0,26,25,1,34,32,2,58,42,16,4,6,0,0
"8798","EDM","VAN",2008020118,14177,20082009,0,60,3,6,-3,0,0,0,28,30,-2,42,42,0,54,52,2,5,7,0,0
"8799","EDM","BOS",2008020124,14179,20082009,1,63.3,0,1,-1,0,0,0,27,36,-9,39,48,-9,57,64,-7,3,5,0,0
"8800","EDM","NSH",2008020140,14182,20082009,0,60,1,3,-2,0,0,0,28,25,3,44,35,9,57,44,13,4,3,0,0
"8801","EDM","CAR",2008020150,14184,20082009,0,60,3,1,2,0,0,0,32,34,-2,41,48,-7,58,61,-3,3,6,0,0
"8802","EDM","PHI",2008020162,14185,20082009,0,60,5,4,1,0,0,0,28,26,2,39,33,6,53,48,5,7,6,0,0
"8803","EDM","CBJ",2008020179,14188,20082009,0,60,4,5,-1,0,0,0,26,38,-12,40,48,-8,54,65,-11,6,7,0,0
"8804","EDM","PIT",2008020186,14189,20082009,0,60,4,5,-1,0,0,0,31,34,-3,42,50,-8,54,72,-18,6,7,0,0
"8805","EDM","N.J",2008020209,14192,20082009,0,60,2,1,1,0,0,0,28,38,-10,31,57,-26,42,68,-26,3,2,0,0
"8806","EDM","NYR",2008020213,14193,20082009,0,65,2,2,0,0,0,0,31,42,-11,41,58,-17,51,68,-17,5,6,0,0
"8807","EDM","TOR",2008020234,14196,20082009,1,60,2,5,-3,0,0,0,25,28,-3,37,32,5,49,40,9,4,4,0,0
"8808","EDM","COL",2008020250,14198,20082009,1,65,2,2,0,0,0,0,35,32,3,49,40,9,69,46,23,4,4,0,0
"8809","EDM","DET",2008020260,14200,20082009,0,60,0,4,-4,0,0,0,21,41,-20,32,56,-24,45,67,-22,5,5,0,0
"8810","EDM","CBJ",2008020264,14201,20082009,0,60,7,2,5,0,0,0,19,39,-20,25,52,-27,38,70,-32,3,7,0,0
"8811","EDM","DET",2008020277,14203,20082009,1,60,3,4,-1,0,0,0,34,35,-1,53,51,2,64,64,0,6,6,0,0
"8812","EDM","L.A",2008020319,14209,20082009,1,60,1,2,-1,0,0,0,23,29,-6,35,38,-3,50,61,-11,5,3,0,0
"8813","EDM","STL",2008020334,14212,20082009,0,60,4,2,2,0,0,0,22,29,-7,38,38,0,48,43,5,5,5,0,0
"8814","EDM","DAL",2008020348,14213,20082009,0,60,3,4,-1,0,0,0,28,26,2,41,37,4,54,49,5,3,5,0,0
"8815","EDM","DAL",2008020365,14216,20082009,1,60,5,2,3,0,0,0,22,25,-3,29,38,-9,42,52,-10,5,4,0,0
"8816","EDM","L.A",2008020379,14218,20082009,0,65,4,4,0,0,0,0,44,36,8,57,50,7,71,61,10,4,4,0,0
"8817","EDM","S.J",2008020390,14219,20082009,0,62.6666666666667,3,2,1,0,0,0,17,43,-26,26,57,-31,40,72,-32,5,3,0,0
"8818","EDM","FLA",2008020418,14224,20082009,1,60,0,2,-2,0,0,0,41,16,25,51,24,27,66,34,32,3,1,0,0
"8819","EDM","VAN",2008020439,14226,20082009,1,60,3,0,3,0,0,0,29,23,6,43,34,9,56,47,9,10,6,0,0
"8820","EDM","CHI",2008020453,14229,20082009,1,60,2,9,-7,0,0,0,33,44,-11,45,61,-16,57,79,-22,3,5,0,0
"8821","EDM","VAN",2008020458,14230,20082009,0,60,2,4,-2,0,0,0,24,28,-4,35,36,-1,52,47,5,7,7,0,0
"8822","EDM","ANA",2008020473,14232,20082009,1,65,2,2,0,0,0,0,53,36,17,63,48,15,75,59,16,11,10,0,0
"8823","EDM","ARI",2008020492,14235,20082009,1,60,4,2,2,0,0,0,27,29,-2,44,39,5,52,45,7,9,7,0,0
"8824","EDM","VAN",2008020514,14239,20082009,0,60,3,2,1,0,0,0,23,28,-5,34,43,-9,50,55,-5,5,5,0,0
"8825","EDM","NSH",2008020531,14241,20082009,1,60,5,2,3,0,0,0,33,30,3,47,44,3,55,56,-1,4,1,0,0
"8826","EDM","OTT",2008020545,14243,20082009,1,60,2,3,-1,0,0,0,22,25,-3,35,37,-2,51,46,5,1,3,0,0
"8827","EDM","CGY",2008020553,14244,20082009,0,60,4,6,-2,0,0,0,32,37,-5,45,50,-5,55,69,-14,5,5,0,0
"8828","EDM","DAL",2008020573,14247,20082009,1,60,4,1,3,0,0,0,19,39,-20,34,60,-26,41,83,-42,5,6,0,0
"8829","EDM","NYI",2008020584,14249,20082009,1,60,3,2,1,0,0,0,26,27,-1,41,38,3,60,44,16,3,2,0,0
"8830","EDM","VAN",2008020597,14251,20082009,1,60,2,4,-2,0,0,0,25,22,3,37,32,5,52,51,1,4,4,0,0
"8831","EDM","S.J",2008020611,14253,20082009,1,60,1,4,-3,0,0,0,26,31,-5,35,46,-11,47,54,-7,7,5,0,0
"8832","EDM","STL",2008020627,14255,20082009,1,60,2,1,1,0,0,0,28,22,6,38,38,0,49,52,-3,5,5,0,0
"8833","EDM","WSH",2008020634,14257,20082009,0,60,5,2,3,0,0,0,23,36,-13,34,55,-21,48,73,-25,5,5,0,0
"8834","EDM","MIN",2008020650,14259,20082009,0,60,1,5,-4,0,0,0,21,24,-3,32,36,-4,44,46,-2,5,7,0,0
"8835","EDM","COL",2008020661,14260,20082009,0,60,3,2,1,0,0,0,37,39,-2,48,59,-11,66,74,-8,4,3,0,0
"8836","EDM","ARI",2008020675,14262,20082009,1,60,6,3,3,0,0,0,29,28,1,43,39,4,58,48,10,3,1,0,0
"8837","EDM","CBJ",2008020689,14264,20082009,1,60,4,3,1,0,0,0,22,23,-1,32,34,-2,42,52,-10,3,3,0,0
"8838","EDM","BUF",2008020710,14271,20082009,1,60,2,10,-8,0,0,0,38,37,1,56,44,12,77,51,26,8,6,0,0
"8839","EDM","MIN",2008020729,14274,20082009,1,60,3,1,2,0,0,0,28,30,-2,36,36,0,48,55,-7,5,3,0,0
"8840","EDM","NSH",2008020744,14276,20082009,1,60,1,2,-1,0,0,0,33,29,4,47,38,9,61,48,13,3,2,0,0
"8841","EDM","CHI",2008020757,14278,20082009,1,60,1,3,-2,0,0,0,21,41,-20,32,55,-23,46,69,-23,3,1,0,0
"8842","EDM","STL",2008020768,14280,20082009,0,65,1,1,0,0,0,0,23,34,-11,36,53,-17,49,62,-13,3,4,0,0
"8843","EDM","DET",2008020778,14282,20082009,0,60,3,8,-5,0,0,0,26,35,-9,35,45,-10,38,55,-17,3,5,0,0
"8844","EDM","MIN",2008020791,14283,20082009,0,65,2,2,0,0,0,0,30,39,-9,38,56,-18,52,62,-10,6,3,0,0
"8845","EDM","MTL",2008020809,14286,20082009,1,60,7,2,5,0,0,0,27,38,-11,29,47,-18,37,58,-21,7,6,0,0
"8846","EDM","L.A",2008020826,14289,20082009,0,65,2,2,0,0,0,0,21,41,-20,37,57,-20,45,69,-24,9,9,0,0
"8847","EDM","ARI",2008020845,14291,20082009,0,60,3,1,2,0,0,0,29,29,0,42,44,-2,51,59,-8,4,6,0,0
"8848","EDM","S.J",2008020853,14292,20082009,0,60,2,4,-2,0,0,0,26,31,-5,37,38,-1,54,46,8,10,8,0,0
"8849","EDM","DAL",2008020868,14294,20082009,0,60,2,4,-2,0,0,0,23,25,-2,31,38,-7,41,48,-7,10,10,0,0
"8850","EDM","CGY",2008020886,14296,20082009,1,65,2,2,0,0,0,0,28,32,-4,33,45,-12,38,64,-26,6,4,0,0
"8851","EDM","T.B",2008020903,14299,20082009,1,60,5,3,2,0,0,0,45,29,16,57,33,24,73,45,28,8,5,0,0
"8852","EDM","CBJ",2008020917,14301,20082009,1,60,0,1,-1,0,0,0,19,32,-13,25,48,-23,32,64,-32,3,5,0,0
"8853","EDM","MIN",2008020933,14303,20082009,1,60,3,2,1,0,0,0,30,45,-15,40,57,-17,53,73,-20,4,6,0,0
"8854","EDM","NSH",2008020948,14306,20082009,0,62.5166666666667,5,6,-1,0,0,0,28,43,-15,38,55,-17,51,64,-13,3,4,0,0
"8855","EDM","OTT",2008020959,14308,20082009,0,60,2,4,-2,0,0,0,26,32,-6,35,42,-7,43,57,-14,4,4,0,0
"8856","EDM","TOR",2008020972,14310,20082009,0,60,4,1,3,0,0,0,18,40,-22,26,51,-25,37,64,-27,5,5,0,0
"8857","EDM","MTL",2008020993,14313,20082009,0,61.6666666666667,3,4,-1,0,0,0,32,26,6,36,45,-9,51,58,-7,3,3,0,0
"8858","EDM","ATL",2008021015,14315,20082009,1,64.1666666666667,3,4,-1,0,0,0,32,33,-1,43,41,2,63,52,11,6,6,0,0
"8859","EDM","COL",2008021028,14317,20082009,1,60.7,2,3,-1,0,0,0,20,30,-10,34,37,-3,51,60,-9,2,4,0,0
"8860","EDM","STL",2008021048,14320,20082009,1,65,1,1,0,0,0,0,34,32,2,47,47,0,72,64,8,4,4,0,0
"8861","EDM","COL",2008021059,14322,20082009,0,60,8,1,7,0,0,0,24,27,-3,33,35,-2,53,51,2,6,3,0,0
"8862","EDM","CHI",2008021068,14323,20082009,0,65,4,4,0,0,0,0,31,43,-12,38,54,-16,43,64,-21,3,4,0,0
"8863","EDM","MIN",2008021081,14325,20082009,0,60,0,3,-3,0,0,0,31,36,-5,43,45,-2,59,55,4,6,6,0,0
"8864","EDM","DET",2008021095,14327,20082009,1,60,2,3,-1,0,0,0,26,44,-18,35,61,-26,48,85,-37,6,6,0,0
"8865","EDM","ARI",2008021109,14329,20082009,0,60,2,3,-1,0,0,0,28,23,5,38,27,11,54,33,21,5,4,0,0
"8866","EDM","ANA",2008021115,14330,20082009,0,60,5,3,2,0,0,0,20,54,-34,27,78,-51,30,93,-63,8,12,0,0
"8867","EDM","MIN",2008021132,14332,20082009,1,60,2,3,-1,0,0,0,33,21,12,46,34,12,58,45,13,5,5,0,0
"8868","EDM","ANA",2008021142,14334,20082009,1,60,3,5,-2,0,0,0,31,25,6,49,39,10,67,50,17,7,5,0,0
"8869","EDM","S.J",2008021155,14336,20082009,1,60,1,2,-1,0,0,0,26,22,4,43,34,9,52,42,10,6,4,0,0
"8870","EDM","VAN",2008021172,14338,20082009,1,60,5,3,2,0,0,0,25,46,-21,33,61,-28,42,78,-36,5,5,0,0
"8871","EDM","L.A",2008021193,14341,20082009,1,60,1,2,-1,0,0,0,39,29,10,55,36,19,76,44,32,3,0,0,0
"8872","EDM","CGY",2008021212,14344,20082009,1,60,5,1,4,0,0,0,36,32,4,44,61,-17,52,80,-28,4,4,0,0
"8873","EDM","CGY",2008021226,14345,20082009,0,60,1,4,-3,0,0,0,36,45,-9,48,61,-13,56,82,-26,1,2,0,0
"8874","EDM","CGY",2009020021,14520,20092010,1,60,3,4,-1,0,0,0,34,21,13,43,36,7,60,50,10,5,4,0,0
"8875","EDM","DAL",2009020031,14523,20092010,1,65,4,4,0,0,0,0,24,34,-10,35,52,-17,52,69,-17,5,7,0,0
"8876","EDM","CGY",2009020044,14525,20092010,1,65,3,3,0,0,0,0,28,28,0,38,42,-4,57,61,-4,4,4,0,0
"8877","EDM","MTL",2009020060,14527,20092010,1,60,3,2,1,0,0,0,19,35,-16,36,50,-14,48,71,-23,3,2,0,0
"8878","EDM","NSH",2009020070,14529,20092010,0,60,6,1,5,0,0,0,20,41,-21,24,53,-29,36,61,-25,3,7,0,0
"8879","EDM","CHI",2009020077,14531,20092010,0,60,3,4,-1,0,0,0,19,38,-19,22,42,-20,36,59,-23,4,4,0,0
"8880","EDM","MIN",2009020092,14533,20092010,1,60,5,2,3,0,0,0,19,31,-12,35,46,-11,53,55,-2,5,4,0,0
"8881","EDM","VAN",2009020108,14536,20092010,1,60,2,1,1,0,0,0,29,40,-11,41,57,-16,55,74,-19,3,5,0,0
"8882","EDM","CBJ",2009020124,14539,20092010,1,60,6,4,2,0,0,0,32,32,0,42,44,-2,55,64,-9,8,5,0,0
"8883","EDM","CGY",2009020143,14541,20092010,0,60,2,5,-3,0,0,0,25,38,-13,41,42,-1,50,53,-3,9,6,0,0
"8884","EDM","VAN",2009020147,14542,20092010,0,60,0,2,-2,0,0,0,27,29,-2,32,41,-9,41,50,-9,5,4,0,0
"8885","EDM","COL",2009020153,14544,20092010,1,60,0,3,-3,0,0,0,25,34,-9,36,43,-7,52,57,-5,5,4,0,0
"8886","EDM","DET",2009020170,14546,20092010,1,65,5,5,0,0,0,0,33,45,-12,37,55,-18,40,70,-30,3,3,0,0
"8887","EDM","BOS",2009020180,14548,20092010,0,60,0,2,-2,0,0,0,19,27,-8,24,41,-17,30,57,-27,2,2,0,0
"8888","EDM","NYI",2009020195,14550,20092010,0,60,1,3,-2,0,0,0,23,37,-14,36,48,-12,49,65,-16,1,5,0,0
"8889","EDM","NYR",2009020216,14553,20092010,1,60,2,4,-2,0,0,0,28,39,-11,38,51,-13,66,66,0,4,6,0,0
"8890","EDM","COL",2009020239,14556,20092010,0,60,5,3,2,0,0,0,32,37,-5,37,47,-10,49,67,-18,8,5,0,0
"8891","EDM","OTT",2009020244,14558,20092010,0,65,3,3,0,0,0,0,34,25,9,45,34,11,58,51,7,2,1,0,0
"8892","EDM","BUF",2009020247,14559,20092010,0,60,1,3,-2,0,0,0,29,26,3,38,39,-1,46,58,-12,7,5,0,0
"8893","EDM","ATL",2009020281,14563,20092010,0,60,2,3,-1,0,0,0,36,30,6,44,41,3,50,48,2,5,3,0,0
"8894","EDM","CBJ",2009020285,14564,20092010,0,65,2,2,0,0,0,0,25,32,-7,37,44,-7,48,55,-7,7,6,0,0
"8895","EDM","COL",2009020297,14566,20092010,1,60,6,4,2,0,0,0,33,18,15,40,26,14,51,34,17,6,4,0,0
"8896","EDM","CHI",2009020324,14569,20092010,1,60,2,5,-3,0,0,0,27,30,-3,38,42,-4,50,60,-10,2,2,0,0
"8897","EDM","ARI",2009020336,14571,20092010,1,60,4,0,4,0,0,0,25,36,-11,31,56,-25,45,76,-31,6,3,0,0
"8898","EDM","L.A",2009020350,14573,20092010,1,60,1,3,-2,0,0,0,23,35,-12,37,50,-13,52,67,-15,6,5,0,0
"8899","EDM","S.J",2009020365,14575,20092010,1,65,4,4,0,0,0,0,33,31,2,52,48,4,63,61,2,6,5,0,0
"8900","EDM","VAN",2009020378,14576,20092010,0,60,3,7,-4,0,0,0,34,35,-1,43,42,1,56,56,0,6,7,0,0
"8901","EDM","DET",2009020404,14581,20092010,0,60,4,1,3,0,0,0,36,28,8,46,41,5,54,58,-4,2,2,0,0
"8902","EDM","DAL",2009020414,14583,20092010,0,65,2,2,0,0,0,0,36,35,1,52,53,-1,72,69,3,3,2,0,0
"8903","EDM","FLA",2009020434,14585,20092010,0,65,2,2,0,0,0,0,28,35,-7,39,46,-7,47,62,-15,4,5,0,0
"8904","EDM","T.B",2009020446,14587,20092010,0,60,3,2,1,0,0,0,32,34,-2,41,44,-3,51,59,-8,5,5,0,0
"8905","EDM","STL",2009020462,14589,20092010,0,60,5,3,2,0,0,0,38,30,8,46,39,7,55,60,-5,4,4,0,0
"8906","EDM","L.A",2009020493,14593,20092010,1,60,2,3,-1,0,0,0,29,26,3,46,32,14,60,40,20,3,1,0,0
"8907","EDM","NSH",2009020509,14595,20092010,1,60,3,6,-3,0,0,0,26,27,-1,41,39,2,52,51,1,5,3,0,0
"8908","EDM","WSH",2009020528,14597,20092010,1,60,2,4,-2,0,0,0,28,42,-14,41,62,-21,49,85,-36,2,4,0,0
"8909","EDM","STL",2009020540,14599,20092010,1,60,2,7,-5,0,0,0,25,26,-1,38,39,-1,52,59,-7,3,5,0,0
"8910","EDM","MIN",2009020551,14601,20092010,0,60,1,3,-2,0,0,0,31,27,4,37,45,-8,50,67,-17,5,7,0,0
"8911","EDM","VAN",2009020568,14604,20092010,0,60,1,4,-3,0,0,0,25,28,-3,43,48,-5,59,60,-1,3,6,0,0
"8912","EDM","CGY",2009020581,14606,20092010,1,60,1,4,-3,0,0,0,35,23,12,52,41,11,63,64,-1,5,5,0,0
"8913","EDM","TOR",2009020596,14608,20092010,1,60,3,1,2,0,0,0,23,28,-5,37,54,-17,53,76,-23,3,3,0,0
"8914","EDM","CGY",2009020608,14609,20092010,0,60,1,2,-1,0,0,0,22,39,-17,34,52,-18,52,64,-12,3,2,0,0
"8915","EDM","S.J",2009020622,14611,20092010,0,60,1,4,-3,0,0,0,23,27,-4,29,33,-4,42,51,-9,6,5,0,0
"8916","EDM","ARI",2009020636,14614,20092010,1,61.6166666666667,4,5,-1,0,0,0,42,30,12,51,42,9,63,55,8,3,5,0,0
"8917","EDM","CBJ",2009020651,14616,20092010,1,60,2,4,-2,0,0,0,26,29,-3,46,35,11,65,41,24,4,3,0,0
"8918","EDM","NSH",2009020687,14621,20092010,1,60,3,5,-2,0,0,0,41,28,13,56,38,18,81,53,28,3,1,0,0
"8919","EDM","PIT",2009020702,14623,20092010,1,60,2,3,-1,0,0,0,35,31,4,50,46,4,61,68,-7,5,3,0,0
"8920","EDM","S.J",2009020711,14625,20092010,0,60,2,4,-2,0,0,0,29,36,-7,39,62,-23,51,85,-34,1,3,0,0
"8921","EDM","COL",2009020731,14627,20092010,0,60,0,6,-6,0,0,0,24,34,-10,33,41,-8,53,48,5,5,6,0,0
"8922","EDM","VAN",2009020743,14629,20092010,1,61.65,2,3,-1,0,0,0,33,29,4,45,44,1,53,70,-17,5,6,0,0
"8923","EDM","DAL",2009020759,14631,20092010,1,60,3,4,-1,0,0,0,38,32,6,55,44,11,77,53,24,4,4,0,0
"8924","EDM","CHI",2009020785,14635,20092010,1,60,2,4,-2,0,0,0,24,37,-13,33,56,-23,48,69,-21,1,2,0,0
"8925","EDM","STL",2009020799,14637,20092010,1,60,1,2,-1,0,0,0,25,20,5,36,32,4,57,51,6,3,2,0,0
"8926","EDM","CGY",2009020815,14639,20092010,0,60,1,6,-5,0,0,0,28,30,-2,36,45,-9,54,59,-5,5,3,0,0
"8927","EDM","CAR",2009020826,14641,20092010,1,60,4,2,2,0,0,0,27,35,-8,34,53,-19,45,72,-27,5,4,0,0
"8928","EDM","PHI",2009020839,14643,20092010,1,60,1,0,1,0,0,0,27,33,-6,38,54,-16,53,70,-17,4,4,0,0
"8929","EDM","MIN",2009020848,14644,20092010,0,60,2,4,-2,0,0,0,32,36,-4,44,47,-3,50,64,-14,4,3,0,0
"8930","EDM","COL",2009020868,14646,20092010,0,60,0,3,-3,0,0,0,20,42,-22,32,60,-28,44,86,-42,3,2,0,0
"8931","EDM","ARI",2009020874,14648,20092010,0,60,1,6,-5,0,0,0,34,33,1,46,39,7,57,48,9,4,2,0,0
"8932","EDM","ANA",2009020890,14650,20092010,0,60,2,3,-1,0,0,0,39,30,9,53,44,9,63,66,-3,4,8,0,0
"8933","EDM","L.A",2009020897,14651,20092010,0,65,2,2,0,0,0,0,23,43,-20,39,61,-22,52,68,-16,5,7,0,0
"8934","EDM","ANA",2009020921,14654,20092010,1,60,3,7,-4,0,0,0,29,46,-17,38,58,-20,50,78,-28,6,12,0,0
"8935","EDM","NSH",2009020931,14670,20092010,0,60,3,4,-1,0,0,0,25,28,-3,31,42,-11,42,55,-13,2,2,0,0
"8936","EDM","CHI",2009020938,14671,20092010,0,60,2,5,-3,0,0,0,14,47,-33,16,68,-52,25,80,-55,6,9,0,0
"8937","EDM","MIN",2009020954,14673,20092010,1,65,1,1,0,0,0,0,23,29,-6,43,41,2,57,57,0,4,5,0,0
"8938","EDM","N.J",2009020972,14675,20092010,1,60,2,0,2,0,0,0,35,22,13,45,38,7,56,56,0,4,2,0,0
"8939","EDM","OTT",2009020983,14677,20092010,1,60,1,4,-3,0,0,0,19,39,-20,26,53,-27,31,73,-42,5,9,0,0
"8940","EDM","MTL",2009020995,14679,20092010,0,65,4,4,0,0,0,0,25,26,-1,36,42,-6,44,57,-13,4,7,0,0
"8941","EDM","TOR",2009021007,14681,20092010,0,60,4,6,-2,0,0,0,29,47,-18,43,68,-25,51,84,-33,9,11,0,0
"8942","EDM","CBJ",2009021026,14683,20092010,0,60,3,5,-2,0,0,0,32,29,3,42,38,4,61,50,11,4,3,0,0
"8943","EDM","MIN",2009021036,14684,20092010,0,60,2,4,-2,0,0,0,36,28,8,48,45,3,62,58,4,6,4,0,0
"8944","EDM","DET",2009021055,14687,20092010,1,65,2,2,0,0,0,0,24,33,-9,32,53,-21,44,76,-32,1,2,0,0
"8945","EDM","S.J",2009021075,14689,20092010,1,60,5,1,4,0,0,0,25,28,-3,32,52,-20,36,81,-45,4,6,0,0
"8946","EDM","VAN",2009021089,14691,20092010,1,60,3,2,1,0,0,0,22,33,-11,27,54,-27,36,76,-40,2,3,0,0
"8947","EDM","ANA",2009021109,14694,20092010,1,60,2,3,-1,0,0,0,36,40,-4,50,54,-4,63,72,-9,8,5,0,0
"8948","EDM","STL",2009021124,14696,20092010,0,60,1,2,-1,0,0,0,24,31,-7,37,39,-2,47,57,-10,5,4,0,0
"8949","EDM","DET",2009021138,14698,20092010,0,60,4,5,-1,0,0,0,26,44,-18,32,71,-39,41,86,-45,4,3,0,0
"8950","EDM","DAL",2009021161,14701,20092010,0,60,3,6,-3,0,0,0,28,35,-7,45,51,-6,57,61,-4,6,3,0,0
"8951","EDM","ARI",2009021173,14702,20092010,0,65,2,2,0,0,0,0,27,44,-17,37,59,-22,47,73,-26,3,9,0,0
"8952","EDM","MIN",2009021181,14704,20092010,1,60,4,1,3,0,0,0,31,26,5,41,39,2,59,56,3,3,2,0,0
"8953","EDM","COL",2009021196,14706,20092010,1,63.8333333333333,5,4,1,0,0,0,45,35,10,57,47,10,68,60,8,2,2,0,0
"8954","EDM","L.A",2009021213,14709,20092010,0,65,3,3,0,0,0,0,16,55,-39,23,83,-60,33,101,-68,5,7,0,0
"8955","EDM","ANA",2009021230,14710,20092010,0,60,2,7,-5,0,0,0,31,45,-14,42,56,-14,47,66,-19,3,4,0,0
"8956","EDM","CGY",2010020005,14889,20102011,1,60,4,0,4,4.70715631263874,3.93053800398872,0.776618308650029,33,37,-4,44,59,-15,61,79,-18,6,4,0,0
"8957","EDM","FLA",2010020026,14892,20102011,1,60,3,2,1,2.37475271818198,4.30121889026486,-1.92646617208288,13,28,-15,23,51,-28,31,75,-44,2,5,0,0
"8958","EDM","MIN",2010020045,14896,20102011,0,60,2,4,-2,3.52494578711776,4.74045537633356,-1.2155095892158,26,24,2,33,38,-5,43,50,-7,8,7,0,0
"8959","EDM","CGY",2010020065,14898,20102011,0,60,3,5,-2,4.75660010678314,4.96260869112552,-0.206008584342385,30,46,-16,39,60,-21,47,74,-27,5,5,0,0
"8960","EDM","MIN",2010020091,14903,20102011,1,60,2,4,-2,4.58885741922429,4.52278089715401,0.0660765220702837,36,25,11,53,35,18,71,45,26,10,4,0,0
"8961","EDM","S.J",2010020110,14905,20102011,1,60,1,6,-5,4.12206151266582,5.57881974149979,-1.45675822883396,22,34,-12,31,44,-13,36,56,-20,6,6,0,0
"8962","EDM","CGY",2010020120,14908,20102011,0,65,4,4,0,7.15179133875322,5.92213473311281,1.22965660564041,32,39,-7,38,52,-14,51,68,-17,4,6,0,0
"8963","EDM","CBJ",2010020131,14910,20102011,0,65,2,2,0,3.52333427480778,6.89991332222384,-3.37657904741606,27,41,-14,35,52,-17,54,61,-7,6,8,0,0
"8964","EDM","CHI",2010020141,14911,20102011,0,60,7,4,3,4.2394407788355,3.54866669210605,0.690774086729448,22,41,-19,29,50,-21,35,69,-34,1,5,0,0
"8965","EDM","VAN",2010020163,14915,20102011,1,60,3,4,-1,3.65540359745501,4.10670865277189,-0.45130505531688,26,30,-4,40,48,-8,55,61,-6,3,4,0,0
"8966","EDM","DET",2010020185,14918,20102011,1,60,1,3,-2,3.1786068575575,5.47241222834191,-2.29380537078441,30,30,0,46,52,-6,53,69,-16,6,4,0,0
"8967","EDM","CHI",2010020201,14920,20102011,0,60,2,1,1,3.28799975592119,2.89276511517096,0.395234640750232,26,27,-1,38,36,2,50,52,-2,4,3,0,0
"8968","EDM","CAR",2010020205,14922,20102011,0,60,1,7,-6,3.686703744086,3.32037047638736,0.366333267698643,22,42,-20,38,55,-17,54,69,-15,4,7,0,0
"8969","EDM","DET",2010020222,14924,20102011,0,60,2,6,-4,2.96144652880321,3.26524577827485,-0.303799249471645,25,34,-9,30,43,-13,42,56,-14,3,2,0,0
"8970","EDM","N.J",2010020227,14925,20102011,0,63.45,3,4,-1,1.81895154427912,3.22101407455921,-1.40206253028009,24,39,-15,26,50,-24,34,61,-27,2,3,0,0
"8971","EDM","NYR",2010020244,14927,20102011,0,60,2,8,-6,2.57221935513617,6.16595737822354,-3.59373802308737,21,31,-10,29,46,-17,46,59,-13,4,3,0,0
"8972","EDM","CHI",2010020267,14930,20102011,1,60,0,5,-5,3.83486265624042,4.95336618166039,-1.11850352541997,18,47,-29,33,60,-27,49,71,-22,2,3,0,0
"8973","EDM","ARI",2010020281,14932,20102011,1,65,3,3,0,5.90563140351151,4.61151702320382,1.29411438030769,30,42,-12,44,49,-5,55,58,-3,6,4,0,0
"8974","EDM","ANA",2010020296,14934,20102011,0,60,4,2,2,4.87069877330214,6.57712593022734,-1.7064271569252,26,40,-14,35,54,-19,54,60,-6,3,5,0,0
"8975","EDM","ARI",2010020306,14936,20102011,0,60,0,5,-5,1.9643729053787,3.28100876732537,-1.31663586194668,23,34,-11,31,43,-12,42,49,-7,2,2,0,0
"8976","EDM","COL",2010020320,14938,20102011,1,60,3,2,1,3.08813180070138,3.34260116936815,-0.254469368666776,24,37,-13,36,46,-10,56,55,1,4,3,0,0
"8977","EDM","S.J",2010020343,14940,20102011,1,60,3,4,-1,2.98793421528649,2.6930685704574,0.294865644829088,25,25,0,34,36,-2,52,53,-1,3,4,0,0
"8978","EDM","OTT",2010020350,14942,20102011,0,60,4,1,3,6.59696973385392,2.7118370591031,3.88513267475083,25,23,2,38,36,2,54,57,-3,5,3,0,0
"8979","EDM","MTL",2010020358,14944,20102011,0,62.4666666666667,4,3,1,4.94484925762578,3.21028217151545,1.73456708611032,32,39,-7,42,50,-8,52,67,-15,5,3,0,0
"8980","EDM","TOR",2010020366,14945,20102011,0,60,5,0,5,2.53207284820382,3.10151290619574,-0.569440057991919,19,33,-14,24,42,-18,39,63,-24,4,5,0,0
"8981","EDM","STL",2010020389,14947,20102011,1,60.3833333333333,2,1,1,2.76762180717196,5.02588525257306,-2.2582634454011,26,32,-6,31,45,-14,40,63,-23,2,2,0,0
"8982","EDM","ANA",2010020405,14950,20102011,1,65,2,2,0,4.62028097234906,4.02641061985469,0.593870352494378,36,32,4,52,44,8,71,56,15,4,4,0,0
"8983","EDM","T.B",2010020423,14953,20102011,1,65,3,3,0,4.21661376535485,4.32693381351419,-0.110320048159338,23,41,-18,29,59,-30,45,87,-42,3,5,0,0
"8984","EDM","VAN",2010020439,14955,20102011,1,60,1,2,-1,1.88129983132239,5.93349527195164,-4.05219544062925,12,32,-20,20,40,-20,40,51,-11,5,4,0,0
"8985","EDM","TOR",2010020448,14957,20102011,1,60,1,4,-3,1.92524830541981,3.26378179333892,-1.33853348791911,24,34,-10,35,51,-16,49,68,-19,4,5,0,0
"8986","EDM","CBJ",2010020468,14959,20102011,1,60,6,3,3,2.96316644159003,4.15764195435622,-1.19447551276619,36,40,-4,47,55,-8,60,77,-17,5,4,0,0
"8987","EDM","S.J",2010020501,14964,20102011,0,60,1,2,-1,4.1862514045788,2.90964504436124,1.27660636021756,27,30,-3,40,35,5,55,49,6,2,4,0,0
"8988","EDM","L.A",2010020517,14966,20102011,0,65,2,2,0,4.31865790020674,5.43760633323109,-1.11894843302434,29,29,0,43,44,-1,50,66,-16,3,4,0,0
"8989","EDM","VAN",2010020528,14969,20102011,0,60,2,3,-1,4.17647157429019,4.85365788618927,-0.677186311899084,21,33,-12,28,53,-25,37,70,-33,4,4,0,0
"8990","EDM","BUF",2010020542,14971,20102011,1,60,2,4,-2,3.99836457084166,3.12115483707748,0.877209733764175,31,21,10,38,35,3,56,46,10,4,1,0,0
"8991","EDM","COL",2010020555,14973,20102011,1,65,3,3,0,3.06134415324777,2.24201262741281,0.819331525834968,35,27,8,49,43,6,67,59,8,4,2,0,0
"8992","EDM","CGY",2010020572,14975,20102011,1,60,1,2,-1,3.25385407917202,5.13763617064978,-1.88378209147777,17,30,-13,23,48,-25,46,76,-30,2,4,0,0
"8993","EDM","DET",2010020589,14978,20102011,1,60,3,5,-2,2.13630608177664,5.62454360490322,-3.48823752312659,25,37,-12,34,49,-15,53,60,-7,3,2,0,0
"8994","EDM","NYI",2010020602,14980,20102011,1,60,2,1,1,2.12340210088587,4.86364904834772,-2.74024694746186,22,31,-9,27,49,-22,46,72,-26,2,8,0,0
"8995","EDM","VAN",2010020610,14981,20102011,0,60,1,6,-5,3.29747846411192,6.02536006842274,-2.72788160431082,24,34,-10,33,44,-11,44,57,-13,7,7,0,0
"8996","EDM","DAL",2010020640,14985,20102011,0,60,2,3,-1,6.69400519980422,2.48661050561959,4.20739469418463,41,20,21,51,35,16,66,42,24,5,5,0,0
"8997","EDM","S.J",2010020653,14987,20102011,0,60,5,2,3,4.79559812062644,4.35287597841868,0.442722142207753,29,43,-14,40,52,-12,56,75,-19,5,6,0,0
"8998","EDM","L.A",2010020670,14989,20102011,0,60,2,5,-3,5.85313018971988,7.37776015972486,-1.52462997000498,26,23,3,50,39,11,57,50,7,5,3,0,0
"8999","EDM","ANA",2010020676,14990,20102011,0,60,2,3,-1,3.70178928523968,2.98810211194729,0.713687173292397,28,28,0,42,39,3,64,47,17,5,4,0,0
"9000","EDM","MIN",2010020691,14992,20102011,1,60,1,4,-3,4.80458622609149,5.23609226796627,-0.431506041874783,32,26,6,45,41,4,63,45,18,8,4,0,0
"9001","EDM","DAL",2010020705,14994,20102011,1,60,2,4,-2,3.66499756937581,4.98457733122632,-1.31957976185051,32,24,8,43,30,13,59,44,15,4,3,0,0
"9002","EDM","NSH",2010020727,14997,20102011,1,65,2,2,0,4.74920019938145,4.4812727038443,0.267927495537151,24,28,-4,38,43,-5,51,64,-13,4,5,0,0
"9003","EDM","ARI",2010020741,14999,20102011,0,60,4,3,1,4.06194215195916,4.63966354743752,-0.577721395478363,35,27,8,51,43,8,67,60,7,3,3,0,0
"9004","EDM","DAL",2010020746,15000,20102011,0,60,1,3,-2,5.47925349770958,3.95043656689813,1.52881693081144,35,21,14,49,35,14,65,50,15,7,8,0,0
"9005","EDM","L.A",2010020768,15007,20102011,1,60,1,3,-2,4.09962686267681,3.43111873074668,0.668508131930139,33,26,7,44,40,4,61,56,5,6,6,0,0
"9006","EDM","STL",2010020780,15009,20102011,0,60,3,5,-2,0,0,0,32,26,6,40,36,4,58,54,4,4,4,0,0
"9007","EDM","CBJ",2010020789,15010,20102011,0,60,3,4,-1,3.15714109793271,2.96052630539634,0.196614792536366,26,34,-8,40,44,-4,52,54,-2,6,4,0,0
"9008","EDM","NSH",2010020798,15012,20102011,0,60,4,0,4,3.80936169188533,4.49044486795901,-0.681083176073685,22,37,-15,30,53,-23,39,70,-31,2,5,0,0
"9009","EDM","CHI",2010020814,15014,20102011,1,60,1,4,-3,2.76004742634723,3.89110227295896,-1.13105484661173,24,26,-2,36,42,-6,49,50,-1,2,6,0,0
"9010","EDM","OTT",2010020830,15017,20102011,1,60,3,5,-2,4.38947755336994,4.67074814781562,-0.281270594445676,18,25,-7,29,34,-5,39,50,-11,10,12,0,0
"9011","EDM","ANA",2010020844,15018,20102011,1,60,0,4,-4,1.36877794043677,3.76317264983663,-2.39439470939986,12,22,-10,22,39,-17,38,49,-11,3,5,0,0
"9012","EDM","DAL",2010020854,15020,20102011,1,60,4,1,3,2.2008291259408,3.88807694071255,-1.68724781477175,30,25,5,38,42,-4,54,68,-14,6,3,0,0
"9013","EDM","MTL",2010020867,15022,20102011,1,60,4,1,3,5.2685783074412,4.63870491051784,0.629873396923358,28,37,-9,38,52,-14,57,73,-16,2,1,0,0
"9014","EDM","ATL",2010020877,15024,20102011,1,60,5,3,2,4.25073582023463,3.66750730189051,0.583228518344123,26,31,-5,39,50,-11,52,63,-11,7,5,0,0
"9015","EDM","MIN",2010020899,15027,20102011,0,60,1,4,-3,4.00200836529325,3.27647980018952,0.72552856510373,21,23,-2,31,37,-6,41,49,-8,7,5,0,0
"9016","EDM","COL",2010020907,15028,20102011,0,60,5,1,4,6.04724227701346,3.53131495660637,2.51592732040709,31,39,-8,39,47,-8,50,62,-12,3,4,0,0
"9017","EDM","STL",2010020922,15030,20102011,1,60,0,5,-5,2.77758848900703,2.52495923178503,0.252629257221997,39,22,17,49,29,20,71,41,30,4,5,0,0
"9018","EDM","BOS",2010020938,15032,20102011,1,60,2,3,-1,3.49910157013801,4.04034579065046,-0.541244220512453,17,40,-23,30,51,-21,44,75,-31,1,2,0,0
"9019","EDM","NSH",2010020948,15034,20102011,1,65,1,1,0,1.7870174445808,4.29935860100886,-2.51234115642806,26,35,-9,32,45,-13,48,61,-13,3,3,0,0
"9020","EDM","CBJ",2010020964,15036,20102011,1,60,4,2,2,3.24827675242204,2.41356224237825,0.834714510043796,38,28,10,40,47,-7,53,73,-20,5,7,0,0
"9021","EDM","COL",2010020981,15038,20102011,0,60,5,1,4,6.49666031970236,4.1510776829964,2.34558263670596,31,34,-3,42,43,-1,56,56,0,4,6,0,0
"9022","EDM","PHI",2010020994,15041,20102011,0,60,1,4,-3,3.57278843445238,5.50696710873673,-1.93417867428435,25,27,-2,38,39,-1,52,57,-5,3,2,0,0
"9023","EDM","WSH",2010021001,15042,20102011,0,60,0,5,-5,3.66415041949421,3.80286196268546,-0.138711543191251,22,36,-14,31,46,-15,45,58,-13,4,5,0,0
"9024","EDM","DET",2010021017,15044,20102011,0,64.3,1,2,-1,2.36534299480263,3.85840963202989,-1.49306663722726,27,44,-17,31,63,-32,39,78,-39,3,6,0,0
"9025","EDM","PIT",2010021033,15046,20102011,0,60,1,5,-4,2.14398521172126,5.63432737065159,-3.49034215893033,29,33,-4,35,45,-10,43,56,-13,4,6,0,0
"9026","EDM","ARI",2010021063,15050,20102011,1,60,1,3,-2,4.45256843193249,2.18792549222963,2.26464293970286,36,17,19,48,27,21,65,39,26,11,5,0,0
"9027","EDM","COL",2010021077,15052,20102011,1,65,2,2,0,0,0,0,33,27,6,45,36,9,67,46,21,4,2,0,0
"9028","EDM","NSH",2010021094,15055,20102011,0,60,1,3,-2,4.29188302366799,4.80674690424061,-0.514863880572619,20,30,-10,30,36,-6,42,44,-2,3,3,0,0
"9029","EDM","STL",2010021106,15057,20102011,0,60,0,4,-4,2.15338777358129,1.69107591705131,0.462311856529987,12,30,-18,24,34,-10,48,48,0,5,7,0,0
"9030","EDM","CGY",2010021127,15059,20102011,1,65,4,4,0,4.12537829391658,2.62309497974275,1.50228331417384,21,31,-10,29,42,-13,44,58,-14,2,4,0,0
"9031","EDM","L.A",2010021143,15062,20102011,1,60,0,2,-2,4.19580236584136,2.45712065733824,1.73868170850312,32,33,-1,39,44,-5,51,61,-10,2,4,0,0
"9032","EDM","MIN",2010021156,15064,20102011,0,60,2,4,-2,5.95535900988762,3.89935850664983,2.05600050323778,35,22,13,44,31,13,59,38,21,6,7,0,0
"9033","EDM","VAN",2010021173,15066,20102011,0,60,4,1,3,5.22624420997771,4.26161270181183,0.964631508165883,34,41,-7,48,49,-1,57,63,-6,3,4,0,0
"9034","EDM","VAN",2010021192,15069,20102011,1,60,2,0,2,3.08457626329619,3.15472773672082,-0.0701514734246302,22,26,-4,30,39,-9,37,54,-17,7,4,0,0
"9035","EDM","CGY",2010021198,15070,20102011,0,60,1,6,-5,4.18184909457341,6.3317788798912,-2.14992978531779,23,47,-24,29,62,-33,40,80,-40,4,7,0,0
"9036","EDM","MIN",2010021212,15072,20102011,1,60,1,3,-2,4.12970039626944,4.61412362811825,-0.484423231848808,29,27,2,44,38,6,63,50,13,4,6,0,0
"9037","EDM","COL",2010021228,15074,20102011,0,63.95,3,4,-1,4.98248704878299,2.87373812143778,2.1087489273452,28,25,3,38,41,-3,43,55,-12,2,5,0,0
"9038","EDM","PIT",2011020024,15256,20112012,1,65,1,1,0,5.21991539655392,2.80861340346337,2.41130199309055,35,34,1,45,50,-5,53,75,-22,6,8,0,0
"9039","EDM","MIN",2011020044,15260,20112012,0,65,1,1,0,3.65886199485796,4.07308456746568,-0.414222572607726,22,35,-13,31,44,-13,39,57,-18,4,6,0,0
"9040","EDM","VAN",2011020061,15262,20112012,1,60,3,4,-1,5.0971388771577,5.63639863506978,-0.539259757912077,30,26,4,39,37,2,56,52,4,5,3,0,0
"9041","EDM","NSH",2011020067,15264,20112012,1,60,3,1,2,5.50774803815875,1.16769058574573,4.34005745241302,25,12,13,38,19,19,54,27,27,5,5,0,0
"9042","EDM","CGY",2011020075,15265,20112012,0,60,1,2,-1,3.97366776975105,3.76063422725415,0.213033542496895,25,28,-3,37,43,-6,44,51,-7,6,3,0,0
"9043","EDM","MIN",2011020088,15267,20112012,1,65,1,1,0,2.84260778259076,3.72069333035324,-0.878085547762481,31,31,0,40,40,0,54,59,-5,2,4,0,0
"9044","EDM","NYR",2011020107,15269,20112012,1,60,2,0,2,2.90869267382459,3.09370718037826,-0.185014506553671,27,19,8,39,32,7,49,44,5,4,5,0,0
"9045","EDM","VAN",2011020119,15272,20112012,1,60,3,2,1,4.14304773346521,6.55071602820027,-2.40766829473506,22,37,-15,32,52,-20,43,83,-40,3,4,0,0
"9046","EDM","WSH",2011020134,15274,20112012,1,60,2,1,1,4.4080988781061,3.93852010657866,0.469578771527438,19,35,-16,26,58,-32,38,76,-38,9,6,0,0
"9047","EDM","COL",2011020138,15275,20112012,0,60,3,1,2,2.60928743536351,5.4430368422346,-2.83374940687109,19,41,-22,28,60,-32,39,83,-44,5,5,0,0
"9048","EDM","STL",2011020156,15277,20112012,1,60,4,2,2,4.44804103148635,5.1936788688181,-0.745637837331742,30,30,0,36,39,-3,49,51,-2,4,3,0,0
"9049","EDM","L.A",2011020176,15281,20112012,0,60,3,0,3,3.97329159775109,2.73862304889553,1.23466854885555,27,19,8,36,34,2,45,56,-11,5,3,0,0
"9050","EDM","ARI",2011020192,15283,20112012,0,60,2,4,-2,3.12552899424918,4.19713286706778,-1.0716038728186,26,30,-4,37,36,1,54,50,4,2,2,0,0
"9051","EDM","MTL",2011020206,15286,20112012,0,60,3,1,2,4.04943508698125,5.38572946481872,-1.33629437783748,14,29,-15,27,42,-15,38,54,-16,2,6,0,0
"9052","EDM","BOS",2011020214,15288,20112012,0,60,3,6,-3,2.57785932569323,3.68457951154596,-1.10672018585273,30,28,2,39,40,-1,51,52,-1,5,5,0,0
"9053","EDM","DET",2011020226,15289,20112012,0,60,0,3,-3,5.57988300322904,3.09179164713714,2.4880913560919,24,30,-6,32,42,-10,44,60,-16,3,6,0,0
"9054","EDM","CHI",2011020241,15291,20112012,0,60,3,6,-3,3.26366767776199,3.75273314964119,-0.489065471879201,23,35,-12,29,42,-13,43,49,-6,3,4,0,0
"9055","EDM","OTT",2011020268,15295,20112012,1,60,2,5,-3,2.57325566542568,2.91807711764704,-0.344821452221368,24,16,8,37,26,11,56,37,19,3,4,0,0
"9056","EDM","CHI",2011020285,15297,20112012,1,60,9,2,7,4.74439571622497,5.48485915584024,-0.740463439615269,34,36,-2,43,48,-5,52,60,-8,6,6,0,0
"9057","EDM","DAL",2011020296,15299,20112012,0,60,1,4,-3,3.89765803969219,4.87447928800975,-0.976821248317567,18,35,-17,32,45,-13,45,57,-12,6,3,0,0
"9058","EDM","NSH",2011020299,15300,20112012,0,60,6,2,4,4.12099170664442,2.9138727906975,1.20711891594692,32,32,0,37,49,-12,43,54,-11,4,6,0,0
"9059","EDM","MIN",2011020316,15303,20112012,0,60,5,2,3,4.06922957226197,4.86425271993556,-0.795023147673589,29,32,-3,39,43,-4,47,55,-8,4,4,0,0
"9060","EDM","COL",2011020328,15304,20112012,0,60,2,5,-3,5.35387775196432,3.74570258909671,1.60817516286761,33,29,4,48,34,14,59,46,13,3,3,0,0
"9061","EDM","NSH",2011020343,15306,20112012,1,60,1,2,-1,1.64111573953414,4.07259398986935,-2.4314782503352,18,31,-13,25,45,-20,41,66,-25,5,2,0,0
"9062","EDM","MIN",2011020356,15308,20112012,1,65,2,2,0,5.76707357572741,3.80122995947022,1.96584361625719,30,29,1,43,40,3,55,60,-5,4,6,0,0
"9063","EDM","CBJ",2011020370,15310,20112012,1,60,6,3,3,4.2011781247711,4.15059353304969,0.0505845917214174,34,39,-5,42,46,-4,48,68,-20,2,5,0,0
"9064","EDM","CGY",2011020382,15311,20112012,1,60,3,5,-2,2.63813437319845,4.28612902804161,-1.64799465484316,29,32,-3,41,39,2,56,51,5,6,3,0,0
"9065","EDM","CAR",2011020404,15315,20112012,1,60,3,5,-2,4.03361929004313,3.06618392919427,0.967435360848867,25,33,-8,37,45,-8,44,62,-18,5,7,0,0
"9066","EDM","COL",2011020420,15317,20112012,1,60,4,1,3,7.03924114215415,4.63508376665413,2.40415737550001,35,29,6,56,40,16,65,54,11,5,3,0,0
"9067","EDM","CGY",2011020431,15318,20112012,0,60,0,3,-3,3.75755772116671,4.61864467492842,-0.861086953761713,21,34,-13,30,44,-14,37,57,-20,3,7,0,0
"9068","EDM","ARI",2011020459,15323,20112012,0,60,2,4,-2,3.03668930556159,6.99394321922846,-3.95725391366686,20,42,-22,33,57,-24,47,67,-20,4,3,0,0
"9069","EDM","S.J",2011020477,15325,20112012,0,60,2,3,-1,2.01929491853323,4.27922096558198,-2.25992604704875,25,37,-12,36,46,-10,54,68,-14,3,5,0,0
"9070","EDM","DET",2011020485,15327,20112012,1,60,2,3,-1,3.53421486847794,4.15781963884365,-0.62360477036571,23,28,-5,31,37,-6,49,48,1,5,2,0,0
"9071","EDM","MIN",2011020506,15330,20112012,1,60,4,1,3,3.22741258860151,5.17725256370613,-1.94983997510462,31,31,0,42,51,-9,51,76,-25,5,3,0,0
"9072","EDM","VAN",2011020526,15334,20112012,0,60,3,5,-2,4.12025401132688,4.02622537962816,0.0940286316987242,21,26,-5,27,41,-14,39,53,-14,7,7,0,0
"9073","EDM","MIN",2011020546,15337,20112012,0,60,3,4,-1,6.47458120126976,4.70747441193043,1.76710678933932,30,27,3,50,34,16,64,39,25,8,7,0,0
"9074","EDM","NYI",2011020557,15339,20112012,0,60,1,4,-3,4.6593075064302,2.88964049434435,1.76966701208585,29,29,0,41,37,4,56,47,9,4,3,0,0
"9075","EDM","CHI",2011020571,15341,20112012,0,60,4,3,1,3.68416597199393,3.3369735801883,0.347192391805635,30,42,-12,44,50,-6,60,58,2,2,4,0,0
"9076","EDM","BUF",2011020574,15342,20112012,0,60,3,4,-1,4.48433192481025,5.62810373630101,-1.14377181149076,26,33,-7,37,41,-4,49,53,-4,3,2,0,0
"9077","EDM","STL",2011020589,15344,20112012,0,60,3,4,-1,3.46254452318317,4.05888059118297,-0.5963360679998,32,37,-5,45,46,-1,60,58,2,6,8,0,0
"9078","EDM","DAL",2011020600,15346,20112012,0,60,1,4,-3,5.42981140757911,7.36194941098802,-1.93213800340891,26,34,-8,40,54,-14,55,64,-9,2,2,0,0
"9079","EDM","N.J",2011020630,15350,20112012,1,61.1,1,2,-1,1.43014681353816,2.8636018480247,-1.43345503448654,23,25,-2,38,34,4,64,45,19,5,2,0,0
"9080","EDM","ANA",2011020646,15352,20112012,1,60,0,5,-5,4.12292761708886,5.90682621424396,-1.7838985971551,33,28,5,48,37,11,58,43,15,2,3,0,0
"9081","EDM","L.A",2011020662,15354,20112012,1,63.1,2,1,1,5.47351165869622,2.20711042860057,3.26640123009565,33,21,12,52,32,20,63,51,12,3,3,0,0
"9082","EDM","CBJ",2011020676,15356,20112012,0,60,2,4,-2,4.59299766839831,4.34717316518072,0.245824503217591,23,25,-2,34,33,1,50,48,2,3,2,0,0
"9083","EDM","STL",2011020690,15358,20112012,0,60,0,1,-1,3.63770357239991,4.67532077576283,-1.03761720336291,15,38,-23,23,59,-36,37,76,-39,3,6,0,0
"9084","EDM","CGY",2011020711,15360,20112012,1,60,2,6,-4,2.02898901858134,4.32868181167578,-2.29969279309444,23,23,0,31,31,0,50,49,1,2,5,0,0
"9085","EDM","S.J",2011020720,15362,20112012,1,65,1,1,0,4.13688231710694,6.97251096733089,-2.83562865022395,18,45,-27,27,65,-38,41,77,-36,1,0,0,0
"9086","EDM","VAN",2011020734,15363,20112012,0,65,2,2,0,6.65068429590974,5.58163536189022,1.06904893401952,32,35,-3,38,46,-8,51,69,-18,1,2,0,0
"9087","EDM","COL",2011020746,15370,20112012,1,60,3,2,1,2.97452955049084,6.33909030884388,-3.36456075835304,23,33,-10,34,47,-13,39,65,-26,1,2,0,0
"9088","EDM","CHI",2011020759,15372,20112012,1,60,8,4,4,6.86526887112996,3.8290706249436,3.03619824618636,41,47,-6,50,60,-10,69,78,-9,7,3,0,0
"9089","EDM","DET",2011020778,15374,20112012,1,65,4,4,0,5.13958314398769,7.65757965513266,-2.51799651114496,32,39,-7,46,50,-4,53,72,-19,4,5,0,0
"9090","EDM","TOR",2011020783,15376,20112012,0,60,3,6,-3,4.59183590749308,6.88447461655596,-2.29263870906289,30,31,-1,44,50,-6,68,61,7,0,0,0,0
"9091","EDM","DET",2011020798,15378,20112012,0,60,2,4,-2,4.3108207745513,4.68160578556738,-0.37078501101608,17,30,-13,26,43,-17,33,51,-18,7,4,0,0
"9092","EDM","OTT",2011020820,15381,20112012,0,60.2833333333333,4,3,1,4.10911154164933,6.18132239453832,-2.07221085288899,40,42,-2,47,56,-9,63,73,-10,2,2,0,0
"9093","EDM","TOR",2011020849,15385,20112012,1,61.65,3,4,-1,5.33212665313476,3.93040587150608,1.40172078162868,32,26,6,49,36,13,64,56,8,2,3,0,0
"9094","EDM","COL",2011020864,15387,20112012,1,60,1,3,-2,2.33066304255044,3.35299678454047,-1.02233374199002,27,23,4,37,31,6,52,43,9,4,4,0,0
"9095","EDM","VAN",2011020881,15389,20112012,1,60,2,5,-3,4.9333327051977,2.9672428114427,1.966089893755,28,31,-3,36,34,2,49,54,-5,1,5,0,0
"9096","EDM","CGY",2011020894,15391,20112012,0,60,6,1,5,2.91931147443952,3.03697162349363,-0.117660149054111,42,22,20,49,28,21,64,37,27,3,1,0,0
"9097","EDM","PHI",2011020907,15393,20112012,1,60,2,0,2,3.89560034845999,3.1640235803934,0.731576768066589,30,35,-5,42,46,-4,50,60,-10,4,4,0,0
"9098","EDM","ARI",2011020916,15395,20112012,1,60,1,3,-2,3.71085293558876,4.88411470665596,-1.1732617710672,22,20,2,36,30,6,46,46,0,1,1,0,0
"9099","EDM","WPG",2011020934,15397,20112012,0,60,5,3,2,4.21349653525976,6.28730489269947,-2.0738083574397,25,32,-7,35,44,-9,49,64,-15,4,4,0,0
"9100","EDM","STL",2011020948,15399,20112012,1,60,2,5,-3,3.7526261069288,4.72232901674579,-0.969702909816988,24,31,-7,31,45,-14,41,52,-11,2,5,0,0
"9101","EDM","DAL",2011020963,15401,20112012,1,60,1,3,-2,3.31399484933354,3.66347617597785,-0.349481326644309,20,15,5,33,28,5,50,45,5,0,2,0,0
"9102","EDM","ANA",2011020983,15404,20112012,0,60,2,4,-2,3.9368015524924,7.64654709220486,-3.70974553971246,36,30,6,44,44,0,59,54,5,1,4,0,0
"9103","EDM","S.J",2011020995,15405,20112012,0,65,2,2,0,3.78626414650353,6.51638263665539,-2.73011849015187,26,30,-4,45,43,2,60,67,-7,1,2,0,0
"9104","EDM","MTL",2011021008,15407,20112012,1,60,3,5,-2,4.3761194676481,5.31064491948405,-0.934525451835952,27,31,-4,35,48,-13,46,67,-21,4,4,0,0
"9105","EDM","COL",2011021015,15409,20112012,0,65,2,2,0,5.08373899746221,5.91329589445377,-0.829556896991562,30,32,-2,43,46,-3,60,58,2,2,2,0,0
"9106","EDM","S.J",2011021035,15411,20112012,1,60,2,3,-1,4.03790272620972,3.83178154674533,0.20612117946439,22,33,-11,32,43,-11,43,56,-13,2,3,0,0
"9107","EDM","CBJ",2011021049,15413,20112012,1,60,3,0,3,5.37847441108184,2.82506308906795,2.55341132201389,27,22,5,40,33,7,51,51,0,4,3,0,0
"9108","EDM","CGY",2011021063,15415,20112012,1,60,3,1,2,1.85661822632125,2.23281996582227,-0.376201739501028,25,19,6,32,33,-1,47,47,0,9,4,0,0
"9109","EDM","ARI",2011021079,15417,20112012,1,65,2,2,0,3.70817601494491,5.96596735851926,-2.25779134357435,38,42,-4,50,57,-7,63,74,-11,2,3,0,0
"9110","EDM","NSH",2011021093,15419,20112012,0,60,6,3,3,3.08984508023225,5.08062765980577,-1.99078257957352,20,44,-24,25,55,-30,28,71,-43,2,5,0,0
"9111","EDM","T.B",2011021104,15421,20112012,0,65,2,2,0,3.01944076971267,2.04838040556092,0.971060364151754,36,21,15,47,31,16,61,46,15,1,4,0,0
"9112","EDM","FLA",2011021115,15422,20112012,0,65,1,1,0,3.4626327707665,5.460713886132,-1.99808111536549,21,27,-6,29,39,-10,41,57,-16,1,4,0,0
"9113","EDM","CBJ",2011021127,15424,20112012,0,60,6,3,3,4.47758850505488,3.38848506113573,1.08910344391916,38,32,6,45,45,0,50,52,-2,6,9,0,0
"9114","EDM","DAL",2011021151,15427,20112012,1,60,1,3,-2,3.94261521204163,2.73165575080202,1.21095946123961,32,25,7,41,32,9,52,49,3,4,5,0,0
"9115","EDM","L.A",2011021167,15429,20112012,1,60,1,4,-3,1.6566362066078,6.27223433286417,-4.61559812625637,14,32,-18,26,51,-25,34,76,-42,5,8,0,0
"9116","EDM","ANA",2011021186,15431,20112012,0,60,2,1,1,2.70449664414627,6.48976037360262,-3.78526372945635,15,33,-18,23,47,-24,37,68,-31,4,7,0,0
"9117","EDM","L.A",2011021188,15432,20112012,0,60,0,2,-2,2.87909987138119,4.97150126269844,-2.09240139131725,19,37,-18,28,56,-28,37,73,-36,2,4,0,0
"9118","EDM","ANA",2011021213,15435,20112012,1,61.2,2,3,-1,4.74756459489436,4.23655563034117,0.511008964553184,26,17,9,37,25,12,54,47,7,1,1,0,0
"9119","EDM","VAN",2011021229,15437,20112012,0,60,0,3,-3,3.18284345976359,5.11374062133837,-1.93089716157477,17,42,-25,26,55,-29,38,70,-32,3,7,0,0
"9120","EDM","VAN",2012020018,15725,20122013,0,65,2,2,0,3.63860049172229,4.03442728207847,-0.395826790356182,32,29,3,41,43,-2,55,60,-5,4,5,0,0
"9121","EDM","S.J",2012020035,15727,20122013,1,60,3,6,-3,2.56722720776118,3.59391674669823,-1.02668953893705,29,31,-2,37,39,-2,47,51,-4,6,6,0,0
"9122","EDM","L.A",2012020048,15729,20122013,1,63.0166666666667,2,1,1,5.54645810936126,4.19192051889327,1.35453759046799,39,31,8,52,46,6,68,65,3,9,9,0,0
"9123","EDM","CGY",2012020063,15731,20122013,0,60,3,4,-1,2.92493166934582,5.05700760887703,-2.13207593953121,20,35,-15,31,45,-14,38,55,-17,5,7,0,0
"9124","EDM","COL",2012020076,15733,20122013,1,60,4,1,3,2.12428979788092,6.86733849191296,-4.74304869403204,27,38,-11,40,51,-11,54,64,-10,6,3,0,0
"9125","EDM","ARI",2012020090,15735,20122013,0,63.8666666666667,2,1,1,4.89682994113011,2.42417462562075,2.47265531550935,21,28,-7,38,44,-6,50,61,-11,5,3,0,0
"9126","EDM","S.J",2012020100,15736,20122013,0,65,2,2,0,2.62238794930951,5.07063710318675,-2.44824915387724,28,38,-10,34,57,-23,47,76,-29,3,5,0,0
"9127","EDM","COL",2012020110,15738,20122013,0,60,1,3,-2,2.25537598800656,7.17680674581788,-4.92143075781132,26,40,-14,38,47,-9,53,64,-11,3,6,0,0
"9128","EDM","VAN",2012020126,15740,20122013,1,64.6666666666667,2,3,-1,3.93395518744364,7.21584200143116,-3.28188681398751,25,40,-15,33,50,-17,48,73,-25,5,4,0,0
"9129","EDM","DAL",2012020140,15742,20122013,1,61.7666666666667,2,3,-1,2.98254875149114,3.35143439966464,-0.368885648173496,29,28,1,39,43,-4,51,64,-13,4,3,0,0
"9130","EDM","DET",2012020158,15745,20122013,0,60,1,2,-1,2.47903183682453,4.78834137270967,-2.30930953588514,24,30,-6,34,45,-11,49,61,-12,8,7,0,0
"9131","EDM","CBJ",2012020167,15746,20122013,0,60,3,1,2,2.35449728276672,2.74575759846732,-0.391260315700606,14,40,-26,20,49,-29,25,62,-37,4,7,0,0
"9132","EDM","DAL",2012020186,15748,20122013,1,60,1,4,-3,4.10536013281671,6.05631789925224,-1.95095776643552,36,29,7,46,42,4,59,56,3,7,5,0,0
"9133","EDM","COL",2012020211,15752,20122013,1,60,6,4,2,5.89139024415332,3.14636206350406,2.74502818064927,56,29,27,67,44,23,85,53,32,4,4,0,0
"9134","EDM","L.A",2012020233,15755,20122013,1,60,1,3,-2,3.5190185259562,4.79478394379839,-1.27576541784219,24,38,-14,34,53,-19,42,69,-27,4,2,0,0
"9135","EDM","MIN",2012020246,15757,20122013,1,60,1,3,-2,4.84219697784283,4.15832424420783,0.683872733634999,28,28,0,41,39,2,54,60,-6,1,2,0,0
"9136","EDM","ARI",2012020252,15759,20122013,1,65,2,2,0,6.38002496526883,6.12704510231015,0.252979862958682,43,36,7,53,52,1,68,66,2,4,6,0,0
"9137","EDM","CHI",2012020273,15761,20122013,0,61.7333333333333,2,3,-1,1.21980124165225,4.20948459617767,-2.98968335452542,19,34,-15,24,46,-22,33,65,-32,4,2,0,0
"9138","EDM","DAL",2012020295,15764,20122013,0,60,5,1,4,7.59765969960404,6.09819274104639,1.49946695855764,38,34,4,47,49,-2,57,71,-14,9,7,0,0
"9139","EDM","STL",2012020299,15765,20122013,0,60,2,4,-2,5.09331298700999,3.55832722094417,1.53498576606582,17,30,-13,30,42,-12,45,64,-19,3,2,0,0
"9140","EDM","MIN",2012020318,15767,20122013,0,60,2,4,-2,0,0,0,21,43,-22,30,53,-23,42,62,-20,1,3,0,0
"9141","EDM","CBJ",2012020328,15769,20122013,0,65,3,3,0,3.04700443852926,5.40778102908202,-2.36077659055276,29,38,-9,35,50,-15,46,63,-17,3,4,0,0
"9142","EDM","DET",2012020347,15771,20122013,0,60,0,3,-3,3.24461758858524,3.57611386486678,-0.331496276281541,22,28,-6,28,42,-14,42,63,-21,0,1,0,0
"9143","EDM","NSH",2012020352,15772,20122013,0,60,0,6,-6,4.80524290437825,4.94065827078884,-0.135415366410598,24,34,-10,31,49,-18,38,62,-24,1,5,0,0
"9144","EDM","CHI",2012020370,15774,20122013,0,60,6,5,1,2.69672252934106,5.96599013048234,-3.26926760114128,25,37,-12,32,51,-19,43,68,-25,5,3,0,0
"9145","EDM","COL",2012020386,15776,20122013,0,60,4,0,4,6.58039204472152,3.82843553495997,2.75195650976156,32,35,-3,42,47,-5,45,58,-13,4,2,0,0
"9146","EDM","DET",2012020404,15779,20122013,1,63.65,2,3,-1,3.82227176056767,7.68001740443287,-3.8577456438652,32,29,3,38,44,-6,45,64,-19,3,5,0,0
"9147","EDM","NSH",2012020421,15781,20122013,1,60,3,2,1,1.84055147925392,3.91019249064947,-2.06964101139555,21,31,-10,26,48,-22,39,63,-24,2,4,0,0
"9148","EDM","S.J",2012020441,15784,20122013,1,65,3,3,0,3.9751837059739,4.55458441222228,-0.579400706248379,27,34,-7,41,49,-8,58,64,-6,6,3,0,0
"9149","EDM","STL",2012020464,15787,20122013,1,60,0,3,-3,2.97958634400857,2.82401143526658,0.155574908741983,19,25,-6,24,39,-15,34,57,-23,3,3,0,0
"9150","EDM","NSH",2012020475,15789,20122013,0,60,2,3,-1,7.11155446921475,2.10817454050266,5.00337992871209,26,26,0,33,30,3,48,43,5,4,2,0,0
"9151","EDM","STL",2012020485,15790,20122013,0,60,3,0,3,2.65956245688722,5.97867916926043,-3.31911671237322,19,43,-24,25,58,-33,34,68,-34,3,5,0,0
"9152","EDM","CBJ",2012020499,15792,20122013,1,60,6,4,2,7.21302775902222,5.8813568209298,1.33167093809243,25,30,-5,33,39,-6,49,56,-7,2,2,0,0
"9153","EDM","VAN",2012020515,15794,20122013,1,60,4,0,4,1.7312403130345,0.986496605379216,0.744743707655289,24,23,1,37,34,3,45,50,-5,3,3,0,0
"9154","EDM","CGY",2012020529,15796,20122013,1,60,4,1,3,3.27968009813992,7.76175805965613,-4.48207796151621,20,34,-14,31,50,-19,46,62,-16,3,4,0,0
"9155","EDM","CGY",2012020540,15798,20122013,0,60,8,2,6,4.17945940076709,5.91202073359741,-1.73256133283032,39,21,18,47,33,14,60,44,16,6,2,0,0
"9156","EDM","VAN",2012020550,15799,20122013,0,60,0,4,-4,2.46050696096474,2.84420725461678,-0.383700293652035,23,28,-5,34,37,-3,44,49,-5,4,5,0,0
"9157","EDM","L.A",2012020561,15801,20122013,0,60,1,4,-3,5.59479991330795,9.07385162683022,-3.47905171352227,24,39,-15,36,50,-14,47,66,-19,4,5,0,0
"9158","EDM","ANA",2012020581,15803,20122013,0,60,1,2,-1,2.95779702283834,5.69132806066074,-2.7335310378224,28,38,-10,41,49,-8,51,69,-18,3,5,0,0
"9159","EDM","ARI",2012020594,15805,20122013,1,60,1,3,-2,3.84236044785939,5.19516987993848,-1.35280943207908,30,32,-2,45,47,-2,53,63,-10,4,6,0,0
"9160","EDM","CGY",2012020619,15808,20122013,1,60,1,4,-3,4.25180040183477,4.33059547323501,-0.0787950714002363,29,38,-9,39,53,-14,46,71,-25,3,5,0,0
"9161","EDM","MIN",2012020638,15811,20122013,1,60,3,5,-2,2.51882223144639,3.68575991509999,-1.1669376836536,19,30,-11,31,36,-5,46,47,-1,1,2,0,0
"9162","EDM","COL",2012020658,15814,20122013,0,60,4,1,3,2.9236169627929,3.48055949667469,-0.556942533881783,24,34,-10,36,44,-8,49,68,-19,4,4,0,0
"9163","EDM","ANA",2012020673,15816,20122013,1,60,1,3,-2,3.43876603525132,3.40535751929565,0.0334085159556707,28,30,-2,37,48,-11,53,63,-10,4,5,0,0
"9164","EDM","ANA",2012020679,15817,20122013,1,60,0,3,-3,5.22115764213959,5.0828099699126,0.138347672226985,24,28,-4,35,41,-6,60,56,4,3,3,0,0
"9165","EDM","CHI",2012020692,15819,20122013,1,60,1,4,-3,4.91529236640781,3.60651637939372,1.30877598701409,22,30,-8,34,42,-8,47,54,-7,4,2,0,0
"9166","EDM","MIN",2012020705,15821,20122013,0,60,6,1,5,6.18391754198819,5.90468345487898,0.279234087109216,17,39,-22,27,52,-25,38,71,-33,2,2,0,0
"9167","EDM","VAN",2012020718,15822,20122013,1,60,7,2,5,6.7965326281701,2.88589408516418,3.91063854300592,37,30,7,60,49,11,68,59,9,6,5,0,0
"9168","EDM","WPG",2013020003,15979,20132014,1,60,4,5,-1,6.78524114167703,4.56710469065001,2.21813645102702,38,28,10,48,42,6,71,56,15,6,5,0,0
"9169","EDM","VAN",2013020030,15983,20132014,0,60,2,6,-4,2.34622794722245,8.07744679885218,-5.73121885162973,23,44,-21,35,55,-20,45,74,-29,7,10,0,0
"9170","EDM","N.J",2013020035,15985,20132014,1,65,4,4,0,4.23947868123651,4.1505608199077,0.0889178613288095,27,25,2,38,36,2,55,49,6,4,3,0,0
"9171","EDM","MTL",2013020055,15988,20132014,1,60,1,4,-3,2.80190928839147,3.27363143095882,-0.471722142567351,28,27,1,38,38,0,59,59,0,4,2,0,0
"9172","EDM","TOR",2013020064,15990,20132014,0,62.15,5,6,-1,4.66419335221872,4.64409415941918,0.0200991927995346,31,26,5,41,40,1,54,60,-6,4,3,0,0
"9173","EDM","WSH",2013020080,15992,20132014,0,60,2,4,-2,4.66016842157842,2.44849498872645,2.21167343285197,30,20,10,42,32,10,55,48,7,6,6,0,0
"9174","EDM","NYI",2013020098,15995,20132014,0,60,2,3,-1,2.44027681582018,3.49856590263653,-1.05828908681634,29,40,-11,35,48,-13,48,58,-10,3,5,0,0
"9175","EDM","OTT",2013020111,15997,20132014,0,60,3,1,2,2.28327417519029,5.00712351074753,-2.72384933555725,21,36,-15,24,55,-31,29,71,-42,7,6,0,0
"9176","EDM","MTL",2013020132,16000,20132014,0,60,4,3,1,3.9406543009971,4.64806576080058,-0.707411459803481,32,32,0,39,44,-5,57,74,-17,4,5,0,0
"9177","EDM","WSH",2013020147,16002,20132014,1,60,1,4,-3,0,0,0,31,26,5,44,36,8,57,45,12,4,3,0,0
"9178","EDM","ARI",2013020164,16004,20132014,0,60,4,5,-1,4.02737173468631,3.10616868454963,0.921203050136683,30,28,2,37,40,-3,46,54,-8,2,6,0,0
"9179","EDM","L.A",2013020170,16005,20132014,0,65,1,1,0,3.14059358208033,6.10332701988395,-2.96273343780362,18,48,-30,25,61,-36,32,79,-47,5,5,0,0
"9180","EDM","TOR",2013020182,16007,20132014,1,60,0,4,-4,3.86221250781091,1.64768393072882,2.21452857708209,43,26,17,55,34,21,76,49,27,2,2,0,0
"9181","EDM","DET",2013020210,16011,20132014,1,60,0,5,-5,2.03744024772536,4.53162740173866,-2.4941871540133,14,31,-17,24,48,-24,37,63,-26,3,5,0,0
"9182","EDM","FLA",2013020221,16014,20132014,0,61.9166666666667,4,3,1,3.93102046489366,4.58437506027985,-0.65335459538619,27,23,4,35,32,3,47,44,3,4,2,0,0
"9183","EDM","T.B",2013020237,16016,20132014,0,60,2,4,-2,4.19456986848704,4.19326261267997,0.00130725580706326,40,26,14,49,34,15,59,51,8,3,3,0,0
"9184","EDM","PHI",2013020245,16018,20132014,0,60,2,4,-2,3.36322186843609,5.89176759149996,-2.52854572306387,26,34,-8,31,56,-25,45,73,-28,6,3,0,0
"9185","EDM","CHI",2013020258,16019,20132014,0,60,4,5,-1,2.50860357299814,4.2681818548881,-1.75957828188996,23,36,-13,33,47,-14,37,70,-33,3,5,0,0
"9186","EDM","DAL",2013020276,16022,20132014,1,60,0,3,-3,3.62378114270814,5.43196601083037,-1.80818486812223,22,26,-4,32,49,-17,44,64,-20,5,7,0,0
"9187","EDM","S.J",2013020293,16024,20132014,1,60,1,3,-2,6.02410153578967,7.93329029239248,-1.90918875660282,31,37,-6,45,56,-11,63,68,-5,4,5,0,0
"9188","EDM","CGY",2013020302,16025,20132014,0,60,4,2,2,0,0,0,24,35,-11,32,48,-16,40,62,-22,2,3,0,0
"9189","EDM","CBJ",2013020319,16028,20132014,1,60,7,0,7,3.15781822526696,3.59197914111428,-0.434160915847315,32,14,18,43,26,17,54,41,13,5,2,0,0
"9190","EDM","FLA",2013020333,16030,20132014,1,60,4,1,3,2.96277481961687,2.87807539326387,0.0846994263529979,35,25,10,44,41,3,52,57,-5,5,5,0,0
"9191","EDM","CHI",2013020362,16034,20132014,1,60,1,5,-4,2.91123582037983,6.51495723208063,-3.6037214117008,25,27,-2,31,44,-13,42,52,-10,3,4,0,0
"9192","EDM","NSH",2013020379,16037,20132014,0,60,3,0,3,4.70396875096594,8.19870552855355,-3.4947367775876,28,33,-5,40,46,-6,58,54,4,5,4,0,0
"9193","EDM","CBJ",2013020390,16038,20132014,0,60,2,4,-2,4.56923256794107,3.65270306684621,0.916529501094857,27,28,-1,34,33,1,42,50,-8,7,5,0,0
"9194","EDM","DAL",2013020405,16040,20132014,0,65,2,2,0,4.49580973914614,7.14692648025277,-2.65111674110663,32,45,-13,48,55,-7,68,76,-8,6,4,0,0
"9195","EDM","ARI",2013020417,16042,20132014,1,60,2,6,-4,3.0587504087016,5.00528959004441,-1.94653918134281,33,33,0,44,40,4,65,50,15,8,5,0,0
"9196","EDM","COL",2013020431,16044,20132014,1,60,8,2,6,5.3407707264123,6.10329187722263,-0.762521150810329,28,35,-7,42,51,-9,51,65,-14,9,8,0,0
"9197","EDM","CGY",2013020447,16046,20132014,1,63.2333333333333,1,2,-1,3.4820483601361,3.31425789848083,0.167790461655272,31,27,4,47,38,9,71,46,25,6,2,0,0
"9198","EDM","CAR",2013020468,16049,20132014,1,61.8,5,4,1,3.82598569511902,6.05728707091475,-2.23130137579574,29,28,1,43,40,3,57,57,0,3,2,0,0
"9199","EDM","BOS",2013020482,16051,20132014,1,60,2,4,-2,5.38073237985373,3.03011528667209,2.35061709318163,41,31,10,54,36,18,74,48,26,3,1,0,0
"9200","EDM","VAN",2013020486,16052,20132014,0,60,0,4,-4,2.37225025705993,6.3664896911996,-3.99423943413967,19,40,-21,29,54,-25,37,72,-35,3,3,0,0
"9201","EDM","ANA",2013020504,16054,20132014,0,60,2,3,-1,2.7069842206256,6.35429641831433,-3.64731219768873,25,34,-9,32,50,-18,39,67,-28,2,1,0,0
"9202","EDM","L.A",2013020520,16056,20132014,0,60,0,3,-3,3.24243262474192,9.34949067869456,-6.10705805395264,24,40,-16,36,64,-28,52,71,-19,2,2,0,0
"9203","EDM","COL",2013020532,16058,20132014,0,60,2,4,-2,7.34324418823235,3.54207155447511,3.80117263375723,29,39,-10,39,48,-9,47,68,-21,1,1,0,0
"9204","EDM","STL",2013020549,16060,20132014,1,60,0,6,-6,2.3177313185588,5.21821886362159,-2.90048754506279,23,33,-10,35,41,-6,55,56,-1,6,7,0,0
"9205","EDM","WPG",2013020564,16062,20132014,1,60,6,2,4,4.59801708847226,3.63665958177446,0.961357506697797,30,20,10,49,39,10,60,50,10,9,5,0,0
"9206","EDM","CGY",2013020575,16066,20132014,0,60,2,0,2,2.37962395769082,3.72540788524202,-1.3457839275512,28,27,1,32,36,-4,42,50,-8,4,2,0,0
"9207","EDM","PHI",2013020584,16067,20132014,1,65,3,3,0,5.23527845018543,4.56478419719497,0.670494252990466,16,38,-22,27,57,-30,34,74,-40,5,5,0,0
"9208","EDM","ARI",2013020609,16070,20132014,0,64.8833333333333,3,4,-1,2.90489032230107,8.14838420570595,-5.24349388340488,25,45,-20,30,61,-31,44,75,-31,1,2,0,0
"9209","EDM","S.J",2013020621,16072,20132014,0,60,1,5,-4,3.78532668028849,4.04432881883986,-0.259002138551372,24,36,-12,35,49,-14,47,64,-17,3,3,0,0
"9210","EDM","ANA",2013020625,16073,20132014,0,60,2,5,-3,2.72574448884025,7.05171491517831,-4.32597042633806,18,37,-19,24,54,-30,33,68,-35,3,7,0,0
"9211","EDM","T.B",2013020641,16075,20132014,1,60,5,3,2,3.62593197647948,5.5317287753569,-1.90579679887742,26,27,-1,35,46,-11,47,58,-11,3,2,0,0
"9212","EDM","STL",2013020653,16077,20132014,1,60,2,5,-3,1.65502558082335,5.38297813006648,-3.72795254924313,18,30,-12,27,48,-21,38,65,-27,0,3,0,0
"9213","EDM","CHI",2013020689,16082,20132014,0,60,3,5,-2,2.46045174162282,6.81808776925027,-4.35763602762745,21,41,-20,28,56,-28,40,74,-34,1,5,0,0
"9214","EDM","DAL",2013020706,16084,20132014,0,60,2,5,-3,3.54690141455376,5.24665882636915,-1.69975741181539,33,30,3,50,44,6,68,58,10,2,1,0,0
"9215","EDM","MIN",2013020716,16086,20132014,0,60,1,4,-3,1.63796828237719,3.75641562861983,-2.11844734624265,21,33,-12,30,47,-17,41,58,-17,5,4,0,0
"9216","EDM","WPG",2013020725,16088,20132014,0,61.1666666666667,2,3,-1,2.66205084951071,7.48493943394351,-4.8228885844328,22,39,-17,30,58,-28,44,78,-34,5,5,0,0
"9217","EDM","VAN",2013020754,16091,20132014,1,60,1,2,-1,2.82756936457008,3.11681486209739,-0.289245497527304,29,27,2,39,43,-4,53,56,-3,4,4,0,0
"9218","EDM","ARI",2013020774,16094,20132014,1,60,3,4,-1,4.87107287393883,6.89116996550001,-2.02009709156118,39,29,10,51,42,9,63,61,2,6,3,0,0
"9219","EDM","NSH",2013020787,16096,20132014,1,60,5,1,4,5.38451584760332,7.52938517893199,-2.14486933132866,27,35,-8,43,47,-4,58,67,-9,3,3,0,0
"9220","EDM","VAN",2013020793,16097,20132014,0,60,4,2,2,3.10226096244878,4.12655497680096,-1.02429401435218,20,27,-7,30,37,-7,48,54,-6,4,3,0,0
"9221","EDM","S.J",2013020807,16099,20132014,1,60,3,0,3,1.92435673748863,6.1230398775042,-4.19868314001556,27,59,-32,31,78,-47,38,100,-62,3,4,0,0
"9222","EDM","BOS",2013020824,16102,20132014,0,60,0,4,-4,4.96815851652354,4.96215089415182,0.00600762237172603,22,41,-19,34,58,-24,40,74,-34,5,6,0,0
"9223","EDM","BUF",2013020837,16104,20132014,0,60,3,2,1,3.9745177827176,7.80872787633461,-3.83421009361702,28,44,-16,39,60,-21,46,73,-27,6,7,0,0
"9224","EDM","NYR",2013020857,16107,20132014,0,60,2,1,1,4.14458545331217,6.97971530323525,-2.83512984992308,31,36,-5,42,50,-8,51,65,-14,1,0,0,0
"9225","EDM","N.J",2013020867,16108,20132014,0,62.5666666666667,1,2,-1,2.80536262266105,4.41414170503413,-1.60877908237308,20,24,-4,29,33,-4,36,47,-11,3,3,0,0
"9226","EDM","MIN",2013020897,16128,20132014,1,60,0,3,-3,1.94035955396248,2.66481013323164,-0.72445057926916,21,21,0,26,34,-8,40,45,-5,7,5,0,0
"9227","EDM","CGY",2013020911,16130,20132014,1,61.8333333333333,1,2,-1,3.41374232364682,2.82777584332507,0.585966480321748,22,30,-8,37,46,-9,64,65,-1,3,4,0,0
"9228","EDM","OTT",2013020932,16133,20132014,1,60,3,2,1,4.75472126493696,4.53985679517064,0.214864469766326,30,36,-6,38,53,-15,47,73,-26,3,3,0,0
"9229","EDM","NYI",2013020946,16135,20132014,1,62.4833333333333,3,2,1,4.35886765960458,5.37383160933047,-1.01496394972588,29,34,-5,44,51,-7,56,65,-9,4,4,0,0
"9230","EDM","L.A",2013020967,16138,20132014,1,60,2,4,-2,4.19361685391414,4.66105313244327,-0.467436278529135,27,50,-23,39,64,-25,56,78,-22,4,4,0,0
"9231","EDM","MIN",2013020983,16140,20132014,0,65,3,3,0,5.00645397760672,3.29325169078963,1.71320228681709,26,31,-5,33,47,-14,41,59,-18,3,4,0,0
"9232","EDM","STL",2013020993,16142,20132014,0,60,2,6,-4,3.25700501294599,3.75166353019788,-0.494658517251894,25,37,-12,34,55,-21,43,72,-29,6,8,0,0
"9233","EDM","DET",2013020998,16143,20132014,0,65,1,1,0,2.10411242669215,3.67184397915844,-1.56773155246628,22,23,-1,27,43,-16,42,58,-16,3,5,0,0
"9234","EDM","CAR",2013021015,16145,20132014,0,60,2,1,1,6.64457217635754,4.07642997259973,2.56814220375782,33,30,3,46,47,-1,55,67,-12,6,5,0,0
"9235","EDM","NSH",2013021035,16147,20132014,1,60,5,1,4,5.57975807068374,7.16827129778202,-1.58851322709829,30,29,1,41,44,-3,54,58,-4,5,6,0,0
"9236","EDM","BUF",2013021047,16149,20132014,1,60,1,3,-2,5.30986379712704,1.47937361465002,3.83049018247701,36,36,0,52,43,9,67,56,11,7,3,0,0
"9237","EDM","CGY",2013021064,16151,20132014,1,60,1,8,-7,5.23861583703547,6.67202658602037,-1.4334107489849,25,31,-6,38,51,-13,50,60,-10,3,5,0,0
"9238","EDM","S.J",2013021088,16154,20132014,1,60,2,5,-3,3.3330056888517,5.41694831383938,-2.08394262498769,30,34,-4,38,46,-8,60,63,-3,2,3,0,0
"9239","EDM","ANA",2013021107,16157,20132014,1,63.85,4,3,1,2.9440101597429,6.88297309612972,-3.93896293638682,23,51,-28,29,67,-38,37,82,-45,4,6,0,0
"9240","EDM","NYR",2013021124,16159,20132014,1,60,0,5,-5,3.7828816856545,2.82640199741581,0.956479688238687,26,32,-6,37,53,-16,47,66,-19,5,6,0,0
"9241","EDM","S.J",2013021139,16161,20132014,0,60,4,5,-1,2.16207227809178,5.30088477098109,-3.1388124928893,29,33,-4,39,45,-6,49,61,-12,5,9,0,0
"9242","EDM","ANA",2013021142,16162,20132014,0,60,2,3,-1,4.77351076620107,2.53059435257182,2.24291641362925,32,26,6,39,35,4,47,47,0,5,5,0,0
"9243","EDM","ARI",2013021158,16164,20132014,0,65,2,2,0,2.61737773969071,3.40341539006377,-0.786037650373064,26,26,0,38,40,-2,55,52,3,1,2,0,0
"9244","EDM","ANA",2013021176,16166,20132014,1,60,4,2,2,4.40307690707724,6.86604911529867,-2.46297220822143,28,36,-8,34,50,-16,47,75,-28,3,5,0,0
"9245","EDM","COL",2013021189,16168,20132014,1,60,1,4,-3,2.26439064016449,3.39001569059383,-1.12562505042933,23,33,-10,36,47,-11,53,58,-5,3,2,0,0
"9246","EDM","L.A",2013021203,16170,20132014,1,60,0,3,-3,2.38930986402374,4.59009229994263,-2.20078243591888,17,48,-31,27,61,-34,39,81,-42,0,4,0,0
"9247","EDM","VAN",2013021219,16172,20132014,1,60,5,2,3,4.17212455768532,5.64062277529956,-1.46849821761424,22,42,-20,39,55,-16,54,78,-24,5,3,0,0
"9248","EDM","CGY",2014020015,16352,20142015,1,60,2,5,-3,5.46300508716376,4.89510364207948,0.567901445084289,40,26,14,57,33,24,75,39,36,3,2,0,0
"9249","EDM","VAN",2014020031,16354,20142015,0,65,4,4,0,3.06599880760768,7.08442181107239,-4.0184230034647,29,43,-14,39,63,-24,49,75,-26,3,6,0,0
"9250","EDM","L.A",2014020046,16357,20142015,0,60,1,6,-5,3.74044028695062,5.9854746205674,-2.24503433361679,32,26,6,41,39,2,53,45,8,3,3,0,0
"9251","EDM","ARI",2014020049,16358,20142015,0,60,4,7,-3,3.35949579312341,7.36056018577074,-4.00106439264733,27,30,-3,37,41,-4,54,53,1,3,5,0,0
"9252","EDM","VAN",2014020061,16360,20142015,1,60,0,2,-2,4.20202007435,4.25784614905569,-0.055826074705692,28,30,-2,39,39,0,58,56,2,4,3,0,0
"9253","EDM","T.B",2014020078,16363,20142015,1,60,3,2,1,4.77916625124635,3.55878683777701,1.22037941346935,23,24,-1,39,29,10,50,43,7,4,3,0,0
"9254","EDM","WSH",2014020091,16365,20142015,1,60,3,2,1,3.93199598789215,4.30274623304285,-0.370750245150703,20,34,-14,27,48,-21,36,66,-30,2,2,0,0
"9255","EDM","CAR",2014020104,16367,20142015,1,60,6,3,3,5.2546881631838,2.81937068660045,2.43531747658335,29,30,-1,46,38,8,63,52,11,4,1,0,0
"9256","EDM","MTL",2014020123,16370,20142015,1,60,3,0,3,0,0,0,19,29,-10,30,40,-10,43,61,-18,6,4,0,0
"9257","EDM","NSH",2014020137,16372,20142015,1,60,1,4,-3,4.19041806890164,4.51746140432078,-0.327043335419148,27,35,-8,41,41,0,65,55,10,2,1,0,0
"9258","EDM","VAN",2014020163,16375,20142015,1,60,2,3,-1,5.35502693912713,5.23335317692181,0.121673762205319,27,30,-3,37,43,-6,48,50,-2,3,3,0,0
"9259","EDM","PHI",2014020174,16378,20142015,0,60,1,4,-3,7.6499677570464,3.49273643704305,4.15723132000335,36,25,11,54,37,17,73,55,18,4,0,0,0
"9260","EDM","BOS",2014020187,16380,20142015,0,60,2,5,-3,3.1307160484721,4.62552549926412,-1.49480945079202,26,32,-6,39,40,-1,50,54,-4,4,4,0,0
"9261","EDM","BUF",2014020197,16381,20142015,0,60,3,2,1,3.91691076403367,3.16489506889047,0.7520156951432,52,31,21,68,43,25,85,51,34,2,1,0,0
"9262","EDM","NYR",2014020215,16383,20142015,0,60,3,1,2,4.00623876248574,3.85290261651971,0.153336145966023,33,21,12,42,33,9,60,46,14,3,1,0,0
"9263","EDM","NSH",2014020227,16385,20142015,0,60,2,3,-1,2.42546986661773,3.84217099997477,-1.41670113335704,23,35,-12,28,42,-14,36,56,-20,2,2,0,0
"9264","EDM","OTT",2014020240,16387,20142015,1,62.65,3,4,-1,3.92440516034549,2.31266460274834,1.61174055759714,37,30,7,49,39,10,55,49,6,5,5,0,0
"9265","EDM","ARI",2014020265,16390,20142015,1,60,1,2,-1,7.00773932075481,4.89525422433508,2.11248509641973,34,28,6,45,36,9,70,57,13,4,4,0,0
"9266","EDM","VAN",2014020279,16393,20142015,1,60,4,5,-1,5.62316537430763,3.73814331645372,1.88502205785392,32,31,1,45,44,1,59,59,0,5,5,0,0
"9267","EDM","N.J",2014020294,16395,20142015,1,60,0,2,-2,7.04593050076161,3.37177971119672,3.67415078956489,29,26,3,46,33,13,69,39,30,3,2,0,0
"9268","EDM","CHI",2014020306,16396,20142015,1,60,1,7,-6,2.57286716034463,4.49158703466258,-1.91871987431795,25,30,-5,33,46,-13,47,59,-12,3,8,0,0
"9269","EDM","DAL",2014020319,16399,20142015,0,60,2,3,-1,5.71842585564002,4.20717822905863,1.51124762658139,37,34,3,44,49,-5,67,65,2,2,4,0,0
"9270","EDM","NSH",2014020332,16401,20142015,0,63.9166666666667,0,1,-1,5.0557363535094,4.52123778463283,0.534498568876572,37,25,12,46,45,1,60,62,-2,5,6,0,0
"9271","EDM","STL",2014020342,16402,20142015,0,64.3333333333333,3,4,-1,1.98881844140124,7.00301223521819,-5.01419379381696,16,41,-25,26,61,-35,39,76,-37,0,3,0,0
"9272","EDM","ARI",2014020360,16405,20142015,1,60,2,5,-3,0,0,0,27,24,3,37,31,6,50,42,8,5,3,0,0
"9273","EDM","WPG",2014020374,16407,20142015,0,60.2833333333333,2,3,-1,3.14277869532816,2.76347463740967,0.379304057918489,24,26,-2,33,32,1,43,52,-9,1,0,0,0
"9274","EDM","S.J",2014020405,16411,20142015,1,60,2,1,1,1.46585763001349,3.42861549300142,-1.96275786298793,24,21,3,27,31,-4,43,43,0,3,3,0,0
"9275","EDM","S.J",2014020418,16413,20142015,0,60,2,5,-3,4.92907104043388,3.07212620549797,1.85694483493591,27,24,3,42,32,10,64,48,16,2,1,0,0
"9276","EDM","ANA",2014020420,16414,20142015,0,60,1,2,-1,3.73845433695533,5.8416161597298,-2.10316182277447,22,34,-12,32,42,-10,43,51,-8,2,4,0,0
"9277","EDM","ANA",2014020434,16416,20142015,1,60,2,4,-2,3.37512627892511,2.1697168252515,1.20540945367361,23,20,3,31,30,1,47,38,9,4,2,0,0
"9278","EDM","NYR",2014020450,16418,20142015,1,60,0,2,-2,2.76081333763432,4.05836503143655,-1.29755169380223,16,22,-6,29,36,-7,50,46,4,2,1,0,0
"9279","EDM","ARI",2014020463,16420,20142015,0,64.9833333333333,1,2,-1,9.06103675680478,8.45311354484875,0.607923211956034,32,44,-12,52,57,-5,71,76,-5,2,4,0,0
"9280","EDM","S.J",2014020473,16422,20142015,0,60,3,4,-1,3.18983653966916,4.38877214002423,-1.19893560035507,28,30,-2,38,42,-4,54,63,-9,1,3,0,0
"9281","EDM","DAL",2014020492,16425,20142015,1,65,5,5,0,3.95081231340423,5.54948356495879,-1.59867125155456,29,45,-16,38,65,-27,50,83,-33,2,4,0,0
"9282","EDM","ARI",2014020510,16427,20142015,1,60,1,5,-4,4.33217302018738,4.6437550535893,-0.311582033401919,27,22,5,39,34,5,54,52,2,7,3,0,0
"9283","EDM","CGY",2014020525,16431,20142015,0,60,1,4,-3,5.00938283792548,5.46693221776218,-0.457549379836699,27,27,0,46,33,13,63,53,10,7,5,0,0
"9284","EDM","L.A",2014020543,16434,20142015,1,65,2,2,0,4.79370745678898,5.65329740608286,-0.859589949293877,21,39,-18,38,49,-11,57,68,-11,4,4,0,0
"9285","EDM","CGY",2014020555,16435,20142015,0,61.1333333333333,3,4,-1,4.99606897363958,3.623111632769,1.37295734087058,20,28,-8,32,43,-11,50,63,-13,4,5,0,0
"9286","EDM","COL",2014020563,16437,20142015,0,65,1,1,0,6.26791566341126,6.6708172931103,-0.402901629699045,28,28,0,36,44,-8,52,57,-5,5,4,0,0
"9287","EDM","NYI",2014020582,16439,20142015,1,60,5,2,3,4.4008799722651,4.22501282498706,0.175867147278041,23,33,-10,36,49,-13,59,64,-5,2,4,0,0
"9288","EDM","DET",2014020592,16441,20142015,1,60,2,4,-2,4.36227195696483,6.38448698120555,-2.02221502424072,23,41,-18,34,59,-25,40,76,-36,3,5,0,0
"9289","EDM","CHI",2014020612,16444,20142015,1,60,5,2,3,3.37589477642905,3.21846306370571,0.157431712723337,22,21,1,33,28,5,52,49,3,2,2,0,0
"9290","EDM","FLA",2014020624,16446,20142015,1,60,2,4,-2,5.46477969444823,3.80403952318375,1.66074017126448,33,27,6,42,42,0,54,48,6,2,2,0,0
"9291","EDM","STL",2014020635,16448,20142015,0,60,2,4,-2,2.46029725135304,3.90533811785281,-1.44504086649977,15,29,-14,26,37,-11,43,45,-2,5,6,0,0
"9292","EDM","T.B",2014020648,16450,20142015,0,60,2,3,-1,3.55119094445013,2.59907144664612,0.952119497804006,32,19,13,41,30,11,56,44,12,4,1,0,0
"9293","EDM","FLA",2014020666,16452,20142015,0,65,2,2,0,3.18143897993832,2.07831204403192,1.1031269359064,34,37,-3,42,47,-5,53,57,-4,4,3,0,0
"9294","EDM","WSH",2014020685,16455,20142015,0,65,4,4,0,4.2234023705039,2.00882935160689,2.21457301889701,31,24,7,40,40,0,60,61,-1,6,2,0,0
"9295","EDM","MIN",2014020706,16462,20142015,1,60,1,2,-1,4.66096486235631,4.97282388561871,-0.3118590232624,24,29,-5,42,46,-4,60,62,-2,4,3,0,0
"9296","EDM","BUF",2014020720,16464,20142015,1,60,3,2,1,5.51895564421513,3.6651487602503,1.85380688396482,34,20,14,52,28,24,74,37,37,3,2,0,0
"9297","EDM","CGY",2014020736,16466,20142015,0,60,2,4,-2,1.91708712137915,3.8112380028615,-1.89415088148235,19,33,-14,29,50,-21,48,72,-24,1,4,0,0
"9298","EDM","S.J",2014020744,16468,20142015,0,65,4,4,0,4.30611739103915,7.85029241633646,-3.54417502529731,40,37,3,55,60,-5,71,74,-3,1,2,0,0
"9299","EDM","TOR",2014020777,16473,20142015,0,60,1,5,-4,4.91238527733367,5.62163033688999,-0.709245059556324,32,28,4,49,49,0,66,61,5,2,3,0,0
"9300","EDM","N.J",2014020792,16475,20142015,0,60,2,1,1,4.2713898960501,1.34436522307806,2.92702467297204,24,14,10,37,24,13,47,34,13,4,2,0,0
"9301","EDM","NYI",2014020799,16476,20142015,0,60,2,3,-1,4.85008445329731,3.03763282436114,1.81245162893617,36,28,8,42,42,0,53,57,-4,4,3,0,0
"9302","EDM","MTL",2014020811,16478,20142015,0,61.7833333333333,4,3,1,6.82221098617538,3.7919199867174,3.03029099945797,38,26,12,52,37,15,65,55,10,3,3,0,0
"9303","EDM","OTT",2014020823,16480,20142015,0,60,2,7,-5,6.2270655373438,7.19973955219393,-0.972674014850135,27,42,-15,38,53,-15,49,66,-17,2,2,0,0
"9304","EDM","WPG",2014020841,16482,20142015,0,65,4,4,0,2.90654901077505,4.63433652865933,-1.72778751788428,22,46,-24,30,60,-30,41,72,-31,4,3,0,0
"9305","EDM","BOS",2014020857,16484,20142015,1,65,3,3,0,4.58336846742168,7.72184435883537,-3.13847589141369,30,41,-11,39,58,-19,58,74,-16,4,1,0,0
"9306","EDM","MIN",2014020872,16486,20142015,1,60,0,4,-4,0.700005168444477,3.83607715393009,-3.13607198548561,15,29,-14,22,40,-18,36,48,-12,1,0,0,0
"9307","EDM","ANA",2014020879,16487,20142015,1,60,1,2,-1,3.08406450576149,3.4178287037536,-0.333764197992111,27,21,6,37,32,5,57,45,12,2,1,0,0
"9308","EDM","MIN",2014020901,16490,20142015,0,60,2,1,1,2.77764952747384,2.48591030323587,0.291739224237972,19,34,-15,29,45,-16,43,69,-26,2,3,0,0
"9309","EDM","STL",2014020931,16494,20142015,1,60,1,2,-1,2.70520069624763,4.12617414246779,-1.42097344622016,22,27,-5,33,50,-17,49,65,-16,1,2,0,0
"9310","EDM","L.A",2014020950,16497,20142015,1,60,2,5,-3,2.74193792556525,2.40649173263228,0.335446192932977,23,29,-6,36,37,-1,54,52,2,4,3,0,0
"9311","EDM","CHI",2014020968,16500,20142015,0,65,1,1,0,5.14846158496465,7.24023771926295,-2.0917761342983,47,39,8,56,56,0,76,78,-2,1,3,0,0
"9312","EDM","CAR",2014020980,16502,20142015,0,60,4,7,-3,2.77937983925244,5.86165655487275,-3.08227671562031,20,35,-15,25,51,-26,36,71,-35,4,6,0,0
"9313","EDM","DET",2014020987,16503,20142015,0,60,2,5,-3,5.20415499073301,5.62249477510341,-0.41833978437039,38,26,12,46,39,7,50,51,-1,5,3,0,0
"9314","EDM","CBJ",2014021015,16507,20142015,0,65,4,4,0,5.05824251030572,2.62769445173922,2.4305480585665,35,31,4,42,44,-2,52,59,-7,5,3,0,0
"9315","EDM","TOR",2014021039,16510,20142015,1,60,4,1,3,5.24170890171081,2.61295299263293,2.62875590907788,32,29,3,43,38,5,53,45,8,6,5,0,0
"9316","EDM","CBJ",2014021051,16512,20142015,1,65,3,3,0,8.65580005581432,3.17097559747344,5.48482445834088,47,20,27,63,29,34,76,38,38,7,2,0,0
"9317","EDM","PHI",2014021078,16515,20142015,1,62.7666666666667,5,4,1,8.95085932364146,3.80385815034494,5.14700117329652,34,31,3,50,40,10,69,57,12,4,4,0,0
"9318","EDM","WPG",2014021089,16517,20142015,1,60,1,4,-3,4.67867324000451,4.510686281997,0.167986958007511,34,24,10,44,37,7,54,59,-5,5,5,0,0
"9319","EDM","COL",2014021099,16519,20142015,1,60,4,3,1,5.68440594465937,4.09597710461821,1.58842884004116,34,44,-10,43,57,-14,58,77,-19,1,5,0,0
"9320","EDM","DAL",2014021114,16521,20142015,1,60,4,0,4,3.62199984036852,2.89623528749507,0.725764552873443,28,29,-1,34,50,-16,42,75,-33,3,4,0,0
"9321","EDM","COL",2014021140,16524,20142015,0,60,4,1,3,6.31357334097265,2.26130234028096,4.05227100069169,36,30,6,48,45,3,56,52,4,0,1,0,0
"9322","EDM","ANA",2014021151,16526,20142015,0,60,1,5,-4,1.38425843117147,4.94850861811221,-3.56425018694074,23,27,-4,34,43,-9,50,49,1,4,3,0,0
"9323","EDM","L.A",2014021161,16527,20142015,0,60,2,8,-6,4.21557040706466,4.53121387907436,-0.315643472009697,30,33,-3,43,47,-4,53,64,-11,3,2,0,0
"9324","EDM","CGY",2014021178,16529,20142015,1,60,0,4,-4,3.15474195453862,3.92235691376118,-0.767614959222556,27,29,-2,49,40,9,66,57,9,0,1,0,0
"9325","EDM","L.A",2014021199,16532,20142015,1,60,4,2,2,3.16225782397669,4.95830750623401,-1.79604968225732,22,27,-5,28,36,-8,38,54,-16,2,3,0,0
"9326","EDM","S.J",2014021212,16534,20142015,1,60,1,3,-2,4.73385402961168,8.84461187686389,-4.11075784725222,27,52,-25,39,71,-32,56,95,-39,2,0,0,0
"9327","EDM","VAN",2014021230,16536,20142015,0,62.4833333333333,5,6,-1,4.67556387958234,3.75836837427033,0.917195505312015,28,23,5,38,34,4,57,52,5,1,3,0,0
"9328","EDM","STL",2015020008,16716,20152016,0,60,1,3,-2,2.93784244595276,3.91374759422803,-0.975905148275264,25,31,-6,32,44,-12,49,57,-8,4,4,0,0
"9329","EDM","NSH",2015020024,16718,20152016,0,60,0,2,-2,4.23685859080979,3.78532148183481,0.451537108974975,31,26,5,41,29,12,57,42,15,5,2,0,0
"9330","EDM","DAL",2015020043,16721,20152016,0,60,2,4,-2,4.25264961065216,7.02619663177757,-2.77354702112541,28,52,-24,35,62,-27,48,87,-39,2,5,0,0
"9331","EDM","STL",2015020056,16723,20152016,1,60,2,4,-2,2.14473584160442,5.99361889581346,-3.84888305420904,26,29,-3,34,42,-8,51,55,-4,5,4,0,0
"9332","EDM","CGY",2015020073,16725,20152016,0,60,5,2,3,4.68559036689112,4.41521574801656,0.270374618874559,28,24,4,43,34,9,63,53,10,4,4,0,0
"9333","EDM","VAN",2015020078,16726,20152016,0,61.7666666666667,2,1,1,3.21660763466794,4.75040397932753,-1.53379634465959,24,34,-10,31,47,-16,37,56,-19,2,2,0,0
"9334","EDM","DET",2015020090,16729,20152016,1,60,3,1,2,2.89463948102835,4.02384314878327,-1.12920366775492,28,29,-1,35,46,-11,43,70,-27,3,6,0,0
"9335","EDM","WSH",2015020104,16731,20152016,1,60,4,7,-3,3.55279984894514,4.80674261904308,-1.25394277009794,23,26,-3,39,37,2,55,49,6,6,4,0,0
"9336","EDM","L.A",2015020120,16733,20152016,1,60,2,3,-1,3.20081850397401,3.54076643068402,-0.339947926710011,28,34,-6,34,41,-7,52,59,-7,2,2,0,0
"9337","EDM","MIN",2015020130,16735,20152016,0,60,3,4,-1,5.3777861689814,7.32393080664406,-1.94614463766266,25,28,-3,37,45,-8,55,59,-4,1,2,0,0
"9338","EDM","MTL",2015020144,16737,20152016,1,60,4,3,1,4.51575887108629,3.34779299599177,1.16796587509452,27,21,6,37,28,9,54,39,15,5,3,0,0
"9339","EDM","CGY",2015020163,16739,20152016,1,60,4,5,-1,2.90043949114624,4.9181237540738,-2.01768426292756,23,32,-9,31,41,-10,48,48,0,5,4,0,0
"9340","EDM","PHI",2015020179,16742,20152016,1,60,4,2,2,6.91371303958101,4.37552769911417,2.53818534046684,49,22,27,61,33,28,87,41,46,5,2,0,0
"9341","EDM","CHI",2015020214,16747,20152016,0,60,2,4,-2,3.64989009010719,3.34049824730027,0.309391842806917,36,28,8,45,35,10,56,60,-4,2,5,0,0
"9342","EDM","ANA",2015020229,16750,20152016,0,61.2666666666667,4,3,1,4.67765544845497,4.80857700777415,-0.130921559319177,27,37,-10,44,49,-5,58,59,-1,2,2,0,0
"9343","EDM","ARI",2015020240,16751,20152016,0,60,1,4,-3,4.58207520890392,2.88939627630502,1.69267893259889,28,21,7,37,31,6,52,41,11,4,3,0,0
"9344","EDM","L.A",2015020258,16753,20152016,0,60,3,4,-1,4.99980622284983,2.94668378107599,2.05312244177384,25,28,-3,41,41,0,52,60,-8,3,4,0,0
"9345","EDM","CHI",2015020277,16757,20152016,1,61.1333333333333,3,4,-1,0,0,0,37,27,10,49,34,15,64,43,21,3,2,0,0
"9346","EDM","N.J",2015020292,16759,20152016,1,60,5,1,4,3.75246664976487,2.22881627071183,1.52365037905304,27,20,7,35,34,1,54,47,7,6,4,0,0
"9347","EDM","WSH",2015020311,16762,20152016,0,60,0,1,-1,3.72141224608509,2.43050761531049,1.2909046307746,33,30,3,49,43,6,68,54,14,3,3,0,0
"9348","EDM","CAR",2015020323,16764,20152016,0,60,1,4,-3,5.45127237699762,6.12982880443451,-0.678556427436888,31,27,4,42,44,-2,54,57,-3,4,1,0,0
"9349","EDM","DET",2015020338,16766,20152016,0,60.4333333333333,3,4,-1,4.68620385392569,3.79160214619651,0.89460170772918,24,32,-8,40,42,-2,50,57,-7,2,2,0,0
"9350","EDM","TOR",2015020357,16769,20152016,0,60,0,3,-3,6.74472628368165,3.91453096797692,2.83019531570473,24,26,-2,40,40,0,57,59,-2,3,3,0,0
"9351","EDM","BOS",2015020371,16771,20152016,1,65,2,2,0,3.26149245072884,4.90864537228578,-1.64715292155694,36,40,-4,45,56,-11,57,65,-8,5,2,0,0
"9352","EDM","DAL",2015020386,16773,20152016,1,60.75,2,1,1,3.85412175561942,4.95132257824298,-1.09720082262356,24,43,-19,33,58,-25,47,77,-30,3,4,0,0
"9353","EDM","BUF",2015020402,16775,20152016,1,60,4,2,2,2.25414238803559,5.16648999141762,-2.91234760338203,28,34,-6,37,45,-8,50,56,-6,3,6,0,0
"9354","EDM","S.J",2015020419,16778,20152016,1,63.9833333333333,4,3,1,3.1601544378791,4.84450160716369,-1.68434716928459,20,28,-8,28,42,-14,42,59,-17,2,4,0,0
"9355","EDM","NYR",2015020432,16780,20152016,1,60,7,5,2,4.27220466688595,4.25990178633947,0.0123028805464855,37,34,3,45,46,-1,56,56,0,3,2,0,0
"9356","EDM","BOS",2015020448,16783,20152016,0,60.6833333333333,3,2,1,1.83426636195091,7.0085229066558,-5.17425654470489,24,49,-25,29,63,-34,41,79,-38,3,3,0,0
"9357","EDM","NYR",2015020455,16784,20152016,0,60,2,4,-2,2.1395778789938,3.41911817280634,-1.27954029381254,20,21,-1,30,32,-2,53,48,5,6,5,0,0
"9358","EDM","CHI",2015020473,16786,20152016,0,60,0,4,-4,3.83111574055511,3.65067119596642,0.180444544588681,33,37,-4,39,41,-2,49,60,-11,0,2,0,0
"9359","EDM","COL",2015020492,16788,20152016,0,60,1,5,-4,4.72657904176958,3.98400535152244,0.742573690247147,40,29,11,51,36,15,70,47,23,2,1,0,0
"9360","EDM","WPG",2015020506,16790,20152016,1,60,3,1,2,3.05724292299783,7.12614227683772,-4.06889935383989,21,45,-24,27,63,-36,37,83,-46,4,7,0,0
"9361","EDM","VAN",2015020525,16795,20152016,0,64.0166666666667,1,2,-1,3.97835729660437,3.39828171691624,0.580075579688128,33,24,9,45,42,3,54,52,2,3,2,0,0
"9362","EDM","CGY",2015020534,16796,20152016,0,60,3,5,-2,5.48010290920675,5.30776919726259,0.172333711944162,31,37,-6,46,49,-3,66,64,2,1,3,0,0
"9363","EDM","L.A",2015020549,16798,20152016,1,60,2,5,-3,6.11809826776152,3.53108115092618,2.58701711683534,44,33,11,60,50,10,81,75,6,2,2,0,0
"9364","EDM","ANA",2015020563,16800,20152016,1,60,0,1,-1,1.61204953741981,4.20200215619116,-2.58995261877135,21,35,-14,25,42,-17,41,61,-20,4,3,0,0
"9365","EDM","ARI",2015020568,16802,20152016,1,65,3,3,0,4.91275334608087,3.97855897513681,0.934194370944065,41,34,7,51,49,2,70,65,5,5,4,0,0
"9366","EDM","CAR",2015020586,16804,20152016,1,62.7833333333333,1,0,1,7.36006918949715,2.83092710811616,4.529142081381,27,29,-2,38,42,-4,49,64,-15,2,1,0,0
"9367","EDM","T.B",2015020612,16808,20152016,1,60,2,3,-1,2.65693706586899,3.75812811870337,-1.10119105283438,26,27,-1,40,36,4,53,55,-2,3,3,0,0
"9368","EDM","FLA",2015020629,16810,20152016,1,60,1,2,-1,5.86551416572547,3.00949552455131,2.85601864117416,25,14,11,46,24,22,69,36,33,2,0,0,0
"9369","EDM","ARI",2015020641,16812,20152016,0,64.85,3,4,-1,7.47187504791287,4.86163734635102,2.61023770156186,28,31,-3,54,48,6,64,63,1,3,4,0,0
"9370","EDM","S.J",2015020653,16814,20152016,0,65,1,1,0,5.65322046977235,7.04995450872229,-1.39673403894994,25,37,-12,35,50,-15,52,61,-9,1,4,0,0
"9371","EDM","CGY",2015020668,16816,20152016,1,65,1,1,0,5.80205278465472,2.96748281878899,2.83456996586573,37,32,5,43,38,5,67,59,8,1,5,0,0
"9372","EDM","FLA",2015020677,16818,20152016,0,60,4,2,2,4.26275203702971,3.9575926341131,0.305159402916615,24,33,-9,31,42,-11,39,49,-10,1,4,0,0
"9373","EDM","T.B",2015020687,16819,20152016,0,60,4,6,-2,4.17531532341728,3.20417172880824,0.971143594609036,26,31,-5,37,42,-5,45,51,-6,5,3,0,0
"9374","EDM","DAL",2015020700,16821,20152016,0,60,2,3,-1,4.50114776485134,4.50820146753904,-0.00705370268769911,25,35,-10,41,53,-12,65,65,0,3,2,0,0
"9375","EDM","NSH",2015020719,16823,20152016,1,60,1,4,-3,2.72838418657193,2.83085392895009,-0.102469742378162,24,25,-1,35,29,6,49,37,12,4,3,0,0
"9376","EDM","CBJ",2015020753,16833,20152016,1,60,5,1,4,5.6271585778244,6.99118632393947,-1.36402774611507,35,37,-2,47,50,-3,59,66,-7,5,7,0,0
"9377","EDM","OTT",2015020763,16835,20152016,0,60,7,2,5,5.47033072862541,7.1181439391803,-1.64781321055489,28,38,-10,35,49,-14,53,76,-23,3,4,0,0
"9378","EDM","MTL",2015020777,16837,20152016,0,60,1,5,-4,4.43334977491759,5.66521867511801,-1.23186890020042,24,36,-12,34,41,-7,50,54,-4,4,4,0,0
"9379","EDM","NYI",2015020789,16838,20152016,0,60,1,8,-7,4.49666706431708,6.93141767504267,-2.43475061072559,31,31,0,38,41,-3,46,52,-6,4,7,0,0
"9380","EDM","N.J",2015020796,16840,20152016,0,60,1,2,-1,2.0916411753511,1.65960167892424,0.432039496426861,20,26,-6,25,33,-8,32,39,-7,3,5,0,0
"9381","EDM","TOR",2015020816,16842,20152016,1,60,5,2,3,5.14792279018729,6.73305471526692,-1.58513192507962,35,36,-1,38,52,-14,51,75,-24,6,6,0,0
"9382","EDM","WPG",2015020833,16844,20152016,1,65,1,1,0,2.00156339774094,3.97449374909047,-1.97293035134953,22,33,-11,38,50,-12,58,66,-8,6,7,0,0
"9383","EDM","ANA",2015020854,16847,20152016,1,60,3,5,-2,3.52044312388171,5.76389815600561,-2.2434550321239,27,31,-4,40,41,-1,53,56,-3,4,4,0,0
"9384","EDM","MIN",2015020866,16849,20152016,1,60,2,5,-3,5.99589893146185,6.44664260698482,-0.450743675522972,33,27,6,51,33,18,74,45,29,2,3,0,0
"9385","EDM","COL",2015020882,16851,20152016,1,60,2,3,-1,3.82914774137316,3.73889972746838,0.0902480139047839,27,29,-2,41,40,1,59,50,9,3,3,0,0
"9386","EDM","OTT",2015020900,16854,20152016,1,60,1,4,-3,3.63733518573281,3.50460037664844,0.132734809084369,32,25,7,47,39,8,62,58,4,4,3,0,0
"9387","EDM","L.A",2015020915,16856,20152016,0,60,1,2,-1,3.08661786932498,4.1259682046948,-1.03935033536982,27,36,-9,37,53,-16,51,65,-14,1,1,0,0
"9388","EDM","ANA",2015020919,16857,20152016,0,61.4,1,2,-1,3.63255007148109,5.52656340278918,-1.89401333130809,18,34,-16,30,48,-18,42,72,-30,3,3,0,0
"9389","EDM","NYI",2015020936,16859,20152016,1,60,3,1,2,5.80683535820572,4.83215397835011,0.97468137985561,26,37,-11,36,50,-14,56,70,-14,1,4,0,0
"9390","EDM","BUF",2015020944,16861,20152016,0,63.8,2,1,1,6.08699853169674,4.90332058061056,1.18367795108617,41,32,9,56,40,16,69,52,17,3,1,0,0
"9391","EDM","PHI",2015020956,16863,20152016,0,60,4,0,4,3.95898239428425,5.22203248168807,-1.26305008740383,31,35,-4,37,55,-18,49,83,-34,4,9,0,0
"9392","EDM","CBJ",2015020967,16864,20152016,0,60,3,6,-3,6.10695532438103,4.04310029132519,2.06385503305584,36,27,9,52,42,10,77,49,28,3,3,0,0
"9393","EDM","WPG",2015020984,16866,20152016,0,60,2,1,1,5.13828277341963,5.73978962506226,-0.601506851642625,31,40,-9,42,56,-14,56,78,-22,2,2,0,0
"9394","EDM","S.J",2015021000,16868,20152016,1,60,0,3,-3,4.28993495256873,3.22315429485491,1.06678065771382,31,22,9,44,31,13,60,45,15,3,2,0,0
"9395","EDM","MIN",2015021011,16870,20152016,0,60,2,1,1,0,0,0,25,30,-5,36,42,-6,51,60,-9,2,4,0,0
"9396","EDM","ARI",2015021026,16872,20152016,1,60,0,4,-4,7.09878905044752,3.8067797776981,3.29200927274943,44,29,15,61,38,23,75,49,26,7,6,0,0
"9397","EDM","NSH",2015021036,16874,20152016,1,60,2,3,-1,3.72404109955028,4.29603541395045,-0.571994314400172,30,25,5,40,35,5,55,47,8,4,4,0,0
"9398","EDM","STL",2015021049,16876,20152016,1,60,6,4,2,1.83250197966117,4.13891234836927,-2.30641036870809,27,28,-1,33,48,-15,44,60,-16,6,4,0,0
"9399","EDM","VAN",2015021065,16878,20152016,1,60,2,0,2,2.02359343973512,4.20987466176666,-2.18628122203154,25,40,-15,34,57,-23,47,83,-36,5,6,0,0
"9400","EDM","COL",2015021083,16880,20152016,1,60,2,3,-1,2.63510865392163,4.37581402631724,-1.74070537239561,28,25,3,35,43,-8,54,58,-4,4,2,0,0
"9401","EDM","ARI",2015021097,16882,20152016,0,60,2,4,-2,3.8315403732704,3.98951560250134,-0.157975229230942,29,31,-2,45,47,-2,65,64,1,4,3,0,0
"9402","EDM","S.J",2015021111,16884,20152016,0,60,6,3,3,3.11459413668126,2.72744682804519,0.387147308636074,22,26,-4,30,41,-11,50,55,-5,1,4,0,0
"9403","EDM","L.A",2015021128,16886,20152016,0,60,4,6,-2,3.66887106998183,4.58909118095289,-0.920220110971059,29,33,-4,37,51,-14,48,61,-13,4,1,0,0
"9404","EDM","ANA",2015021137,16888,20152016,1,60,1,2,-1,4.45208728354191,3.74110401963117,0.710983263910748,28,25,3,39,33,6,61,42,19,3,4,0,0
"9405","EDM","CGY",2015021176,16893,20152016,1,60,0,5,-5,4.28791248055131,4.01613454342038,0.271777937130935,28,35,-7,37,41,-4,51,62,-11,2,6,0,0
"9406","EDM","VAN",2015021201,16897,20152016,1,60,6,2,4,5.08667358232196,5.9356606786605,-0.848987096338533,38,27,11,47,41,6,54,56,-2,6,6,0,0
"9407","EDM","VAN",2015021228,16900,20152016,0,65,3,3,0,5.10386958133074,3.40417133108713,1.69969825024361,38,28,10,47,41,6,56,55,1,3,3,0,0
"9408","EDM","CGY",2016020003,17086,20162017,1,60,7,4,3,5.08170679899285,5.67724197415174,-0.595535175158886,28,41,-13,39,54,-15,52,64,-12,8,4,0,0
"9409","EDM","CGY",2016020015,17088,20162017,0,60,5,3,2,0,0,0,29,35,-6,37,45,-8,48,60,-12,6,7,0,0
"9410","EDM","BUF",2016020031,17090,20162017,1,60,2,6,-4,4.56454066934748,4.35744069845532,0.207099970892159,33,24,9,43,33,10,58,44,14,3,8,0,0
"9411","EDM","CAR",2016020047,17092,20162017,1,60,3,2,1,4.2565429593359,4.0730273501251,0.183515609210801,28,33,-5,41,49,-8,57,64,-7,3,2,0,0
"9412","EDM","STL",2016020060,17094,20162017,1,60,3,1,2,5.37969302758574,3.85477589996376,1.52491712762199,23,35,-12,33,47,-14,51,77,-26,2,3,0,0
"9413","EDM","WPG",2016020077,17097,20162017,0,60,3,0,3,4.45623076387892,4.13200596882962,0.324224795049304,32,31,1,40,45,-5,47,56,-9,2,4,0,0
"9414","EDM","WSH",2016020096,17100,20162017,1,60,4,1,3,4.27441243529029,3.56871227182637,0.705700163463916,29,35,-6,41,51,-10,57,64,-7,5,4,0,0
"9415","EDM","VAN",2016020111,17102,20162017,0,60,2,0,2,5.16871714236913,3.36160902101986,1.80710812134927,27,26,1,31,34,-3,42,50,-8,1,1,0,0
"9416","EDM","OTT",2016020129,17104,20162017,1,60,0,2,-2,7.66238505328362,3.83667488417996,3.82571016910366,37,22,15,42,33,9,65,47,18,4,2,0,0
"9417","EDM","TOR",2016020134,17106,20162017,0,60.2,2,3,-1,5.66694657337212,3.66322098993078,2.00372558344134,46,31,15,62,42,20,76,58,18,3,2,0,0
"9418","EDM","NYR",2016020148,17108,20162017,0,60,3,5,-2,3.15671212872394,6.8195730409825,-3.66286091225857,24,31,-7,32,43,-11,37,54,-17,3,3,0,0
"9419","EDM","NYI",2016020167,17110,20162017,0,65,3,3,0,5.92812185018556,4.2324416837655,1.69568016642006,23,33,-10,43,40,3,66,54,12,4,4,0,0
"9420","EDM","DET",2016020174,17111,20162017,0,60,2,1,1,2.37905313192459,4.01529702590778,-1.63624389398319,28,23,5,36,30,6,44,47,-3,2,2,0,0
"9421","EDM","PIT",2016020186,17113,20162017,0,60,3,4,-1,2.57294216152553,5.37931979484279,-2.80637763331725,28,32,-4,34,40,-6,47,55,-8,2,3,0,0
"9422","EDM","DAL",2016020211,17116,20162017,1,60,2,3,-1,4.49941253031706,5.26961806169592,-0.770205531378863,42,30,12,56,36,20,73,39,34,3,4,0,0
"9423","EDM","NYR",2016020228,17118,20162017,1,60,1,3,-2,4.86535887967693,3.81661466159846,1.04874421807847,39,27,12,55,30,25,77,40,37,2,0,0,0
"9424","EDM","ANA",2016020242,17120,20162017,0,60,1,4,-3,4.61625026899327,4.78100537669354,-0.164755107700273,35,27,8,53,38,15,70,46,24,5,4,0,0
"9425","EDM","L.A",2016020254,17122,20162017,0,60,2,4,-2,3.88241839344031,3.06074660667218,0.821671786768125,30,25,5,42,32,10,55,39,16,1,2,0,0
"9426","EDM","DAL",2016020266,17124,20162017,0,60,5,2,3,6.80267706539962,4.92680276888655,1.87587429651308,30,33,-3,47,51,-4,62,62,0,3,6,0,0
"9427","EDM","CHI",2016020281,17126,20162017,1,60,5,0,5,5.45095992315328,4.48959653562633,0.961363387526944,27,31,-4,40,40,0,49,61,-12,4,2,0,0
"9428","EDM","COL",2016020296,17128,20162017,0,60,6,3,3,7.90326637604448,3.7649877478027,4.13827862824179,41,28,13,50,40,10,67,52,15,8,4,0,0
"9429","EDM","ARI",2016020312,17130,20162017,0,65,2,2,0,6.67379588863696,3.79000191955217,2.88379396908479,34,41,-7,54,49,5,67,58,9,3,3,0,0
"9430","EDM","ARI",2016020323,17132,20162017,1,60,1,2,-1,6.01092409079365,5.22399355480593,0.786930535987722,42,23,19,56,31,25,74,49,25,4,3,0,0
"9431","EDM","TOR",2016020338,17134,20162017,1,60,2,4,-2,4.57912100714748,2.0652352537727,2.51388575337478,30,23,7,42,31,11,73,47,26,8,6,0,0
"9432","EDM","WPG",2016020352,17136,20162017,0,60,6,3,3,7.77673677087781,4.90741826989688,2.86931850098093,33,25,8,42,38,4,53,53,0,5,5,0,0
"9433","EDM","ANA",2016020370,17138,20162017,1,63.2666666666667,3,2,1,3.41804964636322,2.89947227275979,0.518577373603421,32,33,-1,43,40,3,60,60,0,2,2,0,0
"9434","EDM","MIN",2016020376,17139,20162017,1,63.1833333333333,1,2,-1,3.58952097097063,3.59738176583778,-0.00786079486715607,29,33,-4,44,45,-1,62,58,4,4,3,0,0
"9435","EDM","BUF",2016020382,17141,20162017,0,60.95,3,4,-1,5.03245557725792,4.28547035792144,0.746985219336483,37,26,11,49,36,13,62,43,19,4,4,0,0
"9436","EDM","PHI",2016020397,17143,20162017,0,60,5,6,-1,4.79392271918901,4.29084940011442,0.503073319074585,33,31,2,46,44,2,64,63,1,4,5,0,0
"9437","EDM","MIN",2016020408,17144,20162017,0,65,2,2,0,3.36035545775667,5.5670853361371,-2.20672987838043,27,36,-9,36,51,-15,58,66,-8,3,4,0,0
"9438","EDM","WPG",2016020428,17146,20162017,1,60,3,2,1,2.08766162429879,4.27862965408713,-2.19096802978834,31,31,0,47,38,9,58,51,7,3,2,0,0
"9439","EDM","CBJ",2016020440,17148,20162017,1,60,1,3,-2,4.13846153082392,3.44093550945763,0.697526021366286,34,31,3,42,38,4,55,54,1,3,5,0,0
"9440","EDM","T.B",2016020469,17152,20162017,1,65,2,2,0,5.3069506914045,5.97147616496659,-0.664525473562094,32,33,-1,45,48,-3,58,64,-6,6,4,0,0
"9441","EDM","STL",2016020479,17154,20162017,0,62.9166666666667,3,2,1,7.20784588678544,3.35152399466955,3.85632189211589,35,27,8,42,35,7,57,49,8,2,2,0,0
"9442","EDM","ARI",2016020494,17156,20162017,0,60,3,2,1,3.55543690771447,7.90546317495147,-4.35002626723701,21,36,-15,29,55,-26,41,78,-37,7,6,0,0
"9443","EDM","S.J",2016020516,17158,20162017,0,63.3666666666667,2,3,-1,3.76751104314462,3.84911359713055,-0.0816025539859311,18,31,-13,34,46,-12,48,59,-11,6,4,0,0
"9444","EDM","L.A",2016020542,17164,20162017,1,60,3,1,2,4.11757554176438,3.77596166086732,0.341613880897057,35,29,6,53,33,20,70,51,19,2,2,0,0
"9445","EDM","VAN",2016020557,17166,20162017,1,65,2,2,0,4.92830682211206,4.32051959778893,0.607787224323133,44,32,12,60,50,10,79,63,16,5,2,0,0
"9446","EDM","CBJ",2016020568,17169,20162017,0,60,1,3,-2,2.22139568947023,3.82155549925164,-1.60015980978142,22,35,-13,29,41,-12,39,52,-13,3,4,0,0
"9447","EDM","BOS",2016020578,17171,20162017,0,60,4,3,1,3.51180029264651,4.75800619502843,-1.24620590238192,25,36,-11,25,56,-31,32,75,-43,1,3,0,0
"9448","EDM","N.J",2016020597,17173,20162017,0,63.9833333333333,2,1,1,9.27543658566719,2.88964856115513,6.38578802451207,43,20,23,64,27,37,77,34,43,3,2,0,0
"9449","EDM","OTT",2016020606,17174,20162017,0,60,3,5,-2,6.02751024857107,3.58687265612389,2.44063759244718,38,18,20,56,29,27,73,37,36,2,2,0,0
"9450","EDM","S.J",2016020618,17176,20162017,1,60,3,5,-2,6.4204299809644,5.64876127964817,0.77166870131623,36,28,8,46,37,9,71,52,19,2,2,0,0
"9451","EDM","N.J",2016020631,17178,20162017,1,61.8333333333333,3,2,1,4.75875705820363,2.74827702337188,2.01048003483174,34,19,15,54,24,30,70,41,29,3,4,0,0
"9452","EDM","CGY",2016020649,17180,20162017,1,65,1,1,0,6.76713507554086,4.19014735391829,2.57698772162257,27,25,2,31,37,-6,50,50,0,4,2,0,0
"9453","EDM","ARI",2016020662,17182,20162017,1,60,3,1,2,3.76320955188021,1.28108388225885,2.48212566962136,27,22,5,38,30,8,45,51,-6,2,5,0,0
"9454","EDM","FLA",2016020675,17184,20162017,1,64.95,4,3,1,7.64890545178787,2.99067324506177,4.6582322067261,31,31,0,40,39,1,55,59,-4,2,2,0,0
"9455","EDM","NSH",2016020689,17186,20162017,1,65,2,2,0,4.25141992911709,5.27187104949553,-1.02045112037844,32,44,-12,43,58,-15,56,78,-22,6,7,0,0
"9456","EDM","CGY",2016020700,17187,20162017,0,60,7,3,4,5.38360124161126,5.61901641738496,-0.235415175773694,31,41,-10,35,58,-23,40,77,-37,7,5,0,0
"9457","EDM","ANA",2016020727,17191,20162017,0,60,4,0,4,3.10792044722744,5.65151244427112,-2.54359199704368,23,26,-3,32,43,-11,40,54,-14,2,2,0,0
"9458","EDM","S.J",2016020740,17192,20162017,0,60,4,1,3,4.09829413834932,5.87154411303345,-1.77324997468413,21,33,-12,32,53,-21,41,81,-40,2,3,0,0
"9459","EDM","MIN",2016020751,17197,20162017,1,60,2,5,-3,5.75674421472903,4.25251699285582,1.50422722187321,43,35,8,61,43,18,82,56,26,3,1,0,0
"9460","EDM","NSH",2016020762,17199,20162017,0,60,0,2,-2,3.77564614139897,3.31261075317317,0.463035388225791,31,27,4,47,35,12,54,52,2,3,3,0,0
"9461","EDM","CAR",2016020770,17200,20162017,0,60,1,2,-1,4.39119131618645,2.72486766427755,1.6663236519089,25,23,2,38,42,-4,49,59,-10,3,1,0,0
"9462","EDM","MTL",2016020785,17202,20162017,0,65,0,0,0,2.96608270968318,3.5191945553504,-0.553111845667217,32,22,10,41,35,6,62,49,13,4,1,0,0
"9463","EDM","CHI",2016020827,17208,20162017,1,60,1,5,-4,3.55507497334838,2.59554361819755,0.95953135515083,31,25,6,42,33,9,67,43,24,2,2,0,0
"9464","EDM","ARI",2016020842,17211,20162017,1,60,5,2,3,5.69756260321083,4.00853128539165,1.68903131781917,33,25,8,48,34,14,63,54,9,4,5,0,0
"9465","EDM","PHI",2016020853,17213,20162017,1,60,6,3,3,4.41462487616684,7.1806122706621,-2.76598739449526,25,36,-11,33,45,-12,51,66,-15,1,4,0,0
"9466","EDM","CHI",2016020863,17215,20162017,0,60,3,1,2,5.1953564922665,3.71211941892398,1.48323707334252,22,39,-17,29,57,-28,40,83,-43,2,3,0,0
"9467","EDM","T.B",2016020887,17218,20162017,0,60,1,4,-3,2.62570367514854,4.83608367183479,-2.21037999668624,21,28,-7,31,39,-8,41,57,-16,2,2,0,0
"9468","EDM","FLA",2016020891,17219,20162017,0,60,4,3,1,5.23321072997351,6.13635815860471,-0.9031474286312,35,34,1,45,49,-4,52,57,-5,2,3,0,0
"9469","EDM","WSH",2016020900,17221,20162017,0,60,1,2,-1,6.98177060734815,3.40365868330991,3.57811192403824,31,25,6,50,36,14,61,54,7,0,2,0,0
"9470","EDM","NSH",2016020915,17223,20162017,0,60,4,5,-1,3.81571608531522,2.275972972624,1.53974311269121,32,28,4,38,34,4,52,42,10,4,5,0,0
"9471","EDM","STL",2016020928,17225,20162017,0,60,2,1,1,5.79438372910954,3.53510098009428,2.25928274901526,25,26,-1,32,35,-3,38,48,-10,2,2,0,0
"9472","EDM","DET",2016020960,17229,20162017,1,60,4,3,1,6.49775802622025,3.63235981277669,2.86539821344356,38,25,13,52,35,17,66,50,16,2,1,0,0
"9473","EDM","NYI",2016020979,17232,20162017,1,60,1,4,-3,2.93212392547139,3.86710500274785,-0.934981077276461,28,27,1,40,33,7,59,46,13,2,1,0,0
"9474","EDM","PIT",2016020999,17235,20162017,1,65,2,2,0,6.10483231143061,3.87919596640313,2.22563634502747,42,31,11,63,41,22,78,56,22,2,2,0,0
"9475","EDM","MTL",2016021013,17237,20162017,1,60,1,4,-3,2.24046055972576,8.18597912756377,-5.94551856783801,25,41,-16,33,55,-22,51,69,-18,3,3,0,0
"9476","EDM","DAL",2016021030,17239,20162017,1,60,7,1,6,6.00287101735739,3.15173814387526,2.85113287348213,29,23,6,44,35,9,57,62,-5,2,1,0,0
"9477","EDM","BOS",2016021044,17241,20162017,1,60,7,4,3,5.43285862891935,4.88374743438908,0.549111194530269,36,36,0,49,47,2,66,68,-2,7,5,0,0
"9478","EDM","VAN",2016021061,17243,20162017,1,60,2,0,2,4.3915241244249,6.12322475091014,-1.73170062648524,22,33,-11,34,49,-15,46,71,-25,3,2,0,0
"9479","EDM","L.A",2016021074,17245,20162017,1,60,2,0,2,3.91854431957472,4.16867838217877,-0.250134062604047,31,35,-4,46,49,-3,61,84,-23,4,3,0,0
"9480","EDM","ANA",2016021088,17247,20162017,0,60,3,4,-1,3.33357641466279,5.49709022825118,-2.16351381358839,32,34,-2,46,51,-5,58,66,-8,6,6,0,0
"9481","EDM","COL",2016021099,17248,20162017,0,60,7,4,3,3.68964667903492,3.3598163658171,0.329830313217826,30,21,9,41,37,4,52,55,-3,2,3,0,0
"9482","EDM","COL",2016021115,17250,20162017,1,60,4,1,3,3.61179763577033,2.01797727297526,1.59382036279507,29,25,4,35,32,3,48,58,-10,5,4,0,0
"9483","EDM","L.A",2016021134,17253,20162017,1,60,2,1,1,4.00981241460249,3.66979978258132,0.340012632021171,29,35,-6,36,41,-5,54,58,-4,3,1,0,0
"9484","EDM","S.J",2016021149,17255,20162017,1,60,3,2,1,4.18143893314209,3.04295192792688,1.13848700521521,22,40,-18,40,53,-13,60,77,-17,4,3,0,0
"9485","EDM","ANA",2016021164,17257,20162017,1,61.4333333333333,3,2,1,5.2360844539362,3.20956139510963,2.02652305882657,37,18,19,47,26,21,77,40,37,4,2,0,0
"9486","EDM","L.A",2016021190,17260,20162017,0,60,4,6,-2,6.26885741592196,5.45297201794165,0.81588539798031,27,27,0,37,42,-5,52,54,-2,2,3,0,0
"9487","EDM","S.J",2016021205,17262,20162017,0,60,4,2,2,4.264677438545,4.19335663161473,0.0713208069302667,32,15,17,41,27,14,57,55,2,5,5,0,0
"9488","EDM","VAN",2016021218,17264,20162017,0,60,3,2,1,6.76909014210105,5.35720037238207,1.41188976971898,35,31,4,46,38,8,58,54,4,1,3,0,0
"9489","EDM","VAN",2016021230,17265,20162017,1,60,5,2,3,4.93874918180518,4.18353160954575,0.755217572259426,44,17,27,54,29,25,66,41,25,5,1,0,0
"9490","EDM","S.J",2016030181,17268,20162017,1,63.3666666666667,2,3,-1,2.13090226037184,7.02453578618588,-4.89363352581404,19,44,-25,30,64,-34,43,87,-44,4,7,0,0
"9491","EDM","S.J",2016030182,17270,20162017,1,60,2,0,2,4.91044354637047,1.8965173489975,3.01392619737298,36,16,20,52,20,32,77,36,41,4,6,0,0
"9492","EDM","S.J",2016030183,17272,20162017,0,60,1,0,1,3.23644138840609,3.60727602952102,-0.370834641114925,22,23,-1,32,38,-6,54,57,-3,1,2,0,0
"9493","EDM","S.J",2016030184,17274,20162017,0,60,0,7,-7,2.45791263518012,5.27487055156064,-2.81695791638052,23,32,-9,34,50,-16,53,70,-17,4,6,0,0
"9494","EDM","S.J",2016030185,17276,20162017,1,78.25,4,3,1,8.42547981745884,4.56777133606374,3.85770848139509,48,30,18,69,42,27,107,56,51,3,1,0,0
"9495","EDM","S.J",2016030186,17278,20162017,0,60,3,1,2,4.6458339546225,5.69246065426364,-1.04662669964114,21,28,-7,31,44,-13,48,70,-22,1,3,0,0
"9496","EDM","ANA",2016030241,17282,20162017,0,60,5,3,2,6.54389237659052,7.91582431347342,-1.3719319368829,32,36,-4,43,57,-14,59,72,-13,8,6,0,0
"9497","EDM","ANA",2016030242,17284,20162017,0,60,2,1,1,5.5768712123986,6.30625832055659,-0.729387108157994,23,40,-17,39,67,-28,48,85,-37,4,4,0,0
"9498","EDM","ANA",2016030243,17286,20162017,1,60,3,6,-3,3.68329525074664,4.29521783774453,-0.611922586997892,27,28,-1,37,39,-2,61,50,11,4,5,0,0
"9499","EDM","ANA",2016030244,17289,20162017,1,60.75,3,4,-1,4.9096853487008,4.0439324158663,0.865752932834503,32,39,-7,41,49,-8,61,69,-8,3,4,0,0
"9500","EDM","ANA",2016030245,17291,20162017,0,80,3,3,0,9.34084686449158,10.7211622959876,-1.38031543149601,38,58,-20,59,75,-16,70,94,-24,4,6,0,0
"9501","EDM","ANA",2016030246,17293,20162017,1,60,7,1,6,4.69231704279082,4.12417825812098,0.568138784669834,35,35,0,57,55,2,76,66,10,8,4,0,0
"9502","EDM","ANA",2016030247,17296,20162017,0,60,1,2,-1,2.22582717769546,3.31851319590351,-1.09268601820804,24,30,-6,34,45,-11,50,65,-15,1,1,0,0
"9503","EDM","CGY",2017020003,17443,20172018,1,60,3,0,3,7.45447127262196,4.65161499520764,2.80285627741432,45,27,18,63,40,23,80,58,22,2,1,0,0
"9504","EDM","VAN",2017020028,17446,20172018,0,60,2,3,-1,3.94807291595363,4.0945639399419,-0.146491023988266,35,26,9,54,37,17,69,44,25,5,7,0,0
"9505","EDM","WPG",2017020037,17448,20172018,1,60,2,5,-3,4.18231004066183,3.56910923370742,0.61320080695441,39,43,-4,50,49,1,67,66,1,2,4,0,0
"9506","EDM","OTT",2017020073,17453,20172018,1,60,1,6,-5,6.9732447543865,3.83053392509464,3.14271082929185,36,31,5,59,43,16,86,52,34,4,6,0,0
"9507","EDM","CAR",2017020089,17456,20172018,1,60,3,5,-2,4.90951627601376,3.94843286221476,0.961083413799003,51,21,30,63,25,38,82,40,42,7,5,0,0
"9508","EDM","CHI",2017020100,17458,20172018,0,64.7333333333333,2,1,1,8.2176744433591,5.09632647648687,3.12134796687224,42,31,11,49,45,4,61,68,-7,2,5,0,0
"9509","EDM","PHI",2017020111,17460,20172018,0,60,1,2,-1,2.21289640680698,3.05526128373526,-0.842364876928286,24,24,0,38,33,5,59,55,4,3,3,0,0
"9510","EDM","PIT",2017020128,17463,20172018,0,60.7,1,2,-1,6.68494345213634,4.84448475036243,1.84045870177391,30,44,-14,39,47,-8,65,61,4,2,3,0,0
"9511","EDM","DAL",2017020147,17465,20172018,1,60,5,4,1,5.08845138491537,5.7718111905146,-0.683359805599228,35,32,3,51,46,5,76,68,8,3,5,0,0
"9512","EDM","WSH",2017020166,17467,20172018,1,60,2,5,-3,3.38175477230106,5.08535432728968,-1.70359955498861,40,31,9,52,45,7,76,57,19,5,1,0,0
"9513","EDM","PIT",2017020182,17471,20172018,1,60,2,3,-1,5.19434737975098,4.14526564876353,1.04908173098745,37,30,7,53,45,8,70,60,10,5,4,0,0
"9514","EDM","N.J",2017020198,17473,20172018,1,60,6,3,3,7.2407797195774,3.39325137693959,3.84752834263782,42,34,8,62,42,20,76,66,10,1,0,0,0
"9515","EDM","DET",2017020213,17475,20172018,1,60,0,4,-4,6.96312115900218,6.2672926780437,0.695828480958482,36,35,1,54,48,6,74,56,18,2,2,0,0
"9516","EDM","NYI",2017020225,17477,20172018,0,60.6333333333333,2,1,1,1.04158512689173,4.51375515788095,-3.47217003098922,25,37,-12,31,47,-16,46,57,-11,2,3,0,0
"9517","EDM","N.J",2017020235,17479,20172018,0,64.7166666666667,3,2,1,3.56056781656724,5.13053342525382,-1.56996560868658,32,34,-2,42,46,-4,56,60,-4,2,4,0,0
"9518","EDM","NYR",2017020249,17481,20172018,0,60,2,4,-2,5.48396232438972,5.88212750229286,-0.398165177903138,29,34,-5,43,42,1,54,48,6,2,3,0,0
"9519","EDM","WSH",2017020261,17482,20172018,0,65,1,1,0,5.41116425289874,2.21029480476864,3.20086944813011,30,19,11,45,25,20,64,35,29,1,4,0,0
"9520","EDM","VGK",2017020273,17484,20172018,1,60,8,2,6,5.91243887750898,4.57225283421576,1.34018604329322,32,24,8,44,35,9,54,46,8,4,5,0,0
"9521","EDM","STL",2017020286,17486,20172018,1,60,1,4,-3,3.54847660254745,5.27525629115444,-1.72677968860699,30,39,-9,41,41,0,54,55,-1,5,6,0,0
"9522","EDM","DAL",2017020294,17488,20172018,0,60,3,6,-3,2.97697561050203,2.34128835464607,0.635687255855959,30,21,9,38,32,6,57,41,16,6,9,0,0
"9523","EDM","STL",2017020317,17491,20172018,0,60,3,8,-5,4.00425416189114,5.27227600916087,-1.26802184726973,29,40,-11,35,52,-17,43,68,-25,1,3,0,0
"9524","EDM","DET",2017020320,17492,20172018,0,60,6,2,4,3.36308064276818,2.42892883762761,0.934151805140573,28,22,6,35,33,2,45,48,-3,1,2,0,0
"9525","EDM","BUF",2017020339,17494,20172018,0,60,1,3,-2,4.35873272432946,6.24920048681723,-1.89046776248778,30,31,-1,39,40,-1,61,53,8,3,3,0,0
"9526","EDM","BOS",2017020361,17496,20172018,0,60,4,2,2,3.81256580591435,2.68911112868227,1.12345467723208,36,25,11,45,33,12,50,44,6,2,2,0,0
"9527","EDM","ARI",2017020375,17498,20172018,1,64.3333333333333,3,2,1,4.1338429232128,5.68847818646464,-1.55463526325184,27,31,-4,48,49,-1,73,69,4,4,3,0,0
"9528","EDM","TOR",2017020387,17500,20172018,1,60,4,6,-2,5.21613631423907,4.47087626958182,0.745260044657243,45,37,8,59,51,8,77,67,10,2,2,0,0
"9529","EDM","CGY",2017020407,17502,20172018,0,60,7,5,2,6.37739417281322,5.02022962710675,1.35716454570647,33,34,-1,51,43,8,59,67,-8,3,5,0,0
"9530","EDM","PHI",2017020428,17506,20172018,1,60,2,4,-2,5.82620742894511,5.12972102373897,0.696486405206144,26,33,-7,39,42,-3,52,60,-8,2,4,0,0
"9531","EDM","MTL",2017020445,17509,20172018,0,60,6,2,4,6.79205520654796,3.39273046288872,3.39932474365924,40,24,16,55,36,19,65,62,3,4,3,0,0
"9532","EDM","TOR",2017020456,17510,20172018,0,60,0,1,-1,7.4364775453829,2.58433559860737,4.85214194677553,41,23,18,69,33,36,89,47,42,4,2,0,0
"9533","EDM","CBJ",2017020470,17512,20172018,0,60,7,2,5,5.11570744793426,4.51985090605922,0.595856541875037,38,29,9,47,40,7,58,54,4,4,2,0,0
"9534","EDM","NSH",2017020488,17514,20172018,1,60,0,4,-4,6.57203945976516,2.17844590377024,4.39359355599492,46,23,23,59,36,23,88,52,36,4,4,0,0
"9535","EDM","MIN",2017020496,17516,20172018,0,60,3,2,1,4.35364376408004,5.71098629612703,-1.357342532047,29,31,-2,41,42,-1,54,52,2,6,4,0,0
"9536","EDM","S.J",2017020515,17518,20172018,1,60,5,3,2,6.40060887577132,5.00992465331365,1.39068422245767,29,21,8,37,37,0,52,57,-5,3,3,0,0
"9537","EDM","STL",2017020536,17521,20172018,1,60,3,2,1,4.16242609795881,2.52754989464224,1.63487620331658,35,36,-1,48,47,1,66,59,7,3,2,0,0
"9538","EDM","MTL",2017020552,17523,20172018,1,60,4,1,3,6.03398921880139,5.85751149134012,0.176477727461275,35,30,5,53,41,12,69,62,7,3,2,0,0
"9539","EDM","WPG",2017020566,17527,20172018,0,60,3,4,-1,3.33303099689383,4.7770700896217,-1.44403909272788,25,39,-14,38,55,-17,50,72,-22,1,4,0,0
"9540","EDM","CHI",2017020585,17529,20172018,1,60.8333333333333,3,4,-1,4.26160504273139,5.38854344008723,-1.12693839735584,45,36,9,62,53,9,80,78,2,2,3,0,0
"9541","EDM","WPG",2017020600,17531,20172018,1,60,0,5,-5,5.37657788790966,6.37275365595172,-0.996175768042054,35,38,-3,42,52,-10,64,72,-8,2,3,0,0
"9542","EDM","L.A",2017020611,17533,20172018,1,60,0,5,-5,4.65789812773568,4.71977556840284,-0.0618774406671605,32,33,-1,48,44,4,65,59,6,3,2,0,0
"9543","EDM","ANA",2017020626,17535,20172018,1,65,1,1,0,5.78716018411797,4.18283824123941,1.60432194287856,34,34,0,51,38,13,68,55,13,5,2,0,0
"9544","EDM","DAL",2017020634,17537,20172018,0,60,1,5,-4,4.79846788328723,5.25653062824586,-0.458062744958625,38,33,5,51,48,3,67,67,0,4,3,0,0
"9545","EDM","CHI",2017020645,17538,20172018,0,60,1,4,-3,3.9294167652879,2.384416675588,1.5450000896999,33,29,4,35,41,-6,47,68,-21,1,3,0,0
"9546","EDM","NSH",2017020658,17540,20172018,0,60,1,2,-1,2.82913045797613,2.78873753853259,0.0403929194435477,26,24,2,39,32,7,53,42,11,1,3,0,0
"9547","EDM","ARI",2017020669,17543,20172018,0,60,4,2,2,6.20387069135904,4.5856300110172,1.61824068034184,27,22,5,41,37,4,51,50,1,1,1,0,0
"9548","EDM","VGK",2017020676,17544,20172018,0,60.8833333333333,3,2,1,4.87880105446806,4.30753898876856,0.5712620656995,30,36,-6,33,49,-16,36,65,-29,3,6,0,0
"9549","EDM","VAN",2017020720,17551,20172018,1,60,5,2,3,5.14958373708214,4.18687621824936,0.962707518832783,35,27,8,43,42,1,57,59,-2,3,3,0,0
"9550","EDM","BUF",2017020739,17554,20172018,1,60,0,5,-5,6.88609552331036,6.34377941605635,0.54231610725401,33,34,-1,50,40,10,70,48,22,2,4,0,0
"9551","EDM","CGY",2017020755,17556,20172018,1,65,3,3,0,5.58080679783779,5.9331690734464,-0.352362275608604,37,37,0,52,52,0,68,70,-2,4,5,0,0
"9552","EDM","COL",2017020785,17563,20172018,1,62.4666666666667,3,4,-1,3.45582719289814,4.99235458264593,-1.53652738974779,32,31,1,45,38,7,63,58,5,3,1,0,0
"9553","EDM","T.B",2017020811,17567,20172018,1,60,6,2,4,0,0,0,35,34,1,48,44,4,59,63,-4,5,4,0,0
"9554","EDM","L.A",2017020825,17569,20172018,0,60,2,5,-3,5.65542975062272,5.8927588131628,-0.237329062540084,27,28,-1,39,44,-5,50,68,-18,3,3,0,0
"9555","EDM","ANA",2017020842,17571,20172018,0,60,2,3,-1,5.51440250879023,3.17725681068424,2.33714569810598,32,34,-2,49,48,1,63,57,6,3,2,0,0
"9556","EDM","S.J",2017020851,17572,20172018,0,60,4,6,-2,3.05595320910882,4.35288447989842,-1.2969312707896,31,30,1,44,38,6,65,58,7,3,1,0,0
"9557","EDM","FLA",2017020862,17574,20172018,1,60,5,7,-2,4.75839379127137,4.93716501811286,-0.178771226841491,32,40,-8,47,56,-9,66,68,-2,1,5,0,0
"9558","EDM","VGK",2017020888,17577,20172018,0,60,1,4,-3,6.95554123826878,2.87431369486148,4.08122754340729,29,28,1,43,31,12,58,52,6,1,2,0,0
"9559","EDM","ARI",2017020897,17579,20172018,0,60,0,1,-1,8.27440214515281,4.7222543611424,3.5521477840104,40,32,8,53,40,13,65,60,5,2,4,0,0
"9560","EDM","COL",2017020906,17580,20172018,0,60,4,2,2,7.02409503226409,5.59066526521929,1.4334297670448,40,26,14,53,39,14,61,49,12,1,3,0,0
"9561","EDM","BOS",2017020925,17582,20172018,1,60,2,3,-1,3.27582132391399,9.57520989933982,-6.29938857542584,20,45,-25,32,58,-26,42,74,-32,2,4,0,0
"9562","EDM","COL",2017020938,17584,20172018,1,62.3166666666667,3,2,1,5.47457667345589,5.45833321538521,0.0162434580706758,46,30,16,63,42,21,81,61,20,2,1,0,0
"9563","EDM","L.A",2017020957,17586,20172018,0,60,4,3,1,4.38137124995843,5.7639930100413,-1.38262176008288,25,33,-8,34,49,-15,50,65,-15,2,3,0,0
"9564","EDM","ANA",2017020962,17587,20172018,0,65,5,5,0,7.08927718004225,5.58556243825624,1.50371474178601,42,46,-4,55,54,1,67,62,5,2,3,0,0
"9565","EDM","S.J",2017020977,17589,20172018,0,60,2,5,-3,7.41601442894898,6.29008509364843,1.12592933530055,26,37,-11,40,49,-9,60,67,-7,3,4,0,0
"9566","EDM","NSH",2017020987,17591,20172018,1,60,2,4,-2,4.73391270416043,5.01666122587631,-0.28274852171587,36,42,-6,39,57,-18,56,78,-22,1,3,0,0
"9567","EDM","NYR",2017021007,17593,20172018,1,60,2,3,-1,8.28436667635879,7.59459415235324,0.689772524005548,37,34,3,50,41,9,63,58,5,2,3,0,0
"9568","EDM","ARI",2017021018,17595,20172018,1,60.8333333333333,4,3,1,4.84479062855873,3.28743956014184,1.55735106841688,36,35,1,43,47,-4,61,62,-1,6,5,0,0
"9569","EDM","NYI",2017021041,17598,20172018,1,65,1,1,0,9.47923332100618,4.85428206052165,4.62495126048452,36,31,5,55,43,12,76,61,15,3,1,0,0
"9570","EDM","MIN",2017021058,17600,20172018,1,60,4,1,3,5.07538496164489,3.8821496156483,1.19323534599658,28,33,-5,36,48,-12,51,68,-17,3,4,0,0
"9571","EDM","CGY",2017021076,17603,20172018,0,60,0,1,-1,5.04681183800676,4.0429663829303,1.00384545507646,28,32,-4,39,48,-9,54,64,-10,3,2,0,0
"9572","EDM","S.J",2017021080,17604,20172018,1,62.6666666666667,3,4,-1,0,0,0,28,40,-12,38,54,-16,52,66,-14,1,3,0,0
"9573","EDM","FLA",2017021099,17607,20172018,0,60,4,2,2,9.96473234125338,7.73487195083362,2.22986039041976,36,42,-6,46,55,-9,62,64,-2,2,7,0,0
"9574","EDM","CAR",2017021124,17610,20172018,0,60,7,3,4,2.43626200520157,6.48926130434847,-4.0529992991469,30,34,-4,38,46,-8,46,55,-9,1,2,0,0
"9575","EDM","OTT",2017021140,17612,20172018,0,60,6,2,4,5.68042733405309,4.90235952840567,0.778067805647424,38,35,3,46,42,4,61,57,4,5,2,0,0
"9576","EDM","L.A",2017021162,17614,20172018,1,60,3,2,1,2.83913561625691,4.05610862072854,-1.21697300447163,27,29,-2,42,44,-2,49,64,-15,2,1,0,0
"9577","EDM","ANA",2017021167,17615,20172018,1,61.35,4,5,-1,3.36783517133699,5.88123638355728,-2.51340121222029,32,38,-6,47,52,-5,55,71,-16,4,2,0,0
"9578","EDM","CBJ",2017021184,17617,20172018,1,60,3,7,-4,4.63837626783182,4.91181958059158,-0.273443312759765,25,27,-2,33,43,-10,45,63,-18,3,3,0,0
"9579","EDM","VAN",2017021198,17619,20172018,0,60,1,2,-1,3.06172255289221,4.1161956278861,-1.05447307499389,36,30,6,50,37,13,63,43,20,2,1,0,0
"9580","EDM","CGY",2017021216,17621,20172018,0,60,2,3,-1,4.37503805703974,3.67566220237902,0.699375854660722,36,20,16,48,30,18,62,39,23,7,6,0,0
"9581","EDM","MIN",2017021227,17623,20172018,0,60,0,3,-3,3.9936244811562,6.37238315982134,-2.37875867866514,22,40,-18,32,51,-19,41,63,-22,2,2,0,0
"9582","EDM","VGK",2017021249,17626,20172018,1,60,4,3,1,4.53409239789471,3.28441947603551,1.2496729218592,33,33,0,47,49,-2,54,56,-2,3,2,0,0
"9583","EDM","VAN",2017021269,17628,20172018,1,65,2,2,0,4.5545102584656,5.98865511092299,-1.43414485245739,33,38,-5,50,53,-3,65,69,-4,2,4,0,0
"9584","EDM","N.J",2018020020,17810,20182019,0,60,2,5,-3,3.55453479342395,3.97758116945624,-0.423046376032289,19,27,-8,30,40,-10,38,48,-10,4,2,0,0
"9585","EDM","BOS",2018020045,17815,20182019,0,60,1,4,-3,4.39014584289158,4.95837342424784,-0.568227581356254,26,32,-6,32,44,-12,43,52,-9,3,5,0,0
"9586","EDM","NYR",2018020057,17817,20182019,0,60,2,1,1,2.2459122731525,3.35306050513464,-1.10714823198214,27,24,3,40,37,3,55,51,4,4,2,0,0
"9587","EDM","WPG",2018020084,17820,20182019,0,61.4166666666667,5,4,1,5.52570295747137,6.13064566506364,-0.604942707592272,35,33,2,52,39,13,64,54,10,2,3,0,0
"9588","EDM","BOS",2018020096,17822,20182019,1,60.6166666666667,3,2,1,2.51494976664952,3.92931910176412,-1.4143693351146,22,29,-7,37,41,-4,51,58,-7,4,5,0,0
"9589","EDM","NSH",2018020111,17824,20182019,1,60,0,3,-3,3.72126209619455,4.06840243454735,-0.347140338352801,31,28,3,41,36,5,53,54,-1,4,4,0,0
"9590","EDM","PIT",2018020129,17827,20182019,1,62.2,5,6,-1,4.88998739945414,3.6761152125094,1.21387218694474,46,31,15,61,48,13,68,71,-3,5,3,0,0
"9591","EDM","WSH",2018020142,17829,20182019,1,60,4,1,3,6.48775436329015,4.93816491574319,1.54958944754696,32,32,0,42,43,-1,54,68,-14,4,1,0,0
"9592","EDM","NSH",2018020150,17831,20182019,0,60,5,3,2,4.65856444618839,3.12460205276875,1.53396239341964,35,27,8,46,43,3,56,63,-7,6,6,0,0
"9593","EDM","CHI",2018020162,17832,20182019,0,60.8833333333333,2,1,1,3.10336720815712,4.30544944526628,-1.20208223710915,26,32,-6,37,44,-7,53,56,-3,2,5,0,0
"9594","EDM","MIN",2018020174,17834,20182019,1,60,3,4,-1,5.96175330306869,3.32434075849596,2.63741254457273,37,28,9,54,36,18,72,52,20,5,3,0,0
"9595","EDM","CHI",2018020188,17836,20182019,1,60,4,0,4,3.82275432727511,3.82252603977099,0.000228287504114633,29,40,-11,42,51,-9,56,64,-8,3,4,0,0
"9596","EDM","DET",2018020197,17838,20182019,0,60,4,3,1,4.25788514269344,2.26206280500628,1.99582233768716,42,26,16,56,36,20,64,47,17,1,2,0,0
"9597","EDM","WSH",2018020213,17840,20182019,0,60,2,4,-2,4.07826827313693,3.83619337565482,0.242074897482105,33,23,10,50,38,12,73,48,25,4,2,0,0
"9598","EDM","T.B",2018020220,17841,20182019,0,60,2,5,-3,3.04346811051801,3.03326217265567,0.010205937862338,35,35,0,45,47,-2,58,57,1,5,7,0,0
"9599","EDM","FLA",2018020228,17843,20182019,0,60,1,4,-3,2.42614828044498,6.16248315610574,-3.73633487566076,27,33,-6,37,42,-5,49,52,-3,3,4,0,0
"9600","EDM","COL",2018020259,17846,20182019,1,60,1,4,-3,2.78441951645073,4.28710869907834,-1.50268918262762,27,28,-1,33,35,-2,52,40,12,3,2,0,0
"9601","EDM","MTL",2018020270,17848,20182019,1,60,6,2,4,5.82733243422717,3.82252061056156,2.00481182366561,43,29,14,59,38,21,77,52,25,5,5,0,0
"9602","EDM","CGY",2018020301,17852,20182019,0,60,2,4,-2,2.30850878103229,3.97445712787157,-1.66594834683929,26,37,-11,33,47,-14,43,66,-23,4,8,0,0
"9603","EDM","VGK",2018020306,17853,20182019,1,60,3,6,-3,4.16721730842255,4.30520249426627,-0.137985185843718,32,31,1,42,41,1,51,65,-14,3,3,0,0
"9604","EDM","S.J",2018020317,17855,20182019,0,60.85,4,3,1,2.35580761991534,4.55942837486509,-2.20362075494975,23,25,-2,32,34,-2,45,44,1,1,3,0,0
"9605","EDM","ANA",2018020337,17858,20182019,0,60.2333333333333,1,2,-1,3.67010439097066,4.30931125365896,-0.639206862688297,28,25,3,34,36,-2,53,46,7,2,2,0,0
"9606","EDM","L.A",2018020361,17860,20182019,0,60,2,5,-3,3.11409831073667,3.42947301395225,-0.315374703215575,34,32,2,50,48,2,64,66,-2,3,5,0,0
"9607","EDM","DAL",2018020375,17862,20182019,1,62.7,1,0,1,4.89253263825958,4.80419808214953,0.0883345561100555,31,28,3,45,39,6,61,51,10,2,2,0,0
"9608","EDM","L.A",2018020388,17864,20182019,1,60,3,2,1,7.17476146169429,3.26921994693112,3.90554151476317,34,32,2,51,41,10,69,63,6,3,3,0,0
"9609","EDM","VGK",2018020406,17866,20182019,1,60,2,1,1,3.20599454177281,4.37630730144834,-1.17031275967553,34,32,2,44,55,-11,58,76,-18,3,3,0,0
"9610","EDM","DAL",2018020415,17868,20182019,0,60,1,4,-3,7.65464992327907,6.38443725598336,1.27021266729571,29,25,4,48,35,13,65,52,13,5,4,0,0
"9611","EDM","STL",2018020426,17870,20182019,0,65,2,2,0,3.77727315334778,2.3085029939283,1.46877015941948,36,30,6,55,37,18,72,45,27,5,2,0,0
"9612","EDM","MIN",2018020442,17872,20182019,1,60,7,2,5,2.70173753687413,3.15261182827817,-0.450874291404034,32,33,-1,47,47,0,63,61,2,1,2,0,0
"9613","EDM","CGY",2018020459,17874,20182019,1,60,1,0,1,2.88236825828062,2.52574728481915,0.356620973461474,30,24,6,39,32,7,53,52,1,5,2,0,0
"9614","EDM","COL",2018020474,17876,20182019,0,60,6,4,2,4.57310699253867,5.76974136554054,-1.19663437300187,26,43,-17,37,58,-21,46,74,-28,4,6,0,0
"9615","EDM","WPG",2018020485,17878,20182019,0,60.6833333333333,4,5,-1,2.48759435598573,6.49245288312341,-4.00485852713767,26,40,-14,34,54,-20,42,75,-33,2,3,0,0
"9616","EDM","PHI",2018020494,17879,20182019,1,60,4,1,3,3.8038919447572,3.31776433762502,0.486127607132175,22,32,-10,29,43,-14,39,59,-20,2,4,0,0
"9617","EDM","VAN",2018020511,17881,20182019,0,60,2,4,-2,1.83965713013913,4.75097508945328,-2.91131795931415,22,30,-8,30,41,-11,52,45,7,1,5,0,0
"9618","EDM","STL",2018020524,17883,20182019,1,60,1,4,-3,4.2754040210275,3.89371331108123,0.38169070994627,23,30,-7,30,40,-10,48,51,-3,6,1,0,0
"9619","EDM","T.B",2018020557,17887,20182019,1,60,3,6,-3,4.02570509750694,7.22821172245312,-3.20250662494618,28,45,-17,39,52,-13,55,64,-9,6,5,0,0
"9620","EDM","VAN",2018020576,17892,20182019,1,60,2,4,-2,3.79081379729905,5.48921930401411,-1.69840550671506,32,20,12,46,28,18,68,38,30,3,1,0,0
"9621","EDM","S.J",2018020585,17894,20182019,1,60,4,7,-3,1.97368732235831,6.42823563900311,-4.4545483166448,26,40,-14,34,58,-24,40,68,-28,1,3,0,0
"9622","EDM","WPG",2018020610,17896,20182019,1,60,3,4,-1,5.24870428188297,6.66222632414429,-1.41352204226132,24,36,-12,39,50,-11,58,68,-10,1,2,0,0
"9623","EDM","ARI",2018020620,17898,20182019,0,60,3,1,2,5.21405018557562,2.48319381561828,2.73085636995734,24,30,-6,32,47,-15,48,60,-12,3,1,0,0
"9624","EDM","L.A",2018020643,17901,20182019,0,60,0,4,-4,2.31025998553156,3.00556953246996,-0.695309546938404,16,23,-7,28,31,-3,43,39,4,5,5,0,0
"9625","EDM","ANA",2018020651,17902,20182019,0,60,4,0,4,3.74331527757749,6.43728501256555,-2.69396973498806,24,39,-15,32,60,-28,42,84,-42,4,6,0,0
"9626","EDM","S.J",2018020667,17904,20182019,0,60,2,7,-5,2.94013196672631,4.69455490313703,-1.75442293641072,22,36,-14,30,50,-20,36,63,-27,3,4,0,0
"9627","EDM","FLA",2018020679,17906,20182019,1,65,3,3,0,5.6365520438394,5.99791548493704,-0.361363441097637,24,30,-6,34,39,-5,49,52,-3,2,2,0,0
"9628","EDM","ARI",2018020696,17908,20182019,1,60,2,3,-1,6.73343906906666,5.45358335280787,1.27985571625879,25,29,-4,35,39,-4,54,49,5,2,3,0,0
"9629","EDM","BUF",2018020710,17910,20182019,1,60,7,2,5,2.93329843395622,5.00445974757167,-2.07116131361545,25,43,-18,31,57,-26,37,72,-35,1,4,0,0
"9630","EDM","VAN",2018020724,17912,20182019,0,65,2,2,0,4.00394851989236,2.8076087103691,1.19633980952327,30,22,8,43,31,12,58,48,10,4,5,0,0
"9631","EDM","CGY",2018020749,17915,20182019,1,60,2,5,-3,4.71070524476277,6.26703619401621,-1.55633094925344,24,34,-10,37,41,-4,52,55,-3,8,10,0,0
"9632","EDM","CAR",2018020755,17916,20182019,1,60,4,7,-3,3.28603197907796,6.06165356820566,-2.7756215891277,21,34,-13,32,44,-12,48,56,-8,5,2,0,0
"9633","EDM","DET",2018020764,17918,20182019,1,60,2,3,-1,4.03407252910517,4.21265678037889,-0.178584251273727,34,27,7,43,37,6,59,45,14,3,3,0,0
"9634","EDM","PHI",2018020789,17929,20182019,0,62.0166666666667,4,5,-1,6.26085864293786,5.25270738761174,1.00815125532613,44,39,5,54,51,3,69,67,2,4,6,0,0
"9635","EDM","MTL",2018020803,17930,20182019,0,60.9666666666667,3,4,-1,5.13349076290615,4.65922110673637,0.474269656169781,24,27,-3,35,40,-5,51,63,-12,5,5,0,0
"9636","EDM","CHI",2018020820,17932,20182019,1,60,2,6,-4,4.54230119590409,5.4416426064563,-0.899341410552211,27,35,-8,37,44,-7,54,61,-7,4,4,0,0
"9637","EDM","MIN",2018020833,17934,20182019,0,60,4,1,3,4.88195329408876,4.05611992834019,0.825833365748565,23,36,-13,30,50,-20,35,65,-30,3,2,0,0
"9638","EDM","S.J",2018020849,17936,20182019,1,60,2,5,-3,4.10223109702117,5.35115664709161,-1.24892555007043,23,31,-8,34,41,-7,47,54,-7,2,6,0,0
"9639","EDM","PIT",2018020875,17940,20182019,0,60,1,3,-2,5.12737346173299,7.54728481415441,-2.41991135242142,39,34,5,48,41,7,62,52,10,3,1,0,0
"9640","EDM","CAR",2018020889,17942,20182019,0,60,1,3,-2,4.23885781536956,3.11002542090137,1.12883239446819,41,27,14,46,33,13,63,45,18,4,3,0,0
"9641","EDM","NYI",2018020896,17943,20182019,0,60,2,5,-3,5.76800251071109,5.94413248838828,-0.176129977677192,36,24,12,46,31,15,62,39,23,6,4,0,0
"9642","EDM","ARI",2018020924,17946,20182019,1,65,2,2,0,6.11451451026278,4.64417038793399,1.47034412232879,37,35,2,54,44,10,67,58,9,3,4,0,0
"9643","EDM","NYI",2018020938,17948,20182019,1,61.3666666666667,4,3,1,6.55029351371923,2.75625385704916,3.79403965667007,41,23,18,52,28,24,77,45,32,5,3,0,0
"9644","EDM","ANA",2018020954,17950,20182019,1,60,2,1,1,1.99961594387423,4.48128553738934,-2.48166959351511,21,34,-13,26,50,-24,38,67,-29,1,1,0,0
"9645","EDM","NSH",2018020965,17952,20182019,0,65,2,2,0,5.57216936824261,6.67428572796052,-1.10211635971791,27,38,-11,35,61,-26,46,74,-28,3,5,0,0
"9646","EDM","TOR",2018020979,17954,20182019,0,60,2,6,-4,7.38298795057926,4.80460818274878,2.57837976783048,36,36,0,50,51,-1,64,68,-4,2,5,0,0
"9647","EDM","OTT",2018020987,17955,20182019,0,60,4,2,2,4.19801873258257,7.61506505693251,-3.41704632434994,26,37,-11,32,58,-26,48,77,-29,3,1,0,0
"9648","EDM","CBJ",2018020999,17957,20182019,0,60,4,0,4,5.23120124920206,2.24495402054163,2.98624722866043,24,30,-6,30,40,-10,37,57,-20,1,1,0,0
"9649","EDM","BUF",2018021017,17959,20182019,0,60,4,3,1,2.98545265845314,3.87091040912492,-0.885457750671776,27,38,-11,35,50,-15,47,64,-17,2,3,0,0
"9650","EDM","VAN",2018021040,17962,20182019,1,60,3,2,1,3.46008394898672,4.10369809411128,-0.643614145124559,34,37,-3,43,54,-11,55,79,-24,3,4,0,0
"9651","EDM","TOR",2018021055,17964,20182019,1,60,2,3,-1,5.42635400995813,4.85495731487336,0.571396695084768,33,40,-7,50,57,-7,62,72,-10,4,2,0,0
"9652","EDM","NYR",2018021071,17966,20182019,1,60.5833333333333,3,2,1,6.54303911798343,5.90591172091982,0.637127397063608,33,30,3,52,37,15,62,47,15,4,2,0,0
"9653","EDM","N.J",2018021081,17968,20182019,1,60,3,6,-3,5.78139015298802,4.81127381979116,0.970116333196868,39,35,4,51,41,10,74,50,24,6,5,0,0
"9654","EDM","ARI",2018021109,17971,20182019,0,60.9666666666667,3,2,1,4.8104350692712,4.09229998989531,0.718135079375894,25,30,-5,35,44,-9,48,51,-3,3,5,0,0
"9655","EDM","VGK",2018021117,17972,20182019,0,60,3,6,-3,2.29458965881349,3.32264291118751,-1.02805325237402,19,34,-15,25,51,-26,37,64,-27,1,3,0,0
"9656","EDM","STL",2018021127,17974,20182019,0,60,2,7,-5,1.8420214402222,7.48347228852799,-5.64145084830579,17,44,-27,23,53,-30,33,65,-32,1,4,0,0
"9657","EDM","CBJ",2018021145,17976,20182019,1,60,4,1,3,5.44172386243008,4.32079039269593,1.12093346973415,22,20,2,38,28,10,59,42,17,1,0,0,0
"9658","EDM","OTT",2018021153,17978,20182019,1,62.15,3,4,-1,5.03410073147459,4.88608497917869,0.148015752295898,29,35,-6,43,47,-4,61,59,2,2,3,0,0
"9659","EDM","L.A",2018021182,17981,20182019,1,60,8,4,4,5.06529782050347,3.67336693181278,1.39193088869069,32,38,-6,43,54,-11,53,80,-27,2,5,0,0
"9660","EDM","DAL",2018021194,17983,20182019,1,65,2,2,0,3.87510084862379,2.6147446623072,1.26035618631659,42,22,20,53,29,24,64,47,17,2,3,0,0
"9661","EDM","ANA",2018021212,17985,20182019,1,60,1,5,-4,3.83213288085312,2.75494865930523,1.0771842215479,31,38,-7,40,44,-4,56,55,1,2,2,0,0
"9662","EDM","VGK",2018021227,17987,20182019,0,60,1,3,-2,2.06889049468637,5.04476878482819,-2.97587829014182,19,31,-12,28,49,-21,44,67,-23,2,2,0,0
"9663","EDM","COL",2018021236,17988,20182019,0,60,2,6,-4,3.67130836209981,3.10206722075236,0.569241141347447,29,29,0,35,39,-4,51,52,-1,1,3,0,0
"9664","EDM","S.J",2018021252,17990,20182019,1,60,2,3,-1,2.76173262683938,3.41037152941863,-0.64863890257925,28,27,1,35,34,1,51,41,10,5,3,0,0
"9665","EDM","CGY",2018021268,17992,20182019,0,60,3,1,2,3.17331990625352,3.79785555589478,-0.624535649641266,25,31,-6,33,47,-14,41,59,-18,1,3,0,0
"9666","FLA","CAR",2008020011,14162,20082009,0,60,4,6,-2,0,0,0,33,24,9,49,39,10,73,55,18,6,4,0,0
"9667","FLA","ATL",2008020021,14163,20082009,1,63.9,3,2,1,0,0,0,39,33,6,51,40,11,61,47,14,6,6,0,0
"9668","FLA","MIN",2008020052,14168,20082009,1,60,2,6,-4,0,0,0,26,34,-8,38,42,-4,53,49,4,6,8,0,0
"9669","FLA","NYI",2008020069,14170,20082009,1,60,2,0,2,0,0,0,36,31,5,53,39,14,65,49,16,6,2,0,0
"9670","FLA","MTL",2008020080,14172,20082009,0,60,1,3,-2,0,0,0,36,34,2,45,46,-1,68,63,5,4,7,0,0
"9671","FLA","OTT",2008020087,14174,20082009,0,60,3,1,2,0,0,0,21,42,-21,31,55,-24,44,70,-26,4,5,0,0
"9672","FLA","S.J",2008020102,14176,20082009,1,60,4,3,1,0,0,0,35,50,-15,42,56,-14,52,75,-23,3,5,0,0
"9673","FLA","STL",2008020116,14177,20082009,0,60,0,4,-4,0,0,0,17,31,-14,36,45,-9,52,59,-7,5,8,0,0
"9674","FLA","OTT",2008020139,14182,20082009,1,60,1,2,-1,0,0,0,26,31,-5,37,41,-4,50,52,-2,3,5,0,0
"9675","FLA","NSH",2008020158,14184,20082009,0,65,2,2,0,0,0,0,26,32,-6,39,46,-7,53,68,-15,3,4,0,0
"9676","FLA","ATL",2008020164,14185,20082009,0,60,3,5,-2,0,0,0,21,31,-10,34,44,-10,44,54,-10,3,4,0,0
"9677","FLA","L.A",2008020190,14189,20082009,0,60,2,3,-1,0,0,0,15,32,-17,29,53,-24,35,69,-34,6,5,0,0
"9678","FLA","ARI",2008020204,14191,20082009,0,60,1,4,-3,0,0,0,27,39,-12,41,54,-13,67,73,-6,1,7,0,0
"9679","FLA","ANA",2008020212,14192,20082009,0,60,3,1,2,0,0,0,26,45,-19,34,55,-21,41,64,-23,5,5,0,0
"9680","FLA","T.B",2008020225,14195,20082009,1,60,4,0,4,0,0,0,31,24,7,41,36,5,46,44,2,6,5,0,0
"9681","FLA","DET",2008020239,14197,20082009,1,60,2,3,-1,0,0,0,27,32,-5,36,49,-13,44,63,-19,3,4,0,0
"9682","FLA","T.B",2008020265,14201,20082009,0,65,3,3,0,0,0,0,36,52,-16,46,65,-19,55,74,-19,5,2,0,0
"9683","FLA","N.J",2008020271,14203,20082009,0,60,1,3,-2,0,0,0,24,19,5,28,36,-8,40,45,-5,2,2,0,0
"9684","FLA","BOS",2008020279,14204,20082009,0,60,2,4,-2,0,0,0,32,39,-7,39,47,-8,50,55,-5,5,3,0,0
"9685","FLA","CAR",2008020302,14207,20082009,1,60,3,2,1,0,0,0,22,29,-7,32,44,-12,45,57,-12,0,2,0,0
"9686","FLA","N.J",2008020315,14209,20082009,1,64.0666666666667,2,3,-1,0,0,0,38,37,1,46,49,-3,56,58,-2,5,4,0,0
"9687","FLA","NYR",2008020331,14211,20082009,1,65,3,3,0,0,0,0,41,46,-5,48,54,-6,57,64,-7,7,6,0,0
"9688","FLA","NYR",2008020346,14213,20082009,0,60,4,0,4,0,0,0,30,37,-7,46,49,-3,58,68,-10,4,6,0,0
"9689","FLA","WSH",2008020356,14215,20082009,0,60,5,3,2,0,0,0,22,26,-4,32,30,2,46,52,-6,4,4,0,0
"9690","FLA","BUF",2008020371,14217,20082009,1,60,2,1,1,0,0,0,25,46,-21,41,58,-17,55,75,-20,2,4,0,0
"9691","FLA","BOS",2008020385,14219,20082009,1,60,0,4,-4,0,0,0,27,32,-5,37,49,-12,44,61,-17,2,4,0,0
"9692","FLA","OTT",2008020399,14221,20082009,0,64.8333333333333,4,3,1,0,0,0,40,38,2,49,49,0,69,66,3,5,3,0,0
"9693","FLA","EDM",2008020418,14224,20082009,0,60,2,0,2,0,0,0,16,41,-25,24,51,-27,34,66,-32,1,3,0,0
"9694","FLA","CGY",2008020428,14225,20082009,0,65,2,2,0,0,0,0,29,37,-8,42,49,-7,52,68,-16,4,5,0,0
"9695","FLA","VAN",2008020443,14227,20082009,0,60,3,5,-2,0,0,0,21,30,-9,37,42,-5,46,53,-7,5,6,0,0
"9696","FLA","CAR",2008020462,14231,20082009,0,64.2666666666667,1,2,-1,0,0,0,20,37,-17,30,58,-28,47,80,-33,1,4,0,0
"9697","FLA","COL",2008020486,14234,20082009,1,60,3,0,3,0,0,0,24,23,1,38,33,5,52,42,10,6,5,0,0
"9698","FLA","NSH",2008020501,14236,20082009,1,60,3,0,3,0,0,0,43,27,16,48,46,2,56,57,-1,5,2,0,0
"9699","FLA","T.B",2008020511,14239,20082009,1,65,3,3,0,0,0,0,28,35,-7,39,47,-8,64,51,13,5,5,0,0
"9700","FLA","T.B",2008020521,14240,20082009,0,60,4,6,-2,0,0,0,29,42,-13,38,52,-14,49,66,-17,8,6,0,0
"9701","FLA","MTL",2008020534,14242,20082009,1,60,2,5,-3,0,0,0,28,29,-1,40,44,-4,56,50,6,6,7,0,0
"9702","FLA","NYI",2008020547,14244,20082009,0,60,2,4,-2,0,0,0,29,35,-6,41,48,-7,57,58,-1,4,6,0,0
"9703","FLA","PIT",2008020566,14247,20082009,0,60,6,1,5,0,0,0,24,30,-6,36,38,-2,51,47,4,8,5,0,0
"9704","FLA","MTL",2008020576,14248,20082009,0,65,5,5,0,0,0,0,35,45,-10,55,61,-6,71,78,-7,8,7,0,0
"9705","FLA","TOR",2008020589,14250,20082009,0,60,4,2,2,0,0,0,34,26,8,40,45,-5,54,65,-11,4,4,0,0
"9706","FLA","CAR",2008020602,14252,20082009,1,60,4,2,2,0,0,0,31,33,-2,39,45,-6,49,55,-6,2,0,0,0
"9707","FLA","ATL",2008020619,14254,20082009,1,60,8,4,4,0,0,0,29,32,-3,36,46,-10,46,54,-8,5,5,0,0
"9708","FLA","PHI",2008020659,14260,20082009,1,65,2,2,0,0,0,0,34,26,8,44,40,4,59,49,10,6,3,0,0
"9709","FLA","T.B",2008020667,14261,20082009,0,60,4,3,1,0,0,0,21,33,-12,27,46,-19,35,57,-22,2,4,0,0
"9710","FLA","BUF",2008020681,14263,20082009,1,65,2,2,0,0,0,0,29,24,5,42,34,8,51,41,10,5,6,0,0
"9711","FLA","DAL",2008020697,14265,20082009,1,60,1,4,-3,0,0,0,28,25,3,38,33,5,53,44,9,1,2,0,0
"9712","FLA","PHI",2008020706,14271,20082009,1,60,3,2,1,0,0,0,27,35,-8,36,46,-10,46,60,-14,7,5,0,0
"9713","FLA","MTL",2008020719,14273,20082009,1,60,5,1,4,0,0,0,36,36,0,43,52,-9,47,62,-15,5,2,0,0
"9714","FLA","NYI",2008020735,14275,20082009,0,60,1,3,-2,0,0,0,38,30,8,53,39,14,77,51,26,4,4,0,0
"9715","FLA","TOR",2008020752,14278,20082009,0,63.5,4,3,1,0,0,0,31,34,-3,46,51,-5,65,60,5,1,2,0,0
"9716","FLA","NYI",2008020766,14280,20082009,1,60,3,2,1,0,0,0,29,22,7,38,37,1,50,55,-5,2,4,0,0
"9717","FLA","WSH",2008020783,14282,20082009,0,60,1,3,-2,0,0,0,21,39,-18,25,49,-24,44,64,-20,4,3,0,0
"9718","FLA","TOR",2008020799,14285,20082009,1,61.1333333333333,5,4,1,0,0,0,38,39,-1,53,46,7,67,55,12,3,4,0,0
"9719","FLA","CAR",2008020812,14287,20082009,0,60,5,0,5,0,0,0,23,42,-19,35,61,-26,44,81,-37,6,6,0,0
"9720","FLA","NYR",2008020821,14288,20082009,1,65,1,1,0,0,0,0,43,35,8,56,46,10,65,58,7,4,4,0,0
"9721","FLA","WSH",2008020836,14290,20082009,1,60,2,4,-2,0,0,0,31,33,-2,50,40,10,64,53,11,8,3,0,0
"9722","FLA","N.J",2008020850,14292,20082009,1,60,4,0,4,0,0,0,28,36,-8,37,44,-7,50,65,-15,4,5,0,0
"9723","FLA","CHI",2008020865,14294,20082009,1,60,0,4,-4,0,0,0,31,42,-11,42,60,-18,46,78,-32,3,6,0,0
"9724","FLA","BOS",2008020882,14296,20082009,1,60,2,0,2,0,0,0,29,41,-12,41,60,-19,61,68,-7,4,4,0,0
"9725","FLA","BOS",2008020893,14299,20082009,0,60,1,6,-5,0,0,0,25,39,-14,36,49,-13,51,68,-17,1,2,0,0
"9726","FLA","NYR",2008020911,14301,20082009,0,60,2,1,1,0,0,0,22,41,-19,30,54,-24,42,70,-28,4,3,0,0
"9727","FLA","N.J",2008020924,14303,20082009,0,60,2,7,-5,0,0,0,17,46,-29,19,58,-39,23,63,-40,3,3,0,0
"9728","FLA","WSH",2008020935,14304,20082009,0,60,6,2,4,0,0,0,33,34,-1,45,52,-7,60,79,-19,6,2,0,0
"9729","FLA","ATL",2008020943,14306,20082009,0,60,4,3,1,0,0,0,34,30,4,45,43,2,57,55,2,3,2,0,0
"9730","FLA","PIT",2008020960,14308,20082009,1,60,1,4,-3,0,0,0,32,47,-15,45,66,-21,58,83,-25,2,4,0,0
"9731","FLA","STL",2008020975,14310,20082009,1,60,5,3,2,0,0,0,35,29,6,44,41,3,54,56,-2,5,4,0,0
"9732","FLA","PIT",2008020994,14313,20082009,0,65,3,3,0,0,0,0,21,50,-29,29,62,-33,42,85,-43,2,6,0,0
"9733","FLA","BUF",2008021004,14315,20082009,0,60,1,3,-2,0,0,0,31,23,8,39,35,4,56,45,11,4,4,0,0
"9734","FLA","T.B",2008021026,14317,20082009,1,65,3,3,0,0,0,0,37,27,10,48,37,11,62,51,11,3,4,0,0
"9735","FLA","WSH",2008021045,14320,20082009,1,60,0,3,-3,0,0,0,19,27,-8,32,43,-11,52,54,-2,4,1,0,0
"9736","FLA","TOR",2008021058,14322,20082009,1,60,3,1,2,0,0,0,42,38,4,58,51,7,76,62,14,2,4,0,0
"9737","FLA","CBJ",2008021075,14324,20082009,1,60,1,3,-2,0,0,0,23,37,-14,39,51,-12,53,63,-10,3,1,0,0
"9738","FLA","CAR",2008021086,14326,20082009,1,61.6166666666667,2,3,-1,0,0,0,39,31,8,51,42,9,64,55,9,4,1,0,0
"9739","FLA","BUF",2008021096,14328,20082009,0,60,3,5,-2,0,0,0,33,45,-12,46,56,-10,62,73,-11,4,7,0,0
"9740","FLA","PHI",2008021102,14329,20082009,0,60,4,2,2,0,0,0,28,42,-14,37,56,-19,44,79,-35,6,5,0,0
"9741","FLA","DAL",2008021123,14331,20082009,0,60,6,3,3,0,0,0,33,35,-2,47,52,-5,63,69,-6,4,6,0,0
"9742","FLA","OTT",2008021140,14334,20082009,1,60,5,2,3,0,0,0,27,32,-5,36,51,-15,49,71,-22,3,2,0,0
"9743","FLA","ATL",2008021161,14337,20082009,1,60,1,3,-2,0,0,0,36,32,4,52,36,16,67,45,22,4,3,0,0
"9744","FLA","PIT",2008021176,14339,20082009,1,60,4,2,2,0,0,0,26,43,-17,35,53,-18,51,66,-15,4,3,0,0
"9745","FLA","PHI",2008021186,14341,20082009,0,60,1,2,-1,0,0,0,30,30,0,43,46,-3,61,61,0,3,2,0,0
"9746","FLA","ATL",2008021202,14343,20082009,0,60,3,2,1,0,0,0,31,25,6,41,36,5,55,46,9,9,6,0,0
"9747","FLA","WSH",2008021223,14345,20082009,1,60,7,4,3,0,0,0,42,41,1,56,54,2,66,69,-3,1,3,0,0
"9748","FLA","CHI",2009020007,14519,20092010,0,65,3,3,0,0,0,0,24,55,-31,36,70,-34,53,90,-37,3,3,0,0
"9749","FLA","CHI",2009020017,14520,20092010,1,60,0,4,-4,0,0,0,23,33,-10,38,44,-6,48,59,-11,3,5,0,0
"9750","FLA","CAR",2009020047,14526,20092010,0,60,2,7,-5,0,0,0,27,33,-6,44,44,0,62,57,5,7,4,0,0
"9751","FLA","N.J",2009020053,14527,20092010,1,60,2,3,-1,0,0,0,21,41,-20,28,49,-21,44,65,-21,4,6,0,0
"9752","FLA","T.B",2009020069,14529,20092010,0,60,2,3,-1,0,0,0,33,31,2,44,42,2,53,56,-3,5,6,0,0
"9753","FLA","PHI",2009020089,14533,20092010,1,60,4,2,2,0,0,0,28,27,1,40,46,-6,58,54,4,3,2,0,0
"9754","FLA","BUF",2009020114,14538,20092010,1,60,2,5,-3,0,0,0,43,36,7,59,46,13,69,55,14,9,6,0,0
"9755","FLA","PIT",2009020127,14540,20092010,0,65,2,2,0,0,0,0,29,43,-14,40,61,-21,64,75,-11,5,7,0,0
"9756","FLA","PHI",2009020133,14541,20092010,0,60,1,5,-4,0,0,0,18,38,-20,28,53,-25,46,81,-35,4,5,0,0
"9757","FLA","OTT",2009020160,14545,20092010,1,60,3,4,-1,0,0,0,38,29,9,52,38,14,69,47,22,7,1,0,0
"9758","FLA","DAL",2009020177,14547,20092010,0,65,5,5,0,0,0,0,29,37,-8,39,51,-12,55,83,-28,2,6,0,0
"9759","FLA","STL",2009020187,14548,20092010,0,60,4,0,4,0,0,0,27,34,-7,33,44,-11,40,64,-24,3,3,0,0
"9760","FLA","CAR",2009020206,14552,20092010,1,60,3,0,3,0,0,0,25,32,-7,33,47,-14,41,56,-15,8,7,0,0
"9761","FLA","WSH",2009020222,14554,20092010,1,60,1,4,-3,0,0,0,29,25,4,38,37,1,53,52,1,1,2,0,0
"9762","FLA","WSH",2009020232,14555,20092010,0,60,4,7,-3,0,0,0,28,32,-4,37,44,-7,50,67,-17,3,5,0,0
"9763","FLA","BOS",2009020253,14560,20092010,0,65,0,0,0,0,0,0,23,40,-17,30,53,-23,44,70,-26,3,3,0,0
"9764","FLA","NYI",2009020272,14562,20092010,1,65,4,4,0,0,0,0,42,40,2,59,49,10,80,56,24,5,4,0,0
"9765","FLA","L.A",2009020287,14564,20092010,1,65,3,3,0,0,0,0,29,34,-5,40,45,-5,52,59,-7,4,7,0,0
"9766","FLA","BUF",2009020294,14566,20092010,0,60,6,2,4,0,0,0,24,28,-4,35,40,-5,46,61,-15,3,4,0,0
"9767","FLA","DET",2009020309,14568,20092010,0,60.6666666666667,2,1,1,0,0,0,20,40,-20,29,63,-34,39,76,-37,3,4,0,0
"9768","FLA","NYR",2009020317,14569,20092010,0,60,3,2,1,0,0,0,28,34,-6,34,46,-12,44,63,-19,2,1,0,0
"9769","FLA","PIT",2009020332,14571,20092010,1,63.1166666666667,2,3,-1,0,0,0,21,45,-24,33,59,-26,44,71,-27,4,4,0,0
"9770","FLA","NYR",2009020344,14573,20092010,1,65,1,1,0,0,0,0,26,28,-2,43,43,0,56,53,3,5,4,0,0
"9771","FLA","TOR",2009020362,14575,20092010,1,60,4,6,-2,0,0,0,30,33,-3,49,41,8,65,61,4,4,5,0,0
"9772","FLA","NSH",2009020375,14576,20092010,0,60,1,4,-3,0,0,0,24,29,-5,36,43,-7,49,66,-17,5,4,0,0
"9773","FLA","ATL",2009020385,14578,20092010,0,60,3,4,-1,0,0,0,28,35,-7,34,43,-9,43,62,-19,3,1,0,0
"9774","FLA","COL",2009020396,14580,20092010,1,65,5,5,0,0,0,0,44,34,10,55,41,14,66,53,13,9,7,0,0
"9775","FLA","WSH",2009020400,14581,20092010,0,60,2,6,-4,0,0,0,28,44,-16,38,63,-25,50,84,-34,6,9,0,0
"9776","FLA","ATL",2009020420,14583,20092010,1,65,1,1,0,0,0,0,31,37,-6,42,52,-10,53,71,-18,6,5,0,0
"9777","FLA","EDM",2009020434,14585,20092010,1,65,2,2,0,0,0,0,35,28,7,46,39,7,62,47,15,5,4,0,0
"9778","FLA","CBJ",2009020445,14587,20092010,0,60,0,3,-3,0,0,0,32,32,0,42,43,-1,48,63,-15,3,2,0,0
"9779","FLA","N.J",2009020458,14589,20092010,0,60,4,2,2,0,0,0,22,28,-6,26,39,-13,31,54,-23,2,2,0,0
"9780","FLA","PIT",2009020473,14590,20092010,0,60.6166666666667,2,3,-1,0,0,0,31,40,-9,40,54,-14,61,65,-4,5,7,0,0
"9781","FLA","NYI",2009020482,14592,20092010,0,60,7,1,6,0,0,0,26,31,-5,36,37,-1,53,59,-6,2,2,0,0
"9782","FLA","ATL",2009020499,14594,20092010,1,60,4,3,1,0,0,0,29,23,6,36,33,3,45,53,-8,4,2,0,0
"9783","FLA","CAR",2009020513,14596,20092010,1,60,6,3,3,0,0,0,28,35,-7,37,43,-6,42,56,-14,4,2,0,0
"9784","FLA","CAR",2009020524,14597,20092010,0,60,2,3,-1,0,0,0,30,24,6,38,37,1,53,56,-3,5,2,0,0
"9785","FLA","PHI",2009020533,14599,20092010,0,60,4,1,3,0,0,0,30,31,-1,41,40,1,51,58,-7,6,8,0,0
"9786","FLA","NYR",2009020547,14601,20092010,0,60,1,4,-3,0,0,0,34,32,2,40,48,-8,60,75,-15,6,6,0,0
"9787","FLA","BOS",2009020571,14605,20092010,1,60,1,2,-1,0,0,0,26,28,-2,34,39,-5,40,51,-11,3,2,0,0
"9788","FLA","MTL",2009020598,14609,20092010,1,60,4,5,-1,0,0,0,36,42,-6,51,51,0,60,62,-2,3,4,0,0
"9789","FLA","PIT",2009020625,14612,20092010,1,60,6,2,4,0,0,0,35,48,-13,49,59,-10,59,75,-16,1,3,0,0
"9790","FLA","TOR",2009020629,14614,20092010,0,60,2,3,-1,0,0,0,31,31,0,42,46,-4,58,65,-7,3,3,0,0
"9791","FLA","MTL",2009020648,14616,20092010,0,60,0,2,-2,0,0,0,38,39,-1,51,52,-1,77,75,2,1,2,0,0
"9792","FLA","OTT",2009020664,14618,20092010,0,60,3,0,3,0,0,0,19,24,-5,26,38,-12,36,59,-23,7,4,0,0
"9793","FLA","WSH",2009020690,14622,20092010,1,65,4,4,0,0,0,0,30,37,-7,46,60,-14,54,78,-24,3,1,0,0
"9794","FLA","T.B",2009020697,14623,20092010,0,60,3,2,1,0,0,0,29,30,-1,41,38,3,51,52,-1,4,3,0,0
"9795","FLA","T.B",2009020714,14625,20092010,1,60,5,2,3,0,0,0,23,49,-26,38,66,-28,47,85,-38,3,4,0,0
"9796","FLA","ATL",2009020728,14627,20092010,1,60,1,0,1,0,0,0,24,27,-3,37,43,-6,45,64,-19,4,3,0,0
"9797","FLA","N.J",2009020741,14629,20092010,0,60,0,2,-2,0,0,0,22,32,-10,26,45,-19,33,58,-25,3,2,0,0
"9798","FLA","NYI",2009020746,14630,20092010,0,65,1,1,0,0,0,0,34,36,-2,48,51,-3,69,79,-10,3,1,0,0
"9799","FLA","TOR",2009020765,14632,20092010,1,60,2,0,2,0,0,0,22,39,-17,30,57,-27,36,72,-36,3,4,0,0
"9800","FLA","MTL",2009020783,14635,20092010,1,60,2,1,1,0,0,0,29,17,12,44,32,12,61,49,12,4,2,0,0
"9801","FLA","WSH",2009020802,14638,20092010,0,60,1,4,-3,0,0,0,36,40,-4,54,51,3,66,73,-7,6,4,0,0
"9802","FLA","NYI",2009020820,14640,20092010,1,60,2,0,2,0,0,0,25,33,-8,41,49,-8,47,70,-23,5,6,0,0
"9803","FLA","ANA",2009020824,14641,20092010,1,60,0,3,-3,0,0,0,33,25,8,49,37,12,63,51,12,4,3,0,0
"9804","FLA","CGY",2009020853,14645,20092010,1,60,1,2,-1,0,0,0,13,40,-27,20,47,-27,38,60,-22,4,3,0,0
"9805","FLA","ATL",2009020862,14646,20092010,0,60,2,4,-2,0,0,0,28,35,-7,39,48,-9,49,64,-15,8,5,0,0
"9806","FLA","CAR",2009020878,14649,20092010,0,60,1,4,-3,0,0,0,20,30,-10,33,44,-11,44,62,-18,4,4,0,0
"9807","FLA","VAN",2009020894,14651,20092010,1,60,0,3,-3,0,0,0,31,35,-4,49,50,-1,65,63,2,7,6,0,0
"9808","FLA","BOS",2009020909,14653,20092010,1,65,2,2,0,0,0,0,28,39,-11,42,47,-5,52,70,-18,4,2,0,0
"9809","FLA","ATL",2009020926,14670,20092010,0,60,2,4,-2,0,0,0,36,39,-3,46,49,-3,52,71,-19,8,5,0,0
"9810","FLA","PHI",2009020936,14671,20092010,1,60,7,4,3,0,0,0,43,42,1,49,55,-6,60,66,-6,8,5,0,0
"9811","FLA","CAR",2009020959,14674,20092010,1,60,4,1,3,0,0,0,30,32,-2,39,49,-10,42,68,-26,4,7,0,0
"9812","FLA","MIN",2009020981,14677,20092010,0,65,2,2,0,0,0,0,31,11,20,45,19,26,67,39,28,5,2,0,0
"9813","FLA","COL",2009020997,14679,20092010,0,60,0,3,-3,0,0,0,27,31,-4,34,39,-5,49,66,-17,1,2,0,0
"9814","FLA","S.J",2009021014,14681,20092010,0,62.7666666666667,3,2,1,0,0,0,28,39,-11,40,59,-19,55,78,-23,4,3,0,0
"9815","FLA","WSH",2009021033,14684,20092010,1,60,3,7,-4,0,0,0,37,39,-2,49,54,-5,67,64,3,4,5,0,0
"9816","FLA","ARI",2009021048,14686,20092010,1,65,3,3,0,0,0,0,24,46,-22,33,58,-25,42,83,-41,2,3,0,0
"9817","FLA","BUF",2009021062,14688,20092010,1,60,1,3,-2,0,0,0,32,36,-4,50,40,10,61,49,12,6,5,0,0
"9818","FLA","T.B",2009021071,14689,20092010,1,60,5,2,3,0,0,0,40,31,9,45,42,3,56,59,-3,5,2,0,0
"9819","FLA","TOR",2009021080,14691,20092010,0,60,4,1,3,0,0,0,29,43,-14,42,63,-21,52,88,-36,3,6,0,0
"9820","FLA","MTL",2009021103,14693,20092010,0,60,1,4,-3,0,0,0,24,31,-7,38,43,-5,61,58,3,6,3,0,0
"9821","FLA","OTT",2009021115,14695,20092010,0,60,2,3,-1,0,0,0,22,25,-3,34,37,-3,49,55,-6,4,4,0,0
"9822","FLA","NSH",2009021130,14697,20092010,1,61,2,3,-1,0,0,0,29,25,4,38,41,-3,47,54,-7,3,1,0,0
"9823","FLA","BUF",2009021142,14699,20092010,0,60,2,6,-4,0,0,0,15,41,-26,21,51,-30,31,65,-34,2,2,0,0
"9824","FLA","BOS",2009021149,14700,20092010,0,60,1,0,1,0,0,0,20,36,-16,24,54,-30,30,86,-56,1,3,0,0
"9825","FLA","NYR",2009021170,14702,20092010,1,60,1,4,-3,0,0,0,20,27,-7,31,40,-9,42,54,-12,4,1,0,0
"9826","FLA","OTT",2009021188,14705,20092010,1,60,2,5,-3,0,0,0,34,29,5,43,40,3,57,53,4,3,3,0,0
"9827","FLA","N.J",2009021202,14707,20092010,1,60,3,2,1,0,0,0,18,44,-26,27,48,-21,40,62,-22,1,2,0,0
"9828","FLA","T.B",2009021218,14709,20092010,0,65,3,3,0,0,0,0,32,37,-5,42,47,-5,53,73,-20,6,5,0,0
"9829","FLA","T.B",2009021229,14710,20092010,1,60,1,3,-2,0,0,0,31,31,0,40,39,1,50,49,1,3,5,0,0
"9830","FLA","EDM",2010020026,14892,20102011,0,60,2,3,-1,4.30121889026486,2.37475271818198,1.92646617208288,28,13,15,51,23,28,75,31,44,5,2,0,0
"9831","FLA","VAN",2010020033,14893,20102011,0,60,1,2,-1,5.03954928862368,4.60495748124413,0.434591807379547,42,35,7,53,43,10,78,59,19,3,0,0,0
"9832","FLA","CGY",2010020047,14896,20102011,0,60,3,0,3,2.42788384779124,3.63582841063271,-1.20794456284148,18,27,-9,27,43,-16,42,62,-20,3,4,0,0
"9833","FLA","T.B",2010020059,14898,20102011,1,60,6,0,6,3.3699810031394,3.18596633808469,0.184014665054715,38,29,9,45,48,-3,58,58,0,4,2,0,0
"9834","FLA","DAL",2010020088,14903,20102011,1,60,1,4,-3,3.63708569543451,3.70098315038194,-0.0638974549474369,28,29,-1,40,41,-1,50,49,1,3,2,0,0
"9835","FLA","NYI",2010020103,14905,20102011,1,60,4,3,1,2.86567079937885,2.87059775530361,-0.00492695592475911,30,33,-3,39,38,1,48,46,2,6,5,0,0
"9836","FLA","TOR",2010020117,14908,20102011,0,60,1,3,-2,7.1696246159845,4.01124751020689,3.15837710577762,22,27,-5,38,37,1,65,58,7,3,2,0,0
"9837","FLA","OTT",2010020132,14910,20102011,0,60,3,5,-2,6.67407390702283,4.76443517175358,1.90963873526925,31,28,3,43,39,4,60,49,11,3,1,0,0
"9838","FLA","MTL",2010020144,14912,20102011,0,60,3,1,2,5.18424466097457,3.92039100462105,1.26385365635352,31,41,-10,44,55,-11,55,73,-18,4,5,0,0
"9839","FLA","ATL",2010020167,14916,20102011,1,60,3,4,-1,6.19200711560552,5.15849254396744,1.03351457163808,55,23,32,64,33,31,79,47,32,1,1,0,0
"9840","FLA","CAR",2010020182,14918,20102011,1,60,7,4,3,5.04976735120499,5.7424608732108,-0.692693522005811,50,31,19,61,46,15,74,56,18,2,7,0,0
"9841","FLA","CAR",2010020192,14919,20102011,0,60,2,3,-1,3.88319083061651,5.42046048342308,-1.53726965280657,20,29,-9,30,40,-10,49,66,-17,2,5,0,0
"9842","FLA","TOR",2010020214,14923,20102011,1,60,4,1,3,4.60453948589566,4.07884332067624,0.525696165219415,28,33,-5,40,45,-5,47,59,-12,5,5,0,0
"9843","FLA","MIN",2010020230,14925,20102011,1,60,2,1,1,3.41716668918855,5.01199211875351,-1.59482542956496,27,23,4,37,36,1,53,55,-2,5,4,0,0
"9844","FLA","PHI",2010020237,14926,20102011,0,60,2,5,-3,7.68704224530521,5.65495668397384,2.03208556133137,36,42,-6,46,59,-13,67,78,-11,2,4,0,0
"9845","FLA","ATL",2010020262,14930,20102011,0,60,2,1,1,3.81273282552138,5.08690245965082,-1.27416963412944,34,39,-5,45,50,-5,62,61,1,3,1,0,0
"9846","FLA","BOS",2010020269,14931,20102011,0,60,0,4,-4,7.56207739023431,5.76980519543765,1.79227219479667,41,40,1,56,45,11,68,63,5,5,2,0,0
"9847","FLA","NYI",2010020286,14933,20102011,0,60,4,1,3,3.71457912828191,5.07966069130998,-1.36508156302807,31,40,-9,46,52,-6,65,76,-11,6,4,0,0
"9848","FLA","PIT",2010020305,14935,20102011,1,60,2,3,-1,3.73639664027723,2.1353044580278,1.60109218224943,29,26,3,42,32,10,61,41,20,5,3,0,0
"9849","FLA","BOS",2010020315,14937,20102011,1,60,1,3,-2,4.53165924863424,5.64177671711741,-1.11011746848317,32,37,-5,45,50,-5,55,59,-4,2,4,0,0
"9850","FLA","NYR",2010020331,14939,20102011,1,60,0,3,-3,4.10550046220783,2.54143608717575,1.56406437503207,40,19,21,49,32,17,59,41,18,4,3,0,0
"9851","FLA","T.B",2010020338,14940,20102011,0,65,3,3,0,3.65809531183913,6.43382976393332,-2.77573445209418,27,37,-10,39,57,-18,59,73,-14,5,7,0,0
"9852","FLA","ANA",2010020364,14944,20102011,0,60,3,5,-2,3.72064524958842,4.66528614901472,-0.944640899426304,32,29,3,48,36,12,59,50,9,2,1,0,0
"9853","FLA","L.A",2010020372,14945,20102011,0,60,2,3,-1,3.20515566462018,4.51513091022935,-1.30997524560917,26,24,2,33,38,-5,43,56,-13,3,2,0,0
"9854","FLA","ARI",2010020388,14947,20102011,0,65,1,1,0,5.775413806492,2.42576403941156,3.34964976708043,37,41,-4,48,60,-12,57,72,-15,4,3,0,0
"9855","FLA","COL",2010020403,14950,20102011,1,60.7166666666667,4,3,1,2.69155683205463,2.23813788843123,0.453418943623397,25,25,0,36,33,3,51,42,9,2,1,0,0
"9856","FLA","WSH",2010020414,14952,20102011,0,60,3,0,3,5.77118055980407,4.31404387961315,1.45713668019092,32,36,-4,41,52,-11,54,68,-14,6,8,0,0
"9857","FLA","NSH",2010020433,14954,20102011,0,60,0,3,-3,3.51021875742299,1.63780160006718,1.87241715735581,22,27,-5,37,37,0,45,54,-9,3,6,0,0
"9858","FLA","CAR",2010020456,14958,20102011,1,60,3,4,-1,4.213001095457,4.89752336306992,-0.68452226761292,27,34,-7,40,42,-2,49,63,-14,3,4,0,0
"9859","FLA","BUF",2010020470,14960,20102011,1,60,6,2,4,3.37883210933069,6.53256059058332,-3.15372848125264,26,43,-17,41,57,-16,50,72,-22,7,7,0,0
"9860","FLA","PHI",2010020490,14963,20102011,0,60,5,0,5,6.87653568608221,3.66099222860616,3.21554345747604,34,26,8,47,43,4,60,57,3,4,1,0,0
"9861","FLA","PIT",2010020503,14965,20102011,0,60,2,5,-3,7.7040978759178,6.52808111795457,1.17601675796323,37,34,3,51,45,6,63,56,7,3,4,0,0
"9862","FLA","BUF",2010020507,14966,20102011,0,60,4,3,1,3.97414673346979,7.73912647420866,-3.76497974073887,29,48,-19,40,64,-24,50,82,-32,6,7,0,0
"9863","FLA","BOS",2010020532,14970,20102011,1,65,2,2,0,3.399578996934,4.55886546396721,-1.15928646703321,34,42,-8,37,57,-20,54,68,-14,3,2,0,0
"9864","FLA","MTL",2010020558,14974,20102011,1,63.6833333333333,2,3,-1,4.64931980558322,6.73287537532417,-2.08355556974095,22,48,-26,34,58,-24,47,71,-24,6,4,0,0
"9865","FLA","CAR",2010020582,14977,20102011,0,61.2666666666667,4,3,1,5.02187317106063,6.16096985188011,-1.13909668081948,28,37,-9,45,60,-15,66,75,-9,2,4,0,0
"9866","FLA","ATL",2010020593,14979,20102011,1,60,2,3,-1,3.25135148048682,3.12212788797569,0.129223592511124,35,31,4,44,38,6,62,51,11,2,5,0,0
"9867","FLA","CAR",2010020606,14981,20102011,1,60,3,5,-2,6.99331662543597,6.82841399280005,0.164902632635922,35,35,0,40,46,-6,55,54,1,3,3,0,0
"9868","FLA","WSH",2010020617,14982,20102011,0,60,2,3,-1,3.93592274404386,2.73013099596596,1.20579174807791,27,27,0,39,35,4,57,52,5,4,3,0,0
"9869","FLA","WSH",2010020638,14985,20102011,1,62.85,4,3,1,6.26176310342271,6.09859387791948,0.163169225503225,41,33,8,46,46,0,68,49,19,6,6,0,0
"9870","FLA","NSH",2010020650,14987,20102011,1,60,3,2,1,3.60821399548615,4.94600155521766,-1.33778755973151,34,29,5,42,41,1,48,52,-4,3,3,0,0
"9871","FLA","N.J",2010020665,14989,20102011,1,63.6,3,2,1,2.50676956985262,2.96714208977937,-0.46037251992675,22,35,-13,30,46,-16,43,56,-13,4,4,0,0
"9872","FLA","ATL",2010020681,14991,20102011,1,65,2,2,0,7.6366869112461,6.38185762555804,1.25482928568806,40,30,10,61,45,16,76,65,11,5,2,0,0
"9873","FLA","CBJ",2010020694,14993,20102011,1,64.1,2,3,-1,2.60623555567872,5.88559700710846,-3.27936145142974,31,38,-7,37,53,-16,50,66,-16,4,3,0,0
"9874","FLA","T.B",2010020710,14995,20102011,1,65,1,1,0,4.42125433788169,2.97973219181711,1.44152214606459,30,21,9,53,34,19,67,53,14,7,3,0,0
"9875","FLA","N.J",2010020723,14997,20102011,0,60,2,5,-3,3.28930218380992,3.61919428769033,-0.329892103880411,26,23,3,38,32,6,46,39,7,1,3,0,0
"9876","FLA","NYR",2010020734,14999,20102011,0,60,4,3,1,2.35177055541372,3.01410147480419,-0.662330919390471,17,35,-18,19,50,-31,30,66,-36,1,4,0,0
"9877","FLA","BOS",2010020742,15000,20102011,0,60,1,2,-1,3.20366456886404,5.37164677319578,-2.16798220433174,35,35,0,41,52,-11,50,71,-21,1,1,0,0
"9878","FLA","TOR",2010020751,15006,20102011,0,65,3,3,0,4.01656356209112,4.54387802749989,-0.527314465408762,33,25,8,45,40,5,69,55,14,4,4,0,0
"9879","FLA","MTL",2010020766,15007,20102011,0,60,2,3,-1,3.94294212119712,7.08375096046029,-3.14080883926317,35,40,-5,49,59,-10,72,74,-2,3,5,0,0
"9880","FLA","N.J",2010020776,15009,20102011,0,62,4,3,1,5.95073134023903,4.38850071705856,1.56223062318048,29,31,-2,36,39,-3,43,51,-8,2,3,0,0
"9881","FLA","STL",2010020807,15013,20102011,1,60,1,2,-1,4.27766755432822,4.89245540498814,-0.614787850659923,31,28,3,41,38,3,55,51,4,5,5,0,0
"9882","FLA","BUF",2010020820,15015,20102011,1,64.9166666666667,2,3,-1,4.42749248503242,6.60828241606941,-2.180789931037,26,27,-1,31,37,-6,39,51,-12,1,2,0,0
"9883","FLA","S.J",2010020841,15018,20102011,1,60,3,2,1,3.5618972296943,3.49989695261061,0.0620002770836816,22,30,-8,34,45,-11,45,68,-23,4,2,0,0
"9884","FLA","PHI",2010020858,15021,20102011,1,60,2,4,-2,0,0,0,35,35,0,46,45,1,66,53,13,3,4,0,0
"9885","FLA","DET",2010020874,15023,20102011,1,60,3,4,-1,6.20973551931618,2.3940911343052,3.81564438501098,32,30,2,47,33,14,58,42,16,4,3,0,0
"9886","FLA","T.B",2010020881,15024,20102011,0,65,2,2,0,4.86753025353892,6.92533118814754,-2.05780093460862,26,36,-10,38,57,-19,54,69,-15,3,6,0,0
"9887","FLA","NYI",2010020891,15026,20102011,0,60,1,5,-4,1.79937476952909,7.48154184488513,-5.68216707535604,21,37,-16,33,49,-16,56,64,-8,5,3,0,0
"9888","FLA","OTT",2010020903,15028,20102011,0,60,1,5,-4,4.85685622833751,2.95122045297371,1.9056357753638,24,34,-10,41,43,-2,56,58,-2,5,6,0,0
"9889","FLA","ATL",2010020919,15030,20102011,0,65,1,1,0,3.94923548734914,5.24948048302969,-1.30024499568054,32,46,-14,37,56,-19,48,76,-28,5,3,0,0
"9890","FLA","N.J",2010020935,15032,20102011,1,60,1,2,-1,4.21706032333896,3.31236436197651,0.904695961362449,26,26,0,35,32,3,49,41,8,1,3,0,0
"9891","FLA","CAR",2010020944,15034,20102011,0,60,1,2,-1,7.14614031417295,6.23408595139335,0.9120543627796,42,22,20,60,39,21,80,52,28,1,2,0,0
"9892","FLA","MTL",2010020963,15036,20102011,1,60,0,4,-4,5.92324359532358,6.9452561275012,-1.02201253217762,30,31,-1,45,43,2,57,59,-2,3,1,0,0
"9893","FLA","ATL",2010020978,15038,20102011,0,60.4166666666667,3,4,-1,3.6019084446281,5.22763309122456,-1.62572464659646,34,36,-2,41,51,-10,60,64,-4,4,4,0,0
"9894","FLA","WSH",2010020985,15039,20102011,1,60.8,2,3,-1,3.53740692396241,4.56716028959522,-1.02975336563281,34,25,9,45,38,7,61,51,10,6,1,0,0
"9895","FLA","CHI",2010020997,15041,20102011,1,60,3,2,1,2.92579700789497,6.56792656509788,-3.64212955720291,15,39,-24,23,53,-30,28,64,-36,0,3,0,0
"9896","FLA","OTT",2010021010,15043,20102011,1,60,1,2,-1,3.1524803872453,4.47015212532361,-1.3176717380783,34,39,-5,43,49,-6,50,63,-13,3,4,0,0
"9897","FLA","T.B",2010021028,15045,20102011,1,64.7333333333333,4,3,1,4.01068769651465,5.8180750813172,-1.80738738480255,27,38,-11,32,57,-25,40,70,-30,4,7,0,0
"9898","FLA","PHI",2010021047,15048,20102011,1,60,2,3,-1,4.64096358255892,3.7368234051099,0.904140177449015,22,31,-9,35,40,-5,57,49,8,3,5,0,0
"9899","FLA","TOR",2010021059,15050,20102011,1,60,4,0,4,3.94848130468745,3.4282616575365,0.520219647150952,26,24,2,40,36,4,50,51,-1,2,5,0,0
"9900","FLA","NYI",2010021074,15052,20102011,1,65,3,3,0,4.40858902062337,3.71732041265932,0.691268607964048,32,21,11,50,35,15,66,50,16,3,3,0,0
"9901","FLA","NYR",2010021089,15055,20102011,0,60,0,1,-1,2.3829168927766,2.61284946778324,-0.229932575006631,22,33,-11,31,38,-7,43,51,-8,0,1,0,0
"9902","FLA","CHI",2010021099,15056,20102011,0,60,0,4,-4,2.29106752533698,2.91828454192728,-0.627217016590293,23,31,-8,31,37,-6,40,53,-13,2,4,0,0
"9903","FLA","BUF",2010021112,15058,20102011,0,60,2,4,-2,3.25788637269397,5.22682680006308,-1.96894042736911,24,32,-8,40,40,0,52,46,6,3,3,0,0
"9904","FLA","PIT",2010021128,15060,20102011,0,65,1,1,0,7.86799922313185,4.89238067658152,2.97561854655032,38,28,10,49,43,6,64,60,4,2,3,0,0
"9905","FLA","CBJ",2010021138,15062,20102011,0,65,2,2,0,8.30873029064969,6.5122243370372,1.7965059536125,31,32,-1,43,42,1,55,58,-3,3,3,0,0
"9906","FLA","OTT",2010021155,15064,20102011,1,60,1,4,-3,4.48882310045883,3.11508584772272,1.37373725273611,38,23,15,55,32,23,71,35,36,4,2,0,0
"9907","FLA","PIT",2010021172,15066,20102011,1,60,2,4,-2,5.17916052218061,7.18678935808791,-2.0076288359073,30,34,-4,48,54,-6,57,72,-15,3,2,0,0
"9908","FLA","WSH",2010021195,15070,20102011,0,60,2,5,-3,4.00231396366477,3.48053616665595,0.52177779700882,33,25,8,44,37,7,68,43,25,5,5,0,0
"9909","FLA","T.B",2010021209,15072,20102011,0,60,2,4,-2,4.20810016731275,4.20578817939026,0.00231198792249465,25,34,-9,42,45,-3,52,59,-7,5,5,0,0
"9910","FLA","WSH",2010021220,15073,20102011,1,60,1,0,1,4.86640117783099,4.96549001305035,-0.0990888352193586,23,28,-5,34,41,-7,52,54,-2,2,1,0,0
"9911","FLA","NYI",2011020014,15255,20112012,0,60,2,0,2,4.36566294749298,4.14775019704393,0.217912750449045,29,27,2,41,37,4,65,50,15,6,4,0,0
"9912","FLA","PIT",2011020032,15258,20112012,0,60,2,4,-2,6.20854394961617,3.40832173041861,2.80022221919756,34,29,5,44,38,6,59,50,9,5,4,0,0
"9913","FLA","T.B",2011020056,15262,20112012,1,65,2,2,0,3.29422401243426,4.73680041730404,-1.44257640486978,38,30,8,54,42,12,65,53,12,8,4,0,0
"9914","FLA","T.B",2011020065,15264,20112012,0,60,7,4,3,5.91331923286683,8.26466749063668,-2.35134825776985,33,39,-6,48,48,0,60,56,4,9,3,0,0
"9915","FLA","WSH",2011020070,15265,20112012,0,60,0,3,-3,3.57633107792208,4.15015532658435,-0.573824248662277,20,32,-12,32,47,-15,44,56,-12,3,2,0,0
"9916","FLA","BUF",2011020085,15267,20112012,1,60,0,3,-3,3.44663547817618,5.15091598598519,-1.70428050780902,22,38,-16,29,48,-19,39,60,-21,1,3,0,0
"9917","FLA","NYI",2011020105,15269,20112012,1,60,4,2,2,5.86863906128701,3.74168590389309,2.12695315739393,33,28,5,48,39,9,57,46,11,3,5,0,0
"9918","FLA","MTL",2011020111,15271,20112012,0,60,2,1,1,4.86029885525932,6.39238706441392,-1.53208820915461,31,41,-10,43,49,-6,57,58,-1,3,3,0,0
"9919","FLA","OTT",2011020130,15274,20112012,0,60,3,4,-1,3.82987267203407,5.44242702675547,-1.6125543547214,25,38,-13,36,50,-14,50,68,-18,5,3,0,0
"9920","FLA","BUF",2011020141,15276,20112012,0,60,3,2,1,4.82389518615673,4.50235110503854,0.321544081118191,36,26,10,48,38,10,55,46,9,6,4,0,0
"9921","FLA","WPG",2011020158,15278,20112012,1,65,3,3,0,3.74097621926558,4.74383457098156,-1.00285835171599,42,31,11,49,38,11,69,47,22,6,2,0,0
"9922","FLA","CHI",2011020172,15281,20112012,1,65,2,2,0,3.87201597160329,4.26235167036066,-0.390335698757369,43,33,10,53,48,5,71,61,10,2,2,0,0
"9923","FLA","T.B",2011020196,15284,20112012,1,65,3,3,0,4.81773716284806,3.50684234857908,1.31089481426898,41,37,4,53,43,10,64,52,12,2,3,0,0
"9924","FLA","TOR",2011020203,15286,20112012,0,60,5,1,4,4.15473144920543,4.31129925212008,-0.156567802914651,28,39,-11,37,49,-12,57,67,-10,2,2,0,0
"9925","FLA","WPG",2011020217,15288,20112012,0,60,5,2,3,6.7737500775676,2.54313096069657,4.23061911687103,20,27,-7,38,41,-3,47,52,-5,5,3,0,0
"9926","FLA","PHI",2011020240,15291,20112012,1,60,2,3,-1,3.93201999634473,3.69692043726536,0.235099559079366,33,35,-2,48,44,4,66,56,10,6,6,0,0
"9927","FLA","DAL",2011020254,15293,20112012,0,60,6,0,6,3.19265220632587,2.6039083446376,0.588743861688272,30,25,5,43,33,10,72,40,32,5,3,0,0
"9928","FLA","STL",2011020264,15295,20112012,0,60,1,4,-3,3.81388038162777,5.70029094725282,-1.88641056562506,21,31,-10,31,38,-7,48,50,-2,3,5,0,0
"9929","FLA","PIT",2011020281,15297,20112012,1,60,3,2,1,4.01039239136975,5.06937082996592,-1.05897843859617,31,41,-10,42,47,-5,46,64,-18,4,2,0,0
"9930","FLA","N.J",2011020295,15299,20112012,1,60,4,3,1,5.63377730951083,2.75480877660448,2.87896853290636,36,25,11,44,37,7,57,46,11,5,3,0,0
"9931","FLA","NYR",2011020307,15301,20112012,1,60,2,1,1,3.5649688016274,3.92841606942238,-0.363447267794982,38,20,18,51,28,23,59,39,20,3,4,0,0
"9932","FLA","T.B",2011020322,15303,20112012,1,62.4833333333333,1,2,-1,3.47807170135638,3.2865702509489,0.191501450407479,24,31,-7,38,38,0,49,51,-2,4,2,0,0
"9933","FLA","T.B",2011020332,15304,20112012,0,60,1,5,-4,3.41899662552169,4.75688344493401,-1.33788681941232,25,34,-9,36,41,-5,51,55,-4,6,2,0,0
"9934","FLA","CAR",2011020348,15307,20112012,0,60,3,1,2,4.08298431435568,3.17539927747566,0.907585036880015,21,27,-6,27,47,-20,35,65,-30,3,5,0,0
"9935","FLA","L.A",2011020364,15309,20112012,0,60,1,2,-1,4.57307066197973,5.20424997492228,-0.63117931294255,42,26,16,59,35,24,76,41,35,7,3,0,0
"9936","FLA","S.J",2011020383,15311,20112012,0,60,5,3,2,3.81424786066054,4.87112528234138,-1.05687742168084,35,26,9,42,40,2,63,60,3,5,3,0,0
"9937","FLA","WSH",2011020390,15313,20112012,1,60,5,4,1,3.42509071336895,7.05463475114084,-3.62954403777189,30,32,-2,41,44,-3,45,54,-9,6,2,0,0
"9938","FLA","BOS",2011020405,15316,20112012,0,60,2,0,2,5.41254696630826,7.73489037004356,-2.3223434037353,30,40,-10,35,54,-19,45,70,-25,1,4,0,0
"9939","FLA","BUF",2011020418,15317,20112012,0,62.3166666666667,1,2,-1,4.42262620496564,4.25115257228026,0.171473632685379,23,20,3,35,31,4,44,42,2,4,5,0,0
"9940","FLA","NYR",2011020433,15319,20112012,0,60,1,6,-5,3.68793467228534,5.21173627397711,-1.52380160169177,21,33,-12,34,41,-7,53,58,-5,6,3,0,0
"9941","FLA","N.J",2011020444,15321,20112012,1,65,2,2,0,1.48000691310153,5.18933674221626,-3.70932982911472,26,34,-8,34,54,-20,42,65,-23,3,6,0,0
"9942","FLA","CGY",2011020464,15324,20112012,1,65,2,2,0,5.35990018122902,2.63873295110579,2.72116723012323,41,26,15,57,34,23,69,48,21,6,5,0,0
"9943","FLA","CAR",2011020478,15326,20112012,1,63.1333333333333,3,2,1,4.80091236745223,2.97591820638627,1.82499416106596,25,26,-1,37,37,0,50,55,-5,3,3,0,0
"9944","FLA","ARI",2011020491,15328,20112012,1,60,1,2,-1,3.27670679623827,1.79193147825299,1.48477531798528,28,22,6,42,25,17,52,35,17,5,7,0,0
"9945","FLA","OTT",2011020502,15330,20112012,0,62.0333333333333,3,4,-1,5.16629857616499,5.45298334821014,-0.286684772045152,35,26,9,49,38,11,66,53,13,4,3,0,0
"9946","FLA","BOS",2011020508,15331,20112012,0,60,0,8,-8,3.15261293170374,4.84209387941519,-1.68948094771144,30,35,-5,36,50,-14,49,66,-17,2,5,0,0
"9947","FLA","TOR",2011020533,15335,20112012,1,60,5,3,2,3.77742446266604,4.26618969865376,-0.488765235987717,26,32,-6,37,42,-5,45,58,-13,3,4,0,0
"9948","FLA","NYR",2011020553,15338,20112012,1,60,1,4,-3,3.70878211698437,3.23303805466276,0.47574406232161,28,25,3,42,31,11,60,37,23,4,2,0,0
"9949","FLA","MTL",2011020559,15339,20112012,1,60,3,2,1,7.68364557522128,5.90514207639424,1.77850349882704,35,28,7,45,41,4,54,55,-1,8,5,0,0
"9950","FLA","NYR",2011020586,15344,20112012,0,63.4833333333333,2,3,-1,3.26620441750856,5.22668785478891,-1.96048343728035,21,41,-20,25,57,-32,39,74,-35,1,3,0,0
"9951","FLA","N.J",2011020593,15345,20112012,0,60,2,5,-3,3.22156575568169,5.44164868647931,-2.22008293079762,24,29,-5,28,36,-8,35,41,-6,2,3,0,0
"9952","FLA","VAN",2011020614,15348,20112012,1,60,2,1,1,3.58632111782754,4.39723002841856,-0.810908910591024,22,26,-4,35,43,-8,46,59,-13,4,4,0,0
"9953","FLA","BOS",2011020667,15355,20112012,1,65,2,2,0,0,0,0,40,35,5,50,45,5,59,52,7,3,2,0,0
"9954","FLA","COL",2011020683,15357,20112012,0,63.9166666666667,3,4,-1,5.31679058331065,7.72053522495844,-2.40374464164779,29,44,-15,39,54,-15,57,75,-18,2,3,0,0
"9955","FLA","CHI",2011020697,15359,20112012,0,60,1,3,-2,2.01884800297921,3.18094452492369,-1.16209652194448,19,22,-3,26,31,-5,34,46,-12,3,4,0,0
"9956","FLA","WPG",2011020706,15360,20112012,0,65,3,3,0,2.54077010150831,6.47683337537455,-3.93606327386624,23,44,-21,28,56,-28,35,80,-45,3,5,0,0
"9957","FLA","PHI",2011020727,15363,20112012,1,65,2,2,0,2.92395800167026,6.78485227009924,-3.86089426842898,25,37,-12,32,45,-13,45,54,-9,2,3,0,0
"9958","FLA","WSH",2011020751,15371,20112012,1,60,4,2,2,5.38549563587719,3.03546327343065,2.35003236244654,38,28,10,54,40,14,70,51,19,4,2,0,0
"9959","FLA","WPG",2011020763,15373,20112012,1,60,2,1,1,6.37271938870333,3.58255409655976,2.79016529214357,30,21,9,43,26,17,58,45,13,3,1,0,0
"9960","FLA","T.B",2011020774,15374,20112012,0,60,3,6,-3,3.02346884731014,4.27847850284888,-1.25500965553874,20,34,-14,33,42,-9,55,54,1,3,3,0,0
"9961","FLA","WSH",2011020788,15377,20112012,0,60,0,4,-4,4.24292740915553,2.40492578521052,1.83800162394501,42,24,18,57,33,24,74,39,35,4,1,0,0
"9962","FLA","L.A",2011020808,15379,20112012,1,60,3,1,2,3.43681084869657,3.43106500727299,0.00574584142357892,23,23,0,31,35,-4,35,53,-18,2,2,0,0
"9963","FLA","N.J",2011020817,15381,20112012,0,60,3,1,2,2.80785000050673,2.77343823765841,0.0344117628483218,20,28,-8,20,33,-13,31,42,-11,3,1,0,0
"9964","FLA","NYI",2011020827,15382,20112012,0,60,4,1,3,2.50012574971652,4.06717109458987,-1.56704534487335,19,27,-8,25,46,-21,36,68,-32,1,2,0,0
"9965","FLA","OTT",2011020848,15385,20112012,1,60,2,6,-4,3.93528444352078,3.41588120304678,0.519403240474002,44,31,13,57,42,15,67,61,6,5,4,0,0
"9966","FLA","WSH",2011020861,15387,20112012,1,60,1,2,-1,2.98200888044084,5.8929263951577,-2.91091751471686,23,41,-18,33,59,-26,50,75,-25,3,6,0,0
"9967","FLA","ANA",2011020878,15389,20112012,1,60,0,2,-2,6.62394354300341,2.4478982704544,4.176045272549,31,27,4,42,40,2,58,54,4,3,2,0,0
"9968","FLA","MIN",2011020901,15393,20112012,1,65,2,2,0,4.31225922447629,3.99217183399014,0.320087390486151,43,28,15,58,35,23,81,45,36,3,3,0,0
"9969","FLA","CAR",2011020921,15395,20112012,0,65,2,2,0,8.350974181325,5.49007003367296,2.86090414765204,44,28,16,62,35,27,81,49,32,3,3,0,0
"9970","FLA","MTL",2011020929,15396,20112012,1,60,4,2,2,4.46515821386754,2.09753052896122,2.36762768490632,32,20,12,48,32,16,57,37,20,7,7,0,0
"9971","FLA","TOR",2011020938,15398,20112012,0,60,5,3,2,3.60592055605957,3.61390178391263,-0.00798122785305644,23,31,-8,33,47,-14,40,64,-24,4,5,0,0
"9972","FLA","WPG",2011020954,15400,20112012,0,60,0,7,-7,4.20951729174703,5.54207996754121,-1.33256267579418,33,32,1,45,42,3,61,57,4,4,4,0,0
"9973","FLA","NSH",2011020968,15402,20112012,1,60,1,3,-2,5.39175464672735,2.74357365227971,2.64818099444764,40,23,17,49,32,17,58,43,15,3,1,0,0
"9974","FLA","OTT",2011020977,15403,20112012,1,60,4,2,2,4.8945375578478,2.31669376999044,2.57784378785735,28,25,3,39,38,1,46,63,-17,4,2,0,0
"9975","FLA","PHI",2011021000,15407,20112012,0,60,0,5,-5,4.18525908698211,5.65134235373113,-1.46608326674902,28,35,-7,42,53,-11,60,59,1,6,6,0,0
"9976","FLA","CAR",2011021026,15410,20112012,1,60,2,0,2,3.66949148904364,3.64521223800966,0.0242792510339731,33,34,-1,46,46,0,59,59,0,3,4,0,0
"9977","FLA","TOR",2011021041,15412,20112012,1,60,5,2,3,3.05869277764577,1.9697870479431,1.08890572970267,27,28,-1,39,40,-1,47,53,-6,4,2,0,0
"9978","FLA","BOS",2011021057,15414,20112012,1,60,6,2,4,4.6179464526067,5.53069282422075,-0.912746371614048,29,26,3,40,37,3,50,49,1,3,2,0,0
"9979","FLA","BUF",2011021072,15416,20112012,1,65,2,2,0,2.65177953569219,2.80807992815971,-0.156300392467529,17,26,-9,27,30,-3,43,45,-2,2,3,0,0
"9980","FLA","PHI",2011021089,15419,20112012,0,60,2,1,1,2.91397647513804,5.38197105911968,-2.46799458398164,13,36,-23,30,50,-20,41,68,-27,2,4,0,0
"9981","FLA","CAR",2011021098,15420,20112012,0,60,1,3,-2,3.79028040199134,5.60289904003412,-1.81261863804278,31,39,-8,45,52,-7,63,63,0,8,7,0,0
"9982","FLA","EDM",2011021115,15422,20112012,1,65,1,1,0,5.460713886132,3.4626327707665,1.99808111536549,27,21,6,39,29,10,57,41,16,4,1,0,0
"9983","FLA","NYI",2011021129,15424,20112012,1,65,2,2,0,3.15070083655883,6.42388808081091,-3.27318724425209,35,37,-2,45,51,-6,59,60,-1,2,2,0,0
"9984","FLA","MTL",2011021145,15426,20112012,0,65,2,2,0,6.18926962895785,4.42999050481012,1.75927912414772,36,29,7,50,37,13,70,48,22,3,2,0,0
"9985","FLA","MIN",2011021158,15428,20112012,0,60.25,2,3,-1,5.91000287351198,2.95598122737397,2.95402164613802,27,25,2,43,32,11,56,43,13,5,2,0,0
"9986","FLA","CBJ",2011021163,15429,20112012,0,60,1,4,-3,3.76289786101552,5.07596323231701,-1.31306537130149,31,29,2,36,41,-5,50,49,1,4,6,0,0
"9987","FLA","DET",2011021183,15431,20112012,0,65,1,1,0,3.85452288863598,6.40795057287755,-2.55342768424157,28,32,-4,37,45,-8,43,56,-13,4,4,0,0
"9988","FLA","WPG",2011021194,15433,20112012,1,63.2,4,5,-1,5.96080343757058,6.04049569080235,-0.0796922532317694,38,30,8,49,42,7,64,50,14,2,2,0,0
"9989","FLA","WSH",2011021205,15435,20112012,0,60,2,4,-2,3.87919625298309,2.62955251074163,1.24964374224146,27,24,3,45,28,17,70,39,31,1,2,0,0
"9990","FLA","CAR",2011021225,15437,20112012,1,60,4,1,3,3.0911819451826,4.97425539146207,-1.88307344627947,26,35,-9,34,43,-9,45,57,-12,2,2,0,0
"9991","FLA","N.J",2011030131,15443,20112012,1,60,2,3,-1,2.83401314353409,4.57997314657405,-1.74596000303995,26,38,-12,34,45,-11,40,51,-11,4,6,0,0
"9992","FLA","N.J",2011030132,15445,20112012,1,60,4,2,2,7.33334048353646,2.95950932666892,4.37383115686754,24,25,-1,35,38,-3,47,56,-9,4,2,0,0
"9993","FLA","N.J",2011030133,15447,20112012,0,60,4,3,1,2.72848689911189,2.79141030422761,-0.0629234051157255,26,25,1,34,33,1,40,48,-8,4,4,0,0
"9994","FLA","N.J",2011030134,15449,20112012,0,60,0,4,-4,3.99227435369312,4.49902453545025,-0.506750181757127,26,27,-1,33,37,-4,40,48,-8,8,6,0,0
"9995","FLA","N.J",2011030135,15451,20112012,1,60,3,0,3,6.23946029755468,5.46324354922569,0.776216748328981,33,30,3,48,40,8,60,53,7,6,4,0,0
"9996","FLA","N.J",2011030136,15454,20112012,0,65.65,2,3,-1,3.84594390664637,3.81625348145462,0.0296904251917454,16,42,-26,24,57,-33,30,61,-31,1,4,0,0
"9997","FLA","N.J",2011030137,15456,20112012,1,80,2,2,0,3.80320177490103,3.14787505187996,0.655326723021062,45,35,10,55,50,5,72,68,4,6,6,0,0
"9998","FLA","CAR",2012020008,15724,20122013,1,60,5,1,4,3.309533699241,6.21305985380604,-2.90352615456504,25,42,-17,29,67,-38,39,81,-42,7,8,0,0
"9999","FLA","OTT",2012020024,15726,20122013,0,60,0,4,-4,3.92589914416914,4.82934358928292,-0.903444445113776,31,37,-6,37,44,-7,50,62,-12,3,4,0,0
"10000","FLA","MTL",2012020029,15727,20122013,0,60,1,4,-3,5.89858423639089,5.88592963668452,0.0126545997063658,28,33,-5,38,47,-9,48,59,-11,8,7,0,0
"10001","FLA","OTT",2012020044,15729,20122013,1,60,1,3,-2,2.62375677673845,5.60497611548635,-2.98121933874791,26,37,-11,35,45,-10,50,64,-14,5,4,0,0
"10002","FLA","PHI",2012020060,15731,20122013,1,60,1,7,-6,5.36344481588458,3.20671617169864,2.15672864418593,31,26,5,50,37,13,60,51,9,5,8,0,0
"10003","FLA","T.B",2012020084,15734,20122013,0,60,2,5,-3,3.54339659746856,5.27818764157146,-1.7347910441029,28,33,-5,38,43,-5,48,50,-2,5,6,0,0
"10004","FLA","WPG",2012020097,15736,20122013,1,60,6,3,3,5.29343726031948,4.57537898444571,0.718058275873773,34,25,9,44,41,3,57,46,11,7,5,0,0
"10005","FLA","BUF",2012020121,15739,20122013,0,60,4,3,1,5.07418646867154,3.25326522500836,1.82092124366318,33,20,13,40,29,11,51,43,8,3,1,0,0
"10006","FLA","WPG",2012020135,15741,20122013,0,64.7333333333333,2,3,-1,2.7856251798803,4.91016769672569,-2.12454251684539,19,21,-2,25,36,-11,37,56,-19,2,4,0,0
"10007","FLA","PHI",2012020144,15743,20122013,0,65,2,2,0,1.87087506311309,2.2791468691139,-0.408271806000812,24,32,-8,34,40,-6,46,59,-13,4,4,0,0
"10008","FLA","WSH",2012020162,15745,20122013,0,60,0,5,-5,1.65174817268462,4.43131087050795,-2.77956269782333,27,25,2,31,35,-4,50,53,-3,3,3,0,0
"10009","FLA","WSH",2012020182,15748,20122013,1,60.5333333333333,5,6,-1,3.92098399360289,3.60145493731751,0.319529056285385,32,29,3,40,43,-3,49,57,-8,6,4,0,0
"10010","FLA","MTL",2012020194,15750,20122013,1,62.1666666666667,0,1,-1,3.27904694441531,2.9888374695438,0.290209474871517,26,32,-6,34,38,-4,46,48,-2,2,3,0,0
"10011","FLA","T.B",2012020208,15752,20122013,1,61.3166666666667,5,6,-1,4.74783704009639,4.40064025466563,0.347196785430754,30,36,-6,47,52,-5,54,59,-5,3,4,0,0
"10012","FLA","TOR",2012020223,15754,20122013,1,60,0,3,-3,5.04626517181202,2.26003302503932,2.7862321467727,37,33,4,46,41,5,53,49,4,5,4,0,0
"10013","FLA","PHI",2012020238,15757,20122013,0,60,5,2,3,6.66829231317388,4.9493497862918,1.71894252688207,26,34,-8,35,50,-15,47,73,-26,4,2,0,0
"10014","FLA","BOS",2012020262,15760,20122013,1,60,1,4,-3,5.84460110565083,3.97373796736429,1.87086313828655,35,32,3,52,43,9,70,53,17,4,1,0,0
"10015","FLA","BUF",2012020292,15764,20122013,1,65,3,3,0,5.13505158817134,4.20013554392641,0.934916044244922,43,25,18,58,29,29,71,39,32,5,2,0,0
"10016","FLA","CAR",2012020307,15766,20122013,0,60,2,6,-4,3.63972830861167,5.16692893719301,-1.52720062858134,24,34,-10,30,44,-14,45,59,-14,1,5,0,0
"10017","FLA","CAR",2012020315,15767,20122013,1,60,2,3,-1,3.17559570580488,2.32102317811223,0.854572527692653,36,24,12,46,32,14,55,43,12,1,2,0,0
"10018","FLA","WPG",2012020330,15769,20122013,1,60,4,1,3,4.66688907745993,3.5261441556504,1.14074492180953,26,31,-5,39,41,-2,48,47,1,3,0,0,0
"10019","FLA","WSH",2012020343,15771,20122013,0,60,1,7,-6,5.06858590436643,2.85075425272225,2.21783165164417,30,26,4,44,37,7,66,48,18,2,1,0,0
"10020","FLA","WPG",2012020351,15772,20122013,1,64.3166666666667,2,3,-1,6.57682369750796,4.24665619328557,2.33016750422239,40,28,12,54,37,17,63,54,9,4,1,0,0
"10021","FLA","MTL",2012020367,15774,20122013,1,60,2,5,-3,3.41690554283559,5.04238421602713,-1.62547867319154,17,38,-21,23,55,-32,33,62,-29,2,7,0,0
"10022","FLA","T.B",2012020381,15776,20122013,1,60,2,3,-1,4.9696659569745,5.04129354122051,-0.0716275842460163,39,13,26,55,22,33,68,33,35,4,2,0,0
"10023","FLA","BOS",2012020391,15778,20122013,0,60,1,4,-3,1.28528995852532,5.80656956969324,-4.52127961116792,30,32,-2,37,44,-7,52,54,-2,2,2,0,0
"10024","FLA","NYI",2012020413,15780,20122013,1,60,3,4,-1,5.91449843093869,3.97125943300125,1.94323899793744,30,25,5,49,32,17,66,49,17,1,0,0,0
"10025","FLA","CAR",2012020431,15783,20122013,0,60,4,1,3,4.38004768949494,3.50765282208698,0.872394867407962,44,34,10,62,52,10,73,71,2,4,4,0,0
"10026","FLA","NYR",2012020445,15785,20122013,0,60,3,1,2,0,0,0,24,45,-21,35,53,-18,41,77,-36,2,3,0,0
"10027","FLA","N.J",2012020461,15787,20122013,0,60,1,2,-1,3.58018675073833,3.20673238216692,0.373454368571416,18,25,-7,31,40,-9,47,48,-1,2,1,0,0
"10028","FLA","NYI",2012020465,15788,20122013,0,60,0,3,-3,3.1279845329118,5.19885801521013,-2.07087348229834,26,37,-11,38,41,-3,56,52,4,2,2,0,0
"10029","FLA","TOR",2012020479,15790,20122013,0,60,2,3,-1,6.29706813215876,4.48866382052711,1.80840431163165,42,31,11,56,39,17,76,54,22,1,3,0,0
"10030","FLA","BUF",2012020496,15792,20122013,1,65,4,4,0,4.72826510146071,6.3662263137037,-1.63796121224298,40,40,0,52,52,0,60,58,2,6,5,0,0
"10031","FLA","N.J",2012020514,15794,20122013,1,61.7166666666667,3,2,1,4.38036403603746,3.99395108528087,0.386412950756593,30,26,4,36,31,5,51,37,14,4,5,0,0
"10032","FLA","T.B",2012020535,15797,20122013,0,65,2,2,0,3.98344337931485,5.34374143640622,-1.36029805709137,25,41,-16,37,56,-19,49,70,-21,3,3,0,0
"10033","FLA","WSH",2012020566,15801,20122013,1,60,3,4,-1,3.55295073668822,4.2604566195223,-0.707505882834084,30,31,-1,33,43,-10,45,58,-13,2,3,0,0
"10034","FLA","OTT",2012020571,15802,20122013,1,60,2,1,1,2.06152622401714,3.85174675824237,-1.79022053422523,17,41,-24,25,55,-30,32,74,-42,1,5,0,0
"10035","FLA","WPG",2012020602,15806,20122013,0,60,2,7,-5,3.86845803519827,6.81858542337432,-2.95012738817604,27,35,-8,40,51,-11,50,67,-17,2,4,0,0
"10036","FLA","NYI",2012020632,15811,20122013,0,60,2,5,-3,5.57206293396857,4.08078272324565,1.49128021072292,28,31,-3,45,43,2,66,52,14,6,3,0,0
"10037","FLA","NYR",2012020645,15813,20122013,0,60,1,6,-5,3.04072888324791,5.28689624590334,-2.24616736265543,35,30,5,45,42,3,57,50,7,1,4,0,0
"10038","FLA","N.J",2012020660,15815,20122013,0,60,2,6,-4,0.91622809600085,3.82735125499111,-2.91112315899026,13,33,-20,15,41,-26,22,49,-27,3,3,0,0
"10039","FLA","BOS",2012020668,15816,20122013,0,60,0,3,-3,3.86338382790564,6.21152378949478,-2.34813996158914,28,39,-11,41,52,-11,52,64,-12,2,2,0,0
"10040","FLA","NYR",2012020685,15818,20122013,1,60,3,2,1,3.33438739361009,6.57795396133588,-3.24356656772579,16,38,-22,22,49,-27,37,66,-29,2,3,0,0
"10041","FLA","TOR",2012020698,15820,20122013,1,60,0,4,-4,3.36827138627996,1.51254615196376,1.8557252343162,34,17,17,47,24,23,67,30,37,5,3,0,0
"10042","FLA","T.B",2012020712,15822,20122013,0,60,5,3,2,5.17227573474884,3.93112291992657,1.24115281482227,32,31,1,43,42,1,54,54,0,2,4,0,0
"10043","FLA","DAL",2013020012,15981,20132014,0,60,4,2,2,7.58179518933089,2.27471499246894,5.30708019686195,39,27,12,46,37,9,56,61,-5,4,3,0,0
"10044","FLA","STL",2013020027,15983,20132014,0,60,0,7,-7,2.11714409710839,4.78328656339363,-2.66614246628524,19,34,-15,29,44,-15,41,50,-9,9,7,0,0
"10045","FLA","PHI",2013020039,15986,20132014,0,60,1,2,-1,4.61625689381526,4.03259904043091,0.583657853384352,34,30,4,48,41,7,68,57,11,7,6,0,0
"10046","FLA","T.B",2013020052,15988,20132014,0,60,2,7,-5,3.38323046087316,2.59707874556625,0.786151715306914,21,28,-7,30,37,-7,39,53,-14,6,6,0,0
"10047","FLA","L.A",2013020076,15991,20132014,1,60,0,3,-3,3.18595744372578,5.65547330911707,-2.46951586539129,20,29,-9,27,39,-12,32,54,-22,2,1,0,0
"10048","FLA","NSH",2013020090,15993,20132014,0,60,3,4,-1,3.96682615492318,3.34451011742931,0.622316037493874,25,30,-5,40,39,1,52,50,2,1,2,0,0
"10049","FLA","BOS",2013020103,15995,20132014,1,60,2,3,-1,3.26338506976026,4.21492484753253,-0.951539777772268,29,40,-11,35,49,-14,38,63,-25,1,2,0,0
"10050","FLA","MIN",2013020115,15997,20132014,1,65,1,1,0,4.14535618090304,4.24039147367387,-0.0950352927708309,22,31,-9,31,43,-12,34,57,-23,5,5,0,0
"10051","FLA","CHI",2013020133,16000,20132014,1,65,2,2,0,3.89699811959872,4.35186155815609,-0.454863438557368,22,29,-7,40,44,-4,53,71,-18,2,2,0,0
"10052","FLA","BUF",2013020152,16003,20132014,1,60,1,3,-2,4.70948708429933,6.15248524684398,-1.44299816254465,45,21,24,62,30,32,79,39,40,2,1,0,0
"10053","FLA","T.B",2013020167,16005,20132014,1,65,3,3,0,4.50414544105104,4.2935260216817,0.21061941936934,32,28,4,46,39,7,61,49,12,5,4,0,0
"10054","FLA","STL",2013020195,16010,20132014,1,60,0,4,-4,2.72977475480207,5.562125691853,-2.83235093705093,31,23,8,41,35,6,57,46,11,2,4,0,0
"10055","FLA","WSH",2013020206,16011,20132014,0,65,2,2,0,4.94285712314286,3.81449884347967,1.12835827966319,33,23,10,43,39,4,66,50,16,8,5,0,0
"10056","FLA","EDM",2013020221,16014,20132014,1,61.9166666666667,3,4,-1,4.58437506027985,3.93102046489366,0.65335459538619,23,27,-4,32,35,-3,44,47,-3,2,4,0,0
"10057","FLA","BOS",2013020230,16016,20132014,0,60,1,4,-3,2.13770098774694,3.45683268071274,-1.3191316929658,24,30,-6,31,43,-12,51,55,-4,4,1,0,0
"10058","FLA","OTT",2013020246,16018,20132014,0,60,2,3,-1,3.86824021082336,5.59686018325381,-1.72861997243045,28,32,-4,45,43,2,58,54,4,6,4,0,0
"10059","FLA","NYR",2013020257,16019,20132014,0,60,3,4,-1,4.62808446609415,2.47843401381397,2.14965045228018,27,29,-2,42,43,-1,55,58,-3,4,4,0,0
"10060","FLA","ANA",2013020271,16021,20132014,1,60,3,2,1,2.83953484362766,2.94104809954297,-0.101513255915307,25,34,-9,34,38,-4,51,48,3,4,3,0,0
"10061","FLA","MIN",2013020291,16024,20132014,0,60,2,3,-1,7.07178417255636,3.06783094248385,4.00395323007251,24,20,4,36,26,10,48,34,14,3,3,0,0
"10062","FLA","COL",2013020301,16025,20132014,0,60,4,1,3,4.05660755292047,4.66081002121791,-0.604202468297444,33,33,0,45,44,1,58,54,4,4,1,0,0
"10063","FLA","VAN",2013020320,16028,20132014,0,65,2,2,0,4.3634708962345,4.06910379794749,0.294367098287012,36,29,7,39,42,-3,51,54,-3,3,2,0,0
"10064","FLA","EDM",2013020333,16030,20132014,0,60,1,4,-3,2.87807539326387,2.96277481961687,-0.0846994263529979,25,35,-10,41,44,-3,57,52,5,5,5,0,0
"10065","FLA","CGY",2013020338,16031,20132014,0,65,3,3,0,0,0,0,26,24,2,38,30,8,64,40,24,4,2,0,0
"10066","FLA","PHI",2013020359,16034,20132014,1,60,3,1,2,4.56328715901225,4.96806613286026,-0.404778973848003,31,39,-8,38,49,-11,49,66,-17,2,4,0,0
"10067","FLA","NYR",2013020372,16036,20132014,1,60,2,5,-3,3.25228712881653,4.35285343471332,-1.10056630589679,33,22,11,40,31,9,52,39,13,2,3,0,0
"10068","FLA","OTT",2013020414,16042,20132014,1,60,2,4,-2,4.9966479425384,4.5158163036408,0.480831638897598,32,45,-13,41,55,-14,52,71,-19,4,8,0,0
"10069","FLA","WPG",2013020427,16044,20132014,1,60,5,2,3,3.38137576088775,2.62794699147344,0.753428769414313,26,31,-5,33,40,-7,48,51,-3,2,1,0,0
"10070","FLA","DET",2013020441,16046,20132014,0,60,2,1,1,8.41402853444727,2.70616258800313,5.70786594644414,37,23,14,46,33,13,58,40,18,2,3,0,0
"10071","FLA","CHI",2013020452,16047,20132014,0,60,2,6,-4,5.96627623045821,4.95952247024476,1.00675376021345,35,32,3,46,41,5,69,50,19,6,5,0,0
"10072","FLA","DET",2013020462,16049,20132014,1,65,2,2,0,4.53178078017663,4.1267685656203,0.405012214556336,27,26,1,38,36,2,51,54,-3,3,4,0,0
"10073","FLA","WSH",2013020485,16052,20132014,1,65,2,2,0,4.2594621978642,2.84686168784538,1.41260051001882,41,25,16,56,34,22,67,45,22,2,1,0,0
"10074","FLA","MTL",2013020501,16054,20132014,0,60,2,1,1,3.9564961187406,3.93676453194348,0.0197315867971168,25,18,7,35,30,5,54,52,2,2,4,0,0
"10075","FLA","TOR",2013020511,16056,20132014,0,60,3,1,2,4.72756221303061,3.54929958982393,1.17826262320668,23,29,-6,41,44,-3,53,61,-8,2,2,0,0
"10076","FLA","OTT",2013020527,16058,20132014,0,60,4,2,2,6.11790862272365,4.42098624646314,1.6969223762605,35,34,1,47,49,-2,64,59,5,4,4,0,0
"10077","FLA","WPG",2013020538,16059,20132014,0,60,2,5,-3,5.16225293345997,3.47203880257278,1.69021413088718,23,32,-9,33,46,-13,47,54,-7,7,7,0,0
"10078","FLA","T.B",2013020559,16062,20132014,1,60,1,6,-5,2.57348464216557,4.76119756623231,-2.18771292406674,29,36,-7,32,52,-20,37,64,-27,3,4,0,0
"10079","FLA","DET",2013020579,16067,20132014,1,60,3,4,-1,3.56448730583683,3.53160369582474,0.0328836100120853,33,31,2,48,33,15,70,45,25,6,5,0,0
"10080","FLA","MTL",2013020586,16068,20132014,1,60,4,1,3,3.74388684320729,1.92499653563891,1.81889030756838,25,22,3,38,32,6,52,41,11,4,4,0,0
"10081","FLA","NYR",2013020600,16070,20132014,1,65,1,1,0,4.43898212439672,4.01908144937806,0.419900675018653,22,31,-9,38,36,2,47,49,-2,3,3,0,0
"10082","FLA","NSH",2013020631,16074,20132014,1,65,4,4,0,3.64441103869467,5.92534083360806,-2.28092979491339,29,42,-13,47,48,-1,55,53,2,2,2,0,0
"10083","FLA","MTL",2013020645,16076,20132014,0,60,1,2,-1,5.45940189016983,5.63694852535446,-0.177546635184626,27,35,-8,39,44,-5,65,56,9,3,3,0,0
"10084","FLA","BUF",2013020660,16079,20132014,0,65,1,1,0,3.87800899557624,2.58981719089206,1.28819180468417,35,24,11,53,32,21,67,42,25,4,2,0,0
"10085","FLA","N.J",2013020677,16081,20132014,0,64.95,1,2,-1,3.80343529728998,5.04260523401535,-1.23916993672538,30,36,-6,38,48,-10,46,57,-11,2,2,0,0
"10086","FLA","NYI",2013020701,16084,20132014,1,60,4,2,2,2.82400471805522,6.42363411311726,-3.59962939506204,26,33,-7,41,46,-5,52,59,-7,4,3,0,0
"10087","FLA","S.J",2013020714,16086,20132014,1,60,0,3,-3,2.65982960449624,4.45644226719706,-1.79661266270082,24,39,-15,31,52,-21,45,58,-13,3,4,0,0
"10088","FLA","CAR",2013020730,16088,20132014,0,60,2,3,-1,6.97192202376367,8.76315887386761,-1.79123685010394,39,39,0,51,54,-3,63,73,-10,4,2,0,0
"10089","FLA","BUF",2013020746,16091,20132014,0,60,4,3,1,4.35856955118288,5.53869061454316,-1.18012106336028,22,35,-13,36,46,-10,51,56,-5,2,6,0,0
"10090","FLA","COL",2013020772,16094,20132014,1,60,2,3,-1,4.71993694799312,4.49629805888981,0.223638889103313,36,25,11,55,29,26,64,34,30,2,2,0,0
"10091","FLA","DET",2013020785,16096,20132014,0,65,4,4,0,6.16741617082153,2.72136498201871,3.44605118880281,37,30,7,42,39,3,47,55,-8,4,4,0,0
"10092","FLA","BOS",2013020795,16098,20132014,0,60,2,6,-4,6.09268940077163,4.53088934640982,1.56180005436181,30,41,-11,42,53,-11,51,65,-14,2,4,0,0
"10093","FLA","TOR",2013020810,16100,20132014,0,60,3,6,-3,3.87545245414458,1.99302662053953,1.88242583360505,38,32,6,53,41,12,66,51,15,6,4,0,0
"10094","FLA","CBJ",2013020829,16102,20132014,0,60,1,4,-3,6.52085567396716,5.47263026647852,1.04822540748864,36,30,6,48,37,11,64,47,17,4,2,0,0
"10095","FLA","TOR",2013020848,16105,20132014,1,60,4,1,3,5.36769121036195,2.0865194698672,3.28117174049476,48,21,27,60,27,33,71,41,30,2,0,0,0
"10096","FLA","DET",2013020863,16107,20132014,1,60,1,3,-2,3.19477850710973,4.68088889855426,-1.48611039144453,24,33,-9,34,47,-13,42,56,-14,3,7,0,0
"10097","FLA","CAR",2013020869,16108,20132014,0,60,1,5,-4,7.22301396304758,5.35936573171057,1.86364823133701,35,32,3,57,47,10,81,61,20,4,3,0,0
"10098","FLA","WSH",2013020892,16128,20132014,1,60,4,5,-1,4.19359148514195,4.9115723160121,-0.717980830870147,34,32,2,49,37,12,63,43,20,6,2,0,0
"10099","FLA","CBJ",2013020905,16130,20132014,0,60,3,6,-3,3.72868444614362,8.38278027924022,-4.65409583309659,20,37,-17,30,44,-14,47,53,-6,4,4,0,0
"10100","FLA","NYI",2013020914,16131,20132014,0,60,5,3,2,4.55186302754373,3.13652297050865,1.41534005703508,34,38,-4,44,46,-2,56,60,-4,10,12,0,0
"10101","FLA","BOS",2013020924,16133,20132014,0,60,1,4,-3,4.40044210674301,5.87942282544135,-1.47898071869835,24,39,-15,38,45,-7,51,57,-6,3,2,0,0
"10102","FLA","BUF",2013020950,16136,20132014,1,60,2,0,2,6.63189674101427,4.6475879452184,1.98430879579588,44,25,19,52,34,18,64,47,17,7,2,0,0
"10103","FLA","BOS",2013020963,16138,20132014,1,60,2,5,-3,2.6795691723874,5.33953504043549,-2.65996586804808,22,42,-20,28,57,-29,44,72,-28,4,4,0,0
"10104","FLA","ARI",2013020980,16140,20132014,1,60,1,3,-2,4.40248016394344,3.8793246809073,0.523155483036135,32,26,6,49,35,14,60,40,20,5,3,0,0
"10105","FLA","T.B",2013020992,16142,20132014,0,60,4,5,-1,2.37192421290092,3.19613005816791,-0.824205845266988,27,28,-1,38,41,-3,46,55,-9,2,4,0,0
"10106","FLA","N.J",2013020999,16143,20132014,1,60,5,3,2,2.08988433645573,3.93048772508337,-1.84060338862764,22,31,-9,31,41,-10,38,61,-23,4,2,0,0
"10107","FLA","VAN",2013021013,16145,20132014,1,65,3,3,0,4.02756322104992,5.82772679347545,-1.80016357242553,29,32,-3,43,52,-9,57,63,-6,4,4,0,0
"10108","FLA","S.J",2013021037,16147,20132014,0,60,3,2,1,2.41296093493293,9.44377591295051,-7.03081497801759,24,54,-30,31,75,-44,40,99,-59,2,6,0,0
"10109","FLA","ARI",2013021048,16149,20132014,0,60,1,2,-1,2.50196389679331,3.16118532605469,-0.659221429261379,23,22,1,35,29,6,47,43,4,3,1,0,0
"10110","FLA","L.A",2013021059,16151,20132014,0,60,0,4,-4,3.09984384832637,6.61262677540071,-3.51278292707434,24,29,-5,41,43,-2,48,56,-8,2,3,0,0
"10111","FLA","ANA",2013021072,16152,20132014,0,60,2,6,-4,5.59062576493307,5.37907605993314,0.211549704999925,30,40,-10,43,64,-21,52,73,-21,1,3,0,0
"10112","FLA","OTT",2013021084,16154,20132014,1,65,2,2,0,6.66007580367784,4.62318344464029,2.03689235903755,41,39,2,60,56,4,70,65,5,2,2,0,0
"10113","FLA","CAR",2013021097,16156,20132014,1,60,0,3,-3,4.48945864563575,3.98106038224638,0.508398263389367,35,32,3,49,36,13,56,46,10,2,2,0,0
"10114","FLA","MTL",2013021112,16158,20132014,1,60,1,4,-3,3.55197079558414,2.99130345909651,0.560667336487623,37,19,18,51,29,22,63,34,29,5,6,0,0
"10115","FLA","N.J",2013021126,16160,20132014,0,60,3,6,-3,1.95984388807288,3.99916380508284,-2.03931991700997,22,32,-10,29,43,-14,43,48,-5,5,4,0,0
"10116","FLA","NYI",2013021131,16161,20132014,0,60,2,4,-2,3.7402754362192,4.03769492860815,-0.297419492388958,22,40,-18,35,51,-16,54,71,-17,4,5,0,0
"10117","FLA","CGY",2013021156,16164,20132014,1,60,1,2,-1,3.04970289106541,3.26066738646477,-0.210964495399367,35,17,18,43,25,18,63,35,28,2,4,0,0
"10118","FLA","DAL",2013021171,16166,20132014,1,60,3,2,1,2.75319616248427,5.11301649491622,-2.35982033243195,24,37,-13,33,51,-18,46,60,-14,1,5,0,0
"10119","FLA","PHI",2013021185,16168,20132014,1,60,2,5,-3,3.79941924125887,5.13716046046466,-1.33774121920578,40,27,13,47,38,9,59,49,10,1,2,0,0
"10120","FLA","TOR",2013021199,16170,20132014,1,60,4,2,2,4.8419620936038,4.58822188782506,0.25374020577874,37,29,8,52,37,15,63,44,19,4,3,0,0
"10121","FLA","CBJ",2013021216,16172,20132014,1,60,2,3,-1,3.41479182032812,5.40644720338009,-1.99165538305198,35,38,-3,42,50,-8,50,61,-11,4,4,0,0
"10122","FLA","T.B",2014020010,16352,20142015,0,61.1833333333333,2,3,-1,3.68256501341239,6.84960889229842,-3.16704387888603,21,32,-11,26,44,-18,36,57,-21,5,10,0,0
"10123","FLA","N.J",2014020022,16354,20142015,1,60,1,5,-4,4.5836635484231,3.31707212945912,1.26659141896398,29,24,5,41,31,10,51,36,15,9,6,0,0
"10124","FLA","OTT",2014020037,16356,20142015,1,60,0,1,-1,3.26771988945848,4.04030327728469,-0.772583387826216,30,23,7,42,33,9,55,42,13,4,6,0,0
"10125","FLA","BUF",2014020056,16360,20142015,0,60,1,0,1,2.80022866581567,4.97478567609903,-2.17455701028337,35,26,9,47,40,7,64,50,14,6,6,0,0
"10126","FLA","WSH",2014020069,16361,20142015,0,65,1,1,0,4.77361534550437,3.77594948977712,0.99766585572725,21,28,-7,36,40,-4,50,57,-7,5,2,0,0
"10127","FLA","COL",2014020087,16364,20142015,0,62.3833333333333,4,3,1,5.38791441085272,4.58041576494725,0.807498645905468,36,33,3,44,44,0,55,53,2,2,5,0,0
"10128","FLA","ARI",2014020115,16368,20142015,0,62.3333333333333,1,2,-1,2.53104061440216,5.30137320153881,-2.77033258713665,24,41,-17,36,56,-20,45,77,-32,2,8,0,0
"10129","FLA","ARI",2014020143,16373,20142015,1,60,2,1,1,4.50554886000464,5.10788997076452,-0.60234111075988,26,33,-7,34,42,-8,50,50,0,5,6,0,0
"10130","FLA","PHI",2014020156,16375,20142015,1,60,2,1,1,1.89119636871615,3.33120936338105,-1.4400129946649,30,37,-7,37,43,-6,40,55,-15,5,7,0,0
"10131","FLA","BOS",2014020172,16378,20142015,0,63.45,1,2,-1,5.16928916017059,5.29447838186752,-0.125189221696928,19,25,-6,32,40,-8,44,52,-8,1,0,0,0
"10132","FLA","PHI",2014020188,16380,20142015,0,60,1,4,-3,7.31346888415283,2.87544074404059,4.43802814011224,35,30,5,47,39,8,65,53,12,6,4,0,0
"10133","FLA","CGY",2014020202,16382,20142015,1,60,4,6,-2,2.63185558665566,4.16005847411543,-1.52820288745977,31,25,6,47,33,14,62,40,22,3,3,0,0
"10134","FLA","S.J",2014020225,16385,20142015,1,60,4,1,3,3.62752948240282,3.03201587291551,0.595513609487313,30,26,4,35,38,-3,41,55,-14,2,2,0,0
"10135","FLA","NYI",2014020246,16388,20142015,1,65,3,3,0,4.17544949061812,2.19548052557138,1.97996896504674,38,34,4,49,44,5,66,67,-1,6,3,0,0
"10136","FLA","ANA",2014020264,16390,20142015,0,60,6,2,4,0,0,0,29,35,-6,44,54,-10,51,75,-24,1,2,0,0
"10137","FLA","L.A",2014020277,16392,20142015,0,60,2,5,-3,6.08626629635808,3.09124329656436,2.99502299979372,32,27,5,47,42,5,59,53,6,5,6,0,0
"10138","FLA","S.J",2014020290,16394,20142015,0,65,2,2,0,4.59064326972257,5.03519649992484,-0.444553230202267,28,30,-2,43,44,-1,63,70,-7,5,3,0,0
"10139","FLA","NSH",2014020302,16396,20142015,0,65,2,2,0,5.68844678573078,5.14350724109927,0.544939544631507,30,50,-20,38,65,-27,48,76,-28,2,4,0,0
"10140","FLA","MIN",2014020315,16398,20142015,1,60,1,4,-3,3.45854901157802,5.79892267861578,-2.34037366703776,30,39,-9,41,54,-13,51,62,-11,4,4,0,0
"10141","FLA","CAR",2014020327,16400,20142015,1,60,1,0,1,3.29645811527735,6.90945404907688,-3.61299593379954,28,33,-5,37,39,-2,51,49,2,1,3,0,0
"10142","FLA","OTT",2014020341,16402,20142015,1,60,3,2,1,3.13814253939927,3.40284638051526,-0.264703841115988,46,24,22,57,30,27,72,39,33,3,3,0,0
"10143","FLA","CBJ",2014020358,16405,20142015,0,60,1,2,-1,1.65665349756091,6.16587346663437,-4.50921996907346,25,23,2,35,40,-5,55,46,9,3,2,0,0
"10144","FLA","DET",2014020368,16406,20142015,0,60,4,3,1,3.8533616542268,3.42844904376433,0.424912610462469,31,41,-10,38,49,-11,46,63,-17,1,4,0,0
"10145","FLA","CBJ",2014020382,16408,20142015,1,65,3,3,0,6.14354231572361,2.53699274999235,3.60654956573126,55,20,35,72,27,45,99,35,64,6,2,0,0
"10146","FLA","BUF",2014020395,16410,20142015,1,60,3,2,1,3.9346899387607,5.42889926180942,-1.49420932304872,37,28,9,50,36,14,63,44,19,1,2,0,0
"10147","FLA","STL",2014020408,16412,20142015,0,60,2,4,-2,2.1757713750755,6.51493317011477,-4.33916179503927,34,28,6,41,40,1,50,50,0,3,4,0,0
"10148","FLA","DET",2014020433,16416,20142015,0,65,2,2,0,3.35064163635252,4.60026500536088,-1.24962336900836,26,31,-5,39,46,-7,45,59,-14,5,4,0,0
"10149","FLA","BUF",2014020437,16417,20142015,0,60.4833333333333,3,4,-1,3.94921605987736,5.4454202952038,-1.49620423532645,28,32,-4,38,42,-4,51,52,-1,1,2,0,0
"10150","FLA","WSH",2014020457,16420,20142015,1,65,1,1,0,6.26535890297964,5.12790294986917,1.13745595311048,29,24,5,42,34,8,51,49,2,2,2,0,0
"10151","FLA","PHI",2014020467,16422,20142015,0,65,1,1,0,4.8129503183518,3.92196330660954,0.890987011742254,32,26,6,44,36,8,62,51,11,3,2,0,0
"10152","FLA","TOR",2014020527,16432,20142015,1,60,6,4,2,6.54319731006399,4.82413865847047,1.71905865159351,34,22,12,45,34,11,50,44,6,3,4,0,0
"10153","FLA","MTL",2014020541,16434,20142015,1,65,1,1,0,3.45479392295965,3.92195644098683,-0.46716251802718,37,34,3,49,43,6,64,52,12,3,2,0,0
"10154","FLA","NYR",2014020551,16435,20142015,1,60,2,5,-3,3.21495041181953,5.58341736381408,-2.36846695199455,20,34,-14,29,42,-13,45,49,-4,4,3,0,0
"10155","FLA","BUF",2014020558,16437,20142015,0,60,2,0,2,4.30681423371425,5.8010675470432,-1.49425331332895,33,30,3,41,38,3,50,51,-1,1,1,0,0
"10156","FLA","WSH",2014020577,16439,20142015,0,60,3,4,-1,3.7491193228343,4.86495329909121,-1.11583397625691,32,26,6,44,44,0,60,63,-3,6,3,0,0
"10157","FLA","EDM",2014020624,16446,20142015,0,60,4,2,2,3.80403952318375,5.46477969444823,-1.66074017126448,27,33,-6,42,42,0,48,54,-6,2,2,0,0
"10158","FLA","WPG",2014020637,16448,20142015,0,60,2,8,-6,4.24750413134075,4.74650150390517,-0.498997372564418,27,35,-8,31,51,-20,41,66,-25,3,3,0,0
"10159","FLA","COL",2014020649,16450,20142015,1,60,2,4,-2,4.43071894318564,4.27886087947991,0.151858063705731,32,29,3,45,37,8,62,43,19,3,5,0,0
"10160","FLA","EDM",2014020666,16452,20142015,1,65,2,2,0,2.07831204403192,3.18143897993832,-1.1031269359064,37,34,3,47,42,5,57,53,4,3,4,0,0
"10161","FLA","N.J",2014020731,16466,20142015,0,60,1,3,-2,3.3223036370473,2.99373989895685,0.328563738090452,27,14,13,37,23,14,51,33,18,3,4,0,0
"10162","FLA","NYR",2014020742,16468,20142015,0,60,3,6,-3,5.75284888921306,6.91113168663287,-1.15828279741982,36,38,-2,48,51,-3,64,60,4,3,5,0,0
"10163","FLA","NYI",2014020746,16469,20142015,0,60,4,2,2,4.90589068517738,3.72966774960514,1.17622293557224,30,34,-4,40,48,-8,56,68,-12,2,3,0,0
"10164","FLA","ANA",2014020802,16476,20142015,1,60,6,2,4,3.55558503780048,6.70870879778886,-3.15312375998838,26,33,-7,38,45,-7,43,62,-19,7,3,0,0
"10165","FLA","MIN",2014020815,16478,20142015,0,60,1,2,-1,3.26693974767113,5.81139264511876,-2.54445289744763,27,23,4,40,32,8,59,39,20,4,3,0,0
"10166","FLA","DAL",2014020820,16479,20142015,0,60,0,2,-2,5.46516978085856,6.38994827368151,-0.924778492822952,37,28,9,51,50,1,65,61,4,4,4,0,0
"10167","FLA","TOR",2014020850,16483,20142015,0,60,3,2,1,1.32333752412524,3.19247471306642,-1.86913718894118,17,29,-12,24,35,-11,36,47,-11,5,2,0,0
"10168","FLA","MTL",2014020864,16485,20142015,0,65,2,2,0,4.23070089530665,6.65673502032951,-2.42603412502285,21,39,-18,30,48,-18,43,59,-16,1,1,0,0
"10169","FLA","T.B",2014020934,16495,20142015,1,60,4,3,1,3.97031972345576,4.35552842906691,-0.385208705611149,26,23,3,40,39,1,55,45,10,7,6,0,0
"10170","FLA","TOR",2014020946,16497,20142015,1,60,2,3,-1,5.02364818908973,2.74819779873724,2.27545039035249,42,34,8,51,39,12,60,50,10,3,2,0,0
"10171","FLA","DAL",2014020960,16499,20142015,1,65,3,3,0,2.83914173222729,6.1616915083232,-3.32254977609591,24,32,-8,31,45,-14,38,65,-27,2,2,0,0
"10172","FLA","NYI",2014020973,16501,20142015,1,65,3,3,0,3.33778868021909,3.60197938858801,-0.264190708368915,18,28,-10,24,40,-16,36,55,-19,3,5,0,0
"10173","FLA","WPG",2014021007,16506,20142015,1,60,4,2,2,2.73314872847891,2.49284579220785,0.240302936271064,20,20,0,32,31,1,38,43,-5,3,2,0,0
"10174","FLA","NYR",2014021030,16509,20142015,0,60,1,2,-1,4.86368831241271,6.2224347187439,-1.35874640633119,39,34,5,62,44,18,98,52,46,3,2,0,0
"10175","FLA","MTL",2014021044,16511,20142015,1,60,2,3,-1,4.11969073620515,5.46815984807614,-1.34846911187099,43,25,18,52,34,18,67,39,28,5,5,0,0
"10176","FLA","T.B",2014021095,16518,20142015,0,60,3,4,-1,5.49230392387835,1.76100228320593,3.73130164067243,36,25,11,44,33,11,56,43,13,2,0,0,0
"10177","FLA","TOR",2014021106,16520,20142015,0,60,4,1,3,5.33972725047965,2.8326739325638,2.50705331791586,28,25,3,43,43,0,56,56,0,3,5,0,0
"10178","FLA","MTL",2014021122,16522,20142015,0,62.9833333333333,2,3,-1,1.90963180772087,4.88224150179303,-2.97260969407216,23,25,-2,31,34,-3,51,55,-4,2,5,0,0
"10179","FLA","T.B",2014021172,16529,20142015,1,60,0,4,-4,6.85968519150629,2.74087065481823,4.11881453668806,34,22,12,52,34,18,64,43,21,4,1,0,0
"10180","FLA","MTL",2014021181,16530,20142015,1,60,1,4,-3,5.56083298907015,4.38473810767755,1.1760948813926,25,28,-3,39,40,-1,58,51,7,4,7,0,0
"10181","FLA","N.J",2014021222,16536,20142015,1,60,3,2,1,4.07058643960045,6.54906080237051,-2.47847436277006,27,33,-6,38,46,-8,55,56,-1,2,2,0,0
"10182","FLA","PHI",2015020020,16718,20152016,1,60,7,1,6,4.58101378664755,3.62886203044036,0.952151756207186,30,39,-9,35,46,-11,45,56,-11,8,6,0,0
"10183","FLA","PHI",2015020035,16720,20152016,0,60,0,1,-1,5.75074891466647,5.46708643867378,0.283662475992692,31,33,-2,49,45,4,66,59,7,8,6,0,0
"10184","FLA","DAL",2015020068,16725,20152016,1,60,2,4,-2,4.85800894454587,4.44509027896311,0.412918665582765,26,37,-11,38,45,-7,48,58,-10,2,3,0,0
"10185","FLA","DAL",2015020113,16732,20152016,0,60,6,2,4,5.25293644293561,4.11821039636561,1.13472604656999,30,35,-5,50,45,5,64,67,-3,3,5,0,0
"10186","FLA","COL",2015020128,16735,20152016,1,60,4,1,3,4.15366543929122,4.30077603636892,-0.147110597077699,28,32,-4,38,38,0,47,51,-4,3,5,0,0
"10187","FLA","ANA",2015020184,16743,20152016,0,65,2,2,0,2.40386818652041,5.23525143932784,-2.83138325280743,25,39,-14,36,54,-18,52,73,-21,3,5,0,0
"10188","FLA","T.B",2015020251,16753,20152016,0,65,4,4,0,4.33540584900766,4.17573249063207,0.159673358375585,23,28,-5,33,48,-15,49,56,-7,7,5,0,0
"10189","FLA","T.B",2015020265,16755,20152016,1,60,1,0,1,4.36559381736515,3.73266536348956,0.632928453875593,20,39,-19,31,49,-18,42,59,-17,4,4,0,0
"10190","FLA","ANA",2015020285,16758,20152016,1,60,1,3,-2,2.93109703995287,4.5322578885025,-1.60116084854963,25,41,-16,35,49,-14,44,57,-13,3,3,0,0
"10191","FLA","NYR",2015020296,16760,20152016,1,62.0166666666667,4,5,-1,6.44809148102468,5.62564241571818,0.8224490653065,43,31,12,62,38,24,74,46,28,8,4,0,0
"10192","FLA","NYI",2015020339,16766,20152016,1,65,2,2,0,3.30353952846716,3.82137696264545,-0.51783743417829,27,25,2,39,41,-2,47,54,-7,3,3,0,0
"10193","FLA","N.J",2015020400,16775,20152016,0,60,2,4,-2,4.64349781692727,2.05568049673457,2.5878173201927,36,18,18,41,24,17,52,30,22,6,5,0,0
"10194","FLA","NYI",2015020454,16784,20152016,0,60,5,1,4,2.57562210159085,4.56875376905886,-1.993131667468,17,34,-17,23,52,-29,30,62,-32,4,5,0,0
"10195","FLA","N.J",2015020467,16786,20152016,0,60,5,1,4,3.04523939614228,1.91331960182288,1.1319197943194,26,16,10,31,21,10,33,26,7,3,3,0,0
"10196","FLA","MTL",2015020545,16798,20152016,1,60,3,1,2,4.18059576496307,2.98746904949394,1.19312671546913,30,30,0,43,38,5,49,40,9,6,4,0,0
"10197","FLA","NYR",2015020572,16802,20152016,1,60,3,0,3,3.13328898570365,6.57213764957237,-3.43884866386872,20,40,-20,34,54,-20,37,70,-33,5,6,0,0
"10198","FLA","MIN",2015020580,16803,20152016,1,60,2,1,1,2.81284080113983,4.72827123826357,-1.91543043712375,29,40,-11,35,46,-11,43,53,-10,5,4,0,0
"10199","FLA","EDM",2015020629,16810,20152016,0,60,2,1,1,3.00949552455131,5.86551416572547,-2.85601864117416,14,25,-11,24,46,-22,36,69,-33,0,2,0,0
"10200","FLA","T.B",2015020672,16817,20152016,0,60,1,3,-2,5.94865372776985,5.15532824982836,0.793325477941496,27,32,-5,40,44,-4,50,55,-5,5,2,0,0
"10201","FLA","EDM",2015020677,16818,20152016,1,60,2,4,-2,3.9575926341131,4.26275203702971,-0.305159402916615,33,24,9,42,31,11,49,39,10,4,1,0,0
"10202","FLA","T.B",2015020714,16823,20152016,1,60,5,2,3,5.56109958201341,5.15028507420357,0.410814507809846,35,40,-5,41,48,-7,48,57,-9,4,5,0,0
"10203","FLA","TOR",2015020736,16826,20152016,1,60,5,1,4,3.4126591269919,4.99963434034726,-1.58697521335536,27,23,4,40,33,7,45,45,0,6,3,0,0
"10204","FLA","PIT",2015020781,16837,20152016,1,61.45,2,3,-1,5.58017280680575,5.69161754067724,-0.111444733871497,44,35,9,49,54,-5,56,65,-9,5,5,0,0
"10205","FLA","PIT",2015020842,16846,20152016,1,65,1,1,0,1.68069575561094,5.92770414145707,-4.24700838584613,28,32,-4,35,43,-8,49,57,-8,3,2,0,0
"10206","FLA","WPG",2015020877,16851,20152016,1,60,3,1,2,4.69453935039294,3.79812882491493,0.896410525478018,32,30,2,47,36,11,63,50,13,4,4,0,0
"10207","FLA","MIN",2015020932,16859,20152016,0,60,1,3,-2,3.9929196564517,5.77828206768027,-1.78536241122856,18,27,-9,27,43,-16,40,51,-11,5,7,0,0
"10208","FLA","WPG",2015020949,16861,20152016,0,60,3,2,1,4.69059737713542,2.99789553863229,1.69270183850313,22,32,-10,31,45,-14,43,59,-16,3,4,0,0
"10209","FLA","COL",2015020962,16863,20152016,0,60,2,3,-1,7.08520654626773,4.47955696156714,2.60564958470059,40,26,14,55,29,26,74,34,40,3,4,0,0
"10210","FLA","PHI",2015021023,16872,20152016,1,65,4,4,0,2.97253098686493,5.34316265113307,-2.37063166426814,29,26,3,38,39,-1,45,53,-8,3,5,0,0
"10211","FLA","NYI",2015021033,16874,20152016,0,60,2,3,-1,4.52185585869393,3.88743162367415,0.634424235019779,25,28,-3,37,44,-7,55,59,-4,3,3,0,0
"10212","FLA","MTL",2015021043,16875,20152016,0,60,4,1,3,4.8628653929336,5.95803758403054,-1.09517219109694,36,28,8,43,35,8,60,48,12,4,2,0,0
"10213","FLA","TOR",2015021056,16877,20152016,0,60,4,1,3,6.29727603189497,3.32871388084154,2.96856215105343,32,33,-1,51,51,0,65,74,-9,4,2,0,0
"10214","FLA","NYR",2015021086,16881,20152016,0,60,2,4,-2,4.80340012708962,5.02686622968758,-0.223466102597968,27,32,-5,33,39,-6,48,50,-2,3,4,0,0
"10215","FLA","T.B",2015021122,16886,20152016,0,60,5,2,3,3.17795350635424,2.24449170154261,0.933461804811628,27,35,-8,38,44,-6,49,58,-9,5,6,0,0
"10216","FLA","TOR",2015021144,16889,20152016,1,60,2,5,-3,3.99347338418011,5.07196184290478,-1.07848845872468,34,29,5,46,38,8,50,45,5,4,5,0,0
"10217","FLA","N.J",2015021157,16891,20152016,1,60,3,2,1,5.71094047533552,4.5646997706499,1.14624070468562,40,25,15,50,33,17,66,38,28,4,6,0,0
"10218","FLA","MTL",2015021172,16893,20152016,1,60,4,3,1,5.66160559514537,3.33643888350775,2.32516671163762,39,28,11,50,36,14,58,43,15,2,1,0,0
"10219","FLA","TOR",2015021185,16895,20152016,0,60,4,3,1,7.95954072908546,3.67090111220817,4.28863961687729,36,26,10,51,39,12,68,46,22,5,2,0,0
"10220","FLA","MTL",2015021192,16896,20152016,0,60,4,1,3,2.72069808002925,5.27052594738439,-2.54982786735513,19,33,-14,26,46,-20,34,61,-27,5,6,0,0
"10221","FLA","NYI",2015030111,16905,20152016,1,60,4,5,-1,6.81542445100786,3.34815847198479,3.46726597902307,46,26,20,59,33,26,77,42,35,4,3,0,0
"10222","FLA","NYI",2015030112,16906,20152016,1,60,3,1,2,4.40575270733098,3.51279379258631,0.892958914744668,31,42,-11,41,56,-15,49,68,-19,4,6,0,0
"10223","FLA","NYI",2015030113,16908,20152016,0,72.5166666666667,3,4,-1,3.98564525396796,4.59401229970808,-0.608367045740124,39,39,0,56,52,4,73,66,7,4,5,0,0
"10224","FLA","NYI",2015030114,16911,20152016,0,60,2,1,1,2.72642069148878,5.08079393743463,-2.35437324594585,29,27,2,41,39,2,63,49,14,4,4,0,0
"10225","FLA","NYI",2015030115,16913,20152016,1,80,1,1,0,8.55400575046951,3.82513845822632,4.72886729224319,41,36,5,59,47,12,83,54,29,2,3,0,0
"10226","FLA","NYI",2015030116,16915,20152016,0,80,1,1,0,4.59093826708303,6.10841902629785,-1.51748075921482,38,47,-9,56,72,-16,73,95,-22,3,3,0,0
"10227","FLA","N.J",2016020010,17087,20162017,1,62.8,2,1,1,3.74073040722215,2.51542510901345,1.2253052982087,34,24,10,51,33,18,67,37,30,8,7,0,0
"10228","FLA","T.B",2016020042,17092,20162017,0,65,3,3,0,4.63455839572907,3.63268053789773,1.00187785783135,31,28,3,46,36,10,53,43,10,4,4,0,0
"10229","FLA","COL",2016020068,17096,20162017,1,60,5,2,3,4.11153387629972,2.63965824578137,1.47187563051834,38,28,10,50,32,18,58,36,22,6,3,0,0
"10230","FLA","PIT",2016020086,17099,20162017,0,60,2,3,-1,3.21362798509654,2.17506704804225,1.03856093705429,22,22,0,33,25,8,53,45,8,4,2,0,0
"10231","FLA","TOR",2016020101,17101,20162017,0,60,2,3,-1,4.27283566165715,3.23723071095867,1.03560495069848,31,28,3,45,46,-1,59,59,0,4,2,0,0
"10232","FLA","N.J",2016020152,17108,20162017,1,64.2666666666667,4,3,1,3.99122144113062,5.31177214474883,-1.32055070361821,31,34,-3,43,49,-6,54,57,-3,4,5,0,0
"10233","FLA","T.B",2016020182,17112,20162017,1,60,3,1,2,5.9630258360412,6.88748112831627,-0.92445529227507,32,35,-3,42,52,-10,58,61,-3,4,3,0,0
"10234","FLA","NYI",2016020214,17117,20162017,1,64.2333333333333,3,2,1,5.56103557054303,2.999840092054,2.56119547848903,43,21,22,58,29,29,85,40,45,6,7,0,0
"10235","FLA","MTL",2016020234,17120,20162017,0,62.9833333333333,4,3,1,2.62546697468497,7.13004283381815,-4.50457585913318,24,37,-13,35,44,-9,48,61,-13,3,3,0,0
"10236","FLA","TOR",2016020247,17122,20162017,0,60,1,6,-5,3.93234721245878,4.90974821467455,-0.977401002215771,27,30,-3,41,43,-2,59,50,9,4,4,0,0
"10237","FLA","NYR",2016020272,17125,20162017,0,65,2,2,0,3.78307800499442,3.59791397835943,0.185164026634993,30,35,-5,39,38,1,60,46,14,4,3,0,0
"10238","FLA","PHI",2016020286,17127,20162017,1,60,1,3,-2,2.84997915416898,2.14626461710208,0.703714537066901,39,28,11,45,32,13,57,36,21,5,3,0,0
"10239","FLA","PHI",2016020385,17141,20162017,0,64.85,2,3,-1,7.71342554975126,2.78695801523281,4.92646753451845,44,25,19,65,35,30,85,51,34,3,5,0,0
"10240","FLA","PIT",2016020400,17143,20162017,1,60,1,5,-4,3.28952145466064,5.44979553712619,-2.16027408246555,29,30,-1,39,43,-4,56,53,3,4,4,0,0
"10241","FLA","MIN",2016020438,17148,20162017,0,60,1,5,-4,3.27089895556855,1.9227936592784,1.34810529629016,30,22,8,42,32,10,59,44,15,5,2,0,0
"10242","FLA","WPG",2016020451,17150,20162017,0,65,3,3,0,5.97133664836292,5.01558925100835,0.955747397354571,44,32,12,60,44,16,69,53,16,6,5,0,0
"10243","FLA","COL",2016020457,17151,20162017,0,60,3,1,2,3.71999843094799,3.25008086435264,0.469917566595351,23,31,-8,30,42,-12,39,53,-14,3,7,0,0
"10244","FLA","TOR",2016020527,17163,20162017,1,65,2,2,0,6.97536048818506,3.01331298923469,3.96204749895037,47,40,7,68,47,21,79,58,21,7,5,0,0
"10245","FLA","MTL",2016020536,17164,20162017,1,60.65,2,3,-1,8.4020075961324,6.54488467151532,1.85712292461708,33,41,-8,53,52,1,66,63,3,3,2,0,0
"10246","FLA","DAL",2016020554,17166,20162017,0,60,3,1,2,4.8372853709443,8.85159988765372,-4.01431451670942,38,36,2,46,63,-17,54,89,-35,2,4,0,0
"10247","FLA","WPG",2016020572,17170,20162017,1,60,1,4,-3,5.29314142023213,4.95901297775976,0.334128442472377,32,39,-7,44,47,-3,57,56,1,5,2,0,0
"10248","FLA","N.J",2016020609,17175,20162017,0,60,3,0,3,5.46522113577521,3.4827575304555,1.98246360531971,29,28,1,35,36,-1,44,39,5,4,3,0,0
"10249","FLA","NYI",2016020620,17177,20162017,0,60,2,1,1,3.45266504539177,5.16530596096266,-1.71264091557089,24,30,-6,30,41,-11,49,60,-11,2,1,0,0
"10250","FLA","NYI",2016020636,17179,20162017,1,60,2,5,-3,3.69962136581307,7.87436709355097,-4.1747457277379,29,42,-13,40,55,-15,50,66,-16,5,8,0,0
"10251","FLA","EDM",2016020675,17184,20162017,0,64.95,3,4,-1,2.99067324506177,7.64890545178787,-4.6582322067261,31,31,0,39,40,-1,59,55,4,2,2,0,0
"10252","FLA","T.B",2016020734,17192,20162017,1,61.8166666666667,2,1,1,7.3777161938915,6.10878075956134,1.26893543433016,37,32,5,47,41,6,54,54,0,4,5,0,0
"10253","FLA","ANA",2016020768,17200,20162017,1,60,2,1,1,4.86842098260759,3.93249955949281,0.935921423114779,37,23,14,50,30,20,58,43,15,6,4,0,0
"10254","FLA","ANA",2016020857,17214,20162017,0,60,4,1,3,6.55270427677897,4.65756242492353,1.89514185185544,31,36,-5,45,53,-8,57,62,-5,4,4,0,0
"10255","FLA","EDM",2016020891,17219,20162017,1,60,3,4,-1,6.13635815860471,5.23321072997351,0.9031474286312,34,35,-1,49,45,4,57,52,5,3,2,0,0
"10256","FLA","PHI",2016020938,17227,20162017,0,65,1,1,0,6.32078693158913,10.2906054575869,-3.9698185259978,40,49,-9,51,74,-23,63,89,-26,4,6,0,0
"10257","FLA","DAL",2016020955,17229,20162017,1,60,1,2,-1,6.33094330737367,4.50403144840539,1.82691185896829,42,34,8,56,38,18,63,52,11,3,3,0,0
"10258","FLA","NYR",2016020976,17232,20162017,1,60,2,5,-3,6.83531769003275,5.28074121601639,1.55457647401636,45,28,17,58,45,13,73,52,21,5,4,0,0
"10259","FLA","MIN",2016020997,17235,20162017,1,60,4,7,-3,7.6931639128743,9.17876160170999,-1.4855976888357,40,46,-6,48,54,-6,59,70,-11,3,4,0,0
"10260","FLA","T.B",2016021003,17236,20162017,0,60,2,3,-1,3.79184963279658,6.20109532878269,-2.4092456959861,34,34,0,41,47,-6,51,57,-6,5,6,0,0
"10261","FLA","TOR",2016021029,17239,20162017,1,60,7,2,5,5.64416562771279,3.82440721482271,1.81975841289008,32,30,2,50,42,8,59,54,5,7,6,0,0
"10262","FLA","NYR",2016021049,17242,20162017,0,65,3,3,0,4.12553065285232,3.88443603807291,0.241094614779407,37,32,5,46,44,2,61,61,0,4,5,0,0
"10263","FLA","PIT",2016021064,17244,20162017,0,60,0,4,-4,2.73051490762737,4.88273039438332,-2.15221548675595,21,28,-7,28,34,-6,47,44,3,6,6,0,0
"10264","FLA","TOR",2016021131,17253,20162017,0,60,2,3,-1,2.42377975437466,4.9474790586072,-2.52369930423254,27,25,2,40,44,-4,53,59,-6,4,4,0,0
"10265","FLA","MTL",2016021144,17255,20162017,0,60,2,6,-4,2.47365196946087,4.35138521126009,-1.87773324179922,31,33,-2,38,45,-7,55,63,-8,5,3,0,0
"10266","FLA","MTL",2016021178,17259,20162017,1,60,1,4,-3,7.54251657921421,3.64575788177171,3.89675869744249,32,31,1,44,47,-3,49,56,-7,2,2,0,0
"10267","FLA","T.B",2017020014,17445,20172018,0,60,3,5,-2,6.8594470747048,4.17761705723798,2.68183001746682,36,25,11,50,32,18,67,44,23,4,3,0,0
"10268","FLA","T.B",2017020018,17446,20172018,1,60,5,4,1,0,0,0,48,30,18,60,43,17,73,56,17,7,9,0,0
"10269","FLA","PIT",2017020067,17453,20172018,0,60,3,4,-1,3.60905293607539,5.85049699211027,-2.24144405603488,46,33,13,61,46,15,67,63,4,5,3,0,0
"10270","FLA","PHI",2017020083,17456,20172018,0,60,1,5,-4,5.05269985124244,6.49337382835302,-1.44067397711059,41,39,2,54,53,1,76,63,13,6,4,0,0
"10271","FLA","PIT",2017020107,17459,20172018,1,60,3,4,-1,2.80655920412391,5.9643592618917,-3.15780005776779,31,48,-17,41,55,-14,57,68,-11,2,4,0,0
"10272","FLA","MTL",2017020130,17463,20172018,0,60,1,5,-4,1.34853261846001,5.17399556812597,-3.82546294966596,27,37,-10,29,47,-18,41,70,-29,2,4,0,0
"10273","FLA","ANA",2017020145,17465,20172018,1,60,8,3,5,3.25924119655974,3.63169843071019,-0.372457234150446,22,34,-12,30,47,-17,33,58,-25,3,3,0,0
"10274","FLA","T.B",2017020174,17469,20172018,1,60,5,8,-3,3.39630195271457,6.08490020595491,-2.68859825324034,23,38,-15,33,49,-16,48,61,-13,3,5,0,0
"10275","FLA","NYR",2017020203,17474,20172018,1,61.1333333333333,4,5,-1,6.03850658527226,7.7951113898439,-1.75660480457164,34,44,-10,43,53,-10,59,64,-5,2,3,0,0
"10276","FLA","N.J",2017020254,17481,20172018,0,60,1,2,-1,4.24619279161539,1.64958756800479,2.5966052236106,33,21,12,46,24,22,58,33,25,5,4,0,0
"10277","FLA","DAL",2017020269,17484,20172018,1,65,3,3,0,5.24457009122125,5.22164557657618,0.0229245146450703,29,43,-14,41,49,-8,49,57,-8,6,3,0,0
"10278","FLA","ANA",2017020309,17489,20172018,0,60,2,3,-1,0,0,0,52,28,24,70,40,30,88,52,36,7,5,0,0
"10279","FLA","TOR",2017020321,17492,20172018,1,65,1,1,0,6.89088509885124,7.80798270861851,-0.917097609767268,43,44,-1,56,53,3,62,71,-9,3,3,0,0
"10280","FLA","N.J",2017020362,17497,20172018,0,60,3,2,1,3.57002392249342,3.66185214649704,-0.0918282240036206,38,25,13,52,36,16,64,43,21,5,4,0,0
"10281","FLA","NYR",2017020369,17498,20172018,0,60,5,4,1,4.55697981137928,4.89501739357365,-0.338037582194374,27,37,-10,36,54,-18,48,69,-21,3,4,0,0
"10282","FLA","NYI",2017020413,17504,20172018,1,65,4,4,0,5.74426288885297,6.76086780260084,-1.01660491374787,43,32,11,51,45,6,59,54,5,4,2,0,0
"10283","FLA","WPG",2017020434,17507,20172018,1,60,6,4,2,3.24330972981988,3.78650058261871,-0.54319085279883,36,39,-3,45,56,-11,53,68,-15,5,8,0,0
"10284","FLA","COL",2017020448,17509,20172018,1,60,3,7,-4,7.33039381966311,7.01491169218207,0.315482127481042,42,30,12,55,36,19,72,49,23,4,3,0,0
"10285","FLA","COL",2017020486,17514,20172018,0,60,1,2,-1,5.06731791057821,3.97765275446,1.08966515611822,33,30,3,40,39,1,54,57,-3,1,3,0,0
"10286","FLA","VGK",2017020510,17517,20172018,0,60,2,5,-3,2.24544545239473,6.7066894987986,-4.46124404640386,18,40,-22,30,58,-28,43,73,-30,3,4,0,0
"10287","FLA","MIN",2017020540,17522,20172018,1,60,4,2,2,0,0,0,34,31,3,38,45,-7,50,52,-2,3,5,0,0
"10288","FLA","PHI",2017020571,17528,20172018,1,60,3,2,1,5.08689944155049,5.04187812330201,0.0450213182484731,27,31,-4,40,43,-3,58,53,5,5,5,0,0
"10289","FLA","MTL",2017020588,17530,20172018,1,60,2,0,2,5.45450042613083,6.22445907871228,-0.769958652581443,33,38,-5,46,46,0,61,63,-2,3,0,0,0
"10290","FLA","MIN",2017020608,17533,20172018,0,60,1,5,-4,6.18248858667357,6.72849958813458,-0.546011001461011,26,41,-15,38,47,-9,50,61,-11,2,1,0,0
"10291","FLA","VGK",2017020705,17550,20172018,1,60.6666666666667,4,3,1,2.62074458842476,6.06747301965515,-3.4467284312304,26,36,-10,32,52,-20,40,75,-35,1,3,0,0
"10292","FLA","DAL",2017020738,17554,20172018,0,60,1,6,-5,6.30133561518018,3.79172145229581,2.50961416288437,34,39,-5,57,50,7,78,58,20,7,7,0,0
"10293","FLA","NYI",2017020763,17561,20172018,0,60,4,1,3,6.26866899602942,4.82202725077514,1.44664174525428,40,33,7,51,40,11,62,56,6,0,1,0,0
"10294","FLA","EDM",2017020862,17574,20172018,0,60,7,5,2,4.93716501811286,4.75839379127137,0.178771226841491,40,32,8,56,47,9,68,66,2,5,1,0,0
"10295","FLA","WPG",2017020910,17580,20172018,0,60,2,7,-5,5.13448087690631,7.35967935762892,-2.22519848072261,27,34,-7,36,51,-15,50,62,-12,4,2,0,0
"10296","FLA","TOR",2017020918,17582,20172018,0,60,0,1,-1,6.21207991984556,5.07315356456093,1.13892635528464,40,31,9,56,49,7,70,61,9,2,2,0,0
"10297","FLA","PIT",2017020951,17586,20172018,1,60,6,5,1,1.94190623884788,4.57794183352962,-2.63603559468174,30,37,-7,36,44,-8,47,63,-16,3,1,0,0
"10298","FLA","TOR",2017020972,17589,20172018,1,63.7833333333333,3,2,1,4.27672331078611,7.13894001254711,-2.862216701761,31,39,-8,40,53,-13,47,68,-21,4,2,0,0
"10299","FLA","N.J",2017020985,17591,20172018,1,60,3,2,1,5.55464885670591,6.80105891553103,-1.24641005882512,29,31,-2,43,44,-1,56,62,-6,2,2,0,0
"10300","FLA","PHI",2017021008,17594,20172018,1,60,4,1,3,3.72577743569309,8.57721299112773,-4.85143555543464,26,40,-14,38,51,-13,52,67,-15,6,3,0,0
"10301","FLA","T.B",2017021024,17596,20172018,0,62.8166666666667,4,5,-1,5.40922182009672,3.9743243316982,1.43489748839852,49,33,16,67,46,21,79,60,19,2,0,0,0
"10302","FLA","MTL",2017021038,17598,20172018,1,60,5,0,5,4.70353026692273,4.62985882856447,0.0736714383582626,32,40,-8,44,50,-6,54,73,-19,2,4,0,0
"10303","FLA","NYR",2017021056,17600,20172018,1,65,3,3,0,6.80980646068929,2.27664272777508,4.5331637329142,35,37,-2,54,46,8,62,58,4,2,1,0,0
"10304","FLA","EDM",2017021099,17607,20172018,1,60,2,4,-2,7.73487195083362,9.96473234125338,-2.22986039041976,42,36,6,55,46,9,64,62,2,7,2,0,0
"10305","FLA","MTL",2017021118,17609,20172018,0,60,2,0,2,5.7705810238371,6.01632318260447,-0.245742158767375,40,28,12,58,36,22,79,49,30,3,6,0,0
"10306","FLA","NYI",2017021169,17616,20172018,0,60,3,0,3,5.47031636509394,4.33782634220552,1.13249002288842,41,32,9,60,39,21,77,58,19,5,4,0,0
"10307","FLA","TOR",2017021186,17618,20172018,0,60,3,4,-1,4.95381850908541,3.22816754186306,1.72565096722235,33,35,-2,52,48,4,74,66,8,3,1,0,0
"10308","FLA","T.B",2018020019,17810,20182019,0,65,1,1,0,3.20036501799041,4.31919864433004,-1.11883362633964,43,29,14,56,40,16,65,53,12,5,3,0,0
"10309","FLA","PHI",2018020080,17820,20182019,0,65,5,5,0,6.92243734265503,2.21022619175578,4.71221115089925,26,26,0,40,36,4,53,50,3,4,3,0,0
"10310","FLA","NYR",2018020122,17827,20182019,0,60,2,5,-3,4.28669872908563,5.01978706464082,-0.733088335555192,38,22,16,46,31,15,64,48,16,4,6,0,0
"10311","FLA","NYI",2018020130,17828,20182019,0,60.55,3,2,1,4.43630354586264,3.32483676041011,1.11146678545254,41,22,19,58,25,33,71,37,34,6,4,0,0
"10312","FLA","N.J",2018020148,17831,20182019,0,60,2,3,-1,6.9768366859816,2.42680914129107,4.55002754469052,37,26,11,51,40,11,81,48,33,6,6,0,0
"10313","FLA","WPG",2018020180,17836,20182019,1,60,2,4,-2,4.53593572415036,5.39355883339695,-0.857623109246589,38,36,2,51,46,5,77,59,18,6,7,0,0
"10314","FLA","WPG",2018020192,17837,20182019,0,60,4,2,2,5.73615803441498,9.08047591215347,-3.34431787773849,26,34,-8,40,43,-3,53,64,-11,4,2,0,0
"10315","FLA","EDM",2018020228,17843,20182019,1,60,4,1,3,6.16248315610574,2.42614828044498,3.73633487566076,33,27,6,42,37,5,52,49,3,4,3,0,0
"10316","FLA","NYI",2018020248,17845,20182019,1,60,4,2,2,6.54930807141136,3.02061778636562,3.52869028504574,31,31,0,40,41,-1,49,52,-3,6,5,0,0
"10317","FLA","PHI",2018020267,17848,20182019,0,60,2,1,1,2.05837979432957,7.42662852503145,-5.36824873070187,30,31,-1,37,53,-16,52,74,-22,3,1,0,0
"10318","FLA","NYR",2018020296,17852,20182019,0,60,2,4,-2,4.39476539449242,2.80031300302471,1.59445239146771,41,24,17,58,34,24,79,47,32,4,3,0,0
"10319","FLA","T.B",2018020325,17856,20182019,0,60,3,7,-4,5.05163105761585,4.6914002156991,0.360230841916746,43,33,10,53,45,8,60,62,-2,4,4,0,0
"10320","FLA","N.J",2018020363,17861,20182019,1,61.4666666666667,4,3,1,4.10654985259433,4.58805275290678,-0.481502900312449,34,32,2,47,44,3,59,58,1,4,2,0,0
"10321","FLA","ANA",2018020378,17863,20182019,1,60,2,3,-1,7.21270818364428,3.27035933846491,3.94234884517937,44,25,19,50,36,14,60,42,18,3,2,0,0
"10322","FLA","T.B",2018020399,17866,20182019,1,63.2,4,5,-1,5.03030325028158,5.20552279473536,-0.175219544453786,27,39,-12,35,49,-14,53,64,-11,5,4,0,0
"10323","FLA","COL",2018020430,17871,20182019,1,60,2,5,-3,5.44795583368786,6.07856594318401,-0.630610109496156,35,37,-2,47,50,-3,62,64,-2,5,4,0,0
"10324","FLA","NYR",2018020450,17873,20182019,1,65,4,4,0,5.96841979937381,3.96196620073377,2.00645359864004,31,26,5,42,35,7,58,50,8,4,1,0,0
"10325","FLA","MIN",2018020484,17878,20182019,0,60,1,5,-4,2.47365835800883,1.32741342407472,1.14624493393412,31,26,5,37,33,4,58,45,13,3,1,0,0
"10326","FLA","TOR",2018020497,17880,20182019,1,63.4,4,3,1,5.63983182764827,5.22997085718089,0.409860970467378,33,32,1,41,52,-11,53,74,-21,5,4,0,0
"10327","FLA","TOR",2018020531,17885,20182019,0,60,1,6,-5,3.37843163500656,2.88677275290055,0.491658882106009,26,26,0,44,44,0,57,66,-9,3,3,0,0
"10328","FLA","MTL",2018020580,17893,20182019,1,60,3,5,-2,4.57380572071088,5.32933061069343,-0.755524889982553,26,28,-2,36,41,-5,47,52,-5,3,3,0,0
"10329","FLA","PHI",2018020591,17894,20182019,1,60,2,1,1,2.68554010027572,7.13019841624191,-4.44465831596619,36,35,1,46,50,-4,67,58,9,3,2,0,0
"10330","FLA","PIT",2018020660,17904,20182019,0,60,1,5,-4,4.42089265310577,4.38678084817349,0.0341118049322802,37,31,6,50,40,10,72,50,22,5,5,0,0
"10331","FLA","EDM",2018020679,17906,20182019,0,65,3,3,0,5.99791548493704,5.6365520438394,0.361363441097637,30,24,6,39,34,5,52,49,3,2,2,0,0
"10332","FLA","MTL",2018020714,17911,20182019,0,60,1,5,-4,8.34073365367658,5.02036985785354,3.32036379582304,53,28,25,68,48,20,84,60,24,5,4,0,0
"10333","FLA","TOR",2018020733,17914,20182019,1,60,3,1,2,5.03567630401812,5.05740846158005,-0.021732157561928,29,21,8,40,30,10,48,41,7,3,1,0,0
"10334","FLA","VGK",2018020793,17929,20182019,1,60,3,1,2,5.51589604979381,4.99912367627257,0.516772373521235,25,35,-10,39,49,-10,48,61,-13,2,1,0,0
"10335","FLA","PIT",2018020824,17934,20182019,1,64.2333333333333,3,2,1,10.3351407835709,4.23608572266335,6.09905506090751,42,31,11,58,45,13,70,54,16,3,3,0,0
"10336","FLA","T.B",2018020858,17937,20182019,1,60,2,5,-3,3.57257614035731,5.00593802670483,-1.43336188634751,27,23,4,41,34,7,52,44,8,5,5,0,0
"10337","FLA","DAL",2018020865,17939,20182019,1,60,0,3,-3,2.5018603684257,2.57417389150942,-0.0723135230837215,30,19,11,39,30,9,59,45,14,4,2,0,0
"10338","FLA","MTL",2018020908,17944,20182019,1,60,6,3,3,9.30691390430718,3.65389695078193,5.65301695352525,36,31,5,50,43,7,58,55,3,3,3,0,0
"10339","FLA","COL",2018020966,17952,20182019,0,60.4333333333333,4,3,1,4.36065714372334,3.50368887305603,0.856968270667309,38,39,-1,45,46,-1,67,58,9,2,2,0,0
"10340","FLA","VGK",2018020989,17955,20182019,0,65,5,5,0,3.75715467880946,4.65524915774552,-0.898094478936059,37,46,-9,44,60,-16,48,80,-32,5,2,0,0
"10341","FLA","PIT",2018021022,17960,20182019,0,62.7333333333333,2,3,-1,3.72762858815021,6.08097048114207,-2.35334189299186,34,37,-3,41,50,-9,54,69,-15,3,2,0,0
"10342","FLA","MIN",2018021044,17963,20182019,1,60,6,2,4,4.97611014115409,4.38149817995648,0.594611961197609,29,27,2,42,41,1,51,49,2,4,4,0,0
"10343","FLA","ANA",2018021116,17972,20182019,0,60,2,3,-1,5.75089736689552,3.45090732036624,2.29999004652927,39,22,17,61,34,27,71,44,27,2,3,0,0
"10344","FLA","DAL",2018021130,17974,20182019,0,60,2,4,-2,4.45605716970749,7.53745792874315,-3.08140075903566,22,37,-15,31,55,-24,47,70,-23,3,3,0,0
"10345","FLA","TOR",2018021169,17980,20182019,0,60,5,7,-2,6.28994433419075,2.90413870065806,3.38580563353269,36,37,-1,56,47,9,71,64,7,4,4,0,0
"10346","FLA","MTL",2018021180,17981,20182019,0,60,1,6,-5,5.0628512985988,5.96569971559063,-0.90284841699183,34,27,7,46,41,5,59,64,-5,3,2,0,0
"10347","FLA","NYI",2018021244,17990,20182019,1,65,1,1,0,6.02152767953151,4.49552774219774,1.52599993733378,30,36,-6,38,52,-14,52,72,-20,2,3,0,0
"10348","L.A","S.J",2008020028,14163,20082009,0,60,1,3,-2,0,0,0,13,41,-28,21,58,-37,34,69,-35,4,6,0,0
"10349","L.A","S.J",2008020031,14164,20082009,1,60,0,1,-1,0,0,0,21,19,2,36,42,-6,49,55,-6,5,3,0,0
"10350","L.A","ANA",2008020042,14166,20082009,1,60,6,3,3,0,0,0,23,26,-3,37,36,1,45,46,-1,11,7,0,0
"10351","L.A","CAR",2008020062,14169,20082009,1,63.35,4,3,1,0,0,0,24,26,-2,37,41,-4,45,52,-7,3,5,0,0
"10352","L.A","COL",2008020081,14172,20082009,1,60,3,4,-1,0,0,0,29,16,13,43,25,18,57,28,29,4,4,0,0
"10353","L.A","STL",2008020104,14176,20082009,0,60,4,0,4,0,0,0,29,15,14,42,31,11,56,43,13,6,7,0,0
"10354","L.A","NSH",2008020112,14177,20082009,0,60,4,5,-1,0,0,0,30,27,3,44,36,8,56,42,14,5,3,0,0
"10355","L.A","DET",2008020125,14179,20082009,1,65,3,3,0,0,0,0,19,37,-18,35,55,-20,47,63,-16,7,6,0,0
"10356","L.A","VAN",2008020146,14182,20082009,1,60,0,4,-4,0,0,0,28,18,10,42,30,12,54,38,16,9,7,0,0
"10357","L.A","CGY",2008020161,14184,20082009,1,60,2,3,-1,0,0,0,36,21,15,49,31,18,59,38,21,7,5,0,0
"10358","L.A","ANA",2008020176,14187,20082009,1,60.6666666666667,0,1,-1,0,0,0,35,27,8,55,35,20,66,42,24,7,6,0,0
"10359","L.A","FLA",2008020190,14189,20082009,1,60,3,2,1,0,0,0,32,15,17,53,29,24,69,35,34,5,6,0,0
"10360","L.A","STL",2008020207,14191,20082009,1,60,5,3,2,0,0,0,31,27,4,45,52,-7,58,69,-11,6,4,0,0
"10361","L.A","DAL",2008020219,14194,20082009,1,65,2,2,0,0,0,0,26,21,5,34,39,-5,49,53,-4,6,3,0,0
"10362","L.A","DAL",2008020233,14196,20082009,0,60,3,2,1,0,0,0,29,26,3,41,36,5,57,48,9,9,5,0,0
"10363","L.A","NSH",2008020251,14198,20082009,1,60,1,3,-2,0,0,0,34,22,12,53,31,22,68,40,28,3,3,0,0
"10364","L.A","ANA",2008020256,14199,20082009,0,60,0,2,-2,0,0,0,29,26,3,43,38,5,51,42,9,4,3,0,0
"10365","L.A","WSH",2008020278,14203,20082009,1,60,5,2,3,0,0,0,33,21,12,55,39,16,67,55,12,5,5,0,0
"10366","L.A","COL",2008020295,14205,20082009,1,65,3,3,0,0,0,0,30,29,1,47,46,1,66,63,3,8,5,0,0
"10367","L.A","CGY",2008020308,14208,20082009,0,60,2,6,-4,0,0,0,25,35,-10,32,50,-18,43,62,-19,5,13,0,0
"10368","L.A","EDM",2008020319,14209,20082009,0,60,2,1,1,0,0,0,29,23,6,38,35,3,61,50,11,3,5,0,0
"10369","L.A","CHI",2008020335,14212,20082009,1,60,5,2,3,0,0,0,28,24,4,50,32,18,65,52,13,4,3,0,0
"10370","L.A","TOR",2008020354,14214,20082009,1,60,1,3,-2,0,0,0,33,30,3,51,40,11,71,53,18,5,6,0,0
"10371","L.A","ARI",2008020359,14215,20082009,0,60,2,4,-2,0,0,0,34,26,8,47,40,7,62,64,-2,1,5,0,0
"10372","L.A","EDM",2008020379,14218,20082009,1,65,4,4,0,0,0,0,36,44,-8,50,57,-7,61,71,-10,4,4,0,0
"10373","L.A","CBJ",2008020391,14219,20082009,1,60,3,0,3,0,0,0,18,23,-5,37,34,3,51,50,1,2,4,0,0
"10374","L.A","COL",2008020412,14222,20082009,0,60,1,6,-5,0,0,0,30,26,4,49,34,15,75,42,33,5,5,0,0
"10375","L.A","STL",2008020420,14224,20082009,1,60,6,2,4,0,0,0,32,28,4,48,39,9,60,56,4,9,7,0,0
"10376","L.A","MIN",2008020430,14226,20082009,1,60,3,1,2,0,0,0,43,34,9,57,41,16,70,50,20,5,4,0,0
"10377","L.A","S.J",2008020445,14228,20082009,1,65,2,2,0,0,0,0,28,25,3,46,40,6,62,59,3,5,1,0,0
"10378","L.A","NYR",2008020459,14230,20082009,1,63.6833333333333,2,3,-1,0,0,0,41,30,11,56,48,8,65,56,9,4,2,0,0
"10379","L.A","BUF",2008020470,14232,20082009,0,60,0,5,-5,0,0,0,40,23,17,53,30,23,67,39,28,2,5,0,0
"10380","L.A","DET",2008020480,14233,20082009,0,60,4,6,-2,0,0,0,26,36,-10,35,47,-12,42,66,-24,3,3,0,0
"10381","L.A","CBJ",2008020498,14236,20082009,0,60,3,0,3,0,0,0,42,24,18,51,37,14,61,55,6,3,5,0,0
"10382","L.A","ARI",2008020515,14239,20082009,1,60,1,2,-1,0,0,0,25,26,-1,46,41,5,58,52,6,3,4,0,0
"10383","L.A","ARI",2008020525,14240,20082009,0,60,4,0,4,0,0,0,30,26,4,50,42,8,60,57,3,6,9,0,0
"10384","L.A","CBJ",2008020538,14242,20082009,1,60,0,2,-2,0,0,0,24,25,-1,38,35,3,54,46,8,4,3,0,0
"10385","L.A","PHI",2008020574,14247,20082009,1,65,1,1,0,0,0,0,31,32,-1,50,45,5,73,54,19,6,3,0,0
"10386","L.A","ANA",2008020595,14250,20082009,0,60,1,3,-2,0,0,0,18,26,-8,28,33,-5,40,44,-4,4,5,0,0
"10387","L.A","ANA",2008020608,14252,20082009,1,60,4,3,1,0,0,0,26,27,-1,36,48,-12,46,60,-14,4,7,0,0
"10388","L.A","N.J",2008020625,14254,20082009,1,60,1,5,-4,0,0,0,35,28,7,49,36,13,62,50,12,4,7,0,0
"10389","L.A","T.B",2008020630,14256,20082009,1,60,1,3,-2,0,0,0,30,22,8,47,36,11,56,44,12,5,5,0,0
"10390","L.A","DET",2008020654,14259,20082009,1,60,0,4,-4,0,0,0,23,31,-8,36,47,-11,48,60,-12,5,7,0,0
"10391","L.A","DAL",2008020662,14261,20082009,0,65,2,2,0,0,0,0,22,34,-12,44,46,-2,60,58,2,5,4,0,0
"10392","L.A","MIN",2008020688,14264,20082009,0,60,5,2,3,0,0,0,32,27,5,47,38,9,57,55,2,5,5,0,0
"10393","L.A","COL",2008020699,14265,20082009,0,60,6,5,1,0,0,0,28,41,-13,39,60,-21,48,82,-34,4,8,0,0
"10394","L.A","CHI",2008020723,14273,20082009,1,60,5,2,3,0,0,0,26,33,-7,33,51,-18,47,70,-23,3,2,0,0
"10395","L.A","MTL",2008020732,14275,20082009,0,60,3,4,-1,0,0,0,32,26,6,44,37,7,60,59,1,6,6,0,0
"10396","L.A","OTT",2008020754,14278,20082009,0,60,1,0,1,0,0,0,26,29,-3,32,45,-13,46,58,-12,6,6,0,0
"10397","L.A","WSH",2008020764,14280,20082009,0,60,5,4,1,0,0,0,35,45,-10,44,47,-3,60,65,-5,8,6,0,0
"10398","L.A","N.J",2008020782,14282,20082009,0,60,3,1,2,0,0,0,32,26,6,44,37,7,52,47,5,7,6,0,0
"10399","L.A","NYI",2008020796,14285,20082009,0,65,3,3,0,0,0,0,39,25,14,58,39,19,84,61,23,5,3,0,0
"10400","L.A","CGY",2008020817,14287,20082009,1,60,0,2,-2,0,0,0,36,20,16,54,28,26,64,39,25,7,5,0,0
"10401","L.A","EDM",2008020826,14289,20082009,1,65,2,2,0,0,0,0,41,21,20,57,37,20,69,45,24,9,9,0,0
"10402","L.A","ATL",2008020846,14291,20082009,1,65,6,6,0,0,0,0,45,27,18,62,36,26,89,41,48,8,3,0,0
"10403","L.A","ANA",2008020858,14293,20082009,0,60,4,3,1,0,0,0,26,31,-5,42,41,1,54,50,4,8,8,0,0
"10404","L.A","S.J",2008020870,14294,20082009,0,60,2,4,-2,0,0,0,32,40,-8,40,55,-15,52,72,-20,9,10,0,0
"10405","L.A","ARI",2008020877,14296,20082009,1,60,3,6,-3,0,0,0,33,29,4,55,41,14,63,49,14,4,2,0,0
"10406","L.A","MIN",2008020900,14299,20082009,0,65,1,1,0,0,0,0,25,24,1,38,34,4,53,45,8,5,4,0,0
"10407","L.A","PHI",2008020904,14300,20082009,0,60,0,2,-2,0,0,0,34,20,14,46,37,9,77,46,31,5,3,0,0
"10408","L.A","DET",2008020919,14302,20082009,0,60,1,2,-1,0,0,0,31,41,-10,40,48,-8,59,62,-3,2,2,0,0
"10409","L.A","CHI",2008020936,14304,20082009,0,60,2,4,-2,0,0,0,24,38,-14,30,50,-20,35,61,-26,4,5,0,0
"10410","L.A","CBJ",2008020944,14306,20082009,0,60,4,5,-1,0,0,0,26,25,1,34,31,3,50,42,8,3,1,0,0
"10411","L.A","DAL",2008020962,14308,20082009,1,61.5166666666667,5,4,1,0,0,0,40,23,17,55,33,22,69,42,27,10,3,0,0
"10412","L.A","MIN",2008020971,14310,20082009,1,60,4,3,1,0,0,0,24,24,0,39,33,6,52,44,8,3,2,0,0
"10413","L.A","VAN",2008020988,14312,20082009,1,60,3,2,1,0,0,0,22,22,0,31,43,-12,41,56,-15,6,4,0,0
"10414","L.A","VAN",2008021017,14316,20082009,0,60,2,4,-2,0,0,0,26,32,-6,41,45,-4,56,54,2,5,6,0,0
"10415","L.A","S.J",2008021030,14317,20082009,0,65,1,1,0,0,0,0,24,39,-15,34,52,-18,46,78,-32,4,8,0,0
"10416","L.A","NSH",2008021039,14319,20082009,1,60,3,4,-1,0,0,0,29,30,-1,40,48,-8,52,59,-7,4,4,0,0
"10417","L.A","BOS",2008021055,14322,20082009,0,64.4166666666667,3,2,1,0,0,0,38,26,12,47,39,8,63,51,12,3,4,0,0
"10418","L.A","PIT",2008021066,14323,20082009,0,60,1,4,-3,0,0,0,25,26,-1,41,37,4,57,49,8,10,6,0,0
"10419","L.A","CHI",2008021080,14325,20082009,0,60,1,4,-3,0,0,0,15,32,-17,25,41,-16,37,53,-16,3,7,0,0
"10420","L.A","STL",2008021093,14327,20082009,0,60,0,2,-2,0,0,0,22,23,-1,39,30,9,54,43,11,6,5,0,0
"10421","L.A","DAL",2008021108,14329,20082009,0,65,0,0,0,0,0,0,30,29,1,38,46,-8,46,57,-11,5,6,0,0
"10422","L.A","NSH",2008021122,14331,20082009,0,63.6833333333333,3,4,-1,0,0,0,27,28,-1,39,39,0,46,57,-11,4,6,0,0
"10423","L.A","DAL",2008021143,14334,20082009,1,60,2,3,-1,0,0,0,28,35,-7,44,42,2,57,53,4,2,5,0,0
"10424","L.A","CGY",2008021183,14340,20082009,0,60,1,4,-3,0,0,0,24,38,-14,37,48,-11,45,64,-19,5,8,0,0
"10425","L.A","EDM",2008021193,14341,20082009,0,60,2,1,1,0,0,0,29,39,-10,36,55,-19,44,76,-32,0,3,0,0
"10426","L.A","VAN",2008021208,14343,20082009,0,60,0,1,-1,0,0,0,20,28,-8,27,41,-14,39,57,-18,3,5,0,0
"10427","L.A","S.J",2008021219,14345,20082009,1,60,4,3,1,0,0,0,24,30,-6,34,52,-18,40,65,-25,5,7,0,0
"10428","L.A","S.J",2009020032,14523,20092010,1,60,6,4,2,0,0,0,30,29,1,44,37,7,57,48,9,5,5,0,0
"10429","L.A","MIN",2009020045,14525,20092010,1,60,6,3,3,0,0,0,23,29,-6,32,39,-7,43,54,-11,4,4,0,0
"10430","L.A","STL",2009020056,14527,20092010,0,60,2,1,1,0,0,0,26,30,-4,37,39,-2,44,52,-8,6,5,0,0
"10431","L.A","NYI",2009020065,14529,20092010,0,60,2,1,1,0,0,0,22,29,-7,29,40,-11,44,53,-9,3,3,0,0
"10432","L.A","NYR",2009020076,14531,20092010,0,60,2,4,-2,0,0,0,36,21,15,50,29,21,63,37,26,7,3,0,0
"10433","L.A","DET",2009020084,14532,20092010,0,60,2,5,-3,0,0,0,26,32,-6,35,46,-11,45,61,-16,5,7,0,0
"10434","L.A","DAL",2009020107,14536,20092010,0,60,4,1,3,0,0,0,32,30,2,44,42,2,50,53,-3,5,4,0,0
"10435","L.A","DAL",2009020126,14539,20092010,1,60.9166666666667,5,4,1,0,0,0,31,21,10,46,33,13,56,42,14,6,5,0,0
"10436","L.A","S.J",2009020164,14545,20092010,0,65,1,1,0,0,0,0,29,30,-1,44,39,5,59,67,-8,2,2,0,0
"10437","L.A","VAN",2009020171,14546,20092010,1,65,1,1,0,0,0,0,31,15,16,49,24,25,65,41,24,4,3,0,0
"10438","L.A","PIT",2009020218,14553,20092010,1,60,5,2,3,0,0,0,32,23,9,50,39,11,61,45,16,4,4,0,0
"10439","L.A","NSH",2009020225,14555,20092010,1,60,1,3,-2,0,0,0,28,25,3,43,46,-3,52,59,-7,5,5,0,0
"10440","L.A","CHI",2009020240,14557,20092010,0,60,1,4,-3,0,0,0,18,29,-11,29,38,-9,41,53,-12,3,4,0,0
"10441","L.A","CAR",2009020250,14559,20092010,0,60,5,2,3,0,0,0,31,24,7,44,39,5,58,57,1,5,2,0,0
"10442","L.A","ATL",2009020266,14561,20092010,0,60,0,7,-7,0,0,0,38,21,17,49,25,24,66,34,32,7,4,0,0
"10443","L.A","T.B",2009020275,14562,20092010,0,65,1,1,0,0,0,0,30,29,1,41,36,5,59,48,11,6,7,0,0
"10444","L.A","FLA",2009020287,14564,20092010,0,65,3,3,0,0,0,0,34,29,5,45,40,5,59,52,7,7,4,0,0
"10445","L.A","PHI",2009020298,14566,20092010,1,60,2,3,-1,0,0,0,39,20,19,53,36,17,67,46,21,5,3,0,0
"10446","L.A","CGY",2009020313,14569,20092010,1,60,2,5,-3,0,0,0,25,32,-7,31,45,-14,40,56,-16,4,8,0,0
"10447","L.A","EDM",2009020350,14573,20092010,0,60,3,1,2,0,0,0,35,23,12,50,37,13,67,52,15,5,6,0,0
"10448","L.A","VAN",2009020354,14574,20092010,0,60,1,4,-3,0,0,0,32,34,-2,41,53,-12,61,69,-8,5,6,0,0
"10449","L.A","CHI",2009020379,14576,20092010,1,65,1,1,0,0,0,0,22,33,-11,34,41,-7,51,50,1,3,4,0,0
"10450","L.A","ANA",2009020392,14579,20092010,0,60,4,3,1,0,0,0,42,30,12,55,37,18,64,43,21,5,4,0,0
"10451","L.A","OTT",2009020407,14581,20092010,1,60,6,3,3,0,0,0,24,30,-6,35,44,-9,43,57,-14,6,5,0,0
"10452","L.A","STL",2009020415,14583,20092010,1,65,4,4,0,0,0,0,40,31,9,57,48,9,69,60,9,2,5,0,0
"10453","L.A","CGY",2009020437,14585,20092010,1,60,2,1,1,0,0,0,16,27,-11,32,39,-7,44,54,-10,4,5,0,0
"10454","L.A","S.J",2009020451,14587,20092010,0,61.2666666666667,5,4,1,0,0,0,28,34,-6,35,50,-15,46,63,-17,5,7,0,0
"10455","L.A","DAL",2009020477,14590,20092010,1,65,2,2,0,0,0,0,27,27,0,42,43,-1,56,52,4,3,5,0,0
"10456","L.A","VAN",2009020487,14592,20092010,0,60,1,3,-2,0,0,0,25,28,-3,40,36,4,45,48,-3,6,6,0,0
"10457","L.A","EDM",2009020493,14593,20092010,0,60,3,2,1,0,0,0,26,29,-3,32,46,-14,40,60,-20,1,3,0,0
"10458","L.A","CGY",2009020508,14595,20092010,0,60,1,2,-1,0,0,0,35,24,11,46,32,14,60,48,12,4,5,0,0
"10459","L.A","MIN",2009020582,14606,20092010,1,60,3,4,-1,0,0,0,32,23,9,49,31,18,62,34,28,1,2,0,0
"10460","L.A","CGY",2009020595,14608,20092010,0,60,1,2,-1,0,0,0,24,21,3,38,34,4,57,50,7,5,9,0,0
"10461","L.A","MIN",2009020605,14609,20092010,0,60,5,2,3,0,0,0,29,29,0,32,38,-6,49,49,0,5,6,0,0
"10462","L.A","S.J",2009020628,14613,20092010,0,60,6,2,4,0,0,0,20,47,-27,30,61,-31,42,77,-35,5,5,0,0
"10463","L.A","DET",2009020654,14616,20092010,1,60,1,2,-1,0,0,0,52,24,28,62,39,23,76,52,24,5,3,0,0
"10464","L.A","STL",2009020671,14618,20092010,1,60,3,4,-1,0,0,0,24,32,-8,42,45,-3,49,55,-6,5,3,0,0
"10465","L.A","S.J",2009020679,14620,20092010,1,60,1,2,-1,0,0,0,34,36,-2,45,46,-1,59,54,5,5,3,0,0
"10466","L.A","ANA",2009020703,14623,20092010,1,60,4,0,4,0,0,0,27,22,5,32,42,-10,42,58,-16,8,8,0,0
"10467","L.A","BOS",2009020710,14625,20092010,1,65,3,3,0,0,0,0,34,24,10,51,38,13,66,51,15,5,1,0,0
"10468","L.A","S.J",2009020740,14628,20092010,1,60,1,5,-4,0,0,0,37,24,13,51,31,20,64,38,26,7,7,0,0
"10469","L.A","DET",2009020766,14632,20092010,0,60,3,2,1,0,0,0,33,33,0,45,44,1,60,52,8,3,3,0,0
"10470","L.A","TOR",2009020778,14635,20092010,0,60,5,3,2,0,0,0,33,28,5,45,36,9,64,53,11,2,1,0,0
"10471","L.A","BOS",2009020808,14639,20092010,0,65,2,2,0,0,0,0,29,33,-4,33,40,-7,43,52,-9,5,7,0,0
"10472","L.A","N.J",2009020819,14640,20092010,0,60,3,2,1,0,0,0,22,28,-6,33,38,-5,41,46,-5,4,3,0,0
"10473","L.A","NYR",2009020834,14642,20092010,1,60,2,1,1,0,0,0,21,21,0,41,31,10,51,43,8,4,4,0,0
"10474","L.A","ANA",2009020849,14644,20092010,1,60,6,4,2,0,0,0,31,22,9,45,33,12,56,41,15,2,1,0,0
"10475","L.A","DET",2009020857,14646,20092010,1,60,4,3,1,0,0,0,27,23,4,37,39,-2,46,49,-3,3,4,0,0
"10476","L.A","ANA",2009020875,14648,20092010,0,60,2,4,-2,0,0,0,37,33,4,47,47,0,55,59,-4,5,5,0,0
"10477","L.A","EDM",2009020897,14651,20092010,1,65,2,2,0,0,0,0,43,23,20,61,39,22,68,52,16,7,5,0,0
"10478","L.A","COL",2009020915,14653,20092010,1,60,3,0,3,0,0,0,23,22,1,30,36,-6,36,49,-13,5,3,0,0
"10479","L.A","DAL",2009020932,14670,20092010,0,60,5,1,4,0,0,0,22,32,-10,39,58,-19,56,81,-25,4,6,0,0
"10480","L.A","NSH",2009020946,14672,20092010,0,60,2,4,-2,0,0,0,22,32,-10,29,48,-19,35,59,-24,5,7,0,0
"10481","L.A","MTL",2009020963,14674,20092010,1,60,2,4,-2,0,0,0,25,25,0,44,33,11,59,39,20,4,1,0,0
"10482","L.A","CHI",2009020988,14678,20092010,0,62.1333333333333,2,3,-1,0,0,0,30,43,-13,35,56,-21,48,74,-26,2,4,0,0
"10483","L.A","DAL",2009021004,14680,20092010,0,65,1,1,0,0,0,0,28,30,-2,42,51,-9,52,62,-10,5,5,0,0
"10484","L.A","NSH",2009021017,14682,20092010,1,60,2,3,-1,0,0,0,20,31,-11,33,45,-12,41,55,-14,1,1,0,0
"10485","L.A","CHI",2009021052,14686,20092010,1,60,0,3,-3,0,0,0,17,37,-20,27,57,-30,36,75,-39,0,4,0,0
"10486","L.A","NYI",2009021067,14688,20092010,1,60,1,0,1,0,0,0,26,26,0,36,46,-10,44,60,-16,4,4,0,0
"10487","L.A","COL",2009021079,14690,20092010,1,63.6666666666667,4,3,1,0,0,0,23,21,2,36,32,4,43,41,2,4,6,0,0
"10488","L.A","COL",2009021094,14692,20092010,0,65,3,3,0,0,0,0,30,30,0,41,39,2,61,51,10,3,5,0,0
"10489","L.A","STL",2009021104,14693,20092010,0,60,1,3,-2,0,0,0,31,25,6,44,32,12,63,38,25,8,3,0,0
"10490","L.A","DAL",2009021121,14695,20092010,1,60,1,4,-3,0,0,0,30,26,4,49,39,10,60,43,17,8,8,0,0
"10491","L.A","MIN",2009021131,14697,20092010,0,60,2,3,-1,0,0,0,31,20,11,45,25,20,69,35,34,5,3,0,0
"10492","L.A","NSH",2009021140,14698,20092010,0,60,2,0,2,0,0,0,31,34,-3,42,45,-3,58,64,-6,2,3,0,0
"10493","L.A","VAN",2009021156,14700,20092010,1,60,8,3,5,0,0,0,29,30,-1,39,50,-11,52,65,-13,5,3,0,0
"10494","L.A","ANA",2009021174,14702,20092010,1,65,1,1,0,0,0,0,29,33,-4,49,55,-6,54,72,-18,5,3,0,0
"10495","L.A","ANA",2009021192,14705,20092010,0,65,4,4,0,0,0,0,40,21,19,48,35,13,66,41,25,3,3,0,0
"10496","L.A","EDM",2009021213,14709,20092010,1,65,3,3,0,0,0,0,55,16,39,83,23,60,101,33,68,7,5,0,0
"10497","L.A","COL",2009021226,14710,20092010,0,61.5166666666667,2,1,1,0,0,0,33,32,1,41,36,5,61,44,17,3,4,0,0
"10498","L.A","VAN",2009030171,14714,20092010,0,68.8666666666667,2,3,-1,0,0,0,27,44,-17,39,60,-21,52,78,-26,2,5,0,0
"10499","L.A","VAN",2009030172,14716,20092010,0,67.4666666666667,3,2,1,0,0,0,32,26,6,43,43,0,56,50,6,7,4,0,0
"10500","L.A","VAN",2009030173,14718,20092010,1,60,5,3,2,0,0,0,23,28,-5,33,48,-15,46,76,-30,3,4,0,0
"10501","L.A","VAN",2009030174,14720,20092010,1,60,4,6,-2,0,0,0,26,37,-11,37,57,-20,47,71,-24,6,7,0,0
"10502","L.A","VAN",2009030175,14722,20092010,0,60,2,7,-5,0,0,0,26,30,-4,36,38,-2,49,49,0,6,7,0,0
"10503","L.A","VAN",2009030176,14724,20092010,1,60,2,4,-2,0,0,0,32,22,10,53,36,17,65,44,21,5,3,0,0
"10504","L.A","VAN",2010020023,14891,20102011,0,65,1,1,0,3.57688447687073,2.64906394654352,0.927820530327203,32,24,8,42,31,11,55,45,10,6,5,0,0
"10505","L.A","CGY",2010020025,14892,20102011,0,60,1,3,-2,4.25359736986249,3.0944018913433,1.15919547851919,22,32,-10,31,38,-7,50,50,0,3,5,0,0
"10506","L.A","ATL",2010020035,14894,20102011,1,60,3,1,2,6.50431478396058,2.87002322505577,3.63429155890481,35,32,3,52,41,11,69,52,17,2,5,0,0
"10507","L.A","VAN",2010020054,14897,20102011,1,60,4,1,3,1.95353734203673,3.7340662388493,-1.78052889681257,19,26,-7,24,46,-22,37,60,-23,5,5,0,0
"10508","L.A","CAR",2010020081,14902,20102011,1,60,4,3,1,3.81311274884501,5.36020672755694,-1.54709397871193,27,30,-3,39,42,-3,45,53,-8,4,3,0,0
"10509","L.A","COL",2010020108,14905,20102011,0,60,6,4,2,5.16123379419949,2.64621114823603,2.51502264596346,30,32,-2,39,41,-2,51,48,3,4,5,0,0
"10510","L.A","MIN",2010020116,14907,20102011,0,65,2,2,0,5.56425013330387,2.62406490795547,2.9401852253484,34,22,12,55,36,19,74,55,19,7,3,0,0
"10511","L.A","CHI",2010020127,14909,20102011,0,60,1,3,-2,4.93724149558693,2.09542687866531,2.84181461692162,34,28,6,43,36,7,59,55,4,2,3,0,0
"10512","L.A","DAL",2010020135,14910,20102011,0,60,5,2,3,2.95278914601658,3.23763825464994,-0.284849108633352,24,32,-8,30,51,-21,43,66,-23,4,7,0,0
"10513","L.A","N.J",2010020155,14912,20102011,1,60,3,1,2,4.9501100290363,6.2534198274011,-1.30330979836481,23,40,-17,31,50,-19,40,62,-22,3,2,0,0
"10514","L.A","T.B",2010020178,14917,20102011,1,60,1,0,1,2.15675237744586,3.42431690282219,-1.26756452537633,26,24,2,34,38,-4,47,51,-4,3,3,0,0
"10515","L.A","NSH",2010020187,14919,20102011,1,60,4,1,3,6.02771107658918,3.78764369108831,2.24006738550088,31,26,5,41,41,0,48,62,-14,3,3,0,0
"10516","L.A","DAL",2010020225,14924,20102011,1,60,3,1,2,4.27035178197548,2.62174992537695,1.64860185659853,29,28,1,44,44,0,53,55,-2,7,6,0,0
"10517","L.A","NYI",2010020243,14926,20102011,1,60,5,1,4,4.2059856976266,2.53407886037965,1.67190683724696,34,19,15,51,30,21,61,40,21,4,5,0,0
"10518","L.A","S.J",2010020253,14928,20102011,0,60,3,6,-3,4.30247763545363,1.97072494772146,2.33175268773217,35,34,1,49,42,7,57,62,-5,3,4,0,0
"10519","L.A","BOS",2010020283,14933,20102011,0,65,3,3,0,2.36185722425125,3.60352913767447,-1.24167191342321,26,41,-15,33,58,-25,50,78,-28,5,5,0,0
"10520","L.A","OTT",2010020303,14935,20102011,0,60,2,3,-1,4.51681988206693,1.60381754340779,2.91300233865915,30,19,11,38,26,12,48,41,7,5,2,0,0
"10521","L.A","MTL",2010020311,14937,20102011,0,60,1,4,-3,5.98348751459162,2.44503192135992,3.5384555932317,25,33,-8,33,43,-10,53,57,-4,4,4,0,0
"10522","L.A","CHI",2010020344,14940,20102011,1,60,1,2,-1,2.68192441421045,3.80222925402495,-1.1203048398145,22,23,-1,36,33,3,50,46,4,6,4,0,0
"10523","L.A","ANA",2010020352,14942,20102011,0,60,0,2,-2,4.84034302910732,1.52193253926089,3.31841048984643,27,19,8,46,32,14,62,36,26,3,2,0,0
"10524","L.A","FLA",2010020372,14945,20102011,1,60,3,2,1,4.51513091022935,3.20515566462018,1.30997524560917,24,26,-2,38,33,5,56,43,13,2,3,0,0
"10525","L.A","DET",2010020390,14947,20102011,1,64.0666666666667,3,2,1,5.10518477356527,5.98510374425678,-0.879918970691506,25,29,-4,31,42,-11,42,58,-16,2,2,0,0
"10526","L.A","CGY",2010020418,14952,20102011,1,60,2,1,1,8.01519055698412,3.81814868122675,4.19704187575738,32,27,5,53,38,15,70,46,24,6,3,0,0
"10527","L.A","MIN",2010020436,14954,20102011,1,62.8333333333333,2,3,-1,3.57168534307857,4.45961796092342,-0.887932617844854,26,21,5,45,33,12,59,44,15,8,5,0,0
"10528","L.A","DET",2010020441,14956,20102011,0,60,5,0,5,4.1928608622984,4.66421944562819,-0.471358583329792,26,51,-25,38,68,-30,44,84,-40,1,3,0,0
"10529","L.A","STL",2010020464,14959,20102011,0,60,4,6,-2,3.69236583845781,2.44667776940332,1.24568806905449,29,31,-2,34,39,-5,50,48,2,7,6,0,0
"10530","L.A","NSH",2010020481,14961,20102011,0,60,6,1,5,4.00660398293985,3.84135118062574,0.165252802314113,34,30,4,38,38,0,50,47,3,3,3,0,0
"10531","L.A","CHI",2010020486,14962,20102011,0,60,2,3,-1,2.7562518267023,2.39935919793788,0.35689262876442,28,24,4,38,28,10,60,40,20,1,3,0,0
"10532","L.A","COL",2010020500,14964,20102011,0,60,5,0,5,3.65606210421538,5.22884638345568,-1.5727842792403,32,23,9,48,38,10,61,50,11,4,4,0,0
"10533","L.A","EDM",2010020517,14966,20102011,1,65,2,2,0,5.43760633323109,4.31865790020674,1.11894843302434,29,29,0,44,43,1,66,50,16,4,3,0,0
"10534","L.A","ANA",2010020529,14969,20102011,1,60,4,1,3,2.76257774644182,2.78677322188742,-0.0241954754455946,30,19,11,45,31,14,69,42,27,4,2,0,0
"10535","L.A","S.J",2010020535,14970,20102011,0,60,4,0,4,6.45520255969313,2.54010998133208,3.91509257836105,37,24,13,45,34,11,59,57,2,3,3,0,0
"10536","L.A","PHI",2010020556,14973,20102011,1,60,4,7,-3,6.23516069935067,4.31444530459301,1.92071539475766,36,28,8,52,38,14,71,52,19,7,5,0,0
"10537","L.A","S.J",2010020571,14975,20102011,1,60,0,1,-1,5.42773163957281,3.05321459950551,2.3745170400673,29,19,10,46,33,13,53,41,12,3,2,0,0
"10538","L.A","CHI",2010020584,14977,20102011,1,60,3,4,-1,4.27442046072974,5.53997285896912,-1.26555239823938,29,28,1,50,42,8,61,48,13,5,4,0,0
"10539","L.A","NSH",2010020603,14980,20102011,1,60,2,5,-3,4.62365098443115,3.2790548040939,1.34459618033725,26,28,-2,41,42,-1,51,51,0,2,3,0,0
"10540","L.A","TOR",2010020631,14984,20102011,1,60,2,3,-1,9.38729471398983,2.70117758694141,6.68611712704842,32,28,4,48,36,12,65,42,23,4,2,0,0
"10541","L.A","STL",2010020652,14987,20102011,1,60,1,3,-2,3.65647799563885,4.03814308710184,-0.381665091462992,25,21,4,41,28,13,52,40,12,2,1,0,0
"10542","L.A","EDM",2010020670,14989,20102011,1,60,5,2,3,7.37776015972486,5.85313018971988,1.52462997000498,23,26,-3,39,50,-11,50,57,-7,3,5,0,0
"10543","L.A","DAL",2010020682,14991,20102011,0,60,1,2,-1,2.2903408514976,2.5974653797457,-0.307124528248096,24,27,-3,30,40,-10,45,53,-8,2,5,0,0
"10544","L.A","STL",2010020689,14992,20102011,0,60,1,2,-1,2.68125490599778,5.85381094697823,-3.17255604098045,27,26,1,36,42,-6,54,59,-5,4,5,0,0
"10545","L.A","BOS",2010020733,14998,20102011,1,60,2,0,2,6.05047194692418,3.75333765278629,2.29713429413789,34,34,0,51,42,9,66,60,6,3,3,0,0
"10546","L.A","S.J",2010020750,15000,20102011,1,65,2,2,0,2.53724501252873,4.50037668569712,-1.96313167316839,20,24,-4,39,41,-2,61,58,3,1,2,0,0
"10547","L.A","MIN",2010020761,15006,20102011,0,65,0,0,0,5.25368588036508,3.68274945679215,1.57093642357293,27,25,2,43,35,8,68,47,21,2,2,0,0
"10548","L.A","EDM",2010020768,15007,20102011,0,60,3,1,2,3.43111873074668,4.09962686267681,-0.668508131930139,26,33,-7,40,44,-4,56,61,-5,6,6,0,0
"10549","L.A","CGY",2010020792,15010,20102011,0,65,3,3,0,5.41369499213761,3.22228882473428,2.19140616740333,33,35,-2,44,42,2,62,58,4,4,4,0,0
"10550","L.A","PIT",2010020818,15015,20102011,0,64.6833333333333,1,2,-1,6.34410218390099,4.32632718537934,2.01777499852165,33,26,7,45,30,15,66,48,18,3,2,0,0
"10551","L.A","PHI",2010020843,15018,20102011,0,60,1,0,1,4.25224318586048,4.95401926787372,-0.701776082013244,25,40,-15,33,50,-17,41,65,-24,2,4,0,0
"10552","L.A","NYR",2010020864,15022,20102011,0,65,3,3,0,0,0,0,28,37,-9,41,44,-3,66,59,7,4,3,0,0
"10553","L.A","NYI",2010020879,15024,20102011,0,60,0,3,-3,4.04761755823813,3.50043246520012,0.54718509303801,35,23,12,46,33,13,65,47,18,5,4,0,0
"10554","L.A","ANA",2010020908,15028,20102011,0,60,3,2,1,5.12551623990294,4.32366248133621,0.801853758566722,18,27,-9,36,34,2,50,43,7,1,2,0,0
"10555","L.A","MIN",2010020914,15029,20102011,1,60,4,2,2,4.28810408758682,3.71135445137043,0.576749636216391,30,27,3,44,38,6,63,52,11,4,5,0,0
"10556","L.A","COL",2010020925,15031,20102011,1,60,4,3,1,6.82253658776062,2.42739509022795,4.39514149753268,42,17,25,74,29,45,89,37,52,11,6,0,0
"10557","L.A","DET",2010020941,15033,20102011,1,60,4,7,-3,9.26556704846681,4.04134653488609,5.22422051358072,39,27,12,57,38,19,68,45,23,4,4,0,0
"10558","L.A","VAN",2010020975,15038,20102011,1,60,1,3,-2,4.07482535031045,3.98001770264455,0.0948076476659026,22,36,-14,33,50,-17,38,62,-24,8,8,0,0
"10559","L.A","DAL",2010020991,15040,20102011,1,60.6333333333333,3,4,-1,3.1280061276484,3.7690372902598,-0.641031162611398,23,22,1,37,35,2,56,45,11,4,5,0,0
"10560","L.A","DET",2010021003,15042,20102011,0,60,2,1,1,3.97717506357003,2.75620671152137,1.22096835204866,26,29,-3,33,42,-9,43,57,-14,3,2,0,0
"10561","L.A","DAL",2010021035,15046,20102011,0,60,3,2,1,3.67609944500146,4.11111629835796,-0.435016853356501,30,23,7,39,42,-3,47,60,-13,4,4,0,0
"10562","L.A","NSH",2010021048,15048,20102011,0,60,4,2,2,3.78176733874716,3.11140065369885,0.670366685048307,18,32,-14,29,41,-12,39,53,-14,1,2,0,0
"10563","L.A","STL",2010021064,15050,20102011,1,60,0,4,-4,3.51153248077389,8.89843399231904,-5.38690151154515,17,39,-22,31,55,-24,53,67,-14,1,3,0,0
"10564","L.A","ANA",2010021078,15052,20102011,1,61.5333333333333,1,2,-1,6.84246855892707,2.90195601840969,3.94051254051737,32,25,7,54,34,20,73,43,30,6,3,0,0
"10565","L.A","CGY",2010021087,15054,20102011,1,65,1,1,0,4.24458325409796,5.08431576429211,-0.839732510194153,27,28,-1,44,46,-2,61,58,3,5,7,0,0
"10566","L.A","S.J",2010021110,15057,20102011,1,65,3,3,0,6.02010152097876,6.29641777025063,-0.276316249271872,38,28,10,47,41,6,61,51,10,5,3,0,0
"10567","L.A","COL",2010021117,15059,20102011,1,60,4,1,3,6.32345005183015,3.19630334154317,3.12714671028698,25,21,4,41,31,10,53,37,16,3,2,0,0
"10568","L.A","EDM",2010021143,15062,20102011,0,60,2,0,2,2.45712065733824,4.19580236584136,-1.73868170850312,33,32,1,44,39,5,61,51,10,4,2,0,0
"10569","L.A","VAN",2010021158,15064,20102011,0,60,1,3,-2,4.40308630709478,6.18708008566586,-1.78399377857107,19,35,-16,28,60,-32,34,71,-37,3,4,0,0
"10570","L.A","DAL",2010021167,15066,20102011,1,60,3,1,2,7.55433691421786,6.46328721320606,1.0910497010118,32,25,7,45,46,-1,62,55,7,1,1,0,0
"10571","L.A","S.J",2010021183,15068,20102011,0,60,1,6,-5,4.77753677799046,4.72228433649798,0.0552524414924846,32,35,-3,41,44,-3,61,49,12,3,0,0,0
"10572","L.A","ANA",2010021214,15072,20102011,0,60,1,2,-1,5.02150406822057,2.01018604403362,3.01131802418695,24,28,-4,30,35,-5,53,50,3,4,3,0,0
"10573","L.A","ANA",2010021224,15073,20102011,1,60,1,3,-2,7.17161857849239,2.82982295351667,4.34179562497572,44,20,24,71,27,44,93,31,62,8,6,0,0
"10574","L.A","S.J",2010030161,15078,20102011,0,74.7333333333333,2,3,-1,6.30894432787318,6.99575859830608,-0.686814270432905,35,45,-10,49,59,-10,82,80,2,4,3,0,0
"10575","L.A","S.J",2010030162,15080,20102011,0,60,4,0,4,3.04331008263398,5.30350248432469,-2.26019240169071,23,34,-11,30,50,-20,38,72,-34,6,5,0,0
"10576","L.A","S.J",2010030163,15083,20102011,1,63.15,5,6,-1,4.83428487576733,7.34362515042085,-2.50934027465352,22,36,-14,33,55,-22,47,73,-26,3,3,0,0
"10577","L.A","S.J",2010030164,15085,20102011,1,60,3,6,-3,6.5508811789897,5.23700731296377,1.31387386602593,38,27,11,56,40,16,72,54,18,7,6,0,0
"10578","L.A","S.J",2010030165,15087,20102011,0,60,3,1,2,0,0,0,22,52,-30,27,66,-39,41,89,-48,1,4,0,0
"10579","L.A","S.J",2010030166,15089,20102011,1,62.3666666666667,3,4,-1,5.11807940468702,4.60629821591829,0.511781188768737,29,35,-6,41,48,-7,59,67,-8,2,3,0,0
"10580","L.A","NYR",2011020009,15254,20112012,1,64.1333333333333,3,2,1,2.5948123409762,1.87204868615822,0.722763654817982,30,26,4,43,32,11,50,48,2,5,1,0,0
"10581","L.A","N.J",2011020037,15260,20112012,0,65,1,1,0,3.24035489138623,3.67607702344321,-0.435722132056981,27,37,-10,33,50,-17,49,64,-15,1,2,0,0
"10582","L.A","PHI",2011020052,15262,20112012,0,61.65,3,2,1,4.91211057279725,4.15108016147133,0.761030411325919,26,34,-8,34,45,-11,52,67,-15,8,9,0,0
"10583","L.A","STL",2011020078,15265,20112012,1,60,5,0,5,4.09729518447421,5.09562029087101,-0.998325106396805,24,27,-3,36,44,-8,49,55,-6,4,4,0,0
"10584","L.A","DAL",2011020108,15269,20112012,1,60,1,0,1,3.16917171334353,6.02764497778844,-2.85847326444491,24,28,-4,34,46,-12,60,57,3,3,3,0,0
"10585","L.A","N.J",2011020121,15272,20112012,1,60,0,3,-3,6.36512206523912,5.41904529200313,0.946076773235987,31,23,8,47,40,7,60,50,10,1,2,0,0
"10586","L.A","DAL",2011020133,15274,20112012,0,60,5,3,2,3.42958393640242,2.77061120734137,0.65897272906105,29,33,-4,42,48,-6,67,59,8,7,6,0,0
"10587","L.A","COL",2011020155,15277,20112012,0,60,2,3,-1,5.46679172538279,3.5889024187054,1.87788930667739,32,16,16,40,29,11,51,39,12,4,4,0,0
"10588","L.A","EDM",2011020176,15281,20112012,1,60,0,3,-3,2.73862304889553,3.97329159775109,-1.23466854885555,19,27,-8,34,36,-2,56,45,11,3,5,0,0
"10589","L.A","PIT",2011020193,15283,20112012,1,65,2,2,0,5.3211810361172,7.38178340997547,-2.06060237385827,26,33,-7,45,49,-4,55,65,-10,4,6,0,0
"10590","L.A","S.J",2011020201,15285,20112012,0,60,2,4,-2,2.24300569732638,4.95457307563629,-2.71156737830991,31,38,-7,40,46,-6,64,62,2,6,6,0,0
"10591","L.A","NSH",2011020210,15286,20112012,1,60,4,3,1,4.66680709112552,2.47167951814944,2.19512757297608,30,30,0,45,40,5,54,55,-1,7,7,0,0
"10592","L.A","VAN",2011020220,15288,20112012,1,60,2,3,-1,3.78455129207578,4.63692515442247,-0.852373862346695,30,32,-2,46,41,5,59,47,12,7,5,0,0
"10593","L.A","MIN",2011020238,15290,20112012,1,60,5,2,3,5.19552314480097,3.59471177128371,1.60081137351726,36,26,10,45,36,9,61,42,19,7,6,0,0
"10594","L.A","ANA",2011020259,15294,20112012,1,65,1,1,0,7.0300446606562,4.92269112844951,2.10735353220669,37,24,13,59,42,17,74,47,27,6,4,0,0
"10595","L.A","ANA",2011020269,15295,20112012,0,60,5,3,2,4.35579038050491,6.13112709043216,-1.77533670992725,36,38,-2,49,56,-7,67,67,0,5,4,0,0
"10596","L.A","DET",2011020275,15297,20112012,1,60,1,4,-3,3.44722723925952,6.60494035088517,-3.15771311162565,24,38,-14,37,47,-10,50,54,-4,5,5,0,0
"10597","L.A","STL",2011020298,15300,20112012,0,60,3,2,1,4.00149381073015,2.96712487346515,1.034368937265,28,25,3,34,35,-1,45,52,-7,6,6,0,0
"10598","L.A","DAL",2011020309,15301,20112012,0,62.9333333333333,2,3,-1,6.42926921118396,6.5767760080338,-0.147506796849832,24,38,-14,36,54,-18,54,72,-18,3,3,0,0
"10599","L.A","CHI",2011020336,15304,20112012,1,60,1,2,-1,4.49986768065719,5.27389350930025,-0.774025828643062,27,27,0,44,42,2,57,53,4,2,2,0,0
"10600","L.A","S.J",2011020344,15306,20112012,1,60,2,0,2,5.80000739521347,6.89553951862035,-1.09553212340688,33,33,0,46,56,-10,58,75,-17,6,7,0,0
"10601","L.A","FLA",2011020364,15309,20112012,1,60,2,1,1,5.20424997492228,4.57307066197973,0.63117931294255,26,42,-16,35,59,-24,41,76,-35,3,7,0,0
"10602","L.A","MTL",2011020372,15311,20112012,1,60,1,2,-1,4.84073511592785,4.53018906343675,0.310546052491098,27,27,0,34,34,0,49,43,6,6,5,0,0
"10603","L.A","ANA",2011020400,15314,20112012,0,60,2,3,-1,5.82053224134143,3.48419768805616,2.33633455328527,39,27,12,56,40,16,70,51,19,2,2,0,0
"10604","L.A","MIN",2011020415,15316,20112012,1,60,2,4,-2,9.01093350081021,4.40364540083101,4.6072880999792,44,24,20,77,35,42,98,44,54,1,4,0,0
"10605","L.A","DAL",2011020432,15318,20112012,1,60,1,2,-1,5.18544047813447,2.67368604944204,2.51175442869243,27,28,-1,43,43,0,63,58,5,5,9,0,0
"10606","L.A","BOS",2011020436,15321,20112012,0,60,0,3,-3,3.38456494622966,2.55267858526872,0.831886360960933,41,22,19,55,38,17,80,46,34,5,3,0,0
"10607","L.A","CBJ",2011020453,15323,20112012,0,60,2,1,1,6.67854596266989,5.18015251244651,1.49839345022338,41,25,16,46,32,14,60,44,16,3,4,0,0
"10608","L.A","DET",2011020471,15325,20112012,0,60,2,8,-6,4.14939995704481,6.27270741411485,-2.12330745707004,29,27,2,42,39,3,60,49,11,4,3,0,0
"10609","L.A","TOR",2011020482,15327,20112012,0,65,2,2,0,7.65680401129748,3.06173852421439,4.59506548708309,42,33,9,64,47,17,88,61,27,6,6,0,0
"10610","L.A","ANA",2011020507,15330,20112012,1,65,2,2,0,5.65754417513381,2.75317328388337,2.90437089125044,34,22,12,50,34,16,67,41,26,5,4,0,0
"10611","L.A","S.J",2011020518,15331,20112012,0,65,1,1,0,4.36220182891944,5.26879139884841,-0.906589569928968,29,35,-6,41,52,-11,61,76,-15,4,6,0,0
"10612","L.A","CHI",2011020539,15336,20112012,0,60,2,0,2,3.59192279586568,3.75761550670404,-0.165692710838357,38,38,0,48,55,-7,64,73,-9,4,4,0,0
"10613","L.A","WPG",2011020547,15337,20112012,0,61.15,0,1,-1,5.33992581945677,5.2851316045444,0.0547942149123628,31,27,4,42,38,4,66,50,16,6,3,0,0
"10614","L.A","VAN",2011020567,15339,20112012,1,60,4,1,3,6.0571908673692,4.31381909714634,1.74337177022286,33,28,5,43,49,-6,48,58,-10,7,5,0,0
"10615","L.A","COL",2011020573,15341,20112012,1,65,1,1,0,3.39264301361982,5.64893910425599,-2.25629609063617,32,21,11,57,39,18,60,55,5,5,3,0,0
"10616","L.A","CBJ",2011020601,15346,20112012,1,60,0,1,-1,5.4761021562349,2.31426276707771,3.16183938915719,31,18,13,47,30,17,67,38,29,9,7,0,0
"10617","L.A","DAL",2011020641,15351,20112012,1,65,4,4,0,5.81086050937553,4.33923256209678,1.47162794727875,41,38,3,51,56,-5,63,67,-4,9,8,0,0
"10618","L.A","CGY",2011020657,15353,20112012,0,60,4,1,3,5.866013644958,4.78598779303138,1.08002585192662,24,30,-6,33,41,-8,48,51,-3,4,3,0,0
"10619","L.A","EDM",2011020662,15354,20112012,0,63.1,1,2,-1,2.20711042860057,5.47351165869622,-3.26640123009565,21,33,-12,32,52,-20,51,63,-12,3,3,0,0
"10620","L.A","VAN",2011020679,15356,20112012,0,65,2,2,0,6.05319256376242,6.68141268193722,-0.628220118174795,41,33,8,45,42,3,59,61,-2,2,4,0,0
"10621","L.A","CGY",2011020693,15358,20112012,1,65,1,1,0,5.81044537739217,6.00381861126516,-0.19337323387299,32,25,7,51,36,15,64,47,17,2,3,0,0
"10622","L.A","COL",2011020712,15360,20112012,1,60,1,3,-2,4.27388179364221,2.37708055996336,1.89680123367885,26,31,-5,36,44,-8,49,51,-2,3,3,0,0
"10623","L.A","OTT",2011020721,15362,20112012,1,60,4,1,3,5.52512928431679,5.10268690528756,0.422442379029235,34,28,6,49,44,5,59,54,5,5,5,0,0
"10624","L.A","CBJ",2011020753,15371,20112012,1,60,3,2,1,4.15927649952937,3.3856058466481,0.773670652881265,33,22,11,53,28,25,66,34,32,3,3,0,0
"10625","L.A","STL",2011020764,15373,20112012,0,60,0,1,-1,4.23614563291942,4.89267429565371,-0.656528662734289,22,33,-11,36,47,-11,51,61,-10,1,1,0,0
"10626","L.A","CAR",2011020773,15374,20112012,0,60,1,2,-1,6.52309862028266,4.14669009448691,2.37640852579575,25,22,3,35,31,4,59,45,14,2,3,0,0
"10627","L.A","T.B",2011020792,15377,20112012,0,60,3,1,2,2.00203091394366,3.00983632646967,-1.00780541252601,20,25,-5,33,42,-9,45,56,-11,2,3,0,0
"10628","L.A","FLA",2011020808,15379,20112012,0,60,1,3,-2,3.43106500727299,3.43681084869657,-0.00574584142357892,23,23,0,35,31,4,53,35,18,2,2,0,0
"10629","L.A","NYI",2011020818,15381,20112012,0,61.6,1,2,-1,4.72808231348781,2.85268547755338,1.87539683593443,35,25,10,46,35,11,68,46,22,2,2,0,0
"10630","L.A","DAL",2011020831,15382,20112012,0,60,4,2,2,3.57262465483005,3.56224675719242,0.0103778976376248,16,28,-12,24,40,-16,34,53,-19,4,5,0,0
"10631","L.A","ARI",2011020857,15386,20112012,1,60,0,1,-1,5.74410589687735,1.86458136324654,3.87952453363081,28,21,7,53,35,18,63,42,21,4,7,0,0
"10632","L.A","CGY",2011020872,15388,20112012,1,60,0,1,-1,3.65530175564345,1.54344974120613,2.11185201443732,28,18,10,45,25,20,62,35,27,3,1,0,0
"10633","L.A","ARI",2011020895,15391,20112012,0,65,4,4,0,4.73214377806289,4.21389848412582,0.518245293937071,29,29,0,44,40,4,58,46,12,4,5,0,0
"10634","L.A","COL",2011020898,15392,20112012,0,60,1,4,-3,4.5777162509039,3.2735839415716,1.3041323093323,33,27,6,46,33,13,60,48,12,4,2,0,0
"10635","L.A","CHI",2011020917,15395,20112012,1,60,4,0,4,5.24971334149086,4.22047292153002,1.02924041996084,30,19,11,41,31,10,51,44,7,3,6,0,0
"10636","L.A","NSH",2011020933,15397,20112012,0,60,1,2,-1,7.9960854633191,5.52796302567003,2.46812243764907,31,28,3,52,34,18,69,43,26,1,1,0,0
"10637","L.A","MIN",2011020943,15398,20112012,0,60,4,0,4,5.09280076139839,4.49905400245916,0.593746758939233,15,26,-11,30,36,-6,44,47,-3,4,4,0,0
"10638","L.A","ANA",2011020972,15402,20112012,1,60,4,2,2,0,0,0,20,31,-11,40,41,-1,50,50,0,4,4,0,0
"10639","L.A","NSH",2011020991,15405,20112012,0,60,5,4,1,5.75313722087502,2.93391951115336,2.81921770972166,28,26,2,39,36,3,48,46,2,2,4,0,0
"10640","L.A","CBJ",2011021002,15407,20112012,0,60,1,3,-2,5.93516342267264,4.29048540419899,1.64467801847366,30,36,-6,46,47,-1,69,60,9,2,6,0,0
"10641","L.A","DET",2011021011,15408,20112012,0,60,3,4,-1,4.59960348403547,5.17612977593427,-0.576526291898801,24,15,9,32,28,4,41,37,4,4,3,0,0
"10642","L.A","CHI",2011021031,15410,20112012,0,65,2,2,0,3.53764319491893,5.34109414218983,-1.8034509472709,29,37,-8,46,47,-1,60,67,-7,2,3,0,0
"10643","L.A","DET",2011021045,15412,20112012,1,60,5,2,3,2.48754860219196,4.5531399527099,-2.06559135051793,27,24,3,36,38,-2,43,48,-5,2,4,0,0
"10644","L.A","ANA",2011021064,15415,20112012,0,60,4,2,2,6.64393295256082,4.51096554280031,2.13296740976051,43,20,23,59,36,23,77,48,29,4,4,0,0
"10645","L.A","NSH",2011021074,15416,20112012,1,60,4,2,2,2.42831497310544,3.61095764732454,-1.1826426742191,27,21,6,37,30,7,48,38,10,3,3,0,0
"10646","L.A","S.J",2011021096,15419,20112012,1,60,5,2,3,7.06982496706769,3.40744480328931,3.66238016377838,42,22,20,56,31,25,71,44,27,4,2,0,0
"10647","L.A","STL",2011021108,15421,20112012,1,65,0,0,0,5.69616248487728,8.96607235918648,-3.2699098743092,37,35,2,54,56,-2,68,68,0,2,3,0,0
"10648","L.A","BOS",2011021117,15423,20112012,1,60,2,4,-2,6.70903717523834,4.32319600625124,2.3858411689871,42,26,16,58,36,22,68,47,21,4,1,0,0
"10649","L.A","VAN",2011021138,15425,20112012,0,60,0,1,-1,5.18252263554314,4.7167378087175,0.465784826825633,38,25,13,47,40,7,65,49,16,3,4,0,0
"10650","L.A","CGY",2011021150,15427,20112012,0,60,3,0,3,3.81545872716379,1.55115559324622,2.26430313391756,30,19,11,42,23,19,55,44,11,5,5,0,0
"10651","L.A","EDM",2011021167,15429,20112012,0,60,4,1,3,6.27223433286417,1.6566362066078,4.61559812625637,32,14,18,51,26,25,76,34,42,8,5,0,0
"10652","L.A","MIN",2011021177,15430,20112012,0,65,3,3,0,6.88876175855114,4.09428079414647,2.79448096440467,29,23,6,49,35,14,69,43,26,4,3,0,0
"10653","L.A","EDM",2011021188,15432,20112012,1,60,2,0,2,4.97150126269844,2.87909987138119,2.09240139131725,37,19,18,56,28,28,73,37,36,4,2,0,0
"10654","L.A","S.J",2011021214,15435,20112012,1,65,5,5,0,7.11829872637802,3.61572520799136,3.50257351838666,36,31,5,51,41,10,70,54,16,8,6,0,0
"10655","L.A","S.J",2011021230,15437,20112012,0,63.9666666666667,2,3,-1,5.26326556020649,3.27479738747934,1.98846817272715,31,23,8,42,39,3,66,51,15,3,5,0,0
"10656","L.A","VAN",2011030151,15441,20112012,0,60,4,2,2,3.62350370726301,2.17479386655759,1.44870984070542,39,26,13,45,34,11,63,53,10,6,5,0,0
"10657","L.A","VAN",2011030152,15443,20112012,0,60,4,2,2,3.46733129714266,4.74620286700818,-1.27887156986552,26,48,-22,35,57,-22,45,77,-32,6,7,0,0
"10658","L.A","VAN",2011030153,15445,20112012,1,60,1,0,1,4.33557848871018,7.12614074535668,-2.7905622566465,20,41,-21,34,59,-25,48,82,-34,8,4,0,0
"10659","L.A","VAN",2011030154,15448,20112012,1,60,1,3,-2,5.77785110756076,5.322299060761,0.455552046799767,44,30,14,57,41,16,72,55,17,4,4,0,0
"10660","L.A","VAN",2011030155,15452,20112012,0,64.45,2,1,1,6.132432083803,5.88688128214198,0.245550801661016,37,27,10,54,40,14,74,59,15,3,4,0,0
"10661","L.A","STL",2011030231,15458,20112012,0,60,3,1,2,4.85649847865193,5.40185669857237,-0.545358219920445,29,29,0,43,37,6,66,49,17,4,3,0,0
"10662","L.A","STL",2011030232,15460,20112012,0,60,5,2,3,2.23248749220056,3.13860985629981,-0.906122364099247,21,29,-8,31,38,-7,44,50,-6,11,14,0,0
"10663","L.A","STL",2011030233,15463,20112012,1,60,4,2,2,4.69924710912164,4.7094658185124,-0.010218709390756,22,20,2,46,37,9,57,47,10,5,2,0,0
"10664","L.A","STL",2011030234,15466,20112012,1,60,3,1,2,3.18118178419536,6.88010826951358,-3.69892648531822,19,24,-5,30,35,-5,41,40,1,5,5,0,0
"10665","L.A","ARI",2011030321,15473,20112012,0,60,4,2,2,6.26631209135399,3.18503939418588,3.08127269716811,48,27,21,65,35,30,90,46,44,4,5,0,0
"10666","L.A","ARI",2011030322,15475,20112012,0,60,4,0,4,4.69257735111751,1.42602100387504,3.26655634724246,40,24,16,51,35,16,60,48,12,8,7,0,0
"10667","L.A","ARI",2011030323,15477,20112012,1,60,2,1,1,6.19256101786101,2.71333549248356,3.47922552537745,28,19,9,45,32,13,57,43,14,6,2,0,0
"10668","L.A","ARI",2011030324,15480,20112012,1,60,0,2,-2,6.89019644989489,3.81159986900457,3.07859658089032,36,21,15,64,34,30,76,44,32,8,5,0,0
"10669","L.A","ARI",2011030325,15482,20112012,0,77.7,4,3,1,9.76159840727333,5.1548660616827,4.60673234559063,51,41,10,66,52,14,91,70,21,4,6,0,0
"10670","L.A","N.J",2011030411,15490,20112012,0,68.2166666666667,2,1,1,4.17683845903457,4.66039753044697,-0.483559071412401,25,17,8,39,28,11,54,34,20,1,2,0,0
"10671","L.A","N.J",2011030412,15493,20112012,0,73.7,2,1,1,3.81651704792239,6.97372424738978,-3.15720719946739,32,33,-1,40,48,-8,53,67,-14,2,4,0,0
"10672","L.A","N.J",2011030413,15495,20112012,1,60,4,0,4,3.48704539852966,7.35854728348204,-3.87150188495238,21,22,-1,31,43,-12,42,60,-18,3,5,0,0
"10673","L.A","N.J",2011030414,15497,20112012,1,60,1,3,-2,3.10413739632349,2.77451528242091,0.329622113902587,22,24,-2,45,34,11,58,45,13,4,3,0,0
"10674","L.A","N.J",2011030415,15500,20112012,0,60,1,2,-1,2.96564984202269,2.97681292926205,-0.0111630872393604,26,19,7,40,25,15,60,38,22,3,3,0,0
"10675","L.A","N.J",2011030416,15502,20112012,1,60,6,1,5,6.32742497826359,4.65786792301803,1.66955705524556,25,18,7,41,29,12,57,38,19,5,3,0,0
"10676","L.A","CHI",2012020003,15724,20122013,1,60,2,5,-3,4.67752164578997,4.06191132750246,0.615610318287509,21,22,-1,35,35,0,50,42,8,5,5,0,0
"10677","L.A","COL",2012020034,15727,20122013,0,60,1,3,-2,3.35679949383757,5.50323076150369,-2.14643126766612,29,31,-2,44,42,2,68,50,18,7,5,0,0
"10678","L.A","EDM",2012020048,15729,20122013,0,63.0166666666667,1,2,-1,4.19192051889327,5.54645810936126,-1.35453759046799,31,39,-8,46,52,-6,65,68,-3,9,9,0,0
"10679","L.A","ARI",2012020062,15731,20122013,0,60,4,2,2,4.61555601150576,5.27327135899395,-0.657715347488192,31,33,-2,42,47,-5,57,59,-2,4,6,0,0
"10680","L.A","VAN",2012020077,15733,20122013,1,65,2,2,0,5.18593619932653,2.72321305966034,2.4627231396662,28,23,5,42,29,13,62,38,24,4,3,0,0
"10681","L.A","NSH",2012020099,15736,20122013,1,65,1,1,0,4.50125162419863,2.9320808032644,1.56917082093423,24,14,10,43,23,20,67,31,36,6,3,0,0
"10682","L.A","ANA",2012020117,15738,20122013,0,60,4,7,-3,6.4814087592531,3.47406458173646,3.00734417751664,34,25,9,56,33,23,74,40,34,4,4,0,0
"10683","L.A","CBJ",2012020131,15741,20122013,0,60,4,2,2,4.24213204917032,1.82684350203331,2.41528854713701,31,20,11,43,25,18,54,37,17,2,4,0,0
"10684","L.A","NSH",2012020150,15743,20122013,0,60,0,3,-3,6.5387399099709,1.64197251130827,4.89676739866263,32,14,18,43,18,25,62,23,39,3,3,0,0
"10685","L.A","DET",2012020166,15746,20122013,0,60,2,3,-1,4.94290823818301,3.68513143190666,1.25777680627635,47,31,16,59,37,22,68,44,24,3,4,0,0
"10686","L.A","STL",2012020175,15747,20122013,0,60,4,1,3,2.76010552941794,3.25706237660415,-0.496956847186216,23,22,1,30,34,-4,41,43,-2,6,6,0,0
"10687","L.A","CBJ",2012020204,15751,20122013,1,60,2,1,1,3.33141281032295,1.44327936181799,1.88813344850496,22,13,9,33,19,14,41,31,10,5,4,0,0
"10688","L.A","CHI",2012020213,15753,20122013,0,60,2,3,-1,3.85320366203496,5.0264853892877,-1.17328172725274,27,37,-10,30,48,-18,54,62,-8,5,6,0,0
"10689","L.A","EDM",2012020233,15755,20122013,0,60,3,1,2,4.79478394379839,3.5190185259562,1.27576541784219,38,24,14,53,34,19,69,42,27,2,4,0,0
"10690","L.A","CGY",2012020236,15756,20122013,0,60,3,1,2,2.70295696475659,3.00762056748499,-0.304663602728397,33,27,6,43,39,4,61,49,12,3,6,0,0
"10691","L.A","COL",2012020253,15759,20122013,1,60,4,1,3,2.54350027680812,3.56847882363945,-1.02497854683133,26,24,2,41,34,7,52,38,14,3,5,0,0
"10692","L.A","ANA",2012020274,15761,20122013,1,60,5,2,3,6.8746272646822,4.00156805824372,2.87305920643848,25,26,-1,43,38,5,62,48,14,2,3,0,0
"10693","L.A","DET",2012020287,15763,20122013,1,60,2,1,1,5.87431605090387,4.43651414051419,1.43780191038968,29,33,-4,42,48,-6,50,60,-10,5,3,0,0
"10694","L.A","VAN",2012020309,15766,20122013,0,60,2,5,-3,3.2468716354058,3.23884145471607,0.00803018068973316,30,24,6,34,34,0,47,48,-1,5,3,0,0
"10695","L.A","NSH",2012020323,15768,20122013,1,60,5,1,4,2.66768381285169,3.0819978652471,-0.414314052395412,16,19,-3,33,28,5,47,35,12,4,3,0,0
"10696","L.A","STL",2012020334,15769,20122013,1,60,6,4,2,5.05259896865027,3.1323608814273,1.92023808722297,29,14,15,40,20,20,55,30,25,7,5,0,0
"10697","L.A","DAL",2012020349,15771,20122013,1,60,2,5,-3,5.51993030248237,4.75072621530853,0.769204087173836,33,22,11,46,33,13,56,41,15,1,3,0,0
"10698","L.A","CGY",2012020364,15773,20122013,1,60,6,2,4,6.05272403791605,2.64326206393889,3.40946197397716,24,19,5,39,31,8,53,41,12,1,4,0,0
"10699","L.A","CGY",2012020376,15775,20122013,1,60,3,1,2,7.14433244569227,2.67679062479874,4.46754182089353,22,24,-2,33,39,-6,41,54,-13,1,4,0,0
"10700","L.A","ARI",2012020387,15776,20122013,0,60,2,5,-3,4.09118982482509,1.55308952549967,2.53810029932542,33,29,4,41,35,6,66,44,22,5,3,0,0
"10701","L.A","S.J",2012020401,15778,20122013,0,60,3,4,-1,7.75563320095534,4.16342732612247,3.59220587483287,37,26,11,44,40,4,68,55,13,3,3,0,0
"10702","L.A","S.J",2012020417,15780,20122013,1,60,5,2,3,4.56205926633652,4.4478940482004,0.114165218136126,24,22,2,41,37,4,56,57,-1,1,2,0,0
"10703","L.A","ARI",2012020428,15782,20122013,1,60,4,0,4,5.0541051073385,4.06459803692285,0.989507070415653,29,27,2,44,44,0,56,57,-1,7,5,0,0
"10704","L.A","ARI",2012020437,15783,20122013,1,60,3,2,1,2.08525267655205,5.97555511214091,-3.89030243558886,29,42,-13,42,55,-13,52,70,-18,6,5,0,0
"10705","L.A","DAL",2012020451,15785,20122013,1,60,0,2,-2,5.26535690648598,3.93038147551124,1.33497543097474,40,21,19,59,31,28,69,44,25,3,2,0,0
"10706","L.A","VAN",2012020458,15787,20122013,1,60,0,1,-1,4.15779877165755,3.7852687802224,0.372529991435158,20,13,7,35,21,14,45,27,18,3,3,0,0
"10707","L.A","CHI",2012020474,15789,20122013,0,60,5,4,1,4.51762409138553,2.82856582419822,1.68905826718731,36,25,11,42,32,10,50,41,9,2,3,0,0
"10708","L.A","STL",2012020497,15792,20122013,0,60,4,2,2,4.80099737562256,2.70315345673225,2.09784391889031,40,22,18,56,30,26,74,42,32,4,3,0,0
"10709","L.A","MIN",2012020510,15794,20122013,0,65,3,3,0,7.23263894217416,5.59887305070879,1.63376589146537,31,28,3,46,41,5,59,54,5,2,4,0,0
"10710","L.A","DAL",2012020520,15795,20122013,0,60,3,2,1,5.5508465813673,2.58282257278915,2.96802400857814,40,15,25,49,35,14,65,51,14,1,2,0,0
"10711","L.A","ARI",2012020537,15797,20122013,0,60,1,3,-2,7.31727131869957,6.5167544175772,0.800516901122364,40,31,9,52,45,7,65,54,11,3,3,0,0
"10712","L.A","MIN",2012020552,15799,20122013,1,60,3,0,3,1.7394457818009,3.46410830691457,-1.72466252511367,14,23,-9,28,30,-2,37,39,-2,2,1,0,0
"10713","L.A","EDM",2012020561,15801,20122013,1,60,4,1,3,9.07385162683022,5.59479991330795,3.47905171352227,39,24,15,50,36,14,66,47,19,5,4,0,0
"10714","L.A","ANA",2012020576,15802,20122013,0,65,3,3,0,9.15224517813141,3.51256701267266,5.63967816545875,38,22,16,51,30,21,74,36,38,3,5,0,0
"10715","L.A","DAL",2012020590,15804,20122013,0,60,1,5,-4,6.13309215072405,5.80874684116307,0.324345309560975,30,31,-1,52,41,11,70,55,15,6,4,0,0
"10716","L.A","COL",2012020604,15806,20122013,1,65,2,2,0,5.85530797709134,2.30877171223983,3.54653626485151,37,28,9,54,39,15,71,46,25,4,2,0,0
"10717","L.A","ANA",2012020620,15808,20122013,1,60,2,1,1,3.54450886457926,4.60509611835715,-1.06058725377789,18,20,-2,40,32,8,57,38,19,5,1,0,0
"10718","L.A","S.J",2012020639,15811,20122013,0,65,2,2,0,6.63839059803286,4.26348349901312,2.37490709901974,43,35,8,53,47,6,68,68,0,5,5,0,0
"10719","L.A","CBJ",2012020652,15813,20122013,1,60,2,1,1,3.47479630704038,3.55742206785362,-0.0826257608132437,23,21,2,36,30,6,45,47,-2,4,4,0,0
"10720","L.A","DAL",2012020675,15816,20122013,1,64.1333333333333,4,3,1,6.64858942705964,3.26517466077105,3.38341476628859,31,27,4,64,42,22,83,49,34,8,6,0,0
"10721","L.A","MIN",2012020688,15818,20122013,0,60,1,2,-1,5.37931925838348,4.26839143346755,1.11092782491593,23,25,-2,35,41,-6,46,46,0,1,1,0,0
"10722","L.A","DET",2012020691,15819,20122013,0,60,1,3,-2,2.90994277852587,5.40430966505164,-2.49436688652577,24,36,-12,33,52,-19,38,64,-26,3,4,0,0
"10723","L.A","S.J",2012020720,15822,20122013,1,60,3,2,1,5.0181817607081,3.4585928596789,1.5595889010292,27,25,2,47,33,14,61,45,16,1,0,0,0
"10724","L.A","STL",2012030181,15825,20122013,0,73.4333333333333,1,2,-1,6.15558575609439,5.85763605417378,0.297949701920608,29,42,-13,43,66,-23,61,83,-22,3,6,0,0
"10725","L.A","STL",2012030182,15827,20122013,0,60,1,2,-1,4.5645831945294,5.46513458262007,-0.900551388090662,29,25,4,35,37,-2,42,48,-6,4,4,0,0
"10726","L.A","STL",2012030183,15829,20122013,1,60,1,0,1,4.4266294527115,4.1700227128706,0.25660673984089,21,30,-9,40,46,-6,54,56,-2,5,5,0,0
"10727","L.A","STL",2012030184,15831,20122013,1,60,4,3,1,5.33483911433723,3.85527331801131,1.47956579632591,29,22,7,52,32,20,71,37,34,4,4,0,0
"10728","L.A","STL",2012030185,15833,20122013,0,68,3,2,1,6.59418877714779,8.86660870545893,-2.27241992831114,25,36,-11,43,54,-11,57,75,-18,2,1,0,0
"10729","L.A","STL",2012030186,15835,20122013,1,60,2,1,1,2.91889834476751,4.35680734671769,-1.43790900195017,16,22,-6,24,43,-19,29,52,-23,1,1,0,0
"10730","L.A","S.J",2012030241,15839,20122013,1,60,2,0,2,4.45415332744597,5.59559524749056,-1.1414419200446,20,35,-15,37,55,-18,47,69,-22,1,3,0,0
"10731","L.A","S.J",2012030242,15841,20122013,1,60,4,3,1,6.39394093924511,5.09932584661874,1.29461509262637,31,31,0,46,41,5,61,51,10,6,4,0,0
"10732","L.A","S.J",2012030243,15843,20122013,0,61.4833333333333,1,2,-1,5.61731538164895,6.0692993629109,-0.451983981261947,27,40,-13,41,55,-14,64,81,-17,3,6,0,0
"10733","L.A","S.J",2012030244,15846,20122013,0,60,1,2,-1,3.85485324085539,3.13704345266888,0.717809788186514,23,23,0,36,39,-3,61,56,5,3,4,0,0
"10734","L.A","S.J",2012030245,15848,20122013,1,60,3,0,3,4.68854471595068,2.04806484638539,2.6404798695653,29,24,5,48,36,12,67,45,22,3,3,0,0
"10735","L.A","S.J",2012030246,15851,20122013,0,60,1,2,-1,3.37047547663678,3.30329493797035,0.0671805386664346,25,26,-1,36,37,-1,56,50,6,2,4,0,0
"10736","L.A","S.J",2012030247,15853,20122013,1,60,2,1,1,6.842466450762,3.45938146751723,3.38308498324477,18,26,-8,30,39,-9,41,55,-14,4,3,0,0
"10737","L.A","CHI",2012030321,15857,20122013,0,60,1,2,-1,2.61143746883169,3.43300145894386,-0.821563990112173,22,36,-14,29,47,-18,38,58,-20,2,4,0,0
"10738","L.A","CHI",2012030322,15858,20122013,0,60,2,4,-2,2.37434108686284,3.0040891359115,-0.629748049048658,31,26,5,45,31,14,58,41,17,7,4,0,0
"10739","L.A","CHI",2012030323,15860,20122013,1,60,3,1,2,4.43523600214394,2.49657368197222,1.93866232017172,28,20,8,45,30,15,60,42,18,5,3,0,0
"10740","L.A","CHI",2012030324,15862,20122013,1,60,2,3,-1,5.72557884655488,3.02316720292175,2.70241164363313,21,28,-7,31,38,-7,42,45,-3,3,4,0,0
"10741","L.A","CHI",2012030325,15864,20122013,0,80,3,3,0,4.96936925326008,2.7647221662337,2.20464708702639,34,30,4,51,45,6,69,60,9,2,2,0,0
"10742","L.A","MIN",2013020011,15981,20132014,0,65,2,2,0,1.99130048963889,2.87965164463489,-0.888351154996006,18,29,-11,26,34,-8,46,48,-2,3,5,0,0
"10743","L.A","WPG",2013020019,15982,20132014,0,60,3,5,-2,6.94796021885874,6.68948203608488,0.258478182773857,36,33,3,52,45,7,67,59,8,5,6,0,0
"10744","L.A","NYR",2013020036,15985,20132014,1,60,1,3,-2,4.35387744457012,4.15898684079548,0.194890603774638,29,28,1,44,44,0,60,56,4,3,5,0,0
"10745","L.A","OTT",2013020047,15987,20132014,1,60.4666666666667,4,3,1,6.13811155659027,4.87993051798003,1.25818103861025,32,25,7,52,39,13,66,52,14,7,5,0,0
"10746","L.A","CAR",2013020059,15989,20132014,0,65,1,1,0,4.58535519790557,3.72554664825077,0.859808549654804,37,28,9,58,43,15,70,66,4,3,5,0,0
"10747","L.A","FLA",2013020076,15991,20132014,0,60,3,0,3,5.65547330911707,3.18595744372578,2.46951586539129,29,20,9,39,27,12,54,32,22,1,2,0,0
"10748","L.A","T.B",2013020088,15993,20132014,0,60,1,5,-4,4.29505662793423,5.19692723933986,-0.901870611405627,31,25,6,49,33,16,66,46,20,5,3,0,0
"10749","L.A","NSH",2013020105,15995,20132014,0,65,1,1,0,5.55295375032105,2.72036570264027,2.83258804768079,30,35,-5,39,45,-6,56,61,-5,4,4,0,0
"10750","L.A","DAL",2013020122,15997,20132014,1,60,5,2,3,5.23968806033372,3.49335209542187,1.74633596491185,34,29,5,52,44,8,70,50,20,4,6,0,0
"10751","L.A","CGY",2013020128,15999,20132014,1,60,2,3,-1,5.12709606949487,4.52101380609383,0.606082263401039,29,25,4,41,38,3,58,47,11,3,6,0,0
"10752","L.A","ARI",2013020148,16002,20132014,1,60,7,4,3,6.73471189922566,5.19427668239179,1.54043521683387,38,28,10,50,38,12,59,51,8,5,4,0,0
"10753","L.A","EDM",2013020170,16005,20132014,1,65,1,1,0,6.10332701988395,3.14059358208033,2.96273343780362,48,18,30,61,25,36,79,32,47,5,5,0,0
"10754","L.A","ARI",2013020183,16007,20132014,0,60,1,3,-2,7.72812818579315,5.29801593393495,2.4301122518582,42,33,9,58,42,16,76,56,20,5,7,0,0
"10755","L.A","S.J",2013020187,16008,20132014,1,62.5333333333333,4,3,1,6.29022686200743,2.83362323197071,3.45660363003673,23,20,3,46,32,14,63,39,24,6,4,0,0
"10756","L.A","NSH",2013020200,16011,20132014,1,60,3,4,-1,7.95475142737268,3.40025699371472,4.55449443365796,38,17,21,56,27,29,78,35,43,4,4,0,0
"10757","L.A","VAN",2013020254,16018,20132014,1,60,5,1,4,5.72217784557142,2.90766129997729,2.81451654559413,32,26,6,44,40,4,59,49,10,4,2,0,0
"10758","L.A","NYI",2013020278,16023,20132014,0,60,3,2,1,3.91469461995918,3.29327507978087,0.621419540178306,24,25,-1,33,36,-3,48,47,1,3,4,0,0
"10759","L.A","N.J",2013020285,16024,20132014,0,60,2,0,2,2.70535516095861,4.84083422250241,-2.1354790615438,21,26,-5,27,35,-8,40,44,-4,2,3,0,0
"10760","L.A","NYR",2013020305,16026,20132014,0,60,1,0,1,2.19848805756943,5.30388051867669,-3.10539246110726,30,37,-7,43,48,-5,61,63,-2,1,5,0,0
"10761","L.A","T.B",2013020321,16028,20132014,1,60,5,2,3,7.93465755721627,5.52665758956573,2.40799996765054,31,21,10,49,32,17,57,36,21,4,3,0,0
"10762","L.A","N.J",2013020334,16030,20132014,1,62.5,1,2,-1,4.22522215081608,3.7843604433001,0.440861707515978,35,15,20,56,29,27,76,38,38,5,3,0,0
"10763","L.A","COL",2013020351,16032,20132014,1,62.5333333333333,0,1,-1,3.74034012900665,5.23997051321203,-1.49963038420537,19,33,-14,29,44,-15,44,50,-6,3,3,0,0
"10764","L.A","VAN",2013020363,16034,20132014,0,60.8,3,2,1,3.53257589560235,5.08991952572251,-1.55734363012016,22,39,-17,29,52,-23,42,71,-29,5,10,0,0
"10765","L.A","S.J",2013020377,16036,20132014,0,65,2,2,0,5.74460140586284,9.23678910925049,-3.49218770338765,40,40,0,51,62,-11,73,78,-5,4,4,0,0
"10766","L.A","CGY",2013020401,16039,20132014,1,60,1,2,-1,2.56502232548075,8.45769949466921,-5.89267716918846,22,20,2,37,35,2,56,43,13,4,7,0,0
"10767","L.A","STL",2013020409,16041,20132014,1,60,3,2,1,2.91649625045829,5.87613399664406,-2.95963774618576,23,27,-4,33,41,-8,44,47,-3,3,4,0,0
"10768","L.A","ANA",2013020418,16042,20132014,0,65,2,2,0,6.3306289728207,4.58717456675367,1.74345440606703,51,28,23,75,40,35,103,53,50,6,7,0,0
"10769","L.A","NYI",2013020448,16046,20132014,1,60,3,0,3,5.73164681084199,1.90254851080681,3.82909830003518,24,16,8,36,24,12,51,34,17,8,7,0,0
"10770","L.A","MTL",2013020461,16049,20132014,0,60,6,0,6,5.18733488135279,4.97199048567563,0.215344395677157,30,31,-1,43,47,-4,62,63,-1,3,5,0,0
"10771","L.A","TOR",2013020470,16050,20132014,0,60,3,1,2,4.95937112408907,4.44781838688072,0.511552737208349,23,39,-16,33,49,-16,49,69,-20,4,5,0,0
"10772","L.A","OTT",2013020488,16053,20132014,0,60,5,2,3,3.18296320811271,6.08494737397996,-2.90198416586725,26,39,-13,34,51,-17,48,65,-17,4,5,0,0
"10773","L.A","CHI",2013020503,16054,20132014,0,60,1,3,-2,3.40188413245542,4.07847470446359,-0.676590572008166,22,40,-18,28,49,-21,39,56,-17,3,3,0,0
"10774","L.A","EDM",2013020520,16056,20132014,1,60,3,0,3,9.34949067869456,3.24243262474192,6.10705805395264,40,24,16,64,36,28,71,52,19,2,2,0,0
"10775","L.A","S.J",2013020533,16058,20132014,1,60,4,1,3,5.41310629882355,4.26278788157754,1.15031841724601,32,32,0,46,48,-2,59,57,2,2,3,0,0
"10776","L.A","COL",2013020540,16060,20132014,1,65,2,2,0,7.08089200541144,8.32225579387159,-1.24136378846015,39,25,14,59,43,16,72,57,15,2,4,0,0
"10777","L.A","DAL",2013020565,16062,20132014,1,60,2,5,-3,7.24707413059617,4.96468860073946,2.2823855298567,32,24,8,56,35,21,68,46,22,2,4,0,0
"10778","L.A","NSH",2013020582,16067,20132014,0,60,2,3,-1,2.31831001353692,5.34446298889816,-3.02615297536124,28,31,-3,41,42,-1,60,51,9,2,5,0,0
"10779","L.A","CHI",2013020596,16069,20132014,0,60,0,1,-1,4.55149797163904,1.71321298729754,2.8382849843415,26,30,-4,36,37,-1,49,45,4,3,3,0,0
"10780","L.A","DAL",2013020605,16070,20132014,0,60,2,3,-1,3.68569627625402,4.26736016469658,-0.581663888442563,25,32,-7,46,44,2,63,58,5,3,6,0,0
"10781","L.A","STL",2013020616,16072,20132014,0,60,0,5,-5,4.82011982275631,4.38379653580603,0.436323286950284,30,26,4,46,34,12,70,42,28,6,4,0,0
"10782","L.A","VAN",2013020637,16074,20132014,1,60,3,1,2,5.81603496548472,4.3208134612521,1.49522150423262,49,28,21,61,39,22,74,48,26,3,4,0,0
"10783","L.A","MIN",2013020656,16077,20132014,1,65,1,1,0,4.55892403813777,5.06250133970752,-0.503577301569749,40,17,23,61,26,35,82,39,43,2,2,0,0
"10784","L.A","BOS",2013020667,16079,20132014,1,60,4,2,2,4.79702218517195,3.32406975834806,1.47295242682389,35,22,13,47,37,10,60,45,15,6,3,0,0
"10785","L.A","DET",2013020683,16081,20132014,1,60,1,3,-2,6.9449162781566,4.03037513064919,2.91454114750741,45,26,19,66,37,29,83,44,39,5,5,0,0
"10786","L.A","VAN",2013020695,16083,20132014,1,60,1,0,1,4.10852988495026,2.71866844969588,1.38986143525437,20,28,-8,31,35,-4,46,44,2,7,5,0,0
"10787","L.A","STL",2013020715,16086,20132014,0,60,4,1,3,4.31647568603512,3.97162828331624,0.344847402718881,31,29,2,39,41,-2,51,51,0,9,8,0,0
"10788","L.A","DET",2013020728,16088,20132014,0,65,2,2,0,4.19543908315245,3.53827503183857,0.657164051313885,32,35,-3,39,50,-11,51,67,-16,6,5,0,0
"10789","L.A","BOS",2013020739,16090,20132014,0,60,2,3,-1,2.75981739145936,2.58386892534327,0.175948466116097,23,23,0,37,32,5,53,43,10,5,5,0,0
"10790","L.A","CBJ",2013020751,16091,20132014,0,60,3,5,-2,2.89943378207501,3.12697331166999,-0.227539529594971,29,34,-5,36,44,-8,54,53,1,3,3,0,0
"10791","L.A","ANA",2013020767,16093,20132014,0,60,1,2,-1,5.94468212073434,2.75608278151743,3.18859933921691,31,21,10,49,31,18,61,38,23,4,5,0,0
"10792","L.A","ANA",2013020782,16095,20132014,1,60,0,3,-3,5.44808945532714,4.00181182186692,1.44627763346022,36,21,15,53,32,21,70,34,36,5,4,0,0
"10793","L.A","S.J",2013020794,16097,20132014,0,60,1,0,1,5.88711434967523,2.34097642259439,3.54613792708083,21,23,-2,33,31,2,55,55,0,6,5,0,0
"10794","L.A","ARI",2013020804,16098,20132014,0,60,0,3,-3,8.39431022340432,5.81522667572744,2.57908354767687,30,29,1,47,42,5,56,58,-2,3,4,0,0
"10795","L.A","PHI",2013020827,16102,20132014,1,60,0,2,-2,4.44928328677634,1.6973893652621,2.75189392151424,35,13,22,49,19,30,69,27,42,3,2,0,0
"10796","L.A","CHI",2013020842,16104,20132014,1,60,3,5,-2,4.28814941813471,5.7589747980237,-1.47082537988899,34,30,4,52,45,7,61,56,5,4,5,0,0
"10797","L.A","CBJ",2013020866,16107,20132014,1,62.55,2,1,1,3.9148683451549,2.19462808117012,1.72024026398478,20,25,-5,40,41,-1,54,50,4,6,6,0,0
"10798","L.A","COL",2013020884,16127,20132014,0,60,6,4,2,0,0,0,28,29,-1,36,44,-8,51,59,-8,3,5,0,0
"10799","L.A","CGY",2013020896,16128,20132014,0,60,2,0,2,1.74852946238406,4.09994927560911,-2.35141981322505,24,25,-1,31,39,-8,40,55,-15,3,6,0,0
"10800","L.A","CAR",2013020908,16130,20132014,1,60,3,1,2,7.07286157651137,4.15934206204838,2.91351951446299,31,25,6,53,38,15,62,41,21,7,4,0,0
"10801","L.A","MTL",2013020923,16132,20132014,1,60,2,1,1,4.08382106088243,3.13121059870173,0.952610462180701,22,18,4,40,31,9,56,36,20,4,3,0,0
"10802","L.A","WPG",2013020939,16135,20132014,0,60,3,1,2,6.93322704206184,2.48328005573057,4.44994698633127,41,18,23,55,30,25,78,46,32,4,1,0,0
"10803","L.A","EDM",2013020967,16138,20132014,0,60,4,2,2,4.66105313244327,4.19361685391414,0.467436278529135,50,27,23,64,39,25,78,56,22,4,4,0,0
"10804","L.A","CGY",2013020973,16139,20132014,0,60,3,2,1,2.49673932926089,1.91239090947056,0.584348419790331,23,26,-3,35,32,3,51,49,2,2,3,0,0
"10805","L.A","TOR",2013020995,16142,20132014,1,60,2,3,-1,8.30773795695859,2.58075179519801,5.72698616176058,41,29,12,67,37,30,83,43,40,4,3,0,0
"10806","L.A","ANA",2013021012,16144,20132014,1,60,1,2,-1,4.67747243574559,4.13871665577608,0.538755779969506,38,20,18,51,34,17,68,40,28,4,4,0,0
"10807","L.A","ARI",2013021025,16146,20132014,1,60,3,4,-1,6.65101091703752,3.5897908732295,3.06122004380802,39,27,12,52,35,17,65,43,22,4,4,0,0
"10808","L.A","FLA",2013021059,16151,20132014,1,60,4,0,4,6.61262677540071,3.09984384832637,3.51278292707434,29,24,5,43,41,2,56,48,8,3,2,0,0
"10809","L.A","PHI",2013021074,16153,20132014,0,60,3,2,1,5.68905763675113,7.75252157683585,-2.06346394008471,41,32,9,52,47,5,65,68,-3,5,5,0,0
"10810","L.A","WPG",2013021118,16158,20132014,1,60,4,2,2,4.23030730940809,3.52603973279929,0.7042675766088,29,26,3,45,45,0,59,55,4,2,3,0,0
"10811","L.A","MIN",2013021128,16160,20132014,1,60,2,3,-1,4.987692510942,4.44472778495401,0.542964725987986,20,20,0,35,32,3,46,39,7,3,2,0,0
"10812","L.A","ARI",2013021143,16162,20132014,1,60,4,0,4,3.96175229988876,1.25282425130354,2.70892804858522,32,17,15,39,30,9,53,43,10,4,2,0,0
"10813","L.A","S.J",2013021152,16163,20132014,0,60,1,2,-1,6.58142377412878,4.46439629330416,2.11702748082462,27,21,6,53,32,21,80,49,31,7,4,0,0
"10814","L.A","VAN",2013021169,16165,20132014,0,60,1,2,-1,0,0,0,26,40,-14,43,53,-10,55,73,-18,3,6,0,0
"10815","L.A","CGY",2013021192,16169,20132014,0,65,3,3,0,7.69694418311701,1.87767992920999,5.81926425390702,44,18,26,57,28,29,79,42,37,0,0,0,0
"10816","L.A","EDM",2013021203,16170,20132014,0,60,3,0,3,4.59009229994263,2.38930986402374,2.20078243591888,48,17,31,61,27,34,81,39,42,4,0,0,0
"10817","L.A","ANA",2013021220,16172,20132014,1,65,3,3,0,3.4821781280466,3.13083633860333,0.351341789443266,30,24,6,43,37,6,63,49,14,4,4,0,0
"10818","L.A","S.J",2013030181,16177,20132014,0,60,3,6,-3,4.53030672640775,5.43288061002386,-0.902573883616109,34,33,1,39,49,-10,58,65,-7,5,5,0,0
"10819","L.A","S.J",2013030182,16180,20132014,0,60,2,7,-5,2.16371800408425,4.80589218740351,-2.64217418331926,26,40,-14,36,50,-14,58,60,-2,4,8,0,0
"10820","L.A","S.J",2013030183,16182,20132014,1,66.3333333333333,3,4,-1,8.02509420344904,7.26972826915954,0.755365934289502,31,40,-9,56,55,1,73,65,8,4,4,0,0
"10821","L.A","S.J",2013030184,16184,20132014,1,60,6,3,3,4.70499589098654,5.73898029813517,-1.03398440714864,31,39,-8,43,59,-16,53,71,-18,9,8,0,0
"10822","L.A","S.J",2013030185,16186,20132014,0,60,3,0,3,3.57126069789043,4.24368592018283,-0.672425222292397,41,30,11,51,46,5,62,62,0,6,6,0,0
"10823","L.A","S.J",2013030186,16188,20132014,1,60,4,1,3,6.38968542925431,6.73620967292886,-0.346524243674544,30,26,4,42,43,-1,55,59,-4,7,7,0,0
"10824","L.A","S.J",2013030187,16190,20132014,0,60,5,1,4,7.27234054496853,7.60970592705939,-0.337365382090866,30,40,-10,44,52,-8,60,75,-15,3,6,0,0
"10825","L.A","ANA",2013030241,16193,20132014,0,72.1166666666667,3,2,1,8.20873073910774,7.8597584915172,0.348972247590545,36,35,1,58,54,4,87,74,13,4,4,0,0
"10826","L.A","ANA",2013030242,16195,20132014,0,60,3,1,2,3.98378294906286,5.60180037839382,-1.61801742933096,17,37,-20,30,54,-24,38,62,-24,4,5,0,0
"10827","L.A","ANA",2013030243,16198,20132014,1,60,2,3,-1,3.4313412415795,3.11845107085537,0.312890170724131,31,22,9,49,33,16,60,48,12,3,4,0,0
"10828","L.A","ANA",2013030244,16200,20132014,1,60,0,2,-2,4.03831689710205,2.0489485092173,1.98936838788475,28,14,14,46,27,19,71,36,35,4,2,0,0
"10829","L.A","ANA",2013030245,16202,20132014,0,60,3,4,-1,6.61921929569668,3.2494982201606,3.36972107553608,42,24,18,58,37,21,80,47,33,4,5,0,0
"10830","L.A","ANA",2013030246,16204,20132014,1,60,2,1,1,5.45951543468982,3.27396663615946,2.18554879853036,23,22,1,43,41,2,59,55,4,4,5,0,0
"10831","L.A","ANA",2013030247,16206,20132014,0,60,6,2,4,1.90603217217756,4.03401806134556,-2.127985889168,30,27,3,42,44,-2,53,61,-8,7,5,0,0
"10832","L.A","CHI",2013030321,16208,20132014,0,60,1,3,-2,3.28495707921684,2.67630463335081,0.608652445866028,26,20,6,33,28,5,58,43,15,2,2,0,0
"10833","L.A","CHI",2013030322,16211,20132014,0,60,6,2,4,4.28939225545037,2.96901998629979,1.32037226915057,31,25,6,38,30,8,51,47,4,5,5,0,0
"10834","L.A","CHI",2013030323,16214,20132014,1,60,4,3,1,4.01390961634969,5.994099839314,-1.98019022296431,32,27,5,47,42,5,57,58,-1,3,4,0,0
"10835","L.A","CHI",2013030324,16216,20132014,1,60,5,2,3,4.95379728899673,6.04356681974605,-1.08976953074932,21,24,-3,36,39,-3,48,62,-14,4,4,0,0
"10836","L.A","CHI",2013030325,16218,20132014,0,80,4,4,0,4.58975083474721,6.24909718648996,-1.65934635174276,43,44,-1,57,56,1,74,79,-5,3,4,0,0
"10837","L.A","CHI",2013030326,16220,20132014,1,60,3,4,-1,3.30242955510039,2.92081668587343,0.381612869226956,29,25,4,44,36,8,63,47,16,2,2,0,0
"10838","L.A","CHI",2013030327,16222,20132014,0,65.7833333333333,5,4,1,7.72168746510533,4.17445278170999,3.54723468339534,32,41,-9,48,45,3,71,57,14,2,5,0,0
"10839","L.A","NYR",2013030411,16225,20132014,1,64.6,3,2,1,4.05427199730184,4.89941244355683,-0.845140446254995,43,27,16,52,48,4,64,63,1,5,4,0,0
"10840","L.A","NYR",2013030412,16228,20132014,1,80,4,4,0,9.18241940251561,8.57438382810687,0.608035574408733,38,37,1,65,54,11,81,70,11,4,5,0,0
"10841","L.A","NYR",2013030413,16230,20132014,0,60,3,0,3,2.36660900141578,3.35377152982376,-0.987162528407978,15,32,-17,22,39,-17,33,59,-26,4,6,0,0
"10842","L.A","NYR",2013030414,16232,20132014,0,60,1,2,-1,5.25108172246837,2.63415830407757,2.6169234183908,41,19,22,51,33,18,71,48,23,3,4,0,0
"10843","L.A","NYR",2013030415,16234,20132014,1,80,2,2,0,7.78313340365639,7.49297668223153,0.290156721424864,42,25,17,76,46,30,97,57,40,4,4,0,0
"10844","L.A","S.J",2014020004,16351,20142015,1,60,0,4,-4,6.23686289946251,4.31657264293307,1.92029025652945,34,30,4,53,45,8,68,58,10,5,4,0,0
"10845","L.A","ARI",2014020030,16354,20142015,0,64.7666666666667,2,3,-1,2.84049684734782,6.92637278217516,-4.08587593482734,26,40,-14,40,53,-13,62,63,-1,6,7,0,0
"10846","L.A","WPG",2014020034,16355,20142015,1,60,4,1,3,4.58806097176785,3.83245141158113,0.755609560186713,31,30,1,45,42,3,55,50,5,5,4,0,0
"10847","L.A","EDM",2014020046,16357,20142015,1,60,6,1,5,5.9854746205674,3.74044028695062,2.24503433361679,26,32,-6,39,41,-2,45,53,-8,3,3,0,0
"10848","L.A","STL",2014020055,16359,20142015,1,65,0,0,0,4.623365019419,6.88798024730204,-2.26461522788304,18,43,-25,37,56,-19,49,74,-25,5,5,0,0
"10849","L.A","MIN",2014020074,16362,20142015,1,60,2,1,1,4.01971439440968,5.76661964125469,-1.74690524684502,16,41,-25,24,58,-34,31,70,-39,2,5,0,0
"10850","L.A","CBJ",2014020118,16369,20142015,1,60,5,2,3,3.7141531004745,3.79241962166401,-0.0782665211895051,27,24,3,43,38,5,57,47,10,4,3,0,0
"10851","L.A","PHI",2014020126,16371,20142015,0,62.6,2,3,-1,6.6087541783017,6.72860492627751,-0.119850747975814,40,43,-3,60,54,6,78,67,11,2,2,0,0
"10852","L.A","DET",2014020149,16374,20142015,0,60,2,5,-3,4.6779106668665,3.55213476243769,1.1257759044288,30,35,-5,42,43,-1,52,55,-3,4,6,0,0
"10853","L.A","CAR",2014020165,16376,20142015,0,60,2,3,-1,4.52143249567598,5.53350014503337,-1.01206764935739,32,32,0,40,45,-5,51,59,-8,3,4,0,0
"10854","L.A","DAL",2014020181,16378,20142015,0,60,3,1,2,6.09043532997021,7.17233126925504,-1.08189593928483,30,34,-4,38,46,-8,50,64,-14,6,5,0,0
"10855","L.A","NYI",2014020195,16380,20142015,1,65,1,1,0,3.43779654143145,3.89960664337958,-0.461810101948128,29,26,3,44,46,-2,62,57,5,4,4,0,0
"10856","L.A","VAN",2014020213,16382,20142015,1,60,5,1,4,3.55676764978529,2.98460300890275,0.572164640882536,36,19,17,53,28,25,60,37,23,3,5,0,0
"10857","L.A","ANA",2014020232,16386,20142015,0,65,5,5,0,3.76959760555474,5.5407504292597,-1.77115282370497,26,49,-23,39,68,-29,49,88,-39,3,2,0,0
"10858","L.A","DAL",2014020241,16387,20142015,1,60,0,2,-2,4.45840843501274,2.09907717406168,2.35933126095106,27,27,0,45,34,11,55,48,7,3,4,0,0
"10859","L.A","ANA",2014020250,16389,20142015,1,62.3166666666667,3,2,1,4.43442139693616,3.93383097003061,0.500590426905546,37,29,8,51,41,10,66,54,12,3,3,0,0
"10860","L.A","FLA",2014020277,16392,20142015,1,60,5,2,3,3.09124329656436,6.08626629635808,-2.99502299979372,27,32,-5,42,47,-5,53,59,-6,6,5,0,0
"10861","L.A","CAR",2014020289,16394,20142015,1,60,3,2,1,4.72073878077208,6.58839898288716,-1.86766020211508,39,27,12,49,39,10,62,51,11,3,4,0,0
"10862","L.A","DAL",2014020303,16396,20142015,0,60,4,5,-1,3.48565217661758,3.71387205690792,-0.228219880290343,41,23,18,57,37,20,71,48,23,5,6,0,0
"10863","L.A","MIN",2014020329,16400,20142015,0,60,4,0,4,2.25588488171707,3.79293811535172,-1.53705323363465,22,28,-6,31,46,-15,41,57,-16,3,3,0,0
"10864","L.A","CHI",2014020354,16403,20142015,1,60,1,4,-3,0,0,0,20,25,-5,44,41,3,57,48,9,3,2,0,0
"10865","L.A","BOS",2014020371,16406,20142015,1,60,2,0,2,7.46096113778185,5.22969349909644,2.23126763868541,35,31,4,49,48,1,63,57,6,4,1,0,0
"10866","L.A","ARI",2014020385,16408,20142015,0,60,4,0,4,7.71600692179709,5.09196674666087,2.62404017513622,43,26,17,56,40,16,73,51,22,3,2,0,0
"10867","L.A","PHI",2014020391,16410,20142015,1,60,1,2,-1,6.57902315876464,3.40798730688402,3.17103585188062,38,16,22,47,26,21,69,29,40,5,5,0,0
"10868","L.A","OTT",2014020425,16415,20142015,0,60,5,3,2,7.95577076182235,5.75547189424833,2.20029886757402,36,35,1,49,47,2,65,68,-3,4,2,0,0
"10869","L.A","MTL",2014020432,16416,20142015,0,60,2,6,-4,7.80049239120035,4.30721878073774,3.49327361046261,46,20,26,60,30,30,92,41,51,5,3,0,0
"10870","L.A","TOR",2014020448,16418,20142015,0,65,3,3,0,5.06962067255517,5.55985166244579,-0.49023098989062,36,31,5,56,41,15,80,57,23,3,4,0,0
"10871","L.A","STL",2014020458,16420,20142015,0,60,2,5,-3,2.54516409040662,5.00362082564526,-2.45845673523864,23,23,0,30,32,-2,41,42,-1,6,3,0,0
"10872","L.A","STL",2014020472,16422,20142015,1,60,6,4,2,6.60407507204218,2.8920724223618,3.71200264968038,37,28,9,57,46,11,71,59,12,7,4,0,0
"10873","L.A","ARI",2014020479,16424,20142015,1,60,4,2,2,3.95121003923123,3.04864465579602,0.902565383435203,35,17,18,54,36,18,66,51,15,5,3,0,0
"10874","L.A","S.J",2014020526,16431,20142015,1,60,3,1,2,2.81799080024939,1.8184607380009,0.999530062248486,29,22,7,43,27,16,60,39,21,4,2,0,0
"10875","L.A","EDM",2014020543,16434,20142015,0,65,2,2,0,5.65329740608286,4.79370745678898,0.859589949293877,39,21,18,49,38,11,68,57,11,4,4,0,0
"10876","L.A","VAN",2014020557,16436,20142015,0,60,3,2,1,0,0,0,40,16,24,51,23,28,67,33,34,4,1,0,0
"10877","L.A","NYR",2014020607,16443,20142015,1,60,3,4,-1,3.20149169037904,6.34342201575843,-3.14193032537939,31,26,5,45,40,5,60,51,9,4,4,0,0
"10878","L.A","WPG",2014020622,16445,20142015,1,65,4,4,0,6.8264271663902,5.45801454724691,1.36841261914329,29,25,4,47,33,14,59,41,18,8,5,0,0
"10879","L.A","TOR",2014020629,16447,20142015,1,60,2,0,2,5.02274986400153,3.36640071366418,1.65634915033735,20,19,1,41,33,8,48,46,2,3,4,0,0
"10880","L.A","N.J",2014020643,16449,20142015,1,60,3,5,-2,6.47431548423422,3.20725517597748,3.26706030825674,26,20,6,35,31,4,50,39,11,4,4,0,0
"10881","L.A","ANA",2014020670,16452,20142015,1,65,2,2,0,6.75435762716279,5.15996908874115,1.59438853842164,28,31,-3,47,46,1,62,58,4,2,2,0,0
"10882","L.A","S.J",2014020696,16456,20142015,0,60,2,4,-2,5.24813079521846,3.99084244124128,1.25728835397717,28,25,3,38,40,-2,48,55,-7,6,4,0,0
"10883","L.A","CHI",2014020710,16463,20142015,1,60,4,3,1,3.18931502184205,4.9790001915826,-1.78968516974055,27,29,-2,43,44,-1,51,60,-9,2,4,0,0
"10884","L.A","BOS",2014020730,16466,20142015,0,60,1,3,-2,4.41787844855571,4.56540328231964,-0.147524833763924,31,33,-2,41,39,2,55,48,7,1,1,0,0
"10885","L.A","T.B",2014020774,16473,20142015,0,60,4,2,2,3.58161864604335,4.35139891751516,-0.769780271471802,29,28,1,39,44,-5,47,58,-11,5,5,0,0
"10886","L.A","CBJ",2014020793,16475,20142015,0,60,4,3,1,2.47502864393755,3.67955156617609,-1.20452292223854,44,26,18,53,34,19,62,46,16,1,1,0,0
"10887","L.A","T.B",2014020845,16482,20142015,1,60,3,2,1,3.44349310338809,3.67597357746126,-0.232480474073171,28,23,5,39,34,5,52,45,7,3,2,0,0
"10888","L.A","COL",2014020856,16484,20142015,0,60,4,1,3,3.49520482245134,6.4218838993718,-2.92667907692046,26,43,-17,36,54,-18,52,71,-19,4,3,0,0
"10889","L.A","S.J",2014020883,16487,20142015,0,60,2,1,1,3.99776165191724,2.3256027460302,1.67215890588704,29,32,-3,48,44,4,62,62,0,2,3,0,0
"10890","L.A","DET",2014020904,16490,20142015,1,60,1,0,1,5.34701688273344,2.56181848341657,2.78519839931687,27,20,7,43,29,14,51,41,10,5,6,0,0
"10891","L.A","OTT",2014020915,16492,20142015,1,60,0,1,-1,7.28530129627325,2.84176673711045,4.4435345591628,35,28,7,56,38,18,70,48,22,4,3,0,0
"10892","L.A","ANA",2014020922,16493,20142015,0,60,2,4,-2,5.93577529691356,4.81503723527567,1.12073806163789,22,32,-10,39,45,-6,57,53,4,1,1,0,0
"10893","L.A","WPG",2014020933,16495,20142015,0,60,2,5,-3,5.36309675348457,4.76081255436293,0.602284199121641,20,29,-9,33,40,-7,47,47,0,6,5,0,0
"10894","L.A","EDM",2014020950,16497,20142015,0,60,5,2,3,2.40649173263228,2.74193792556525,-0.335446192932977,29,23,6,37,36,1,52,54,-2,3,4,0,0
"10895","L.A","MTL",2014020963,16499,20142015,1,65,3,3,0,4.17094152965001,2.97393945872318,1.19700207092683,29,18,11,48,31,17,66,42,24,5,3,0,0
"10896","L.A","COL",2014020998,16504,20142015,0,60,5,2,3,3.58890699083508,2.67416943010176,0.914737560733329,30,23,7,38,28,10,59,39,20,3,3,0,0
"10897","L.A","VAN",2014021010,16506,20142015,0,60,4,0,4,3.04620505921775,3.97411922877654,-0.92791416955879,20,19,1,32,27,5,50,40,10,3,2,0,0
"10898","L.A","ARI",2014021040,16510,20142015,1,60,1,0,1,3.07738676309327,3.41729406069499,-0.339907297601712,35,25,10,47,31,16,65,42,23,3,2,0,0
"10899","L.A","ANA",2014021052,16512,20142015,0,60.75,2,3,-1,4.84274065773934,3.7466692777507,1.09607137998864,31,26,5,36,37,-1,52,49,3,4,4,0,0
"10900","L.A","VAN",2014021068,16515,20142015,1,60,1,4,-3,2.79633879947671,6.39211227836313,-3.59577347888642,26,42,-16,39,58,-19,61,74,-13,4,3,0,0
"10901","L.A","N.J",2014021083,16517,20142015,0,60,3,1,2,3.18503375409637,4.08270766306669,-0.897673908970319,33,20,13,47,33,14,59,44,15,4,2,0,0
"10902","L.A","NYR",2014021091,16518,20142015,0,60,4,2,2,4.5403810920543,3.76341976936965,0.776961322684656,35,36,-1,47,45,2,62,56,6,2,1,0,0
"10903","L.A","NYI",2014021103,16520,20142015,0,60,3,2,1,5.9323680157022,2.47340055955465,3.45896745614755,37,27,10,44,35,9,65,56,9,2,2,0,0
"10904","L.A","MIN",2014021125,16522,20142015,0,60,1,4,-3,4.43249987786794,3.96243157728736,0.470068300580579,32,20,12,49,27,22,73,34,39,3,2,0,0
"10905","L.A","CHI",2014021138,16524,20142015,0,60,1,4,-3,5.90822088139743,5.99775559522095,-0.0895347138235181,32,40,-8,37,50,-13,50,62,-12,1,2,0,0
"10906","L.A","EDM",2014021161,16527,20142015,1,60,8,2,6,4.53121387907436,4.21557040706466,0.315643472009697,33,30,3,47,43,4,64,53,11,2,3,0,0
"10907","L.A","COL",2014021179,16529,20142015,1,60,3,1,2,7.8536276150262,2.44090214336757,5.41272547165863,26,10,16,51,17,34,64,32,32,0,1,0,0
"10908","L.A","VAN",2014021188,16531,20142015,0,65,1,1,0,4.93730197899191,9.15046676781458,-4.21316478882267,37,38,-1,46,48,-2,58,63,-5,2,3,0,0
"10909","L.A","EDM",2014021199,16532,20142015,0,60,2,4,-2,4.95830750623401,3.16225782397669,1.79604968225732,27,22,5,36,28,8,54,38,16,3,2,0,0
"10910","L.A","S.J",2014021219,16536,20142015,1,60,4,1,3,5.15000075686112,2.2098921866824,2.94010857017872,36,21,15,48,33,15,62,36,26,4,4,0,0
"10911","L.A","S.J",2015020004,16715,20152016,1,60,1,5,-4,3.44437690466845,4.51006557536311,-1.06568867069467,20,32,-12,31,44,-13,44,54,-10,7,8,0,0
"10912","L.A","ARI",2015020016,16717,20152016,1,60,1,4,-3,5.65703936933551,2.76593132037669,2.89110804895881,41,22,19,63,29,34,73,36,37,5,4,0,0
"10913","L.A","VAN",2015020045,16721,20152016,1,60,0,3,-3,1.56834991348749,3.84749132902465,-2.27914141553715,15,26,-11,37,34,3,54,42,12,3,4,0,0
"10914","L.A","MIN",2015020064,16724,20152016,1,62.3166666666667,2,1,1,5.81681185079651,3.60467762127519,2.21213422952133,37,26,11,60,38,22,74,46,28,4,5,0,0
"10915","L.A","COL",2015020079,16726,20152016,1,60,2,1,1,6.46244661195669,2.33738667885751,4.12505993309918,40,23,17,57,30,27,79,40,39,4,6,0,0
"10916","L.A","S.J",2015020099,16730,20152016,0,60,4,1,3,4.59782281407388,4.73485221916896,-0.137029405095085,29,40,-11,42,50,-8,60,63,-3,5,6,0,0
"10917","L.A","CAR",2015020105,16731,20152016,1,60,3,0,3,3.4780936489001,4.40406286513186,-0.925969216231758,28,40,-12,38,51,-13,50,63,-13,3,5,0,0
"10918","L.A","EDM",2015020120,16733,20152016,0,60,3,2,1,3.54076643068402,3.20081850397401,0.339947926710011,34,28,6,41,34,7,59,52,7,2,2,0,0
"10919","L.A","WPG",2015020131,16735,20152016,0,60,4,1,3,6.98404944324284,1.34782895041826,5.63622049282458,32,25,7,43,37,6,59,52,7,1,1,0,0
"10920","L.A","CHI",2015020170,16741,20152016,0,60,2,4,-2,8.04166281194193,3.69156897696666,4.35009383497527,35,26,9,46,37,9,63,53,10,3,2,0,0
"10921","L.A","CBJ",2015020192,16744,20152016,1,60,2,3,-1,3.91506135840518,4.87872365439325,-0.963662295988065,33,25,8,49,36,13,62,46,16,8,8,0,0
"10922","L.A","ARI",2015020226,16749,20152016,1,60,2,3,-1,4.42969520670158,2.76950025302358,1.660194953678,35,25,10,51,35,16,68,48,20,2,3,0,0
"10923","L.A","NYI",2015020241,16751,20152016,1,60,2,1,1,3.58056433993625,5.02619562973268,-1.44563128979644,22,32,-10,41,47,-6,55,62,-7,3,3,0,0
"10924","L.A","EDM",2015020258,16753,20152016,1,60,4,3,1,2.94668378107599,4.99980622284983,-2.05312244177384,28,25,3,41,41,0,60,52,8,4,3,0,0
"10925","L.A","PHI",2015020269,16756,20152016,0,65,2,2,0,7.83358164259698,3.93944089047,3.89414075212699,40,38,2,51,50,1,65,62,3,2,5,0,0
"10926","L.A","DET",2015020289,16759,20152016,0,60,2,3,-1,4.7153694635781,4.34094763093162,0.374421832646476,37,29,8,53,38,15,66,44,22,4,4,0,0
"10927","L.A","CAR",2015020304,16761,20152016,0,60,3,4,-1,7.07481459947303,3.10574946005363,3.9690651394194,29,29,0,51,38,13,67,54,13,4,6,0,0
"10928","L.A","T.B",2015020326,16764,20152016,0,65,1,1,0,3.99150167830521,2.65249338610738,1.33900829219783,38,30,8,48,43,5,64,58,6,0,3,0,0
"10929","L.A","CHI",2015020353,16767,20152016,1,62.0666666666667,3,2,1,5.65159419697011,1.38453092022974,4.26706327674037,36,22,14,54,33,21,68,40,28,1,1,0,0
"10930","L.A","VAN",2015020367,16770,20152016,1,62.0333333333333,2,1,1,3.76621296758822,1.74562933680136,2.02058363078686,40,16,24,56,26,30,73,31,42,6,4,0,0
"10931","L.A","T.B",2015020404,16775,20152016,1,60,3,1,2,6.52207406079364,2.95206115971041,3.57001290108323,28,25,3,41,33,8,54,45,9,5,7,0,0
"10932","L.A","CBJ",2015020410,16777,20152016,0,64.55,3,2,1,7.23706575327827,3.69839178658972,3.53867396668856,41,23,18,58,31,27,84,40,44,3,2,0,0
"10933","L.A","PIT",2015020429,16780,20152016,0,65,2,2,0,5.53085862038847,6.41329263085772,-0.882434010469244,40,42,-2,55,56,-1,68,70,-2,3,4,0,0
"10934","L.A","OTT",2015020451,16783,20152016,0,60,3,5,-2,4.15358719845972,2.32944673680777,1.82414046165195,36,21,15,51,29,22,60,41,19,3,4,0,0
"10935","L.A","MTL",2015020470,16786,20152016,0,60,3,0,3,5.07135350607132,7.26899170513207,-2.19763819906075,20,45,-25,28,53,-25,44,74,-30,2,3,0,0
"10936","L.A","TOR",2015020485,16788,20152016,0,60,0,5,-5,3.6282861308282,3.23953488401185,0.388751246816355,26,34,-8,48,40,8,64,52,12,1,0,0,0
"10937","L.A","S.J",2015020516,16791,20152016,1,60,3,5,-2,5.7752067688973,4.91031326382111,0.864893505076187,36,23,13,57,34,23,69,41,28,4,5,0,0
"10938","L.A","ARI",2015020524,16795,20152016,0,60.6,4,3,1,5.75633005518016,3.87109930709994,1.88523074808022,33,27,6,50,44,6,66,60,6,7,5,0,0
"10939","L.A","VAN",2015020539,16797,20152016,0,60,5,0,5,3.25846405929769,2.13855107300333,1.11991298629437,38,27,11,49,31,18,63,41,22,5,6,0,0
"10940","L.A","EDM",2015020549,16798,20152016,0,60,5,2,3,3.53108115092618,6.11809826776152,-2.58701711683534,33,44,-11,50,60,-10,75,81,-6,2,2,0,0
"10941","L.A","PHI",2015020569,16802,20152016,1,60,2,1,1,4.05368787624016,3.90920971065064,0.144478165589521,32,30,2,42,41,1,55,56,-1,3,4,0,0
"10942","L.A","COL",2015020585,16804,20152016,0,60,1,4,-3,4.70242848041835,3.34948146504792,1.35294701537043,31,33,-2,43,43,0,60,52,8,5,5,0,0
"10943","L.A","TOR",2015020606,16807,20152016,1,60,2,1,1,6.98956259555416,4.71547945676139,2.27408313879278,41,26,15,59,39,20,66,53,13,2,5,0,0
"10944","L.A","DET",2015020633,16811,20152016,1,60,4,2,2,6.30611219801358,7.70144533483835,-1.39533313682477,31,27,4,50,41,9,64,54,10,3,2,0,0
"10945","L.A","OTT",2015020661,16816,20152016,1,60,3,5,-2,6.74568248978176,5.87497264373815,0.87070984604361,33,23,10,46,37,9,66,51,15,3,3,0,0
"10946","L.A","ANA",2015020676,16817,20152016,0,60,3,2,1,5.30787178018363,6.65295026297099,-1.34507848278736,26,32,-6,42,51,-9,56,66,-10,2,3,0,0
"10947","L.A","DAL",2015020689,16819,20152016,1,60,3,2,1,4.12419764441438,4.48963430541335,-0.365436660998967,29,29,0,41,44,-3,56,58,-2,2,2,0,0
"10948","L.A","MIN",2015020702,16821,20152016,1,60,0,3,-3,7.49253994096944,4.35278856627701,3.13975137469242,32,28,4,55,39,16,76,49,27,2,3,0,0
"10949","L.A","ARI",2015020718,16823,20152016,0,60,2,3,-1,3.40211271244334,4.11029663572481,-0.708183923281467,28,24,4,37,36,1,62,46,16,3,5,0,0
"10950","L.A","S.J",2015020724,16824,20152016,0,64.1,3,2,1,5.99432736269517,4.94207465106581,1.05225271162936,32,32,0,50,44,6,67,62,5,4,4,0,0
"10951","L.A","COL",2015020743,16827,20152016,1,60,3,4,-1,6.32799246160721,2.32469151855912,4.00330094304809,38,19,19,55,29,26,72,37,35,6,7,0,0
"10952","L.A","ARI",2015020754,16833,20152016,0,60,6,2,4,4.86175974360768,5.97293724707561,-1.11117750346793,35,26,9,53,35,18,69,54,15,8,6,0,0
"10953","L.A","ANA",2015020770,16835,20152016,1,60,2,4,-2,2.1831994097447,3.36264897172714,-1.17944956198244,25,24,1,37,44,-7,47,58,-11,3,6,0,0
"10954","L.A","BOS",2015020794,16840,20152016,0,60,9,2,7,8.70464282625471,3.68139789940324,5.02324492685148,57,37,20,70,49,21,80,66,14,3,3,0,0
"10955","L.A","NYI",2015020809,16842,20152016,0,60,2,5,-3,5.38130949808989,8.0380722410788,-2.65676274298891,30,30,0,45,40,5,69,53,16,3,4,0,0
"10956","L.A","NYR",2015020819,16843,20152016,0,63.1666666666667,5,4,1,6.92777541355281,3.78193831692192,3.14583709663088,34,28,6,49,33,16,72,43,29,2,1,0,0
"10957","L.A","N.J",2015020836,16845,20152016,0,60,0,1,-1,4.18664043355966,3.64834325354411,0.538297180015547,28,18,10,39,25,14,52,34,18,1,3,0,0
"10958","L.A","EDM",2015020915,16856,20152016,1,60,2,1,1,4.1259682046948,3.08661786932498,1.03935033536982,36,27,9,53,37,16,65,51,14,1,1,0,0
"10959","L.A","ANA",2015020935,16859,20152016,0,60,2,4,-2,5.70759437709057,4.23965430602948,1.46794007106109,29,29,0,42,51,-9,60,68,-8,6,7,0,0
"10960","L.A","MTL",2015020965,16863,20152016,1,60,3,2,1,6.41671603572797,2.54252007041941,3.87419596530856,31,15,16,49,23,26,59,37,22,6,4,0,0
"10961","L.A","ANA",2015020972,16865,20152016,1,60,2,3,-1,6.35267120029312,3.11080101855623,3.24187018173689,34,22,12,57,31,26,72,39,33,7,3,0,0
"10962","L.A","VAN",2015020992,16867,20152016,1,60,5,1,4,6.33582915939041,3.95603283710079,2.37979632228962,29,22,7,46,38,8,54,56,-2,3,6,0,0
"10963","L.A","N.J",2015021028,16872,20152016,1,64.7333333333333,1,2,-1,3.18234223057516,4.50584863700522,-1.32350640643006,23,24,-1,39,40,-1,68,51,17,4,1,0,0
"10964","L.A","CHI",2015021034,16874,20152016,0,60,5,0,5,4.66016419513471,4.73226536111906,-0.0721011659843498,25,32,-7,31,41,-10,46,65,-19,2,6,0,0
"10965","L.A","DAL",2015021045,16875,20152016,0,60,5,2,3,4.69939167186385,4.08439853312103,0.614993138742818,22,27,-5,29,42,-13,43,55,-12,1,3,0,0
"10966","L.A","NYR",2015021060,16877,20152016,1,61.5666666666667,4,3,1,6.77415552828461,3.33583354840812,3.43832197987649,37,26,11,57,32,25,72,41,31,3,2,0,0
"10967","L.A","BOS",2015021077,16879,20152016,1,60,2,1,1,3.5061798769093,5.15005872863073,-1.64387885172143,20,28,-8,39,43,-4,47,60,-13,2,4,0,0
"10968","L.A","MIN",2015021094,16882,20152016,0,60,1,2,-1,5.63557991669222,2.79061812325381,2.84496179343842,39,18,21,55,23,32,74,32,42,2,5,0,0
"10969","L.A","WPG",2015021108,16884,20152016,0,60,1,4,-3,5.9727308477668,6.36003341752439,-0.387302569757594,34,24,10,51,34,17,76,48,28,3,3,0,0
"10970","L.A","EDM",2015021128,16886,20152016,1,60,6,4,2,4.58909118095289,3.66887106998183,0.920220110971059,33,29,4,51,37,14,61,48,13,1,4,0,0
"10971","L.A","S.J",2015021139,16888,20152016,0,60,2,5,-3,3.14104831748409,6.88585966266692,-3.74481134518282,32,31,1,42,38,4,70,55,15,3,2,0,0
"10972","L.A","DAL",2015021169,16893,20152016,1,60,2,3,-1,4.43269015615806,6.50263136658759,-2.06994121042953,26,39,-13,42,55,-13,53,68,-15,3,4,0,0
"10973","L.A","VAN",2015021187,16895,20152016,0,60,2,3,-1,4.7653407335165,3.46952747972682,1.29581325378967,42,24,18,52,30,22,71,38,33,3,5,0,0
"10974","L.A","ANA",2015021213,16898,20152016,1,60,2,1,1,3.58985890400822,4.15023837164154,-0.560379467633311,31,20,11,49,30,19,66,44,22,6,6,0,0
"10975","L.A","WPG",2015021229,16900,20152016,1,65,3,3,0,6.05766716301594,2.89871691130611,3.15895025170983,29,31,-2,47,43,4,62,55,7,0,3,0,0
"10976","L.A","S.J",2015030181,16905,20152016,1,60,3,4,-1,4.77346328162002,4.68409340571816,0.0893698759018662,24,23,1,43,47,-4,58,57,1,3,4,0,0
"10977","L.A","S.J",2015030182,16907,20152016,1,60,1,2,-1,4.29519177187467,4.40084540715907,-0.105653635284398,27,23,4,51,36,15,79,53,26,5,5,0,0
"10978","L.A","S.J",2015030183,16909,20152016,0,63.7833333333333,2,1,1,5.05535895206399,5.56347455529612,-0.508115603232138,24,30,-6,40,47,-7,58,74,-16,4,6,0,0
"10979","L.A","S.J",2015030184,16911,20152016,0,60,2,3,-1,5.74347424797452,4.07575169525808,1.66772255271644,28,29,-1,41,40,1,66,58,8,2,4,0,0
"10980","L.A","S.J",2015030185,16913,20152016,1,60,3,6,-3,3.48998683440025,5.49674892441544,-2.00676209001519,22,28,-6,40,36,4,69,47,22,1,3,0,0
"10981","L.A","S.J",2016020004,17086,20162017,0,60,1,2,-1,4.1688675081823,5.6518385366071,-1.4829710284248,22,31,-9,37,51,-14,58,73,-15,2,4,0,0
"10982","L.A","PHI",2016020016,17088,20162017,1,60,2,4,-2,2.64590183915425,2.5017236328506,0.14417820630365,25,30,-5,37,36,1,53,49,4,3,3,0,0
"10983","L.A","MIN",2016020044,17092,20162017,0,60,3,6,-3,4.90809851861091,8.50884434627369,-3.60074582766278,30,26,4,47,31,16,72,35,37,5,4,0,0
"10984","L.A","DAL",2016020058,17094,20162017,0,61.3333333333333,4,3,1,6.33574253802362,4.68464566334171,1.65109687468191,39,20,19,58,32,26,78,47,31,7,5,0,0
"10985","L.A","VAN",2016020076,17096,20162017,1,65,3,3,0,7.15451215408399,3.96398727914493,3.19052487493906,31,25,6,53,37,16,74,45,29,3,6,0,0
"10986","L.A","CBJ",2016020092,17099,20162017,1,61.2333333333333,3,2,1,3.9888792863203,3.7178745107376,0.271004775582696,30,21,9,44,32,12,64,41,23,1,1,0,0
"10987","L.A","CHI",2016020128,17104,20162017,0,60,0,3,-3,7.10207079560496,4.70475132853608,2.39731946706888,32,29,3,43,41,2,53,57,-4,2,6,0,0
"10988","L.A","ANA",2016020142,17106,20162017,1,60,0,4,-4,4.46850090531007,2.70797012631374,1.76053077899633,30,21,9,42,29,13,54,37,17,4,6,0,0
"10989","L.A","PIT",2016020156,17108,20162017,1,62.6166666666667,3,2,1,4.91128298530044,3.22947842779104,1.6818045575094,27,23,4,38,36,2,50,46,4,3,3,0,0
"10990","L.A","TOR",2016020188,17113,20162017,0,60,7,0,7,6.33187710495895,1.97251103744929,4.35936606750965,43,19,24,57,28,29,75,38,37,4,1,0,0
"10991","L.A","MTL",2016020199,17115,20162017,0,60,1,4,-3,4.52561912103556,4.55894979015284,-0.0333306691172766,24,23,1,32,35,-3,48,48,0,4,2,0,0
"10992","L.A","WPG",2016020223,17118,20162017,0,65,2,2,0,6.37846629837486,4.86944830963577,1.50901798873909,29,29,0,40,38,2,69,57,12,5,2,0,0
"10993","L.A","COL",2016020240,17120,20162017,0,60,1,4,-3,5.44241547573483,6.45531575172406,-1.01290027598923,33,30,3,44,34,10,64,49,15,5,5,0,0
"10994","L.A","EDM",2016020254,17122,20162017,1,60,4,2,2,3.06074660667218,3.88241839344031,-0.821671786768125,25,30,-5,32,42,-10,39,55,-16,2,1,0,0
"10995","L.A","N.J",2016020261,17124,20162017,1,60,4,2,2,4.77313793302164,3.62871474027634,1.14442319274531,28,23,5,38,31,7,45,44,1,1,2,0,0
"10996","L.A","ANA",2016020275,17125,20162017,0,60,3,2,1,4.48534890045312,2.75362688052701,1.73172201992611,29,30,-1,39,42,-3,48,60,-12,3,7,0,0
"10997","L.A","NYI",2016020298,17128,20162017,1,60,4,2,2,6.46735205869481,3.90524877185817,2.56210328683665,28,24,4,47,34,13,64,53,11,2,2,0,0
"10998","L.A","CHI",2016020320,17131,20162017,1,61.1,2,1,1,2.04708556708647,2.0566252595163,-0.00953969242982566,29,19,10,42,31,11,55,47,8,3,3,0,0
"10999","L.A","S.J",2016020344,17135,20162017,1,60,1,4,-3,5.37499223958002,3.70562811626587,1.66936412331415,27,24,3,49,35,14,70,47,23,2,1,0,0
"11000","L.A","ARI",2016020355,17136,20162017,0,60,4,3,1,4.78460821793851,5.61244406567084,-0.827835847732331,33,32,1,47,44,3,65,53,12,7,7,0,0
"11001","L.A","MTL",2016020377,17139,20162017,1,65,4,4,0,5.19045477785403,4.62908971903744,0.561365058816591,31,30,1,45,42,3,53,59,-6,4,5,0,0
"11002","L.A","CAR",2016020404,17143,20162017,1,60,1,3,-2,4.85647037997842,2.73891764552407,2.11755273445435,22,18,4,38,25,13,58,36,22,3,0,0,0
"11003","L.A","DET",2016020448,17150,20162017,0,60,4,1,3,5.24531603523326,4.6819117696723,0.563404265560962,31,18,13,46,26,20,61,39,22,5,6,0,0
"11004","L.A","PIT",2016020454,17151,20162017,0,61,1,0,1,4.00852146678517,3.89487943208951,0.113642034695658,28,39,-11,37,48,-11,57,67,-10,1,4,0,0
"11005","L.A","BOS",2016020470,17153,20162017,0,60,0,1,-1,2.56124609780822,1.90789907846647,0.653347019341751,18,30,-12,28,36,-8,48,53,-5,4,3,0,0
"11006","L.A","CBJ",2016020484,17155,20162017,0,65,2,2,0,5.20707232499262,3.77667645044858,1.43039587454405,46,27,19,58,43,15,72,56,16,2,2,0,0
"11007","L.A","DAL",2016020513,17158,20162017,0,61.1166666666667,2,3,-1,8.52904989232775,5.986244194962,2.54280569736575,31,31,0,46,45,1,64,57,7,3,3,0,0
"11008","L.A","VAN",2016020531,17163,20162017,0,60,1,2,-1,5.98583158268593,1.56955818906243,4.4162733936235,37,20,17,46,27,19,55,37,18,2,3,0,0
"11009","L.A","EDM",2016020542,17164,20162017,0,60,1,3,-2,3.77596166086732,4.11757554176438,-0.341613880897057,29,35,-6,33,53,-20,51,70,-19,2,2,0,0
"11010","L.A","S.J",2016020558,17166,20162017,1,60,3,2,1,3.79347596807929,4.34186519448122,-0.548389226401923,27,20,7,44,33,11,60,44,16,5,3,0,0
"11011","L.A","S.J",2016020571,17169,20162017,0,60.9666666666667,2,1,1,2.62692871126552,6.63591494128923,-4.00898623002371,35,27,8,47,41,6,65,55,10,3,3,0,0
"11012","L.A","DET",2016020583,17171,20162017,1,60,0,4,-4,6.84682286833413,3.37499667465454,3.47182619367959,34,22,12,50,29,21,69,42,27,1,2,0,0
"11013","L.A","MIN",2016020593,17173,20162017,1,63.5333333333333,4,3,1,6.72218773592613,3.34119207663025,3.38099565929588,36,24,12,53,31,22,63,39,24,3,3,0,0
"11014","L.A","DAL",2016020612,17175,20162017,1,60,4,6,-2,2.37795395072317,3.31759330056957,-0.939639349846402,22,26,-4,41,34,7,64,44,20,3,1,0,0
"11015","L.A","WPG",2016020650,17180,20162017,1,61.6,3,2,1,5.15293346336694,4.71924686002694,0.433686603339993,38,28,10,49,38,11,67,52,15,4,4,0,0
"11016","L.A","T.B",2016020659,17182,20162017,1,60,1,2,-1,3.91934127945569,4.6215562150901,-0.702214935634402,32,29,3,50,47,3,70,58,12,3,2,0,0
"11017","L.A","S.J",2016020676,17184,20162017,1,60,2,3,-1,4.84949822817316,4.1729846352432,0.676513592929961,24,27,-3,37,43,-6,54,53,1,6,6,0,0
"11018","L.A","NYI",2016020695,17187,20162017,0,60,2,4,-2,3.71958620345575,6.44041119845024,-2.72082499499449,36,36,0,50,50,0,60,66,-6,2,5,0,0
"11019","L.A","NYR",2016020708,17189,20162017,0,60,2,3,-1,6.98396539647576,2.2763950212975,4.70757037517826,38,17,21,55,22,33,80,35,45,3,4,0,0
"11020","L.A","N.J",2016020715,17190,20162017,0,60,3,1,2,2.21836606875877,3.02445569090196,-0.80608962214319,25,25,0,32,30,2,35,34,1,2,4,0,0
"11021","L.A","CAR",2016020732,17192,20162017,0,60,3,0,3,4.32402086375041,3.18284630757262,1.14117455617779,29,22,7,41,35,6,52,53,-1,2,5,0,0
"11022","L.A","ARI",2016020752,17197,20162017,0,60,3,2,1,5.95616153103765,3.65236455598733,2.30379697505032,39,32,7,61,42,19,72,61,11,3,1,0,0
"11023","L.A","COL",2016020757,17198,20162017,1,60,5,0,5,5.31431726677511,3.61698221540428,1.69733505137083,40,22,18,55,40,15,64,56,8,3,4,0,0
"11024","L.A","PHI",2016020772,17201,20162017,0,62.5833333333333,1,0,1,3.72525103716907,1.85022466904411,1.87502636812496,28,17,11,39,25,14,68,44,24,2,2,0,0
"11025","L.A","T.B",2016020797,17204,20162017,0,60,0,5,-5,2.74847256031353,3.10060407567653,-0.352131515362998,28,21,7,41,33,8,57,44,13,4,4,0,0
"11026","L.A","ARI",2016020854,17213,20162017,1,60,3,5,-2,7.38604202459101,3.07566471245082,4.31037731214019,44,22,22,64,33,31,83,40,43,4,4,0,0
"11027","L.A","ANA",2016020878,17216,20162017,0,60,0,1,-1,5.7894618842405,3.70838699158776,2.08107489265274,24,29,-5,36,46,-10,53,60,-7,2,2,0,0
"11028","L.A","COL",2016020890,17218,20162017,0,60,2,1,1,3.58415865247662,3.16595524078002,0.418203411696595,32,25,7,42,39,3,53,50,3,1,3,0,0
"11029","L.A","BOS",2016020899,17220,20162017,1,60,1,4,-3,3.47750285174698,4.96544359121443,-1.48794073946745,28,25,3,49,40,9,68,48,20,4,2,0,0
"11030","L.A","ANA",2016020904,17222,20162017,1,60,4,1,3,7.52983675266124,5.32272553775692,2.20711121490432,33,33,0,46,50,-4,63,59,4,5,5,0,0
"11031","L.A","MIN",2016020921,17224,20162017,0,60.2,4,5,-1,5.25124090610188,4.58130306261911,0.669937843482778,30,35,-5,45,45,0,63,55,8,1,2,0,0
"11032","L.A","TOR",2016020944,17227,20162017,1,65,2,2,0,5.08970825066615,7.22579256666359,-2.13608431599744,35,31,4,52,47,5,66,61,5,3,1,0,0
"11033","L.A","VAN",2016020961,17229,20162017,1,60,3,4,-1,5.77042960574181,3.51207778346725,2.25835182227456,44,21,23,60,26,34,80,30,50,7,3,0,0
"11034","L.A","ARI",2016021031,17239,20162017,1,65,2,2,0,9.07728727340873,4.1796351737139,4.89765209969482,46,32,14,59,47,12,74,57,17,3,3,0,0
"11035","L.A","EDM",2016021074,17245,20162017,0,60,0,2,-2,4.16867838217877,3.91854431957472,0.250134062604047,35,31,4,49,46,3,84,61,23,3,4,0,0
"11036","L.A","WPG",2016021100,17248,20162017,1,60,5,2,3,5.11736316381575,5.0366449395014,0.0807182243143529,36,21,15,53,33,20,72,45,27,4,4,0,0
"11037","L.A","NYR",2016021116,17250,20162017,1,60,0,3,-3,3.67993048328208,4.61255112994695,-0.932620646664873,30,20,10,52,31,21,70,41,29,4,3,0,0
"11038","L.A","EDM",2016021134,17253,20162017,0,60,1,2,-1,3.66979978258132,4.00981241460249,-0.340012632021171,35,29,6,41,36,5,58,54,4,1,3,0,0
"11039","L.A","VAN",2016021155,17256,20162017,0,60,2,0,2,3.58649251979659,2.79395465458583,0.792537865210761,26,35,-9,39,50,-11,46,59,-13,1,2,0,0
"11040","L.A","ARI",2016021175,17258,20162017,1,60,1,2,-1,5.10763150400453,1.42238392494619,3.68524757905834,35,15,20,54,23,31,70,33,37,6,1,0,0
"11041","L.A","EDM",2016021190,17260,20162017,1,60,6,4,2,5.45297201794165,6.26885741592196,-0.81588539798031,27,27,0,42,37,5,54,52,2,3,2,0,0
"11042","L.A","CHI",2016021220,17264,20162017,1,60.45,3,2,1,3.28851801858741,6.35283565460122,-3.06431763601381,26,27,-1,42,43,-1,60,55,5,2,3,0,0
"11043","L.A","ANA",2016021229,17265,20162017,0,60.8833333333333,3,4,-1,3.08894855012255,5.05842936669509,-1.96948081657254,18,24,-6,35,45,-10,50,60,-10,5,5,0,0
"11044","L.A","PHI",2017020012,17444,20172018,1,60,2,0,2,2.75600802816916,2.59674058687247,0.159267441296691,27,35,-8,43,52,-9,56,63,-7,4,5,0,0
"11045","L.A","S.J",2017020030,17446,20172018,0,60,4,1,3,5.62678192638856,3.37813710798417,2.24864481840439,39,25,14,48,38,10,62,52,10,6,4,0,0
"11046","L.A","NYI",2017020079,17454,20172018,1,60,3,2,1,4.63299633393763,5.20573741548287,-0.572741081545246,27,25,2,33,42,-9,47,60,-13,3,2,0,0
"11047","L.A","MTL",2017020094,17457,20172018,1,60,5,1,4,5.11369444804378,4.27026805588321,0.843426392160572,42,37,5,61,54,7,80,72,8,3,4,0,0
"11048","L.A","CBJ",2017020117,17460,20172018,0,60,6,4,2,4.18614714348587,6.42666813195683,-2.24052098847096,32,36,-4,41,47,-6,56,70,-14,2,3,0,0
"11049","L.A","TOR",2017020123,17462,20172018,0,60,2,3,-1,3.44310769020827,4.45143337273066,-1.00832568252239,38,34,4,52,46,6,64,59,5,4,8,0,0
"11050","L.A","MTL",2017020142,17465,20172018,0,60,4,0,4,5.92646493241773,4.31516445122179,1.61130048119594,28,40,-12,33,54,-21,51,73,-22,1,5,0,0
"11051","L.A","BOS",2017020156,17467,20172018,0,64.9833333333333,2,1,1,2.92184485734154,3.0974945964922,-0.175649739150654,30,30,0,43,48,-5,63,58,5,3,3,0,0
"11052","L.A","TOR",2017020197,17472,20172018,1,60,5,3,2,2.83573582771196,6.34248765041235,-3.50675182270039,28,36,-8,40,54,-14,46,73,-27,5,7,0,0
"11053","L.A","ANA",2017020231,17477,20172018,0,63.85,4,3,1,4.70704214950779,5.1551356309473,-0.448093481439507,43,36,7,56,52,4,68,65,3,8,4,0,0
"11054","L.A","T.B",2017020241,17479,20172018,1,60,2,5,-3,3.55535758170299,5.13238240306055,-1.57702482135755,24,43,-19,40,51,-11,47,64,-17,5,7,0,0
"11055","L.A","S.J",2017020264,17482,20172018,1,60,1,2,-1,3.33118227357369,3.52249279839452,-0.191310524820835,27,33,-6,44,45,-1,66,59,7,4,3,0,0
"11056","L.A","VAN",2017020274,17484,20172018,1,60,2,3,-1,5.9417956925663,3.13200968645629,2.80978600611002,32,27,5,47,36,11,57,43,14,5,4,0,0
"11057","L.A","BOS",2017020288,17486,20172018,1,60,1,2,-1,3.63452814319498,3.59750241143,0.0370257317649809,28,30,-2,43,39,4,57,55,2,6,5,0,0
"11058","L.A","VGK",2017020308,17489,20172018,0,60,2,4,-2,2.66655515458842,5.01999307063976,-2.35343791605133,29,40,-11,34,51,-17,52,71,-19,1,1,0,0
"11059","L.A","WPG",2017020333,17492,20172018,1,60,1,2,-1,4.64876942747469,3.36297871147142,1.28579071600327,39,27,12,53,48,5,69,64,5,5,4,0,0
"11060","L.A","ARI",2017020346,17494,20172018,0,62.7166666666667,2,3,-1,4.99662366427947,5.54410641332879,-0.547482749049323,25,33,-8,44,51,-7,65,65,0,1,4,0,0
"11061","L.A","ANA",2017020358,17495,20172018,1,65,1,1,0,3.73893372182647,4.34053007930283,-0.601596357476359,34,26,8,53,41,12,72,46,26,4,2,0,0
"11062","L.A","DET",2017020372,17498,20172018,0,60,4,1,3,4.02112489036517,3.75324463049891,0.267880259866266,36,24,12,45,33,12,52,42,10,4,3,0,0
"11063","L.A","CHI",2017020408,17503,20172018,0,60,3,1,2,8.14676109250125,4.84416394372238,3.30259714877888,24,25,-1,33,36,-3,46,55,-9,1,4,0,0
"11064","L.A","MIN",2017020425,17505,20172018,1,60,5,2,3,6.82864033326041,3.84358632458404,2.98505400867637,28,21,7,40,32,8,53,43,10,3,1,0,0
"11065","L.A","CAR",2017020455,17509,20172018,1,64.6666666666667,3,2,1,5.19974898526561,4.09944284794619,1.10030613731942,21,34,-13,32,48,-16,43,68,-25,1,3,0,0
"11066","L.A","N.J",2017020467,17512,20172018,0,60,1,5,-4,1.95824392410113,3.1860342208056,-1.22779029670447,17,26,-9,24,35,-11,34,45,-11,4,3,0,0
"11067","L.A","NYR",2017020493,17515,20172018,0,60,2,4,-2,6.11957261304938,3.50930754165165,2.61026507139773,35,28,7,48,36,12,73,50,23,1,3,0,0
"11068","L.A","NYI",2017020499,17516,20172018,0,61.9,3,4,-1,3.4114973000486,4.22032831265254,-0.808831012603945,29,33,-4,44,45,-1,56,63,-7,3,5,0,0
"11069","L.A","PHI",2017020513,17518,20172018,0,60,4,1,3,3.99711376852151,5.99661298167582,-1.99949921315432,25,37,-12,36,51,-15,46,56,-10,3,7,0,0
"11070","L.A","COL",2017020537,17521,20172018,1,60.7333333333333,2,1,1,4.517561843039,3.94895138003631,0.568610463002699,27,32,-5,42,44,-2,64,56,8,4,3,0,0
"11071","L.A","S.J",2017020557,17523,20172018,0,60,0,2,-2,3.47128791525029,2.84528742289285,0.626000492357441,28,31,-3,40,46,-6,61,62,-1,6,9,0,0
"11072","L.A","VGK",2017020574,17528,20172018,1,63.5,2,3,-1,5.54093290935089,5.13294678955572,0.407986119795169,28,39,-11,39,55,-16,59,67,-8,2,6,0,0
"11073","L.A","VAN",2017020592,17530,20172018,0,60,4,3,1,3.53720003980561,3.38639416114893,0.150805878656683,36,25,11,45,32,13,64,44,20,2,1,0,0
"11074","L.A","EDM",2017020611,17533,20172018,0,60,5,0,5,4.71977556840284,4.65789812773568,0.0618774406671605,33,32,1,44,48,-4,59,65,-6,2,3,0,0
"11075","L.A","ANA",2017020677,17544,20172018,1,60,2,4,-2,7.4422433794747,8.34673245582962,-0.90448907635492,25,22,3,37,38,-1,56,50,6,2,2,0,0
"11076","L.A","S.J",2017020685,17546,20172018,1,60,1,4,-3,6.30919767263893,4.93506000994239,1.37413766269654,36,33,3,54,48,6,69,65,4,2,2,0,0
"11077","L.A","PIT",2017020704,17549,20172018,1,60,1,3,-2,5.51838249319042,4.28357635090785,1.23480614228257,29,31,-2,46,41,5,60,51,9,3,4,0,0
"11078","L.A","ANA",2017020707,17550,20172018,0,60,1,2,-1,5.89663028577343,6.13535338320288,-0.238723097429452,24,31,-7,41,51,-10,65,63,2,1,2,0,0
"11079","L.A","NYR",2017020725,17552,20172018,1,60,4,2,2,6.34856823351583,4.50763864540204,1.8409295881138,30,23,7,40,35,5,56,46,10,3,4,0,0
"11080","L.A","VAN",2017020740,17554,20172018,0,60,2,6,-4,5.01245170609124,5.59001197725554,-0.5775602711643,32,35,-3,44,40,4,61,58,3,5,7,0,0
"11081","L.A","DAL",2017020770,17561,20172018,0,60,3,0,3,4.90267460476025,3.50117772168596,1.40149688307429,42,28,14,51,38,13,82,57,25,3,4,0,0
"11082","L.A","ARI",2017020804,17565,20172018,1,60,6,0,6,4.42753496385262,2.53319427541282,1.8943406884398,35,27,8,50,40,10,58,52,6,2,2,0,0
"11083","L.A","EDM",2017020825,17569,20172018,1,60,5,2,3,5.8927588131628,5.65542975062272,0.237329062540084,28,27,1,44,39,5,68,50,18,3,3,0,0
"11084","L.A","T.B",2017020846,17572,20172018,0,60,3,4,-1,4.93225239923581,2.96234798856312,1.96990441067268,47,28,19,58,43,15,71,58,13,4,3,0,0
"11085","L.A","CAR",2017020869,17575,20172018,0,60,3,7,-4,4.61561609006138,6.31377895049809,-1.69816286043671,30,41,-11,39,52,-13,51,66,-15,2,5,0,0
"11086","L.A","PIT",2017020881,17577,20172018,0,60,1,3,-2,5.81940032777308,7.15617088849551,-1.33677056072243,35,39,-4,47,49,-2,59,68,-9,3,4,0,0
"11087","L.A","CHI",2017020916,17581,20172018,0,60,3,1,2,2.48043501975189,5.06841059123508,-2.58797557148318,32,28,4,38,39,-1,50,70,-20,3,1,0,0
"11088","L.A","WPG",2017020924,17582,20172018,0,60,4,3,1,2.97054992084118,4.24625701236073,-1.27570709151955,32,33,-1,44,43,1,58,53,5,5,5,0,0
"11089","L.A","DAL",2017020940,17584,20172018,1,60,0,2,-2,4.69365040100092,6.71388511326222,-2.0202347122613,18,28,-10,31,43,-12,47,60,-13,2,1,0,0
"11090","L.A","EDM",2017020957,17586,20172018,1,60,3,4,-1,5.7639930100413,4.38137124995843,1.38262176008288,33,25,8,49,34,15,65,50,15,3,2,0,0
"11091","L.A","VGK",2017020968,17588,20172018,1,63.2333333333333,3,2,1,7.32649157219566,4.78512542303133,2.54136614916433,44,39,5,57,51,6,67,63,4,5,4,0,0
"11092","L.A","VGK",2017020976,17589,20172018,0,60,4,1,3,2.45572764149199,3.04439461993052,-0.588666978438539,30,42,-12,37,52,-15,47,70,-23,6,4,0,0
"11093","L.A","CBJ",2017020989,17591,20172018,1,60,5,2,3,4.78483347033034,3.61881409331181,1.16601937701853,34,32,2,42,50,-8,57,64,-7,2,3,0,0
"11094","L.A","CHI",2017021002,17593,20172018,1,60,3,5,-2,4.0955271345847,5.44254952414235,-1.34702238955765,32,25,7,44,41,3,54,60,-6,2,5,0,0
"11095","L.A","VAN",2017021069,17602,20172018,1,60,3,0,3,5.12584051018818,6.43182214656444,-1.30598163637626,33,35,-2,50,46,4,65,58,7,4,4,0,0
"11096","L.A","ARI",2017021077,17603,20172018,0,65,3,3,0,6.0429058734735,4.24501994008205,1.79788593339145,37,29,8,49,39,10,66,62,4,4,1,0,0
"11097","L.A","DET",2017021091,17605,20172018,1,60,4,1,3,5.22291170164873,2.45636774052018,2.76654396112855,22,21,1,35,32,3,48,46,2,5,3,0,0
"11098","L.A","N.J",2017021100,17607,20172018,1,60,0,3,-3,6.58968139056458,8.08545455091495,-1.49577316035037,38,28,10,64,43,21,86,56,30,6,4,0,0
"11099","L.A","MIN",2017021119,17609,20172018,0,64.4333333333333,4,3,1,4.37201659029233,4.4589432960421,-0.0869267057497645,30,27,3,36,39,-3,54,60,-6,3,2,0,0
"11100","L.A","WPG",2017021128,17610,20172018,0,61.6166666666667,1,2,-1,1.81482979401829,5.39879886594281,-3.58396907192451,17,38,-21,24,50,-26,29,73,-44,2,4,0,0
"11101","L.A","COL",2017021144,17612,20172018,0,60,7,1,6,4.17009377842624,3.85872512970718,0.311368648719053,35,30,5,45,40,5,48,51,-3,2,3,0,0
"11102","L.A","EDM",2017021162,17614,20172018,0,60,2,3,-1,4.05610862072854,2.83913561625691,1.21697300447163,29,27,2,44,42,2,64,49,15,1,2,0,0
"11103","L.A","ARI",2017021199,17619,20172018,1,60,4,2,2,4.54817683834699,5.02160168425229,-0.473424845905299,35,22,13,49,35,14,61,47,14,3,3,0,0
"11104","L.A","ANA",2017021204,17620,20172018,0,64.6833333333333,1,2,-1,4.77922753986786,4.43217523803469,0.347052301833173,29,33,-4,39,53,-14,51,71,-20,0,1,0,0
"11105","L.A","COL",2017021228,17623,20172018,1,60,3,1,2,4.8232290725864,2.29664721235167,2.52658186023473,25,28,-3,39,36,3,51,54,-3,2,3,0,0
"11106","L.A","MIN",2017021251,17626,20172018,1,60.3833333333333,5,4,1,7.23610433250833,3.39074625047215,3.84535808203619,28,27,1,43,39,4,61,52,9,9,4,0,0
"11107","L.A","DAL",2017021270,17628,20172018,1,60,2,4,-2,4.8273454332957,0.991305456031114,3.83603997726459,36,18,18,48,26,22,63,32,31,3,1,0,0
"11108","L.A","VGK",2017030171,17632,20172018,0,60,0,1,-1,5.53072647225054,4.62462258084277,0.906103891407767,30,28,2,40,51,-11,53,73,-20,3,3,0,0
"11109","L.A","VGK",2017030172,17634,20172018,0,80,1,1,0,3.16948543605395,5.37462945338098,-2.20514401732703,27,47,-20,40,63,-23,61,90,-29,3,3,0,0
"11110","L.A","VGK",2017030173,17636,20172018,1,60,2,3,-1,4.54039360496972,6.05589776813714,-1.51550416316742,39,26,13,51,46,5,69,65,4,6,5,0,0
"11111","L.A","VGK",2017030174,17638,20172018,1,60,0,1,-1,5.12555184142548,3.59764738914964,1.52790445227583,31,21,10,47,34,13,67,41,26,2,1,0,0
"11112","L.A","S.J",2018020016,17809,20182019,1,62.9,2,3,-1,4.23269284679554,5.17360584821206,-0.940913001416519,21,33,-12,38,56,-18,53,68,-15,5,3,0,0
"11113","L.A","DET",2018020031,17811,20182019,1,60,4,2,2,3.40592044906225,4.5083335408126,-1.10241309175035,25,38,-13,33,55,-22,47,73,-26,4,6,0,0
"11114","L.A","WPG",2018020040,17813,20182019,0,60,1,2,-1,3.05050344891379,4.0601673045494,-1.00966385563561,17,39,-22,27,49,-22,42,70,-28,2,3,0,0
"11115","L.A","MTL",2018020051,17815,20182019,0,60,3,0,3,2.09001526911217,4.54104574197683,-2.45103047286466,29,40,-11,30,51,-21,41,73,-32,3,4,0,0
"11116","L.A","TOR",2018020074,17819,20182019,0,60,1,4,-3,6.02979497605702,3.46497569339954,2.56481928265748,34,25,9,51,34,17,72,55,17,3,2,0,0
"11117","L.A","NYI",2018020097,17822,20182019,1,60,2,7,-5,2.34061061858228,4.97916746297415,-2.63855684439187,35,32,3,49,42,7,63,52,11,4,3,0,0
"11118","L.A","DAL",2018020128,17827,20182019,0,60,2,4,-2,5.82992441016904,4.41864953521872,1.41127487495032,33,23,10,51,34,17,70,43,27,3,3,0,0
"11119","L.A","MIN",2018020138,17829,20182019,0,60,1,4,-3,5.11939546943154,6.50878636492416,-1.38939089549262,24,26,-2,36,34,2,51,47,4,5,5,0,0
"11120","L.A","NYR",2018020159,17832,20182019,1,60,4,3,1,5.24144685361534,6.3470583192684,-1.10561146565306,40,25,15,51,37,14,70,51,19,4,3,0,0
"11121","L.A","PHI",2018020190,17836,20182019,1,60,2,5,-3,6.64677080611204,5.04292322266701,1.60384758344503,27,31,-4,44,45,-1,55,53,2,5,1,0,0
"11122","L.A","CBJ",2018020205,17838,20182019,1,60,4,1,3,4.35179949878907,4.21322855429787,0.1385709444912,29,27,2,47,45,2,55,53,2,5,5,0,0
"11123","L.A","ANA",2018020222,17841,20182019,1,60,4,1,3,5.78017620521132,3.34744321578182,2.4327329894295,27,31,-4,40,43,-3,49,66,-17,1,4,0,0
"11124","L.A","MIN",2018020235,17843,20182019,1,60,1,3,-2,3.68181588159499,3.13649029348744,0.545325588107545,28,24,4,47,38,9,65,52,13,3,3,0,0
"11125","L.A","TOR",2018020271,17848,20182019,1,60,1,5,-4,5.45902235424555,6.88099954265383,-1.42197718840828,23,35,-12,35,50,-15,50,65,-15,2,5,0,0
"11126","L.A","CHI",2018020288,17851,20182019,0,65,1,1,0,7.384946896017,6.21447719965363,1.17046969636337,32,35,-3,44,45,-1,56,59,-3,1,3,0,0
"11127","L.A","COL",2018020331,17856,20182019,1,60,3,7,-4,6.93549765681382,7.04459017772808,-0.10909252091426,36,34,2,53,46,7,63,52,11,4,5,0,0
"11128","L.A","VAN",2018020357,17859,20182019,1,60,2,4,-2,4.6290753004796,3.2107424833257,1.4183328171539,22,29,-7,40,40,0,56,48,8,4,2,0,0
"11129","L.A","EDM",2018020361,17860,20182019,1,60,5,2,3,3.42947301395225,3.11409831073667,0.315374703215575,32,34,-2,48,50,-2,66,64,2,5,3,0,0
"11130","L.A","VAN",2018020376,17862,20182019,0,60.8833333333333,2,1,1,3.75604788231431,3.75456054693619,0.00148733537811641,25,33,-8,33,44,-11,49,62,-13,3,2,0,0
"11131","L.A","EDM",2018020388,17864,20182019,0,60,2,3,-1,3.26921994693112,7.17476146169429,-3.90554151476317,32,34,-2,41,51,-10,63,69,-6,3,3,0,0
"11132","L.A","CAR",2018020412,17867,20182019,1,60,2,0,2,4.58365817968479,4.54649426104152,0.0371639186432731,35,34,1,46,49,-3,56,69,-13,4,3,0,0
"11133","L.A","ARI",2018020425,17869,20182019,1,60,1,2,-1,3.37366066103857,3.55111611291068,-0.177455451872106,26,20,6,41,32,9,59,50,9,2,4,0,0
"11134","L.A","N.J",2018020439,17871,20182019,1,60,3,6,-3,3.89688604228309,6.62160207079796,-2.72471602851488,32,35,-3,45,45,0,57,62,-5,3,4,0,0
"11135","L.A","VGK",2018020445,17873,20182019,1,60,5,1,4,6.12570744025288,3.03136896887372,3.09433847137916,25,30,-5,36,41,-5,41,53,-12,1,3,0,0
"11136","L.A","DET",2018020462,17875,20182019,0,60,1,3,-2,5.14746628438648,2.6002305546614,2.54723572972508,43,21,22,63,35,28,81,43,38,1,1,0,0
"11137","L.A","CBJ",2018020480,17878,20182019,0,60,1,4,-3,4.15072186157809,3.92913911461847,0.221582746959626,30,41,-11,45,48,-3,60,59,1,3,3,0,0
"11138","L.A","PIT",2018020499,17880,20182019,0,63.9833333333333,3,4,-1,4.04209708671988,4.62591706642002,-0.583819979700138,41,36,5,45,43,2,59,54,5,3,3,0,0
"11139","L.A","WPG",2018020527,17883,20182019,1,60,4,1,3,6.51483896555874,3.87384946535894,2.64098950019979,31,28,3,44,39,5,52,57,-5,3,3,0,0
"11140","L.A","S.J",2018020550,17887,20182019,0,62.4833333333333,3,2,1,2.51600954169953,4.07579440902555,-1.55978486732602,31,31,0,35,47,-12,46,76,-30,1,1,0,0
"11141","L.A","VGK",2018020565,17888,20182019,0,61.6666666666667,4,3,1,5.19341680518119,4.32318969600601,0.870227109175175,32,25,7,39,37,2,54,53,1,2,1,0,0
"11142","L.A","ARI",2018020578,17892,20182019,1,60,2,1,1,3.37007080287731,4.3165035115635,-0.946432708686189,26,27,-1,36,39,-3,49,51,-2,3,4,0,0
"11143","L.A","VGK",2018020586,17894,20182019,1,60,1,4,-3,2.50059128785506,5.4122161866643,-2.91162489880924,31,32,-1,41,50,-9,51,67,-16,2,1,0,0
"11144","L.A","COL",2018020607,17896,20182019,0,60.9,3,2,1,4.25240147173463,5.46421524882317,-1.21181377708854,18,24,-6,31,35,-4,39,55,-16,3,3,0,0
"11145","L.A","VGK",2018020614,17897,20182019,0,60,0,2,-2,1.57390825508628,6.63662918454156,-5.06272092945528,17,48,-31,21,66,-45,37,88,-51,2,3,0,0
"11146","L.A","T.B",2018020628,17899,20182019,1,60,2,6,-4,4.57607562753358,6.95611905556609,-2.38004342803251,30,33,-3,42,51,-9,56,59,-3,7,5,0,0
"11147","L.A","EDM",2018020643,17901,20182019,1,60,4,0,4,3.00556953246996,2.31025998553156,0.695309546938404,23,16,7,31,28,3,39,43,-4,5,5,0,0
"11148","L.A","S.J",2018020656,17903,20182019,0,60,1,3,-2,2.66685418304354,3.2035133707468,-0.536659187703266,23,29,-6,28,40,-12,44,60,-16,0,3,0,0
"11149","L.A","PIT",2018020698,17908,20182019,1,60,5,2,3,4.46330333691731,6.53491018272775,-2.07160684581044,25,40,-15,36,61,-25,46,78,-32,3,4,0,0
"11150","L.A","MIN",2018020717,17911,20182019,0,65,2,2,0,5.17212234452702,5.45124027717975,-0.279117932652731,33,42,-9,44,52,-8,58,62,-4,1,2,0,0
"11151","L.A","DAL",2018020732,17913,20182019,0,60,2,1,1,3.73908017587462,6.8657237153966,-3.12664353952198,19,30,-11,32,57,-25,54,81,-27,1,2,0,0
"11152","L.A","COL",2018020741,17915,20182019,0,60,1,7,-6,4.03123564235284,3.35480445542839,0.676431186924447,31,40,-9,41,51,-10,55,71,-16,4,6,0,0
"11153","L.A","NYI",2018020794,17929,20182019,0,60,2,4,-2,3.79353946947086,5.14951825217577,-1.35597878270491,36,32,4,50,38,12,65,52,13,3,2,0,0
"11154","L.A","NYR",2018020806,17931,20182019,0,60.4166666666667,4,3,1,2.93310191212311,3.35527988147805,-0.422177969354946,30,27,3,34,36,-2,41,45,-4,2,2,0,0
"11155","L.A","N.J",2018020812,17932,20182019,0,60,5,1,4,3.27248383636788,3.19834822067432,0.0741356156935638,25,30,-5,35,42,-7,47,58,-11,4,7,0,0
"11156","L.A","PHI",2018020826,17934,20182019,0,65,2,2,0,4.43108547407019,3.75276579678757,0.678319677282616,39,32,7,52,46,6,62,62,0,0,2,0,0
"11157","L.A","BOS",2018020838,17936,20182019,0,62.5666666666667,4,5,-1,3.24859213658194,3.25922449599238,-0.0106323594104456,29,33,-4,39,44,-5,58,58,0,5,3,0,0
"11158","L.A","VAN",2018020886,17941,20182019,1,65,3,3,0,4.36417359873303,6.25054943466185,-1.88637583592882,38,27,11,53,41,12,64,54,10,3,2,0,0
"11159","L.A","BOS",2018020903,17943,20182019,1,60,2,4,-2,3.75542902506389,4.03477236476845,-0.27934333970456,25,24,1,32,37,-5,49,46,3,5,2,0,0
"11160","L.A","T.B",2018020964,17952,20182019,0,65,3,3,0,4.23307414370356,4.86596974796487,-0.632895604261307,33,34,-1,42,57,-15,54,66,-12,4,4,0,0
"11161","L.A","CAR",2018020972,17953,20182019,0,60,1,6,-5,3.19096144230571,5.19807973271236,-2.00711829040665,23,34,-11,32,61,-29,45,80,-35,1,2,0,0
"11162","L.A","DAL",2018020990,17955,20182019,1,63.3166666666667,3,4,-1,6.14053695172075,4.5927653954196,1.54777155630115,30,33,-3,47,44,3,62,58,4,3,4,0,0
"11163","L.A","CHI",2018021000,17957,20182019,1,60,6,3,3,5.15644676974625,6.00785043362703,-0.851403663880774,25,32,-7,34,49,-15,42,65,-23,3,3,0,0
"11164","L.A","MTL",2018021028,17960,20182019,1,60,1,3,-2,4.66325623478042,2.51615015965945,2.14710607512097,27,24,3,37,36,1,53,47,6,2,1,0,0
"11165","L.A","ARI",2018021058,17964,20182019,0,60,2,4,-2,6.47286824545229,7.88324801373528,-1.41037976828299,36,32,4,55,48,7,74,63,11,2,5,0,0
"11166","L.A","ANA",2018021064,17965,20182019,0,60,3,2,1,3.63076572376303,1.79619883414125,1.83456688962178,25,20,5,38,35,3,55,46,9,4,2,0,0
"11167","L.A","WPG",2018021120,17973,20182019,1,60,2,3,-1,2.4162576138333,4.7975728374297,-2.3813152235964,17,28,-11,36,43,-7,53,48,5,3,2,0,0
"11168","L.A","S.J",2018021147,17976,20182019,1,60,4,2,2,7.555497310188,4.95920384287456,2.59629346731344,35,25,10,44,42,2,48,60,-12,1,3,0,0
"11169","L.A","ANA",2018021163,17978,20182019,1,65,3,3,0,5.05335501288937,3.30775199589425,1.74560301699512,30,20,10,45,35,10,55,48,7,5,4,0,0
"11170","L.A","CGY",2018021176,17980,20182019,0,60,3,0,3,4.46842741132423,4.68364893674152,-0.215221525417292,20,42,-22,26,54,-28,37,76,-39,5,6,0,0
"11171","L.A","EDM",2018021182,17981,20182019,0,60,4,8,-4,3.67336693181278,5.06529782050347,-1.39193088869069,38,32,6,54,43,11,80,53,27,5,2,0,0
"11172","L.A","VAN",2018021195,17983,20182019,0,65,2,2,0,5.13647993348422,4.2186429826376,0.917836950846628,39,38,1,59,50,9,78,71,7,5,2,0,0
"11173","L.A","CHI",2018021214,17985,20182019,1,64.8,3,2,1,2.98079631550469,3.37448582438844,-0.393689508883751,29,35,-6,38,55,-17,48,67,-19,3,3,0,0
"11174","L.A","CGY",2018021228,17987,20182019,1,60,2,7,-5,4.22337243659422,4.22030057310985,0.00307186348436517,25,30,-5,40,45,-5,52,57,-5,3,1,0,0
"11175","L.A","ARI",2018021238,17988,20182019,0,60,3,1,2,4.07012155470795,6.66795878946141,-2.59783723475346,24,50,-26,32,67,-35,46,81,-35,1,6,0,0
"11176","L.A","ANA",2018021256,17991,20182019,0,60,2,5,-3,6.49229038860883,3.37290810218983,3.119382286419,47,33,14,64,43,21,75,54,21,5,1,0,0
"11177","L.A","VGK",2018021270,17992,20182019,1,60,5,2,3,5.77250028458366,6.82909879283896,-1.0565985082553,32,31,1,43,46,-3,59,62,-3,3,2,0,0
"11178","MIN","BOS",2008020025,14163,20082009,1,60,4,3,1,0,0,0,26,37,-11,36,52,-16,44,63,-19,5,5,0,0
"11179","MIN","ATL",2008020040,14166,20082009,0,60,4,2,2,0,0,0,26,26,0,36,43,-7,44,51,-7,5,4,0,0
"11180","MIN","FLA",2008020052,14168,20082009,0,60,6,2,4,0,0,0,34,26,8,42,38,4,49,53,-4,8,6,0,0
"11181","MIN","T.B",2008020071,14170,20082009,0,65,0,0,0,0,0,0,21,32,-11,29,43,-14,38,59,-21,7,3,0,0
"11182","MIN","BUF",2008020096,14175,20082009,1,60.7333333333333,3,4,-1,0,0,0,33,24,9,39,33,6,50,41,9,3,2,0,0
"11183","MIN","CBJ",2008020113,14177,20082009,1,60,2,1,1,0,0,0,23,26,-3,32,36,-4,51,50,1,4,2,0,0
"11184","MIN","CHI",2008020123,14179,20082009,1,60,3,2,1,0,0,0,18,36,-18,32,49,-17,40,62,-22,5,4,0,0
"11185","MIN","DAL",2008020134,14181,20082009,0,60,2,4,-2,0,0,0,21,33,-12,32,42,-10,45,52,-7,4,5,0,0
"11186","MIN","MTL",2008020141,14182,20082009,1,60,1,2,-1,0,0,0,29,21,8,37,32,5,54,40,14,11,6,0,0
"11187","MIN","ARI",2008020160,14184,20082009,0,60,3,2,1,0,0,0,33,27,6,44,33,11,51,44,7,2,4,0,0
"11188","MIN","S.J",2008020177,14187,20082009,0,60,1,3,-2,0,0,0,24,49,-25,34,62,-28,44,73,-29,3,6,0,0
"11189","MIN","COL",2008020187,14189,20082009,0,60,3,1,2,0,0,0,20,36,-16,30,45,-15,39,60,-21,4,7,0,0
"11190","MIN","VAN",2008020205,14191,20082009,0,60,0,2,-2,0,0,0,29,29,0,41,41,0,55,58,-3,4,7,0,0
"11191","MIN","ARI",2008020232,14196,20082009,1,60,4,0,4,0,0,0,32,24,8,46,33,13,60,49,11,7,6,0,0
"11192","MIN","CBJ",2008020248,14198,20082009,1,65,2,2,0,0,0,0,30,26,4,41,30,11,46,37,9,3,1,0,0
"11193","MIN","PIT",2008020262,14201,20082009,0,65,1,1,0,0,0,0,25,25,0,36,40,-4,58,53,5,2,4,0,0
"11194","MIN","VAN",2008020274,14203,20082009,1,60,2,3,-1,0,0,0,30,27,3,41,35,6,60,44,16,3,4,0,0
"11195","MIN","STL",2008020292,14205,20082009,1,60,1,2,-1,0,0,0,32,26,6,48,32,16,68,44,24,4,2,0,0
"11196","MIN","WSH",2008020303,14207,20082009,1,60,4,3,1,0,0,0,33,28,5,40,38,2,50,57,-7,6,3,0,0
"11197","MIN","DAL",2008020317,14209,20082009,1,60,3,4,-1,0,0,0,28,30,-2,45,42,3,53,55,-2,4,4,0,0
"11198","MIN","T.B",2008020325,14211,20082009,1,60,4,2,2,0,0,0,33,37,-4,49,48,1,58,61,-3,3,5,0,0
"11199","MIN","NSH",2008020342,14212,20082009,0,60,6,2,4,0,0,0,29,27,2,37,44,-7,46,54,-8,12,5,0,0
"11200","MIN","COL",2008020353,14214,20082009,1,60,5,6,-1,0,0,0,17,31,-14,27,38,-11,43,49,-6,4,3,0,0
"11201","MIN","STL",2008020363,14216,20082009,1,60,4,0,4,0,0,0,38,22,16,49,34,15,61,42,19,5,3,0,0
"11202","MIN","VAN",2008020376,14218,20082009,1,60,1,2,-1,0,0,0,17,31,-14,31,41,-10,45,58,-13,4,4,0,0
"11203","MIN","NSH",2008020388,14219,20082009,0,60,0,1,-1,0,0,0,32,43,-11,43,53,-10,55,65,-10,3,3,0,0
"11204","MIN","ARI",2008020419,14224,20082009,0,60,1,3,-2,0,0,0,31,32,-1,46,39,7,62,55,7,5,5,0,0
"11205","MIN","L.A",2008020430,14226,20082009,0,60,1,3,-2,0,0,0,34,43,-9,41,57,-16,50,70,-20,4,5,0,0
"11206","MIN","ANA",2008020442,14227,20082009,0,60,2,4,-2,0,0,0,28,34,-6,37,45,-8,42,52,-10,4,4,0,0
"11207","MIN","CGY",2008020457,14230,20082009,1,63.8,2,3,-1,0,0,0,27,30,-3,43,40,3,57,55,2,3,3,0,0
"11208","MIN","NYI",2008020471,14232,20082009,1,60,4,1,3,0,0,0,39,16,23,52,19,33,63,31,32,4,5,0,0
"11209","MIN","STL",2008020482,14233,20082009,0,60,2,4,-2,0,0,0,26,24,2,39,39,0,53,47,6,6,4,0,0
"11210","MIN","CAR",2008020503,14236,20082009,1,60,3,2,1,0,0,0,23,37,-14,33,47,-14,50,56,-6,1,4,0,0
"11211","MIN","CHI",2008020529,14241,20082009,1,60,1,4,-3,0,0,0,19,32,-13,28,44,-16,42,68,-26,2,4,0,0
"11212","MIN","CGY",2008020537,14242,20082009,0,60,1,2,-1,0,0,0,24,29,-5,42,42,0,53,57,-4,4,2,0,0
"11213","MIN","S.J",2008020548,14244,20082009,1,61.6333333333333,3,2,1,0,0,0,32,34,-2,40,48,-8,54,58,-4,3,2,0,0
"11214","MIN","DET",2008020571,14247,20082009,1,65,2,2,0,0,0,0,35,37,-2,53,51,2,63,67,-4,4,2,0,0
"11215","MIN","COL",2008020580,14248,20082009,0,60,2,0,2,0,0,0,37,33,4,50,48,2,66,75,-9,7,4,0,0
"11216","MIN","BOS",2008020585,14250,20082009,0,60,1,0,1,0,0,0,24,28,-4,37,39,-2,46,48,-2,6,3,0,0
"11217","MIN","PHI",2008020600,14252,20082009,0,60,1,3,-2,0,0,0,28,23,5,42,26,16,54,36,18,10,3,0,0
"11218","MIN","CBJ",2008020621,14254,20082009,0,60,2,4,-2,0,0,0,23,32,-9,32,42,-10,37,48,-11,3,2,0,0
"11219","MIN","ARI",2008020638,14257,20082009,1,60,6,3,3,0,0,0,34,24,10,44,37,7,60,43,17,6,3,0,0
"11220","MIN","EDM",2008020650,14259,20082009,1,60,5,1,4,0,0,0,24,21,3,36,32,4,46,44,2,7,5,0,0
"11221","MIN","ANA",2008020670,14261,20082009,1,60,0,3,-3,0,0,0,30,34,-4,48,43,5,59,52,7,4,1,0,0
"11222","MIN","CHI",2008020682,14263,20082009,0,60,4,1,3,0,0,0,26,41,-15,34,49,-15,40,57,-17,3,3,0,0
"11223","MIN","L.A",2008020688,14264,20082009,1,60,2,5,-3,0,0,0,27,32,-5,38,47,-9,55,57,-2,5,5,0,0
"11224","MIN","TOR",2008020707,14271,20082009,1,60,6,1,5,0,0,0,21,28,-7,31,45,-14,42,62,-20,4,1,0,0
"11225","MIN","EDM",2008020729,14274,20082009,0,60,1,3,-2,0,0,0,30,28,2,36,36,0,55,48,7,3,5,0,0
"11226","MIN","VAN",2008020740,14275,20082009,0,61.8666666666667,4,3,1,0,0,0,27,40,-13,34,58,-24,48,76,-28,5,3,0,0
"11227","MIN","ANA",2008020763,14279,20082009,1,60,3,0,3,0,0,0,25,34,-9,40,46,-6,48,62,-14,3,5,0,0
"11228","MIN","NSH",2008020775,14281,20082009,1,60,0,2,-2,0,0,0,22,26,-4,34,34,0,56,42,14,7,5,0,0
"11229","MIN","EDM",2008020791,14283,20082009,1,65,2,2,0,0,0,0,39,30,9,56,38,18,62,52,10,3,6,0,0
"11230","MIN","COL",2008020807,14286,20082009,1,60,3,2,1,0,0,0,26,22,4,39,36,3,46,54,-8,4,6,0,0
"11231","MIN","DET",2008020814,14287,20082009,0,60,2,4,-2,0,0,0,23,43,-20,32,65,-33,40,79,-39,3,5,0,0
"11232","MIN","OTT",2008020831,14289,20082009,1,60,3,5,-2,0,0,0,29,22,7,42,38,4,54,50,4,5,2,0,0
"11233","MIN","CGY",2008020867,14294,20082009,1,63.8333333333333,2,3,-1,0,0,0,27,22,5,41,34,7,56,41,15,1,2,0,0
"11234","MIN","DET",2008020884,14296,20082009,1,60,5,2,3,0,0,0,29,37,-8,39,53,-14,47,76,-29,3,5,0,0
"11235","MIN","CHI",2008020891,14297,20082009,0,60,2,1,1,0,0,0,24,45,-21,28,55,-27,43,63,-20,6,7,0,0
"11236","MIN","L.A",2008020900,14299,20082009,1,65,1,1,0,0,0,0,24,25,-1,34,38,-4,45,53,-8,4,5,0,0
"11237","MIN","CGY",2008020921,14302,20082009,0,60,1,4,-3,0,0,0,16,29,-13,25,37,-12,32,51,-19,6,6,0,0
"11238","MIN","EDM",2008020933,14303,20082009,0,60,2,3,-1,0,0,0,45,30,15,57,40,17,73,53,20,6,4,0,0
"11239","MIN","VAN",2008020951,14306,20082009,0,60,2,4,-2,0,0,0,19,32,-13,29,42,-13,35,56,-21,2,2,0,0
"11240","MIN","S.J",2008020963,14308,20082009,0,64.7666666666667,4,3,1,0,0,0,36,35,1,42,48,-6,58,64,-6,0,2,0,0
"11241","MIN","L.A",2008020971,14310,20082009,0,60,3,4,-1,0,0,0,24,24,0,33,39,-6,44,52,-8,2,3,0,0
"11242","MIN","ANA",2008020985,14311,20082009,0,60,3,2,1,0,0,0,25,38,-13,32,54,-22,39,63,-24,4,3,0,0
"11243","MIN","S.J",2008020997,14313,20082009,1,63.5666666666667,4,5,-1,0,0,0,29,23,6,35,28,7,55,45,10,3,3,0,0
"11244","MIN","COL",2008021014,14315,20082009,0,65,1,1,0,0,0,0,17,41,-24,32,52,-20,46,65,-19,5,5,0,0
"11245","MIN","DAL",2008021027,14317,20082009,0,62.3833333333333,2,3,-1,0,0,0,30,29,1,47,45,2,60,59,1,3,3,0,0
"11246","MIN","STL",2008021035,14318,20082009,0,60,3,5,-2,0,0,0,22,36,-14,33,49,-16,47,65,-18,3,7,0,0
"11247","MIN","COL",2008021047,14320,20082009,1,65,2,2,0,0,0,0,29,26,3,41,37,4,66,49,17,3,1,0,0
"11248","MIN","N.J",2008021063,14323,20082009,0,60,0,4,-4,0,0,0,35,29,6,46,41,5,68,50,18,7,3,0,0
"11249","MIN","EDM",2008021081,14325,20082009,1,60,3,0,3,0,0,0,36,31,5,45,43,2,55,59,-4,6,6,0,0
"11250","MIN","NYR",2008021089,14327,20082009,0,60,1,2,-1,0,0,0,19,30,-11,24,44,-20,36,54,-18,3,6,0,0
"11251","MIN","NYI",2008021097,14328,20082009,0,60,6,2,4,0,0,0,28,34,-6,44,47,-3,57,61,-4,11,8,0,0
"11252","MIN","CGY",2008021125,14331,20082009,0,60,2,3,-1,0,0,0,15,40,-25,24,53,-29,35,68,-33,2,4,0,0
"11253","MIN","EDM",2008021132,14332,20082009,0,60,3,2,1,0,0,0,21,33,-12,34,46,-12,45,58,-13,5,5,0,0
"11254","MIN","VAN",2008021141,14334,20082009,1,64,1,2,-1,0,0,0,34,19,15,52,33,19,65,44,21,5,2,0,0
"11255","MIN","CGY",2008021162,14337,20082009,1,60,4,0,4,0,0,0,28,27,1,38,41,-3,47,51,-4,4,5,0,0
"11256","MIN","DET",2008021177,14339,20082009,0,60,2,3,-1,0,0,0,23,44,-21,25,57,-32,32,70,-38,2,2,0,0
"11257","MIN","DAL",2008021192,14341,20082009,1,60,3,1,2,0,0,0,32,28,4,42,43,-1,51,51,0,5,2,0,0
"11258","MIN","NSH",2008021210,14344,20082009,1,60,8,4,4,0,0,0,37,35,2,49,45,4,55,57,-2,6,5,0,0
"11259","MIN","CBJ",2008021224,14345,20082009,0,60,6,3,3,0,0,0,28,28,0,38,36,2,45,47,-2,6,3,0,0
"11260","MIN","CBJ",2009020018,14520,20092010,0,60,1,2,-1,0,0,0,33,39,-6,38,47,-9,46,57,-11,4,2,0,0
"11261","MIN","ANA",2009020029,14523,20092010,1,63.1333333333333,4,3,1,0,0,0,32,19,13,48,27,21,65,35,30,7,4,0,0
"11262","MIN","L.A",2009020045,14525,20092010,0,60,3,6,-3,0,0,0,29,23,6,39,32,7,54,43,11,4,4,0,0
"11263","MIN","S.J",2009020061,14527,20092010,0,60,2,4,-2,0,0,0,40,29,11,54,37,17,71,51,20,8,5,0,0
"11264","MIN","ANA",2009020079,14531,20092010,0,60,2,3,-1,0,0,0,34,35,-1,50,47,3,60,57,3,4,4,0,0
"11265","MIN","EDM",2009020092,14533,20092010,0,60,2,5,-3,0,0,0,31,19,12,46,35,11,55,53,2,4,5,0,0
"11266","MIN","VAN",2009020104,14534,20092010,0,60,1,2,-1,0,0,0,18,39,-21,25,50,-25,41,66,-25,4,5,0,0
"11267","MIN","COL",2009020115,14538,20092010,1,65,2,2,0,0,0,0,26,35,-9,45,45,0,58,48,10,7,2,0,0
"11268","MIN","STL",2009020128,14540,20092010,0,60,1,3,-2,0,0,0,21,26,-5,30,40,-10,43,51,-8,3,6,0,0
"11269","MIN","CAR",2009020139,14541,20092010,1,61.9166666666667,3,2,1,0,0,0,29,23,6,46,41,5,63,54,9,9,5,0,0
"11270","MIN","CHI",2009020150,14543,20092010,0,60,1,3,-2,0,0,0,21,35,-14,29,40,-11,46,56,-10,7,5,0,0
"11271","MIN","NSH",2009020161,14545,20092010,1,60,3,4,-1,0,0,0,22,22,0,31,38,-7,44,53,-9,3,4,0,0
"11272","MIN","NYR",2009020175,14547,20092010,1,60,3,2,1,0,0,0,32,20,12,47,33,14,58,40,18,3,2,0,0
"11273","MIN","PIT",2009020186,14548,20092010,0,60,2,1,1,0,0,0,15,35,-20,19,49,-30,34,60,-26,4,6,0,0
"11274","MIN","VAN",2009020214,14553,20092010,1,60,2,5,-3,0,0,0,30,22,8,50,34,16,63,41,22,5,4,0,0
"11275","MIN","DAL",2009020234,14555,20092010,1,60,3,2,1,0,0,0,37,21,16,48,33,15,59,43,16,6,7,0,0
"11276","MIN","TOR",2009020242,14558,20092010,0,60,5,2,3,0,0,0,31,39,-8,36,52,-16,50,71,-21,4,4,0,0
"11277","MIN","T.B",2009020257,14560,20092010,0,65,3,3,0,0,0,0,34,22,12,44,32,12,55,41,14,5,5,0,0
"11278","MIN","WSH",2009020262,14561,20092010,0,60,1,3,-2,0,0,0,30,41,-11,38,55,-17,51,69,-18,3,3,0,0
"11279","MIN","CAR",2009020280,14563,20092010,0,65,4,4,0,0,0,0,32,35,-3,49,50,-1,61,59,2,3,6,0,0
"11280","MIN","ARI",2009020296,14566,20092010,1,60,2,3,-1,0,0,0,26,32,-6,39,45,-6,52,59,-7,3,2,0,0
"11281","MIN","NYI",2009020310,14568,20092010,1,60,3,2,1,0,0,0,29,29,0,40,40,0,54,52,2,6,7,0,0
"11282","MIN","BOS",2009020346,14573,20092010,1,65,1,1,0,0,0,0,29,16,13,49,29,20,62,52,10,6,4,0,0
"11283","MIN","COL",2009020358,14575,20092010,1,60,5,3,2,0,0,0,32,34,-2,45,46,-1,61,55,6,4,4,0,0
"11284","MIN","COL",2009020377,14576,20092010,0,65,2,2,0,0,0,0,36,22,14,49,27,22,66,35,31,4,1,0,0
"11285","MIN","NSH",2009020397,14580,20092010,1,61.4333333333333,5,4,1,0,0,0,27,35,-8,41,45,-4,52,54,-2,2,2,0,0
"11286","MIN","ANA",2009020411,14582,20092010,1,65,4,4,0,0,0,0,29,22,7,44,28,16,61,40,21,3,3,0,0
"11287","MIN","NSH",2009020424,14583,20092010,0,60,5,3,2,0,0,0,39,29,10,47,38,9,61,54,7,4,5,0,0
"11288","MIN","ARI",2009020436,14585,20092010,0,60,0,2,-2,0,0,0,28,31,-3,34,43,-9,40,51,-11,6,5,0,0
"11289","MIN","COL",2009020449,14587,20092010,0,60,1,0,1,0,0,0,22,22,0,28,32,-4,40,48,-8,3,6,0,0
"11290","MIN","CGY",2009020464,14589,20092010,0,63.25,2,1,1,0,0,0,46,23,23,59,29,30,72,46,26,6,4,0,0
"11291","MIN","VAN",2009020476,14590,20092010,0,60,3,4,-1,0,0,0,41,29,12,48,43,5,58,58,0,4,5,0,0
"11292","MIN","CBJ",2009020491,14593,20092010,1,60,2,1,1,0,0,0,23,22,1,38,33,5,48,41,7,1,1,0,0
"11293","MIN","MTL",2009020502,14595,20092010,0,60,3,1,2,0,0,0,21,31,-10,32,46,-14,42,64,-22,1,2,0,0
"11294","MIN","OTT",2009020522,14597,20092010,0,60,1,4,-3,0,0,0,23,24,-1,33,33,0,45,46,-1,6,3,0,0
"11295","MIN","COL",2009020538,14599,20092010,1,60,3,4,-1,0,0,0,31,21,10,41,24,17,56,41,15,5,6,0,0
"11296","MIN","EDM",2009020551,14601,20092010,1,60,3,1,2,0,0,0,27,31,-4,45,37,8,67,50,17,7,5,0,0
"11297","MIN","STL",2009020565,14604,20092010,1,60,4,3,1,0,0,0,20,18,2,34,28,6,43,37,6,5,5,0,0
"11298","MIN","L.A",2009020582,14606,20092010,0,60,4,3,1,0,0,0,23,32,-9,31,49,-18,34,62,-28,2,1,0,0
"11299","MIN","ANA",2009020589,14607,20092010,0,60,2,4,-2,0,0,0,31,32,-1,44,40,4,53,50,3,5,4,0,0
"11300","MIN","L.A",2009020605,14609,20092010,1,60,2,5,-3,0,0,0,29,29,0,38,32,6,49,49,0,6,5,0,0
"11301","MIN","N.J",2009020620,14611,20092010,1,60,3,5,-2,0,0,0,32,26,6,49,33,16,59,45,14,2,3,0,0
"11302","MIN","CHI",2009020635,14614,20092010,0,60,1,4,-3,0,0,0,20,33,-13,27,39,-12,41,53,-12,3,4,0,0
"11303","MIN","CGY",2009020642,14615,20092010,1,60,4,1,3,0,0,0,35,26,9,50,38,12,65,49,16,5,2,0,0
"11304","MIN","CHI",2009020668,14618,20092010,1,65,5,5,0,0,0,0,21,25,-4,27,32,-5,40,45,-5,2,2,0,0
"11305","MIN","PIT",2009020676,14620,20092010,1,60,4,3,1,0,0,0,24,38,-14,37,49,-12,48,60,-12,3,7,0,0
"11306","MIN","VAN",2009020689,14622,20092010,1,60,5,2,3,0,0,0,22,31,-9,33,39,-6,46,54,-8,7,7,0,0
"11307","MIN","STL",2009020699,14623,20092010,0,60,0,1,-1,0,0,0,19,37,-18,28,47,-19,41,59,-18,5,3,0,0
"11308","MIN","ARI",2009020717,14625,20092010,0,60,4,6,-2,0,0,0,22,33,-11,38,42,-4,48,64,-16,4,6,0,0
"11309","MIN","DAL",2009020730,14627,20092010,0,60,3,4,-1,0,0,0,25,29,-4,41,41,0,51,51,0,4,5,0,0
"11310","MIN","DET",2009020751,14630,20092010,1,65,3,3,0,0,0,0,30,29,1,41,50,-9,53,63,-10,1,3,0,0
"11311","MIN","CBJ",2009020769,14632,20092010,1,60,4,2,2,0,0,0,28,24,4,38,36,2,50,47,3,6,3,0,0
"11312","MIN","DET",2009020790,14636,20092010,1,60,5,2,3,0,0,0,25,28,-3,39,36,3,50,52,-2,8,4,0,0
"11313","MIN","COL",2009020797,14637,20092010,0,60,1,0,1,0,0,0,26,29,-3,33,39,-6,51,56,-5,5,2,0,0
"11314","MIN","S.J",2009020816,14639,20092010,0,60,2,5,-3,0,0,0,38,36,2,49,47,2,62,61,1,5,7,0,0
"11315","MIN","DAL",2009020832,14642,20092010,0,60,2,4,-2,0,0,0,42,18,24,62,27,35,77,37,40,4,3,0,0
"11316","MIN","EDM",2009020848,14644,20092010,1,60,4,2,2,0,0,0,36,32,4,47,44,3,64,50,14,3,4,0,0
"11317","MIN","PHI",2009020867,14646,20092010,1,60,2,1,1,0,0,0,30,39,-9,45,49,-4,53,64,-11,5,5,0,0
"11318","MIN","ARI",2009020888,14650,20092010,1,60,2,3,-1,0,0,0,31,31,0,43,41,2,56,50,6,2,2,0,0
"11319","MIN","ATL",2009020903,14652,20092010,1,60,2,3,-1,0,0,0,38,24,14,47,38,9,61,54,7,3,8,0,0
"11320","MIN","VAN",2009020918,14654,20092010,1,60,6,2,4,0,0,0,41,29,12,54,35,19,66,43,23,8,2,0,0
"11321","MIN","CGY",2009020939,14671,20092010,0,60,4,0,4,0,0,0,21,29,-8,29,43,-14,33,59,-26,0,2,0,0
"11322","MIN","EDM",2009020954,14673,20092010,0,65,1,1,0,0,0,0,29,23,6,41,43,-2,57,57,0,5,4,0,0
"11323","MIN","CGY",2009020967,14675,20092010,1,60,2,5,-3,0,0,0,29,24,5,40,37,3,58,44,14,4,5,0,0
"11324","MIN","FLA",2009020981,14677,20092010,1,65,2,2,0,0,0,0,11,31,-20,19,45,-26,39,67,-28,2,5,0,0
"11325","MIN","DET",2009020996,14679,20092010,0,60,1,5,-4,0,0,0,22,30,-8,34,42,-8,40,56,-16,5,6,0,0
"11326","MIN","BUF",2009021002,14680,20092010,0,60,3,2,1,0,0,0,33,45,-12,38,54,-16,45,68,-23,3,7,0,0
"11327","MIN","STL",2009021021,14682,20092010,1,60,4,2,2,0,0,0,20,38,-18,30,57,-27,32,78,-46,4,7,0,0
"11328","MIN","EDM",2009021036,14684,20092010,1,60,4,2,2,0,0,0,28,36,-8,45,48,-3,58,62,-4,4,6,0,0
"11329","MIN","NSH",2009021049,14686,20092010,0,60,0,5,-5,0,0,0,17,37,-20,21,51,-30,39,63,-24,2,3,0,0
"11330","MIN","CBJ",2009021053,14687,20092010,0,60,2,4,-2,0,0,0,20,32,-12,29,38,-9,39,59,-20,3,5,0,0
"11331","MIN","CGY",2009021069,14689,20092010,1,60,4,3,1,0,0,0,21,32,-11,28,40,-12,35,57,-22,2,1,0,0
"11332","MIN","S.J",2009021086,14691,20092010,1,60,1,4,-3,0,0,0,19,17,2,35,35,0,46,52,-6,4,5,0,0
"11333","MIN","PHI",2009021099,14693,20092010,0,62.55,4,3,1,0,0,0,21,35,-14,35,51,-16,46,69,-23,4,5,0,0
"11334","MIN","DET",2009021108,14694,20092010,0,60,2,6,-4,0,0,0,27,42,-15,33,59,-26,37,74,-37,5,10,0,0
"11335","MIN","L.A",2009021131,14697,20092010,1,60,3,2,1,0,0,0,20,31,-11,25,45,-20,35,69,-34,3,5,0,0
"11336","MIN","CHI",2009021145,14699,20092010,1,60,0,4,-4,0,0,0,21,35,-14,33,51,-18,52,64,-12,3,1,0,0
"11337","MIN","S.J",2009021160,14701,20092010,1,60,2,3,-1,0,0,0,29,28,1,35,41,-6,47,48,-1,6,3,0,0
"11338","MIN","VAN",2009021178,14703,20092010,0,62.25,3,4,-1,0,0,0,27,40,-13,38,50,-12,55,71,-16,8,7,0,0
"11339","MIN","EDM",2009021181,14704,20092010,0,60,1,4,-3,0,0,0,26,31,-5,39,41,-2,56,59,-3,2,3,0,0
"11340","MIN","CGY",2009021204,14707,20092010,0,65,1,1,0,0,0,0,24,33,-9,27,41,-14,35,58,-23,6,6,0,0
"11341","MIN","DAL",2009021220,14709,20092010,1,65,3,3,0,0,0,0,27,26,1,40,35,5,46,46,0,3,4,0,0
"11342","MIN","CAR",2010020003,14889,20102011,1,60,3,4,-1,4.19284423772478,3.03147175791673,1.16137247980805,29,31,-2,37,40,-3,56,59,-3,5,5,0,0
"11343","MIN","CAR",2010020008,14890,20102011,0,65,1,1,0,5.5347172919719,4.51614154528943,1.01857574668247,42,37,5,58,43,15,70,58,12,6,7,0,0
"11344","MIN","EDM",2010020045,14896,20102011,1,60,4,2,2,4.74045537633356,3.52494578711776,1.2155095892158,24,26,-2,38,33,5,50,43,7,7,8,0,0
"11345","MIN","CBJ",2010020061,14898,20102011,1,60,2,3,-1,2.91392295464175,3.53011315481854,-0.616190200176788,23,25,-2,33,37,-4,51,46,5,5,4,0,0
"11346","MIN","VAN",2010020076,14901,20102011,1,60,6,2,4,4.16197202841005,5.65369519186788,-1.49172316345783,24,27,-3,34,41,-7,44,57,-13,4,7,0,0
"11347","MIN","EDM",2010020091,14903,20102011,0,60,4,2,2,4.52278089715401,4.58885741922429,-0.0660765220702837,25,36,-11,35,53,-18,45,71,-26,4,10,0,0
"11348","MIN","VAN",2010020097,14904,20102011,0,60,1,5,-4,3.40660147220034,5.69375128168031,-2.28714980947997,24,35,-11,36,55,-19,48,76,-28,4,5,0,0
"11349","MIN","L.A",2010020116,14907,20102011,1,65,2,2,0,2.62406490795547,5.56425013330387,-2.9401852253484,22,34,-12,36,55,-19,55,74,-19,3,7,0,0
"11350","MIN","WSH",2010020134,14910,20102011,1,60,2,1,1,3.30206027650274,3.67827172031139,-0.376211443808643,17,22,-5,27,40,-13,42,53,-11,5,2,0,0
"11351","MIN","CHI",2010020150,14912,20102011,1,60,1,3,-2,3.85523717591423,4.34603936679923,-0.490802190885006,26,32,-6,31,48,-17,52,59,-7,3,2,0,0
"11352","MIN","S.J",2010020162,14915,20102011,1,60,1,0,1,1.78609077554486,5.16846822242655,-3.38237744688169,16,36,-20,26,44,-18,39,59,-20,9,6,0,0
"11353","MIN","CGY",2010020183,14918,20102011,1,60,2,1,1,2.03192481108937,3.69296465214186,-1.6610398410525,23,34,-11,27,48,-21,36,71,-35,3,4,0,0
"11354","MIN","CBJ",2010020194,14919,20102011,0,60,3,2,1,4.83425307487721,5.30300880649065,-0.468755731613442,24,37,-13,32,48,-16,47,65,-18,4,4,0,0
"11355","MIN","ATL",2010020221,14924,20102011,0,60,1,5,-4,2.8730042518709,3.57471666741185,-0.701712415540946,33,34,-1,43,43,0,56,56,0,3,2,0,0
"11356","MIN","FLA",2010020230,14925,20102011,0,60,1,2,-1,5.01199211875351,3.41716668918855,1.59482542956496,23,27,-4,36,37,-1,55,53,2,4,5,0,0
"11357","MIN","T.B",2010020246,14927,20102011,0,60,4,1,3,3.39301074540759,4.32185681325361,-0.928846067846016,18,38,-20,27,57,-30,36,73,-37,4,4,0,0
"11358","MIN","ANA",2010020264,14930,20102011,1,63.6,2,1,1,3.50786319135022,3.62461755925324,-0.116754367903013,27,28,-1,43,41,2,53,51,2,1,1,0,0
"11359","MIN","DET",2010020275,14932,20102011,0,64.3,4,3,1,3.67459183512256,4.76316211159496,-1.0885702764724,27,44,-17,34,64,-30,45,76,-31,3,4,0,0
"11360","MIN","NYR",2010020290,14933,20102011,1,60,2,5,-3,5.08370599853606,2.80835980844038,2.27534619009568,28,30,-2,42,37,5,55,42,13,4,5,0,0
"11361","MIN","PHI",2010020317,14937,20102011,1,60,1,6,-5,4.34543989529865,4.00099837862945,0.344441516669207,16,28,-12,33,36,-3,46,50,-4,3,3,0,0
"11362","MIN","NSH",2010020325,14939,20102011,1,60,5,2,3,3.03809972308227,5.43128362037668,-2.39318389729441,23,34,-11,31,51,-20,40,59,-19,2,5,0,0
"11363","MIN","COL",2010020342,14940,20102011,0,60,4,7,-3,4.02542792021995,7.02954216036596,-3.00411424014601,32,40,-8,41,50,-9,51,63,-12,3,5,0,0
"11364","MIN","CGY",2010020351,14942,20102011,0,60,0,3,-3,5.17860772545868,4.89403022512325,0.28457750033543,32,31,1,43,47,-4,51,57,-6,3,3,0,0
"11365","MIN","ARI",2010020362,14944,20102011,1,60,2,4,-2,4.71127752622678,5.47510294303208,-0.763825416805305,35,36,-1,53,45,8,60,61,-1,4,3,0,0
"11366","MIN","CGY",2010020376,14946,20102011,1,65,2,2,0,2.39929233116709,4.81914272414906,-2.41985039298197,22,32,-10,31,44,-13,46,50,-4,4,4,0,0
"11367","MIN","DAL",2010020387,14947,20102011,0,63.6166666666667,3,4,-1,4.30756772786845,5.9635991922114,-1.65603146434296,31,33,-2,48,51,-3,66,66,0,4,7,0,0
"11368","MIN","ARI",2010020417,14952,20102011,0,60,3,2,1,0,0,0,33,35,-2,44,51,-7,53,67,-14,3,2,0,0
"11369","MIN","L.A",2010020436,14954,20102011,0,62.8333333333333,3,2,1,4.45961796092342,3.57168534307857,0.887932617844854,21,26,-5,33,45,-12,44,59,-15,5,8,0,0
"11370","MIN","ANA",2010020440,14955,20102011,0,60,2,6,-4,2.75512894289568,4.8947295766236,-2.13960063372792,22,36,-14,31,46,-15,48,57,-9,4,6,0,0
"11371","MIN","OTT",2010020465,14959,20102011,1,60,1,3,-2,3.21485954202944,5.49799577001249,-2.28313622798305,24,25,-1,35,44,-9,48,55,-7,3,2,0,0
"11372","MIN","CGY",2010020482,14961,20102011,0,60,3,1,2,2.73779872519663,5.32018341867729,-2.58238469348066,16,29,-13,26,43,-17,42,62,-20,2,1,0,0
"11373","MIN","CGY",2010020494,14963,20102011,1,60,4,1,3,3.06478116557992,4.91466010318254,-1.84987893760263,23,35,-12,30,47,-17,38,56,-18,3,4,0,0
"11374","MIN","COL",2010020516,14966,20102011,0,60,3,1,2,4.68372882227586,7.74610312275763,-3.06237430048177,32,37,-5,44,45,-1,61,63,-2,3,2,0,0
"11375","MIN","DET",2010020526,14969,20102011,1,60,1,4,-3,2.22076991170525,4.94877042146982,-2.72800050976457,17,27,-10,26,42,-16,35,48,-13,7,7,0,0
"11376","MIN","CBJ",2010020531,14970,20102011,0,65,3,3,0,5.03252404893283,2.61363825846638,2.41888579046645,40,22,18,52,32,20,69,40,29,8,4,0,0
"11377","MIN","S.J",2010020548,14972,20102011,1,60,5,3,2,3.91794158768607,3.5541509286641,0.363790659021973,24,32,-8,37,47,-10,46,70,-24,4,4,0,0
"11378","MIN","NSH",2010020559,14974,20102011,1,60,1,4,-3,2.07431755126163,4.49602655267608,-2.42170900141446,23,32,-9,29,47,-18,45,63,-18,4,1,0,0
"11379","MIN","ARI",2010020578,14976,20102011,1,60.7666666666667,6,5,1,3.50485254930894,4.91615546483081,-1.41130291552187,29,44,-15,43,58,-15,55,70,-15,2,3,0,0
"11380","MIN","N.J",2010020586,14978,20102011,0,60,2,1,1,3.2909739051247,2.72413379678619,0.566840108338511,18,22,-4,24,29,-5,33,46,-13,2,5,0,0
"11381","MIN","BOS",2010020597,14980,20102011,0,60,3,1,2,4.50488079131269,3.22314397174341,1.28173681956928,34,36,-2,40,50,-10,50,59,-9,2,4,0,0
"11382","MIN","PIT",2010020616,14982,20102011,0,60,4,0,4,6.9177503166619,4.10779563754585,2.80995467911605,37,26,11,47,33,14,61,51,10,5,4,0,0
"11383","MIN","DAL",2010020625,14983,20102011,1,60,0,4,-4,3.57190026774682,4.16203413989437,-0.590133872147546,26,28,-2,35,40,-5,46,50,-4,2,3,0,0
"11384","MIN","NSH",2010020639,14985,20102011,0,60,1,5,-4,4.56189317836706,5.44598744943505,-0.884094271067994,26,30,-4,36,37,-1,47,47,0,3,2,0,0
"11385","MIN","COL",2010020659,14988,20102011,1,60,1,4,-3,5.22177494259086,3.17045178591298,2.05132315667788,33,18,15,49,21,28,69,34,35,4,2,0,0
"11386","MIN","VAN",2010020673,14990,20102011,1,60,4,0,4,3.09199494880158,8.15991975012913,-5.06792480132755,25,32,-7,38,48,-10,42,65,-23,3,4,0,0
"11387","MIN","EDM",2010020691,14992,20102011,0,60,4,1,3,5.23609226796627,4.80458622609149,0.431506041874783,26,32,-6,41,45,-4,45,63,-18,4,8,0,0
"11388","MIN","CGY",2010020695,14993,20102011,0,60,6,0,6,4.01221062972763,4.61207259108119,-0.599861961353554,24,37,-13,30,53,-23,36,71,-35,2,2,0,0
"11389","MIN","S.J",2010020722,14996,20102011,0,60,3,4,-1,4.59273501010216,5.96889506958246,-1.3761600594803,26,42,-16,35,53,-18,46,66,-20,6,4,0,0
"11390","MIN","CHI",2010020740,14999,20102011,0,60,4,2,2,1.57155352469999,2.48611660546158,-0.914563080761582,22,33,-11,28,44,-16,39,60,-21,3,2,0,0
"11391","MIN","L.A",2010020761,15006,20102011,1,65,0,0,0,3.68274945679215,5.25368588036508,-1.57093642357293,25,27,-2,35,43,-8,47,68,-21,2,2,0,0
"11392","MIN","COL",2010020775,15008,20102011,0,60,4,3,1,5.13542329745542,4.38939408861916,0.746029208836262,25,41,-16,34,48,-14,43,56,-13,3,2,0,0
"11393","MIN","ARI",2010020791,15010,20102011,0,60,0,1,-1,3.27800175134189,5.48624022297736,-2.20823847163547,25,41,-16,36,57,-21,46,72,-26,4,3,0,0
"11394","MIN","COL",2010020811,15014,20102011,1,60,3,2,1,3.85833533058477,3.89395704504568,-0.0356217144609161,24,25,-1,47,38,9,55,51,4,6,6,0,0
"11395","MIN","STL",2010020826,15016,20102011,0,65,4,4,0,2.97763444128213,4.73969245114131,-1.76205800985917,27,35,-8,32,53,-21,40,64,-24,2,3,0,0
"11396","MIN","STL",2010020835,15017,20102011,1,60,3,1,2,2.25686784170102,1.16714627266975,1.08972156903127,31,25,6,42,34,8,48,51,-3,7,5,0,0
"11397","MIN","VAN",2010020853,15020,20102011,1,60,1,4,-3,5.12848710152321,2.711478296937,2.4170088045862,29,14,15,42,28,14,54,36,18,5,2,0,0
"11398","MIN","CHI",2010020859,15021,20102011,0,60,1,3,-2,2.43579716892805,5.7503011522349,-3.31450398330685,34,37,-3,38,44,-6,48,60,-12,3,5,0,0
"11399","MIN","ANA",2010020875,15023,20102011,1,60,5,1,4,2.72948323446653,4.30091736104805,-1.57143412658152,26,30,-4,35,44,-9,44,56,-12,4,5,0,0
"11400","MIN","DET",2010020889,15025,20102011,1,65,1,1,0,4.38224365512879,9.49387455871797,-5.11163090358918,26,39,-13,36,57,-21,43,71,-28,3,2,0,0
"11401","MIN","EDM",2010020899,15027,20102011,1,60,4,1,3,3.27647980018952,4.00200836529325,-0.72552856510373,23,21,2,37,31,6,49,41,8,5,7,0,0
"11402","MIN","L.A",2010020914,15029,20102011,0,60,2,4,-2,3.71135445137043,4.28810408758682,-0.576749636216391,27,30,-3,38,44,-6,52,63,-11,5,4,0,0
"11403","MIN","ANA",2010020923,15030,20102011,0,64.8833333333333,3,2,1,5.81261472975259,6.9431634944483,-1.13054876469571,31,48,-17,39,65,-26,46,83,-37,4,5,0,0
"11404","MIN","CHI",2010020940,15033,20102011,1,60,2,4,-2,3.59307723919719,4.39671613881092,-0.803638899613725,26,34,-8,34,43,-9,44,58,-14,4,3,0,0
"11405","MIN","NYI",2010020954,15035,20102011,0,60,1,4,-3,0,0,0,34,41,-7,54,51,3,82,64,18,2,4,0,0
"11406","MIN","NYR",2010020958,15036,20102011,0,60,3,1,2,3.32924763456685,5.78210979349114,-2.45286215892429,19,41,-22,25,62,-37,35,77,-42,1,5,0,0
"11407","MIN","BUF",2010020986,15039,20102011,1,60.7666666666667,2,3,-1,3.27524277230716,8.68585234018974,-5.41060956788258,26,33,-7,38,43,-5,49,55,-6,2,2,0,0
"11408","MIN","COL",2010020998,15041,20102011,1,60,5,2,3,6.37393624464045,5.82334034477893,0.55059589986152,25,30,-5,37,42,-5,49,56,-7,6,5,0,0
"11409","MIN","NSH",2010021012,15043,20102011,0,60,0,4,-4,4.11209014654919,5.3858063466032,-1.27371620005402,19,31,-12,26,38,-12,35,44,-9,2,4,0,0
"11410","MIN","DAL",2010021021,15044,20102011,0,60,0,4,-4,2.48639737709891,5.60344218073533,-3.11704480363642,14,31,-17,29,39,-10,48,54,-6,3,4,0,0
"11411","MIN","VAN",2010021040,15047,20102011,0,60,2,4,-2,4.3997865417914,5.49219664799946,-1.09241010620806,35,22,13,48,33,15,61,44,17,6,2,0,0
"11412","MIN","S.J",2010021065,15050,20102011,0,60,2,3,-1,4.05327422945993,7.44062745467818,-3.38735322521825,30,50,-20,32,62,-30,46,78,-32,2,6,0,0
"11413","MIN","CBJ",2010021070,15052,20102011,1,64.4333333333333,4,5,-1,5.43140003544977,4.87049731666684,0.560902718782927,36,33,3,46,41,5,64,56,8,4,3,0,0
"11414","MIN","MTL",2010021083,15053,20102011,1,60,1,8,-7,4.33785787305761,4.04873143642908,0.289126436628528,31,32,-1,43,41,2,58,48,10,4,6,0,0
"11415","MIN","TOR",2010021095,15055,20102011,1,60,0,3,-3,4.12663582427558,2.68492169284491,1.44171413143067,29,17,12,41,25,16,58,38,20,8,7,0,0
"11416","MIN","STL",2010021124,15059,20102011,1,60,3,6,-3,1.28541581006721,4.55005605117913,-3.26464024111192,16,47,-31,24,61,-37,32,72,-40,1,5,0,0
"11417","MIN","STL",2010021141,15062,20102011,0,65,2,2,0,3.44287326833,5.36392702427111,-1.9210537559411,28,29,-1,33,38,-5,45,53,-8,6,6,0,0
"11418","MIN","EDM",2010021156,15064,20102011,1,60,4,2,2,3.89935850664983,5.95535900988762,-2.05600050323778,22,35,-13,31,44,-13,38,59,-21,7,6,0,0
"11419","MIN","T.B",2010021165,15066,20102011,1,60,1,3,-2,4.17919414424517,5.66142197115551,-1.48222782691033,30,23,7,40,33,7,53,43,10,4,4,0,0
"11420","MIN","DET",2010021177,15067,20102011,0,60,2,4,-2,3.80571821113699,7.0118171115605,-3.20609890042351,29,34,-5,42,44,-2,56,60,-4,5,4,0,0
"11421","MIN","VAN",2010021204,15071,20102011,0,60,0,5,-5,2.99025901011191,3.16962776994251,-0.179368759830595,29,28,1,39,39,0,51,52,-1,4,3,0,0
"11422","MIN","EDM",2010021212,15072,20102011,0,60,3,1,2,4.61412362811825,4.12970039626944,0.484423231848808,27,29,-2,38,44,-6,50,63,-13,6,4,0,0
"11423","MIN","DAL",2010021230,15074,20102011,1,60,5,3,2,4.00511622773558,4.64282597834244,-0.637709750606859,23,29,-6,32,38,-6,46,48,-2,2,5,0,0
"11424","MIN","CBJ",2011020016,15255,20112012,1,60,4,2,2,3.93503578178439,2.32766405045186,1.60737173133254,26,31,-5,41,42,-1,51,61,-10,4,5,0,0
"11425","MIN","NYI",2011020027,15257,20112012,0,60,1,2,-1,2.47563538036206,1.32311057401375,1.15252480634831,21,14,7,37,23,14,54,38,16,8,4,0,0
"11426","MIN","OTT",2011020033,15258,20112012,0,65,3,3,0,3.89032800620771,4.74563653185032,-0.855308525642613,27,44,-17,34,59,-25,48,80,-32,3,5,0,0
"11427","MIN","EDM",2011020044,15260,20112012,1,65,1,1,0,4.07308456746568,3.65886199485796,0.414222572607726,35,22,13,44,31,13,57,39,18,6,4,0,0
"11428","MIN","DET",2011020058,15262,20112012,1,64.1833333333333,2,3,-1,1.79618190697511,3.3327722111535,-1.53659030417839,14,41,-27,23,52,-29,31,77,-46,1,3,0,0
"11429","MIN","PIT",2011020074,15265,20112012,1,60,2,4,-2,4.76430024106594,3.0967005032857,1.66759973778024,26,25,1,42,41,1,52,55,-3,5,1,0,0
"11430","MIN","EDM",2011020088,15267,20112012,0,65,1,1,0,3.72069333035324,2.84260778259076,0.878085547762481,31,31,0,40,40,0,59,54,5,4,2,0,0
"11431","MIN","VAN",2011020096,15269,20112012,0,64.65,2,3,-1,1.20380003208993,4.93704925470001,-3.73324922261008,23,32,-9,29,49,-20,36,66,-30,4,3,0,0
"11432","MIN","ANA",2011020132,15274,20112012,1,60,2,3,-1,2.15318012704984,0.959551529926102,1.19362859712373,25,16,9,32,26,6,49,41,8,5,6,0,0
"11433","MIN","DET",2011020148,15276,20112012,1,60,1,0,1,2.96021457596161,5.64403527615286,-2.68382070019125,20,36,-16,28,45,-17,40,54,-14,5,3,0,0
"11434","MIN","DET",2011020163,15279,20112012,0,61.55,2,1,1,2.50863055328955,4.20698062062751,-1.69835006733796,27,37,-10,31,49,-18,46,60,-14,9,4,0,0
"11435","MIN","VAN",2011020174,15281,20112012,1,60,5,1,4,4.07527233367546,2.51530972216278,1.55996261151267,45,25,20,54,37,17,61,53,8,3,5,0,0
"11436","MIN","STL",2011020191,15283,20112012,1,60,2,1,1,3.47883863979951,3.67598909989465,-0.197150460095145,26,31,-5,39,44,-5,48,60,-12,7,6,0,0
"11437","MIN","CGY",2011020209,15286,20112012,0,60,3,0,3,6.89272274418738,5.10879008127877,1.78393266290861,26,41,-15,33,55,-22,40,82,-42,2,6,0,0
"11438","MIN","S.J",2011020221,15288,20112012,0,60,1,3,-2,2.56451251711587,5.9825669110287,-3.41805439391283,22,36,-14,27,44,-17,42,68,-26,4,6,0,0
"11439","MIN","L.A",2011020238,15290,20112012,0,60,2,5,-3,3.59471177128371,5.19552314480097,-1.60081137351726,26,36,-10,36,45,-9,42,61,-19,6,7,0,0
"11440","MIN","ANA",2011020242,15291,20112012,0,60,3,2,1,5.79502773861168,4.4281985171578,1.36682922145388,26,34,-8,45,56,-11,57,73,-16,5,4,0,0
"11441","MIN","CBJ",2011020251,15293,20112012,0,60,4,2,2,3.52919437550008,4.39834704103805,-0.869152665537968,24,45,-21,26,52,-26,37,66,-29,5,3,0,0
"11442","MIN","COL",2011020266,15295,20112012,1,60,1,0,1,2.41665454247072,3.65474023105344,-1.23808568858272,18,27,-9,26,42,-16,38,62,-24,2,3,0,0
"11443","MIN","STL",2011020283,15297,20112012,1,65,2,2,0,3.51891314669774,3.8911555747909,-0.372242428093159,32,27,5,37,37,0,47,50,-3,2,2,0,0
"11444","MIN","NSH",2011020308,15301,20112012,1,60,3,2,1,2.82001361696257,2.89121318748221,-0.0711995705196387,30,25,5,44,37,7,60,48,12,6,7,0,0
"11445","MIN","EDM",2011020316,15303,20112012,1,60,2,5,-3,4.86425271993556,4.06922957226197,0.795023147673589,32,29,3,43,39,4,55,47,8,4,4,0,0
"11446","MIN","CGY",2011020339,15305,20112012,1,60,2,5,-3,4.49158075632295,7.22557722969214,-2.73399647336919,21,35,-14,38,46,-8,47,53,-6,6,4,0,0
"11447","MIN","T.B",2011020341,15306,20112012,1,60,3,1,2,3.6654936382547,5.41030314023297,-1.74480950197826,24,33,-9,34,54,-20,46,77,-31,2,2,0,0
"11448","MIN","EDM",2011020356,15308,20112012,0,65,2,2,0,3.80122995947022,5.76707357572741,-1.96584361625719,29,30,-1,40,43,-3,60,55,5,6,4,0,0
"11449","MIN","N.J",2011020367,15310,20112012,1,60,4,2,2,1.32985810265479,4.5273847111763,-3.19752660852151,16,31,-15,22,40,-18,31,64,-33,3,5,0,0
"11450","MIN","ANA",2011020385,15312,20112012,0,60,5,3,2,6.26925586999528,3.27110692195129,2.99814894804399,36,27,9,47,46,1,58,65,-7,3,3,0,0
"11451","MIN","S.J",2011020401,15314,20112012,0,60,2,1,1,3.24419307988137,5.15962628442867,-1.9154332045473,21,42,-21,28,60,-32,45,93,-48,2,2,0,0
"11452","MIN","L.A",2011020415,15316,20112012,0,60,4,2,2,4.40364540083101,9.01093350081021,-4.6072880999792,24,44,-20,35,77,-42,44,98,-54,4,1,0,0
"11453","MIN","ARI",2011020430,15318,20112012,0,60,4,1,3,4.07173832098488,6.92697094031246,-2.85523261932758,20,36,-16,25,59,-34,36,80,-44,4,4,0,0
"11454","MIN","WPG",2011020446,15321,20112012,0,60,1,2,-1,5.0936210815388,5.51435731704584,-0.420736235507036,35,27,8,50,50,0,62,62,0,3,4,0,0
"11455","MIN","CHI",2011020449,15322,20112012,1,65,3,3,0,5.45820941605894,6.99035226364504,-1.5321428475861,30,31,-1,43,53,-10,53,69,-16,2,2,0,0
"11456","MIN","NYI",2011020474,15325,20112012,1,65,1,1,0,2.38936063941219,6.79428474865492,-4.40492410924273,21,36,-15,34,54,-20,45,67,-22,1,2,0,0
"11457","MIN","VAN",2011020486,15327,20112012,0,60,0,4,-4,2.61240655329965,4.91751909078448,-2.30511253748483,33,33,0,38,43,-5,46,59,-13,1,3,0,0
"11458","MIN","CGY",2011020493,15328,20112012,0,60,1,2,-1,4.94590335366365,3.86588583169214,1.08001752197151,30,30,0,39,37,2,47,54,-7,3,2,0,0
"11459","MIN","EDM",2011020506,15330,20112012,0,60,1,4,-3,5.17725256370613,3.22741258860151,1.94983997510462,31,31,0,51,42,9,76,51,25,3,5,0,0
"11460","MIN","COL",2011020519,15334,20112012,1,60,2,4,-2,3.43589079293565,3.16093188947635,0.274958903459298,22,32,-10,31,42,-11,40,53,-13,4,7,0,0
"11461","MIN","NSH",2011020538,15336,20112012,0,65,1,1,0,6.61423793990616,3.72719857377433,2.88703936613183,35,25,10,53,37,16,65,54,11,2,3,0,0
"11462","MIN","EDM",2011020546,15337,20112012,1,60,4,3,1,4.70747441193043,6.47458120126976,-1.76710678933932,27,30,-3,34,50,-16,39,64,-25,7,8,0,0
"11463","MIN","ARI",2011020560,15339,20112012,1,60,2,4,-2,3.28331962667835,4.15035154018551,-0.867031913507162,30,30,0,40,43,-3,50,56,-6,1,3,0,0
"11464","MIN","VAN",2011020582,15343,20112012,0,60,0,3,-3,3.09163609874668,5.15758952483668,-2.06595342609001,28,35,-7,35,42,-7,52,61,-9,5,3,0,0
"11465","MIN","CGY",2011020609,15346,20112012,0,60,1,3,-2,4.52062765819574,5.29837270698222,-0.777745048786485,28,36,-8,47,48,-1,61,60,1,3,3,0,0
"11466","MIN","S.J",2011020624,15349,20112012,1,65,4,4,0,6.80007910256973,8.46976822544821,-1.66968912287848,31,38,-7,52,56,-4,63,73,-10,4,4,0,0
"11467","MIN","CHI",2011020639,15351,20112012,0,60,2,5,-3,3.31199443724472,4.50653976172907,-1.19454532448435,23,30,-7,29,36,-7,38,53,-15,1,3,0,0
"11468","MIN","STL",2011020655,15353,20112012,0,65,2,2,0,3.2265319802612,5.92138265781114,-2.69485067754993,31,49,-18,44,68,-24,53,97,-44,7,6,0,0
"11469","MIN","PHI",2011020673,15356,20112012,0,60,1,5,-4,5.01587059766098,5.68716031360179,-0.671289715940816,26,34,-8,36,44,-8,50,57,-7,1,6,0,0
"11470","MIN","TOR",2011020685,15358,20112012,0,60,1,4,-3,5.67566387234077,5.69843611882243,-0.0227722464816535,21,33,-12,36,49,-13,55,67,-12,2,6,0,0
"11471","MIN","DAL",2011020710,15360,20112012,1,60,5,2,3,3.01498199952766,3.83961673174053,-0.824634732212871,26,25,1,33,34,-1,44,53,-9,4,2,0,0
"11472","MIN","COL",2011020731,15363,20112012,0,60,3,2,1,5.18965951725841,4.65073310304433,0.538926414214075,34,26,8,47,34,13,69,54,15,5,3,0,0
"11473","MIN","NSH",2011020743,15370,20112012,1,60,4,5,-1,4.86509350361302,5.74338616192108,-0.878292658308055,25,30,-5,38,42,-4,50,58,-8,2,2,0,0
"11474","MIN","COL",2011020758,15372,20112012,0,60,1,0,1,3.6040701615857,3.19833210812067,0.405738053465029,21,37,-16,28,49,-21,40,75,-35,3,3,0,0
"11475","MIN","DAL",2011020776,15374,20112012,0,65,1,1,0,3.7902307938366,3.68005598491116,0.110174808925436,34,26,8,48,38,10,63,59,4,4,2,0,0
"11476","MIN","CBJ",2011020789,15377,20112012,0,60,1,3,-2,3.76916131209873,4.49822643450352,-0.729065122404791,29,37,-8,35,45,-10,41,57,-16,2,7,0,0
"11477","MIN","VAN",2011020809,15379,20112012,1,60,2,5,-3,3.05721252923831,4.2977980388896,-1.24058550965128,24,20,4,29,28,1,45,38,7,4,4,0,0
"11478","MIN","CBJ",2011020824,15381,20112012,1,60,1,3,-2,6.24511194123477,4.44014443084598,1.80496751038879,35,19,16,55,28,27,65,35,30,2,5,0,0
"11479","MIN","ANA",2011020843,15384,20112012,1,60,1,2,-1,1.79017441772157,2.5445226326168,-0.754348214895227,18,25,-7,25,36,-11,43,53,-10,4,3,0,0
"11480","MIN","WPG",2011020855,15386,20112012,1,65,3,3,0,3.33632603505976,4.86853419907857,-1.53220816401881,25,27,-2,31,35,-4,48,50,-2,5,5,0,0
"11481","MIN","STL",2011020867,15388,20112012,0,60,0,4,-4,1.11503378228986,3.77291401718685,-2.65788023489699,13,34,-21,20,52,-32,31,74,-43,6,9,0,0
"11482","MIN","BOS",2011020876,15389,20112012,1,60,2,0,2,4.59825849247864,6.36291556050128,-1.76465706802264,29,48,-19,34,67,-33,45,91,-46,1,1,0,0
"11483","MIN","FLA",2011020901,15393,20112012,0,65,2,2,0,3.99217183399014,4.31225922447629,-0.320087390486151,28,43,-15,35,58,-23,45,81,-36,3,3,0,0
"11484","MIN","DAL",2011020913,15394,20112012,0,60,1,4,-3,0,0,0,29,25,4,47,34,13,69,52,17,6,2,0,0
"11485","MIN","S.J",2011020930,15396,20112012,1,60,4,3,1,4.25572297115312,4.6651001084568,-0.40937713730368,26,28,-2,31,38,-7,45,54,-9,4,3,0,0
"11486","MIN","L.A",2011020943,15398,20112012,1,60,0,4,-4,4.49905400245916,5.09280076139839,-0.593746758939233,26,15,11,36,30,6,47,44,3,4,4,0,0
"11487","MIN","MTL",2011020951,15400,20112012,0,65,4,4,0,4.37699837314608,4.52563861401966,-0.14864024087358,30,28,2,44,44,0,62,58,4,7,10,0,0
"11488","MIN","DET",2011020962,15401,20112012,0,60,0,6,-6,3.98399736784603,5.90629629380055,-1.92229892595452,19,35,-16,28,56,-28,36,71,-35,4,7,0,0
"11489","MIN","COL",2011020980,15403,20112012,1,60,0,2,-2,4.4096445202722,7.24362615569765,-2.83398163542546,30,36,-6,40,51,-11,56,69,-13,3,2,0,0
"11490","MIN","COL",2011020992,15405,20112012,0,60,1,7,-6,2.58801099820192,5.83864956086109,-3.25063856265917,22,39,-17,28,53,-25,43,70,-27,4,5,0,0
"11491","MIN","ARI",2011021007,15407,20112012,0,65,2,2,0,3.0833482836606,6.10432567937096,-3.02097739571036,24,41,-17,35,56,-21,44,86,-42,1,4,0,0
"11492","MIN","CGY",2011021028,15410,20112012,1,60,3,4,-1,4.08991048031021,4.82979476056062,-0.739884280250408,27,25,2,40,39,1,58,50,8,1,0,0,0
"11493","MIN","DAL",2011021042,15412,20112012,1,60,0,1,-1,6.42511905395804,4.01263561074347,2.41248344321457,25,25,0,36,35,1,52,53,-1,5,3,0,0
"11494","MIN","CAR",2011021067,15416,20112012,1,60,3,5,-2,3.08165435181581,5.88732837329007,-2.80567402147426,26,34,-8,35,43,-8,52,52,0,3,2,0,0
"11495","MIN","VAN",2011021086,15418,20112012,1,60,2,0,2,4.00559415679891,4.47911462454067,-0.473520467741764,34,33,1,43,46,-3,52,60,-8,4,2,0,0
"11496","MIN","CGY",2011021105,15421,20112012,1,65,2,2,0,6.40180652434356,7.04252315822714,-0.640716633883585,30,29,1,46,46,0,67,59,8,6,5,0,0
"11497","MIN","BUF",2011021118,15423,20112012,0,60,1,3,-2,2.81529647033312,2.28307020620289,0.53222626413023,25,37,-12,30,44,-14,43,57,-14,2,4,0,0
"11498","MIN","WSH",2011021128,15424,20112012,0,60,0,3,-3,3.02766757685458,3.24267811063328,-0.215010533778695,28,23,5,39,35,4,57,49,8,2,3,0,0
"11499","MIN","NYR",2011021147,15426,20112012,1,60,2,3,-1,6.24278508968013,6.31149786384776,-0.0687127741676328,26,32,-6,34,45,-11,50,54,-4,2,4,0,0
"11500","MIN","FLA",2011021158,15428,20112012,1,60.25,3,2,1,2.95598122737397,5.91000287351198,-2.95402164613802,25,27,-2,32,43,-11,43,56,-13,2,5,0,0
"11501","MIN","L.A",2011021177,15430,20112012,1,65,3,3,0,4.09428079414647,6.88876175855114,-2.79448096440467,23,29,-6,35,49,-14,43,69,-26,3,4,0,0
"11502","MIN","CHI",2011021184,15431,20112012,0,65,4,4,0,2.94406155809543,3.8930874124344,-0.94902585433897,30,35,-5,41,49,-8,51,72,-21,4,5,0,0
"11503","MIN","NSH",2011021195,15433,20112012,0,65,1,1,0,4.8983680876263,2.2813802073797,2.6169878802466,26,24,2,39,37,2,52,45,7,6,3,0,0
"11504","MIN","CHI",2011021210,15435,20112012,1,65,1,1,0,3.35725999542052,6.66258929262403,-3.30532929720351,23,23,0,29,45,-16,40,63,-23,5,6,0,0
"11505","MIN","ARI",2011021226,15437,20112012,1,60,1,4,-3,3.55192197830112,4.88154861588919,-1.32962663758806,24,28,-4,34,42,-8,46,59,-13,6,6,0,0
"11506","MIN","COL",2012020012,15724,20122013,1,60,4,2,2,6.27751225891552,4.68959350037039,1.58791875854513,35,27,8,44,35,9,54,53,1,6,3,0,0
"11507","MIN","DAL",2012020017,15725,20122013,1,60,1,0,1,5.12222049858974,4.02797990229737,1.09424059629237,32,24,8,40,36,4,51,62,-11,4,5,0,0
"11508","MIN","NSH",2012020032,15727,20122013,1,60,1,3,-2,4.27484673855361,2.95668439994915,1.31816233860445,30,26,4,37,35,2,52,43,9,5,5,0,0
"11509","MIN","DET",2012020054,15730,20122013,0,60,3,5,-2,0,0,0,26,27,-1,36,39,-3,60,44,16,8,5,0,0
"11510","MIN","STL",2012020071,15732,20122013,0,62.2666666666667,4,5,-1,4.36427390244516,6.6350953119947,-2.27082140954954,16,34,-18,29,46,-17,40,60,-20,4,6,0,0
"11511","MIN","CBJ",2012020086,15734,20122013,1,60,3,2,1,3.02564205264207,3.43391915913253,-0.408277106490459,26,19,7,33,33,0,41,51,-10,3,4,0,0
"11512","MIN","CHI",2012020089,15735,20122013,1,65,2,2,0,3.59515094209928,5.08246730211874,-1.48731636001946,25,32,-7,38,48,-10,48,58,-10,4,2,0,0
"11513","MIN","ANA",2012020107,15737,20122013,0,60,1,3,-2,3.16065315780151,3.46558316622395,-0.30493000842244,27,31,-4,34,43,-9,46,65,-19,1,2,0,0
"11514","MIN","ARI",2012020125,15740,20122013,0,60,1,2,-1,4.21870496188058,4.4691812324636,-0.250476270583022,22,34,-12,35,45,-10,52,60,-8,2,1,0,0
"11515","MIN","VAN",2012020151,15743,20122013,1,60,1,4,-3,4.56589406515786,2.50802930010832,2.05786476504954,23,22,1,38,28,10,44,34,10,6,8,0,0
"11516","MIN","NSH",2012020164,15745,20122013,1,64.35,2,1,1,0,0,0,32,26,6,44,32,12,60,39,21,6,7,0,0
"11517","MIN","CGY",2012020177,15747,20122013,0,65,1,1,0,3.59849062905414,4.1333959197309,-0.534905290676761,24,24,0,28,34,-6,48,48,0,4,2,0,0
"11518","MIN","VAN",2012020187,15748,20122013,0,60,1,2,-1,2.67018556363564,4.84864162066145,-2.17845605702581,26,30,-4,34,42,-8,42,57,-15,6,3,0,0
"11519","MIN","COL",2012020196,15750,20122013,1,65,3,3,0,4.95788537114277,5.05062423826166,-0.0927388671188965,29,32,-3,34,42,-8,51,51,0,1,2,0,0
"11520","MIN","DET",2012020216,15753,20122013,1,60,3,2,1,2.84331153941594,4.76560413773404,-1.92229259831811,24,31,-7,35,47,-12,41,63,-22,2,2,0,0
"11521","MIN","EDM",2012020246,15757,20122013,0,60,3,1,2,4.15832424420783,4.84219697784283,-0.683872733634999,28,28,0,39,41,-2,60,54,6,2,1,0,0
"11522","MIN","CGY",2012020261,15759,20122013,0,60,1,3,-2,3.3267535741179,4.70906253147405,-1.38230895735614,31,27,4,38,36,2,52,47,5,2,2,0,0
"11523","MIN","CGY",2012020281,15762,20122013,1,60.45,2,1,1,4.72366996797484,2.579850859315,2.14381910865984,30,21,9,47,22,25,65,29,36,8,6,0,0
"11524","MIN","ARI",2012020297,15764,20122013,0,60,4,3,1,5.54529182049424,2.99577594801806,2.54951587247618,23,28,-5,33,49,-16,48,67,-19,6,5,0,0
"11525","MIN","ANA",2012020301,15765,20122013,0,60,2,3,-1,4.24379069466834,3.84081346521498,0.402977229453363,33,29,4,42,41,1,60,48,12,3,1,0,0
"11526","MIN","EDM",2012020318,15767,20122013,1,60,4,2,2,0,0,0,43,21,22,53,30,23,62,42,20,3,1,0,0
"11527","MIN","CHI",2012020332,15769,20122013,0,60,3,5,-2,2.80738962008036,4.10490838441183,-1.29751876433147,23,32,-9,32,42,-10,38,56,-18,2,3,0,0
"11528","MIN","NSH",2012020362,15773,20122013,0,65,1,1,0,5.29754645875073,4.9689457131899,0.328600745560834,29,25,4,44,35,9,56,45,11,6,3,0,0
"11529","MIN","VAN",2012020372,15774,20122013,1,60,4,2,2,2.4280559593912,3.54000901395743,-1.11195305456623,32,27,5,38,40,-2,45,52,-7,6,7,0,0
"11530","MIN","ANA",2012020384,15776,20122013,1,60,1,2,-1,7.88032875279896,3.10835667197594,4.77197208082302,31,21,10,41,30,11,67,41,26,5,4,0,0
"11531","MIN","COL",2012020398,15778,20122013,1,60,5,3,2,8.13870904771893,4.74256969455746,3.39613935316147,40,32,8,55,49,6,75,63,12,5,3,0,0
"11532","MIN","COL",2012020408,15780,20122013,0,60,6,4,2,3.31616667131311,4.87891096339699,-1.56274429208388,28,32,-4,40,39,1,54,49,5,3,3,0,0
"11533","MIN","VAN",2012020426,15782,20122013,0,60,3,1,2,4.97358101280406,4.44673166889697,0.526849343907088,25,36,-11,34,56,-22,39,79,-40,3,5,0,0
"11534","MIN","DET",2012020439,15784,20122013,0,60,4,2,2,2.86150736256968,3.21872814653034,-0.357220783960656,19,38,-19,22,50,-28,29,59,-30,3,6,0,0
"11535","MIN","S.J",2012020457,15787,20122013,1,60,2,0,2,2.15323075575157,3.68532300461084,-1.53209224885927,24,33,-9,29,45,-16,43,61,-18,3,4,0,0
"11536","MIN","DAL",2012020476,15789,20122013,0,60,7,4,3,4.29868183445035,3.62723059489508,0.671451239555267,42,26,16,54,38,16,66,51,15,3,4,0,0
"11537","MIN","ARI",2012020489,15791,20122013,1,62.7166666666667,4,3,1,4.82849985055509,2.62549630605599,2.2030035444991,37,27,10,54,33,21,67,44,23,4,2,0,0
"11538","MIN","DAL",2012020504,15793,20122013,0,60,3,5,-2,4.31426598534325,3.91124482362648,0.403021161716779,33,33,0,53,38,15,71,51,20,5,7,0,0
"11539","MIN","L.A",2012020510,15794,20122013,1,65,3,3,0,5.59887305070879,7.23263894217416,-1.63376589146537,28,31,-3,41,46,-5,54,59,-5,4,2,0,0
"11540","MIN","STL",2012020526,15796,20122013,1,60,1,4,-3,2.37976264418103,3.72497328196187,-1.34521063778084,25,24,1,33,32,1,46,48,-2,5,1,0,0
"11541","MIN","S.J",2012020542,15798,20122013,0,60,2,4,-2,3.81244658435942,4.53584115358535,-0.723394569225931,33,33,0,43,45,-2,65,55,10,3,7,0,0
"11542","MIN","L.A",2012020552,15799,20122013,0,60,0,3,-3,3.46410830691457,1.7394457818009,1.72466252511367,23,14,9,30,28,2,39,37,2,1,2,0,0
"11543","MIN","CBJ",2012020572,15802,20122013,0,60,3,0,3,4.83302154942066,1.05442711568321,3.77859443373745,24,24,0,31,25,6,41,43,-2,3,4,0,0
"11544","MIN","CHI",2012020589,15804,20122013,1,60,0,1,-1,4.22954274833319,4.44227012073679,-0.212727372403606,20,31,-11,33,44,-11,44,51,-7,2,3,0,0
"11545","MIN","STL",2012020603,15806,20122013,1,60,0,2,-2,3.24159981333651,2.47018251515692,0.771417298179585,23,20,3,33,24,9,46,38,8,3,1,0,0
"11546","MIN","CBJ",2012020617,15808,20122013,1,65,2,2,0,6.25033456855454,3.65406207140768,2.59627249714686,41,22,19,48,30,18,60,46,14,5,1,0,0
"11547","MIN","CGY",2012020630,15810,20122013,0,60,4,3,1,3.1460257723229,2.67336268513463,0.472663087188266,27,23,4,38,29,9,54,33,21,1,2,0,0
"11548","MIN","EDM",2012020638,15811,20122013,0,60,5,3,2,3.68575991509999,2.51882223144639,1.1669376836536,30,19,11,36,31,5,47,46,1,2,1,0,0
"11549","MIN","S.J",2012020653,15813,20122013,0,60,1,6,-5,4.25023477489594,5.79605980875203,-1.54582503385609,28,29,-1,41,41,0,59,54,5,1,2,0,0
"11550","MIN","CGY",2012020670,15816,20122013,1,60,1,4,-3,6.18619077945186,3.54168573685456,2.6445050425973,35,24,11,49,32,17,66,46,20,3,3,0,0
"11551","MIN","L.A",2012020688,15818,20122013,1,60,2,1,1,4.26839143346755,5.37931925838348,-1.11092782491593,25,23,2,41,35,6,46,46,0,1,1,0,0
"11552","MIN","EDM",2012020705,15821,20122013,1,60,1,6,-5,5.90468345487898,6.18391754198819,-0.279234087109216,39,17,22,52,27,25,71,38,33,2,2,0,0
"11553","MIN","COL",2012020715,15822,20122013,0,60,3,1,2,3.03464757153415,3.18662090957514,-0.151973338040989,33,30,3,40,42,-2,46,58,-12,3,1,0,0
"11554","MIN","CHI",2012030151,15825,20122013,0,76.5833333333333,1,2,-1,6.76265867215002,3.81649583950639,2.94616283264364,27,37,-10,37,45,-8,47,66,-19,4,3,0,0
"11555","MIN","CHI",2012030152,15828,20122013,0,60,2,5,-3,3.17726755607873,4.08565325746895,-0.908385701390216,28,48,-20,33,56,-23,44,77,-33,3,5,0,0
"11556","MIN","CHI",2012030153,15830,20122013,1,62.25,3,2,1,7.79439977082971,5.88659665312079,1.90780311770892,37,27,10,47,43,4,58,55,3,4,3,0,0
"11557","MIN","CHI",2012030154,15832,20122013,1,60,0,3,-3,4.03560709714657,5.8716997636077,-1.83609266646114,25,24,1,42,36,6,68,46,22,6,2,0,0
"11558","MIN","CHI",2012030155,15834,20122013,0,60,1,5,-4,2.92492514941841,8.2614997091805,-5.33657455976208,22,33,-11,29,39,-10,39,54,-15,3,4,0,0
"11559","MIN","L.A",2013020011,15981,20132014,1,65,2,2,0,2.87965164463489,1.99130048963889,0.888351154996006,29,18,11,34,26,8,48,46,2,5,3,0,0
"11560","MIN","ANA",2013020029,15983,20132014,1,64.9166666666667,3,4,-1,4.44733005864256,5.08165706627692,-0.634327007634354,33,30,3,47,36,11,66,43,23,4,3,0,0
"11561","MIN","NSH",2013020042,15986,20132014,0,60,2,3,-1,5.9558455053193,4.72995654195159,1.22588896336771,34,25,9,45,36,9,57,42,15,6,6,0,0
"11562","MIN","WPG",2013020054,15988,20132014,1,60,2,1,1,4.61533560520607,2.90365894824205,1.71167665696402,30,15,15,45,31,14,62,41,21,8,7,0,0
"11563","MIN","DAL",2013020072,15990,20132014,1,60,5,1,4,5.41841324417055,4.02836064720577,1.39005259696478,36,19,17,47,28,19,61,38,23,4,3,0,0
"11564","MIN","BUF",2013020081,15992,20132014,0,60,2,1,1,3.77730635504331,2.6901885002444,1.0871178547989,20,23,-3,39,34,5,46,45,1,3,4,0,0
"11565","MIN","TOR",2013020082,15993,20132014,0,60,1,4,-3,8.52034691215695,3.32164160907269,5.19870530308426,37,14,23,54,19,35,68,30,38,6,4,0,0
"11566","MIN","T.B",2013020102,15995,20132014,0,60,1,3,-2,2.74790147470776,4.63173821698001,-1.88383674227225,26,30,-4,34,43,-9,46,52,-6,4,8,0,0
"11567","MIN","FLA",2013020115,15997,20132014,0,65,1,1,0,4.24039147367387,4.14535618090304,0.0950352927708309,31,22,9,43,31,12,57,34,23,5,5,0,0
"11568","MIN","NSH",2013020134,16000,20132014,1,60,2,0,2,5.55702074593864,4.09432717059826,1.46269357534038,29,16,13,49,27,22,70,46,24,2,2,0,0
"11569","MIN","CAR",2013020145,16002,20132014,1,60,3,1,2,4.51024194182946,4.16342043988334,0.346821501946124,27,28,-1,40,39,1,53,53,0,5,5,0,0
"11570","MIN","CHI",2013020162,16004,20132014,0,60,5,3,2,3.0589471609686,3.14056749641895,-0.0816203354503564,25,36,-11,30,44,-14,37,63,-26,5,7,0,0
"11571","MIN","CHI",2013020174,16006,20132014,1,60,1,5,-4,3.59958914418237,4.92693312489337,-1.327343980711,30,28,2,41,44,-3,58,57,1,5,5,0,0
"11572","MIN","MTL",2013020196,16010,20132014,1,60,4,3,1,5.5238104085438,6.65852725643432,-1.13471684789052,25,31,-6,33,48,-15,49,69,-20,1,2,0,0
"11573","MIN","N.J",2013020214,16012,20132014,1,60,4,0,4,2.87289815628901,3.54297034932461,-0.670072193035594,20,19,1,27,33,-6,37,52,-15,4,4,0,0
"11574","MIN","CGY",2013020223,16014,20132014,1,60,5,1,4,4.52203222798518,3.28091747638345,1.24111475160173,24,25,-1,28,37,-9,43,46,-3,4,5,0,0
"11575","MIN","WSH",2013020233,16016,20132014,0,65,2,2,0,2.6014276125934,4.33219290315174,-1.73076529055834,35,27,8,41,42,-1,51,57,-6,3,3,0,0
"11576","MIN","CAR",2013020249,16018,20132014,0,65,2,2,0,5.8256268027177,7.79353777954475,-1.96791097682705,30,29,1,42,50,-8,60,64,-4,4,3,0,0
"11577","MIN","TOR",2013020274,16022,20132014,1,65,1,1,0,4.52417142051854,3.06006766247992,1.46410375803862,34,23,11,52,31,21,70,43,27,5,4,0,0
"11578","MIN","FLA",2013020291,16024,20132014,1,60,3,2,1,3.06783094248385,7.07178417255636,-4.00395323007251,20,24,-4,26,36,-10,34,48,-14,3,3,0,0
"11579","MIN","WPG",2013020307,16026,20132014,1,60,2,1,1,3.98000400483761,6.49252783222801,-2.5125238273904,24,22,2,38,30,8,54,54,0,2,2,0,0
"11580","MIN","MTL",2013020315,16028,20132014,0,60,2,6,-4,3.04235388736285,4.20847908902215,-1.1661252016593,27,28,-1,33,40,-7,56,52,4,3,5,0,0
"11581","MIN","OTT",2013020322,16029,20132014,0,60,4,3,1,5.29769821089576,5.79849710425781,-0.500798893362054,25,37,-12,36,45,-9,42,66,-24,4,3,0,0
"11582","MIN","WPG",2013020342,16032,20132014,0,65,2,2,0,5.23020907945465,6.82836637840956,-1.5981572989549,35,39,-4,48,56,-8,65,67,-2,2,2,0,0
"11583","MIN","STL",2013020360,16034,20132014,0,60,0,3,-3,3.25290257786401,5.18719662750829,-1.93429404964428,22,21,1,31,41,-10,43,54,-11,3,3,0,0
"11584","MIN","ARI",2013020374,16036,20132014,1,60,1,3,-2,3.08731965353945,2.47889398681582,0.608425666723633,29,26,3,36,30,6,50,36,14,3,3,0,0
"11585","MIN","COL",2013020387,16038,20132014,1,60,1,3,-2,3.48733070830349,4.67922093495174,-1.19189022664825,28,21,7,40,26,14,59,38,21,2,3,0,0
"11586","MIN","COL",2013020400,16039,20132014,0,65,2,2,0,5.5332286079647,3.61343787114311,1.9197907368216,37,25,12,42,35,7,58,52,6,0,0,0,0
"11587","MIN","PHI",2013020408,16041,20132014,1,60,2,0,2,4.63153991855506,4.3721160304267,0.259423888128367,21,21,0,29,37,-8,37,53,-16,2,2,0,0
"11588","MIN","CHI",2013020430,16044,20132014,1,60,4,3,1,5.00925065792399,1.55953183494421,3.44971882297978,23,19,4,27,28,-1,38,45,-7,3,2,0,0
"11589","MIN","CBJ",2013020434,16045,20132014,0,60,0,4,-4,2.33210386932404,4.860113714563,-2.52800984523896,20,41,-21,28,48,-20,40,57,-17,5,5,0,0
"11590","MIN","S.J",2013020449,16047,20132014,1,60,3,1,2,3.21168505589594,4.22453398778362,-1.01284893188767,13,38,-25,22,51,-29,33,69,-36,2,4,0,0
"11591","MIN","ANA",2013020472,16050,20132014,0,60,1,2,-1,3.92942114117159,4.23051733339707,-0.301096192225486,24,31,-7,34,40,-6,43,46,-3,2,3,0,0
"11592","MIN","S.J",2013020483,16051,20132014,0,60,1,3,-2,3.96994859380538,5.94131617352832,-1.97136757972294,30,39,-9,44,55,-11,60,68,-8,4,7,0,0
"11593","MIN","COL",2013020497,16053,20132014,0,65,1,1,0,6.88435026479419,4.60009013733361,2.28426012746058,27,27,0,42,35,7,57,50,7,1,2,0,0
"11594","MIN","VAN",2013020518,16056,20132014,1,65,2,2,0,5.70777187955626,5.63568242211477,0.0720894574414928,32,31,1,43,41,2,60,50,10,2,2,0,0
"11595","MIN","NYR",2013020551,16061,20132014,0,60,1,4,-3,3.84434225421865,6.33929831963178,-2.49495606541313,25,36,-11,31,45,-14,43,47,-4,3,3,0,0
"11596","MIN","PHI",2013020560,16062,20132014,0,60,1,4,-3,5.23230197015528,3.97284671432863,1.25945525582665,27,31,-4,43,39,4,53,61,-8,5,4,0,0
"11597","MIN","WPG",2013020573,16066,20132014,0,60,4,6,-2,3.86750979084172,5.9652760165045,-2.09776622566278,29,38,-9,33,44,-11,45,63,-18,3,2,0,0
"11598","MIN","NYI",2013020592,16068,20132014,1,60,4,5,-1,3.85497459930775,6.14357543899678,-2.28860083968902,37,31,6,47,38,9,63,48,15,4,3,0,0
"11599","MIN","STL",2013020601,16070,20132014,1,60,1,2,-1,5.65756054083658,4.80727031322391,0.850290227612675,25,23,2,38,38,0,62,51,11,3,1,0,0
"11600","MIN","BUF",2013020617,16072,20132014,1,60,4,1,3,4.7714808320452,5.01962742424803,-0.248146592202829,32,20,12,46,33,13,55,44,11,6,6,0,0
"11601","MIN","WSH",2013020635,16074,20132014,1,60,5,3,2,3.6364681229461,4.72822422225806,-1.09175609931197,11,30,-19,17,44,-27,25,63,-38,6,3,0,0
"11602","MIN","L.A",2013020656,16077,20132014,0,65,1,1,0,5.06250133970752,4.55892403813777,0.503577301569749,17,40,-23,26,61,-35,39,82,-43,2,2,0,0
"11603","MIN","ARI",2013020666,16079,20132014,0,60,4,1,3,6.67128833333845,4.56754428518204,2.10374404815641,29,40,-11,36,56,-20,50,76,-26,3,3,0,0
"11604","MIN","COL",2013020680,16081,20132014,1,60,2,4,-2,3.37245960046818,2.87457637867521,0.497883221792961,27,18,9,38,30,8,53,37,16,2,3,0,0
"11605","MIN","NSH",2013020690,16082,20132014,0,60,4,0,4,6.35787073144456,6.32177684609633,0.0360938853482367,23,23,0,33,37,-4,39,58,-19,1,2,0,0
"11606","MIN","OTT",2013020705,16084,20132014,1,60,0,3,-3,5.19712875498226,2.76100409928767,2.43612465569458,27,32,-5,35,40,-5,48,51,-3,3,5,0,0
"11607","MIN","EDM",2013020716,16086,20132014,1,60,4,1,3,3.75641562861983,1.63796828237719,2.11844734624265,33,21,12,47,30,17,58,41,17,4,5,0,0
"11608","MIN","DAL",2013020734,16088,20132014,1,62.7,3,2,1,2.20444934087573,7.64039294637041,-5.43594360549469,19,35,-16,28,51,-23,40,73,-33,3,4,0,0
"11609","MIN","DAL",2013020752,16091,20132014,0,60,0,4,-4,3.86698666324378,5.97957862598389,-2.11259196274011,18,36,-18,30,50,-20,44,72,-28,5,10,0,0
"11610","MIN","CHI",2013020764,16093,20132014,1,60,2,1,1,2.98416804446606,5.00192602583229,-2.01775798136623,19,34,-15,28,45,-17,37,60,-23,4,1,0,0
"11611","MIN","S.J",2013020783,16095,20132014,0,63.5,2,3,-1,1.57233256730251,4.20654619873676,-2.63421363143425,22,32,-10,34,45,-11,45,71,-26,2,2,0,0
"11612","MIN","ANA",2013020805,16098,20132014,0,60,4,2,2,5.55376996828784,5.41658449272109,0.137185475566753,33,33,0,48,45,3,58,58,0,6,4,0,0
"11613","MIN","COL",2013020814,16100,20132014,0,60,4,5,-1,5.72820830791703,4.08573424923816,1.64247405867887,35,32,3,48,50,-2,60,57,3,5,6,0,0
"11614","MIN","CGY",2013020832,16102,20132014,0,62.4166666666667,3,4,-1,2.4382857606106,4.48194174928358,-2.04365598867298,23,32,-9,34,43,-9,44,51,-7,5,5,0,0
"11615","MIN","T.B",2013020851,16105,20132014,1,60,2,1,1,2.95933899284591,6.66103259552619,-3.70169360268028,26,35,-9,35,48,-13,45,58,-13,3,3,0,0
"11616","MIN","NSH",2013020865,16107,20132014,1,62.2666666666667,3,2,1,6.96443244266266,5.68009216467908,1.28434027798357,36,18,18,47,35,12,66,44,22,5,2,0,0
"11617","MIN","EDM",2013020897,16128,20132014,0,60,3,0,3,2.66481013323164,1.94035955396248,0.72445057926916,21,21,0,34,26,8,45,40,5,5,7,0,0
"11618","MIN","VAN",2013020900,16129,20132014,0,65,1,1,0,2.43904908009722,3.46929438889492,-1.0302453087977,23,31,-8,33,45,-12,39,70,-31,3,2,0,0
"11619","MIN","CGY",2013020922,16132,20132014,1,60,3,2,1,4.18578592943959,1.96440141361381,2.22138451582578,27,23,4,38,29,9,49,43,6,2,1,0,0
"11620","MIN","DAL",2013020960,16137,20132014,0,60,3,4,-1,8.5147597474544,6.4774176758726,2.0373420715818,35,38,-3,51,53,-2,64,69,-5,4,3,0,0
"11621","MIN","STL",2013020966,16138,20132014,1,65,2,2,0,3.67190582925105,3.88156786151194,-0.209662032260894,19,22,-3,34,33,1,46,48,-2,3,2,0,0
"11622","MIN","EDM",2013020983,16140,20132014,1,65,3,3,0,3.29325169078963,5.00645397760672,-1.71320228681709,31,26,5,47,33,14,59,41,18,4,3,0,0
"11623","MIN","NYR",2013020994,16142,20132014,1,60,2,1,1,3.24190871464089,4.41470580737223,-1.17279709273134,26,30,-4,31,37,-6,42,53,-11,3,3,0,0
"11624","MIN","CBJ",2013021010,16144,20132014,1,65,1,1,0,4.42057796480367,5.48341823159899,-1.06284026679532,33,29,4,44,41,3,54,51,3,1,0,0,0
"11625","MIN","BOS",2013021022,16146,20132014,0,60,1,4,-3,4.46135523717385,5.87777102683322,-1.41641578965937,34,29,5,44,33,11,48,49,-1,1,0,0,0
"11626","MIN","NYI",2013021027,16147,20132014,0,60,6,0,6,4.42875642207218,3.18881106745024,1.23994535462194,22,36,-14,33,44,-11,51,66,-15,3,3,0,0
"11627","MIN","N.J",2013021042,16149,20132014,0,62,3,4,-1,4.41709535350674,3.65393001686971,0.76316533663703,23,29,-6,28,38,-10,32,43,-11,6,3,0,0
"11628","MIN","DET",2013021057,16151,20132014,1,60,2,3,-1,3.67483501430252,7.06079646537546,-3.38596145107294,30,30,0,41,40,1,58,46,12,4,3,0,0
"11629","MIN","DET",2013021070,16152,20132014,0,62.25,4,3,1,2.51780644063547,2.95414215541737,-0.436335714781901,25,16,9,37,28,9,49,36,13,3,2,0,0
"11630","MIN","VAN",2013021089,16155,20132014,1,60,2,5,-3,7.23839736246919,3.11291345092637,4.12548391154282,31,19,12,42,29,13,60,39,21,4,2,0,0
"11631","MIN","STL",2013021098,16156,20132014,0,60,1,5,-4,2.72797665107646,2.44008764722776,0.287889003848704,28,24,4,38,35,3,49,51,-2,7,6,0,0
"11632","MIN","ARI",2013021116,16158,20132014,0,60,3,1,2,4.85502602733068,3.65683172013087,1.19819430719981,30,24,6,38,35,3,48,57,-9,2,5,0,0
"11633","MIN","L.A",2013021128,16160,20132014,0,60,3,2,1,4.44472778495401,4.987692510942,-0.542964725987986,20,20,0,32,35,-3,39,46,-7,2,3,0,0
"11634","MIN","CHI",2013021148,16163,20132014,0,65,2,2,0,4.46162471251591,3.69250639205347,0.769118320462439,27,26,1,36,34,2,54,52,2,2,2,0,0
"11635","MIN","WPG",2013021178,16167,20132014,0,60,1,0,1,2.14966791064626,3.66632569947585,-1.51665778882959,17,24,-7,24,31,-7,37,47,-10,3,4,0,0
"11636","MIN","BOS",2013021187,16168,20132014,1,65,3,3,0,3.73418694047723,2.09177168368478,1.64241525679245,24,24,0,37,32,5,47,54,-7,3,5,0,0
"11637","MIN","STL",2013021201,16170,20132014,1,60,4,2,2,3.14131255086977,4.98389035321085,-1.84257780234108,15,45,-30,21,58,-37,27,64,-37,4,3,0,0
"11638","MIN","NSH",2013021227,16173,20132014,1,60,3,7,-4,4.60159631949729,4.90056774916593,-0.29897142966864,29,33,-4,40,42,-2,55,52,3,5,7,0,0
"11639","MIN","COL",2013030151,16177,20132014,0,67.45,4,5,-1,3.97240926948507,6.07041725455201,-2.09800798506694,33,31,2,42,43,-1,57,58,-1,5,5,0,0
"11640","MIN","COL",2013030152,16179,20132014,0,60,2,4,-2,5.08352573886077,2.50140835929051,2.58211737957026,32,29,3,41,41,0,68,54,14,3,3,0,0
"11641","MIN","COL",2013030153,16181,20132014,1,65.1333333333333,1,0,1,7.65699132032061,2.81482785411274,4.84216346620787,46,22,24,61,27,34,75,37,38,7,8,0,0
"11642","MIN","COL",2013030154,16184,20132014,1,60,2,1,1,5.08707984923967,2.09555209615269,2.99152775308698,32,12,20,50,23,27,62,34,28,4,4,0,0
"11643","MIN","COL",2013030155,16186,20132014,0,63.45,3,4,-1,2.97573575560734,4.98263377092991,-2.00689801532257,32,35,-3,44,43,1,63,64,-1,4,4,0,0
"11644","MIN","COL",2013030156,16188,20132014,1,60,5,2,3,4.18114743235083,4.89399842770945,-0.712850995358622,23,23,0,34,39,-5,45,53,-8,6,7,0,0
"11645","MIN","COL",2013030157,16190,20132014,0,65.0333333333333,5,4,1,7.19337446002464,2.0631299599026,5.13024450012205,35,22,13,51,28,23,71,44,27,3,3,0,0
"11646","MIN","CHI",2013030231,16192,20132014,0,60,2,5,-3,4.66040679323942,4.53308460535482,0.127322187884602,32,22,10,50,30,20,60,49,11,3,3,0,0
"11647","MIN","CHI",2013030232,16194,20132014,0,60,1,4,-3,0,0,0,19,22,-3,25,35,-10,50,46,4,1,2,0,0
"11648","MIN","CHI",2013030233,16196,20132014,1,60,4,0,4,4.33253945433535,5.20234764899942,-0.869808194664074,18,19,-1,28,38,-10,44,52,-8,4,2,0,0
"11649","MIN","CHI",2013030234,16199,20132014,1,60,4,2,2,6.60576681990642,3.59317922668165,3.01258759322477,31,20,11,44,26,18,57,41,16,5,2,0,0
"11650","MIN","CHI",2013030235,16201,20132014,0,60,1,2,-1,5.56040738348383,3.69831329770386,1.86209408577997,28,28,0,33,33,0,42,49,-7,2,3,0,0
"11651","MIN","CHI",2013030236,16203,20132014,1,69.7,1,2,-1,6.97860803472577,3.23519435313938,3.74341368158639,35,27,8,47,32,15,68,52,16,3,1,0,0
"11652","MIN","COL",2014020014,16352,20142015,1,60,5,0,5,5.30065556424722,1.9097475091985,3.39090805504873,48,16,32,69,23,46,78,29,49,4,6,0,0
"11653","MIN","COL",2014020029,16354,20142015,0,60,3,0,3,5.042373344856,4.01059832753366,1.03177501732235,34,30,4,44,43,1,58,64,-6,6,6,0,0
"11654","MIN","ANA",2014020062,16360,20142015,0,60,1,2,-1,3.38227990107407,5.2187305959695,-1.83645069489543,28,26,2,41,41,0,53,51,2,4,5,0,0
"11655","MIN","L.A",2014020074,16362,20142015,0,60,1,2,-1,5.76661964125469,4.01971439440968,1.74690524684502,41,16,25,58,24,34,70,31,39,5,2,0,0
"11656","MIN","ARI",2014020097,16366,20142015,1,60,2,0,2,4.94632789898697,4.0355773250035,0.910750573983474,29,26,3,41,41,0,60,55,5,3,2,0,0
"11657","MIN","T.B",2014020114,16368,20142015,1,60,7,2,5,2.8806804328924,3.10100853703261,-0.220328104140208,22,19,3,29,37,-8,37,51,-14,1,4,0,0
"11658","MIN","NYR",2014020122,16370,20142015,0,60,4,5,-1,3.73547634135139,3.31276527514098,0.422711066210411,30,20,10,44,25,19,54,31,23,2,1,0,0
"11659","MIN","BOS",2014020124,16371,20142015,0,60,4,3,1,8.76577093574451,4.55743898655055,4.20833194919396,42,28,14,54,37,17,71,57,14,3,3,0,0
"11660","MIN","S.J",2014020145,16373,20142015,1,65,3,3,0,7.59504616161576,5.03445023741705,2.56059592419871,46,28,18,59,38,21,72,55,17,1,2,0,0
"11661","MIN","DAL",2014020162,16375,20142015,1,60,4,1,3,4.27384662269073,2.8984203574073,1.37542626528342,30,20,10,44,30,14,54,53,1,4,4,0,0
"11662","MIN","OTT",2014020189,16380,20142015,0,60,0,3,-3,5.49439017745561,1.93756858730922,3.5568215901464,35,17,18,41,28,13,54,40,14,5,7,0,0
"11663","MIN","MTL",2014020205,16382,20142015,0,60,1,4,-3,5.60119124982157,4.28033624718046,1.32085500264111,31,31,0,46,36,10,70,45,25,4,3,0,0
"11664","MIN","N.J",2014020220,16385,20142015,0,60,1,3,-2,3.34716546925483,3.49869088096875,-0.151525411713919,24,23,1,31,29,2,37,35,2,4,6,0,0
"11665","MIN","BUF",2014020238,16387,20142015,1,60,6,3,3,6.6041282563765,4.12393379538533,2.48019446099116,39,28,11,57,32,25,78,38,40,4,2,0,0
"11666","MIN","DAL",2014020249,16389,20142015,0,60,2,1,1,4.19775250426028,3.97449540911839,0.223257095141889,22,28,-6,34,43,-9,50,71,-21,1,2,0,0
"11667","MIN","WPG",2014020261,16390,20142015,1,61.0166666666667,4,3,1,4.79536249096336,4.81585663601874,-0.0204941450553804,27,25,2,32,40,-8,41,61,-20,8,11,0,0
"11668","MIN","PHI",2014020280,16394,20142015,0,60,3,2,1,6.41587116126902,4.11015605469304,2.30571510657599,29,39,-10,37,48,-11,43,72,-29,7,5,0,0
"11669","MIN","T.B",2014020298,16396,20142015,0,60,1,2,-1,3.86135567021275,3.35116568877129,0.510189981441457,31,28,3,44,42,2,62,57,5,3,2,0,0
"11670","MIN","FLA",2014020315,16398,20142015,0,60,4,1,3,5.79892267861578,3.45854901157802,2.34037366703776,39,30,9,54,41,13,62,51,11,4,4,0,0
"11671","MIN","L.A",2014020329,16400,20142015,1,60,0,4,-4,3.79293811535172,2.25588488171707,1.53705323363465,28,22,6,46,31,15,57,41,16,3,3,0,0
"11672","MIN","DAL",2014020343,16402,20142015,0,62.0666666666667,5,4,1,7.11970270397217,7.58552700548898,-0.465824301516818,34,45,-11,48,58,-10,61,77,-16,2,4,0,0
"11673","MIN","STL",2014020351,16403,20142015,1,65,2,2,0,4.72747890933533,4.05942947384079,0.668049435494538,38,26,12,55,38,17,72,47,25,3,2,0,0
"11674","MIN","MTL",2014020372,16407,20142015,1,60,2,1,1,5.13399856787873,3.05870323347776,2.07529533440097,35,19,16,48,31,17,62,47,15,4,1,0,0
"11675","MIN","ANA",2014020387,16409,20142015,1,60,4,5,-1,4.84649359062314,2.88307288105716,1.96342070956598,25,21,4,36,35,1,52,47,5,4,4,0,0
"11676","MIN","NYI",2014020415,16413,20142015,1,60,5,4,1,7.17181484129321,2.53778025385691,4.6340345874363,30,19,11,45,29,16,70,41,29,5,5,0,0
"11677","MIN","S.J",2014020430,16415,20142015,0,60,1,2,-1,3.26831788359095,4.05129838513676,-0.782980501545808,19,30,-11,30,51,-21,53,67,-14,3,4,0,0
"11678","MIN","ARI",2014020444,16417,20142015,0,65,3,3,0,5.7273220888892,5.7614416892975,-0.0341196004083031,35,30,5,48,52,-4,69,80,-11,4,4,0,0
"11679","MIN","CHI",2014020461,16420,20142015,0,60,3,5,-2,4.03732131308061,5.77782689034939,-1.74050557726878,29,39,-10,38,44,-6,56,61,-5,4,3,0,0
"11680","MIN","BOS",2014020465,16421,20142015,1,61.5,2,3,-1,5.96070245558254,4.50322579516796,1.45747666041458,37,25,12,52,32,20,63,43,20,2,2,0,0
"11681","MIN","NSH",2014020488,16424,20142015,1,61.75,5,6,-1,8.32030815177131,8.83276427706096,-0.512456125289646,27,44,-17,42,57,-15,56,78,-22,4,4,0,0
"11682","MIN","PHI",2014020507,16427,20142015,1,60,2,5,-3,3.97731818712782,4.72561709077854,-0.748298903650721,24,30,-6,35,36,-1,50,47,3,6,2,0,0
"11683","MIN","WPG",2014020520,16431,20142015,1,62.7833333333333,3,4,-1,5.09438445117399,3.37917789246421,1.71520655870978,25,23,2,40,34,6,54,52,2,5,3,0,0
"11684","MIN","WPG",2014020536,16433,20142015,0,60,3,2,1,8.15229027227906,3.72845556788683,4.42383470439223,31,30,1,43,38,5,60,67,-7,4,3,0,0
"11685","MIN","CBJ",2014020549,16435,20142015,0,60,1,3,-2,4.90112474763737,4.47670974442735,0.424415003210015,29,26,3,42,31,11,51,41,10,4,2,0,0
"11686","MIN","TOR",2014020562,16437,20142015,1,60,3,1,2,3.57406035251915,3.39103011094267,0.183030241576489,29,35,-6,39,46,-7,53,57,-4,4,5,0,0
"11687","MIN","DAL",2014020572,16438,20142015,0,60,1,7,-6,1.30483622496104,4.46215945261065,-3.15732322764961,22,35,-13,29,55,-26,46,72,-26,5,6,0,0
"11688","MIN","S.J",2014020588,16441,20142015,1,63.15,3,4,-1,7.32565487676601,6.42441583943578,0.90123903733023,31,26,5,38,42,-4,49,58,-9,3,5,0,0
"11689","MIN","CHI",2014020603,16443,20142015,1,60,2,4,-2,6.25645523448475,4.27511745016091,1.98133778432384,44,20,24,58,27,31,81,36,45,5,1,0,0
"11690","MIN","NSH",2014020614,16445,20142015,1,60,1,3,-2,4.19122517600245,3.93330461112782,0.257920564874624,37,27,10,50,37,13,64,50,14,6,3,0,0
"11691","MIN","CHI",2014020625,16446,20142015,0,60,1,4,-3,5.06901801982895,3.62867998955335,1.4403380302756,37,35,2,48,46,2,60,63,-3,3,2,0,0
"11692","MIN","BUF",2014020645,16450,20142015,0,60,7,0,7,3.94574498005244,1.79126684747439,2.15447813257805,37,18,19,45,29,16,63,44,19,6,3,0,0
"11693","MIN","ARI",2014020669,16452,20142015,1,60,3,1,2,6.03048211889109,4.51397312758806,1.51650899130303,33,26,7,44,35,9,53,51,2,5,4,0,0
"11694","MIN","CBJ",2014020680,16454,20142015,1,60,1,3,-2,4.02091959211975,3.10192635725252,0.91899323486723,26,23,3,49,29,20,61,41,20,3,2,0,0
"11695","MIN","DET",2014020687,16455,20142015,0,65,4,4,0,3.78562259528553,3.88305309231509,-0.0974304970295634,38,24,14,41,35,6,52,47,5,5,2,0,0
"11696","MIN","EDM",2014020706,16462,20142015,0,60,2,1,1,4.97282388561871,4.66096486235631,0.3118590232624,29,24,5,46,42,4,62,60,2,3,4,0,0
"11697","MIN","CGY",2014020719,16464,20142015,0,60,1,0,1,3.97649896463918,5.26836159308004,-1.29186262844087,32,30,2,42,43,-1,57,62,-5,1,1,0,0
"11698","MIN","VAN",2014020741,16467,20142015,0,60,4,2,2,5.30802503524032,6.09971945915822,-0.791694423917908,20,37,-17,30,49,-19,33,61,-28,3,5,0,0
"11699","MIN","CHI",2014020752,16469,20142015,1,60,3,0,3,5.14497534699171,4.05876732023899,1.08620802675273,43,24,19,51,34,17,65,45,20,4,3,0,0
"11700","MIN","COL",2014020780,16473,20142015,1,60,1,0,1,3.70275055404636,3.75302743643988,-0.0502768823935185,29,18,11,50,26,24,66,42,24,3,2,0,0
"11701","MIN","VAN",2014020794,16475,20142015,1,60,5,3,2,5.53981889388524,4.71405030993128,0.825768583953959,32,25,7,41,43,-2,55,54,1,7,3,0,0
"11702","MIN","WPG",2014020805,16476,20142015,0,64,1,2,-1,3.86998357460834,3.76167414866359,0.108309425944753,30,34,-4,38,49,-11,45,74,-29,3,4,0,0
"11703","MIN","FLA",2014020815,16478,20142015,1,60,2,1,1,5.81139264511876,3.26693974767113,2.54445289744763,23,27,-4,32,40,-8,39,59,-20,3,4,0,0
"11704","MIN","CAR",2014020828,16480,20142015,1,60,6,3,3,5.46232179435901,2.97645782429026,2.48586397006875,24,27,-3,33,45,-12,39,71,-32,3,3,0,0
"11705","MIN","VAN",2014020844,16482,20142015,0,60,2,3,-1,2.39056075213011,3.50999083584611,-1.119430083716,22,29,-7,34,38,-4,55,47,8,1,1,0,0
"11706","MIN","CGY",2014020855,16484,20142015,0,61.8333333333333,3,2,1,5.21511486988979,4.20638320555491,1.00873166433487,29,37,-8,38,52,-14,58,73,-15,1,3,0,0
"11707","MIN","EDM",2014020872,16486,20142015,0,60,4,0,4,3.83607715393009,0.700005168444477,3.13607198548561,29,15,14,40,22,18,48,36,12,0,1,0,0
"11708","MIN","DAL",2014020891,16488,20142015,1,60,6,2,4,4.34722801880494,4.86438047062997,-0.517152451825027,35,20,15,42,26,16,51,35,16,2,3,0,0
"11709","MIN","EDM",2014020901,16490,20142015,1,60,1,2,-1,2.48591030323587,2.77764952747384,-0.291739224237972,34,19,15,45,29,16,69,43,26,3,2,0,0
"11710","MIN","NSH",2014020913,16492,20142015,0,60,4,2,2,5.42466313525074,3.91994219824846,1.50472093700228,30,29,1,37,37,0,42,53,-11,2,2,0,0
"11711","MIN","COL",2014020930,16494,20142015,0,60,3,1,2,5.32286538924382,5.20241278359808,0.120452605645738,32,34,-2,45,50,-5,63,67,-4,5,7,0,0
"11712","MIN","OTT",2014020947,16497,20142015,1,65,2,2,0,6.17156456372672,7.70615648754866,-1.53459192382194,38,33,5,47,46,1,58,63,-5,3,4,0,0
"11713","MIN","WSH",2014020958,16499,20142015,0,60,2,1,1,4.94546681178326,3.26265455393961,1.68281225784365,30,25,5,40,36,4,55,46,9,2,1,0,0
"11714","MIN","CAR",2014020965,16500,20142015,0,60,3,1,2,2.70623689219065,5.02545901019766,-2.31922211800702,19,38,-19,29,48,-19,35,73,-38,2,2,0,0
"11715","MIN","COL",2014020982,16502,20142015,1,60,2,3,-1,2.80346566118533,3.12818489434591,-0.324719233160579,34,21,13,51,27,24,69,35,34,2,3,0,0
"11716","MIN","N.J",2014020997,16504,20142015,1,60,6,2,4,4.95371786832402,5.23452383123185,-0.280805962907834,38,32,6,57,41,16,70,45,25,4,0,0,0
"11717","MIN","ANA",2014021016,16507,20142015,1,60,1,2,-1,10.5152326272382,7.7288876228491,2.78634500438912,33,24,9,48,31,17,57,41,16,6,4,0,0
"11718","MIN","STL",2014021026,16508,20142015,0,60,3,1,2,1.43365988566802,5.43180439260323,-3.9981445069352,19,42,-23,25,59,-34,36,83,-47,4,4,0,0
"11719","MIN","NSH",2014021045,16511,20142015,0,60.3666666666667,3,2,1,2.36727670067921,4.49141056431108,-2.12413386363187,21,27,-6,26,35,-9,37,55,-18,0,4,0,0
"11720","MIN","WSH",2014021057,16513,20142015,1,60,2,3,-1,4.60262570963113,3.11057449321379,1.49205121641734,30,27,3,40,42,-2,54,58,-4,5,6,0,0
"11721","MIN","STL",2014021066,16515,20142015,1,60,6,3,3,4.8329937921788,4.65468029785552,0.178313494323277,28,29,-1,37,40,-3,49,54,-5,4,4,0,0
"11722","MIN","TOR",2014021085,16517,20142015,0,60,2,1,1,3.51615905930521,5.66052988704243,-2.14437082773722,32,36,-4,43,47,-4,56,61,-5,3,4,0,0
"11723","MIN","NYI",2014021090,16518,20142015,0,65,1,1,0,4.51163364812965,5.03784663180977,-0.526212983680125,32,38,-6,47,51,-4,65,72,-7,1,1,0,0
"11724","MIN","CGY",2014021112,16521,20142015,1,60,4,2,2,3.07239928399213,5.40496495623051,-2.33256567223839,36,25,11,46,34,12,64,43,21,1,2,0,0
"11725","MIN","L.A",2014021125,16522,20142015,1,60,4,1,3,3.96243157728736,4.43249987786794,-0.470068300580579,20,32,-12,27,49,-22,34,73,-39,2,3,0,0
"11726","MIN","NYR",2014021159,16527,20142015,1,60,2,3,-1,8.17071311082168,3.51057874791877,4.66013436290291,28,26,2,39,33,6,46,43,3,2,5,0,0
"11727","MIN","DET",2014021175,16529,20142015,1,65,2,2,0,2.23048819692485,3.94600646781013,-1.71551827088528,24,22,2,35,44,-9,47,64,-17,6,2,0,0
"11728","MIN","WPG",2014021187,16531,20142015,1,60,0,2,-2,6.27320632363013,3.02363640980911,3.24956991382101,32,34,-2,48,43,5,67,51,16,3,4,0,0
"11729","MIN","CHI",2014021196,16532,20142015,0,60,2,1,1,4.35740092815831,4.85036004800349,-0.492959119845182,30,33,-3,45,39,6,55,59,-4,1,1,0,0
"11730","MIN","NSH",2014021209,16534,20142015,0,60,4,2,2,3.78581847250462,4.69905129242034,-0.91323281991572,27,34,-7,31,42,-11,47,54,-7,2,3,0,0
"11731","MIN","STL",2014021226,16536,20142015,0,60,2,4,-2,3.96277124258631,3.66341630167881,0.299354940907506,25,24,1,31,33,-2,50,50,0,5,3,0,0
"11732","MIN","STL",2014030151,16541,20142015,0,60,4,2,2,3.27312803595851,5.15731513459468,-1.88418709863618,29,21,8,35,38,-3,49,58,-9,4,2,0,0
"11733","MIN","STL",2014030152,16543,20142015,0,60,1,4,-3,3.3222528711708,5.65249111689627,-2.33023824572547,25,27,-2,35,36,-1,47,50,-3,1,3,0,0
"11734","MIN","STL",2014030153,16545,20142015,1,60,3,0,3,5.53878018661635,4.26887057034672,1.26990961626963,24,17,7,36,29,7,55,47,8,3,0,0,0
"11735","MIN","STL",2014030154,16547,20142015,1,60,1,6,-5,1.42490330020203,4.66400726977736,-3.23910396957532,18,26,-8,28,48,-20,43,57,-14,1,2,0,0
"11736","MIN","STL",2014030155,16549,20142015,0,60,4,1,3,2.28673901990987,4.29980863587116,-2.01306961596129,19,37,-18,26,55,-29,39,73,-34,3,3,0,0
"11737","MIN","STL",2014030156,16551,20142015,1,60,4,1,3,5.28469135134947,4.63096287951339,0.653728471836075,21,31,-10,32,42,-10,38,65,-27,2,3,0,0
"11738","MIN","CHI",2014030231,16556,20142015,0,60,3,4,-1,3.18363917991519,4.99162794458971,-1.80798876467452,33,35,-2,40,43,-3,52,55,-3,3,1,0,0
"11739","MIN","CHI",2014030232,16558,20142015,0,60,1,4,-3,7.25533899664879,7.09964501991635,0.155693976732437,31,31,0,42,45,-3,51,63,-12,2,2,0,0
"11740","MIN","CHI",2014030233,16560,20142015,1,60,0,1,-1,5.7624851805158,3.28299831195909,2.47948686855671,30,22,8,46,31,15,65,41,24,3,1,0,0
"11741","MIN","CHI",2014030234,16562,20142015,1,60,3,4,-1,4.54784709436353,3.55977274928591,0.988074345077621,37,25,12,50,39,11,64,53,11,3,2,0,0
"11742","MIN","COL",2015020011,16716,20152016,0,60,5,4,1,4.52367684665114,3.57692198303994,0.946754863611204,30,23,7,46,36,10,75,48,27,3,3,0,0
"11743","MIN","STL",2015020025,16718,20152016,1,60,3,2,1,3.45027231622953,6.72502479149261,-3.27475247526309,19,32,-13,29,43,-14,43,62,-19,5,4,0,0
"11744","MIN","ARI",2015020057,16723,20152016,0,60,4,3,1,3.50279635608155,3.9091870875011,-0.406390731419545,24,30,-6,33,43,-10,41,58,-17,7,9,0,0
"11745","MIN","L.A",2015020064,16724,20152016,0,62.3166666666667,1,2,-1,3.60467762127519,5.81681185079651,-2.21213422952133,26,37,-11,38,60,-22,46,74,-28,5,4,0,0
"11746","MIN","ANA",2015020077,16726,20152016,0,60,1,4,-3,5.39720959561441,3.88222497305833,1.51498462255609,35,22,13,56,37,19,76,47,29,1,2,0,0
"11747","MIN","CBJ",2015020096,16730,20152016,1,60,3,2,1,2.48182477863156,5.55923207021472,-3.07740729158315,23,29,-6,34,44,-10,49,55,-6,2,2,0,0
"11748","MIN","ANA",2015020106,16732,20152016,1,60,3,0,3,6.39421297915396,2.02699250928407,4.3672204698699,30,15,15,43,24,19,64,42,22,5,1,0,0
"11749","MIN","WPG",2015020118,16733,20152016,0,60,4,5,-1,3.51416295289528,5.83814173801724,-2.32397878512197,30,33,-3,41,41,0,55,54,1,5,1,0,0
"11750","MIN","EDM",2015020130,16735,20152016,1,60,4,3,1,7.32393080664406,5.3777861689814,1.94614463766266,28,25,3,45,37,8,59,55,4,2,1,0,0
"11751","MIN","CHI",2015020151,16738,20152016,1,60,5,4,1,3.2393794223899,6.36295700468253,-3.12357758229263,30,29,1,48,41,7,66,56,10,2,1,0,0
"11752","MIN","STL",2015020162,16739,20152016,0,64.4333333333333,2,3,-1,6.08332038519438,3.7242885883461,2.35903179684829,31,26,5,41,35,6,53,44,9,7,4,0,0
"11753","MIN","NSH",2015020189,16744,20152016,1,60,2,3,-1,2.6049687092891,4.33304443590168,-1.72807572661259,29,24,5,44,37,7,67,51,16,7,2,0,0
"11754","MIN","T.B",2015020207,16746,20152016,1,60,1,0,1,5.3117217473191,5.02125101867034,0.290470728648756,25,31,-6,41,45,-4,48,53,-5,3,2,0,0
"11755","MIN","WPG",2015020224,16749,20152016,1,60,5,3,2,3.80396236671368,3.41002809093787,0.393934275775806,28,28,0,42,37,5,57,59,-2,6,2,0,0
"11756","MIN","CAR",2015020233,16751,20152016,0,63.8333333333333,3,2,1,3.84612359356834,7.69434860650654,-3.8482250129382,21,39,-18,36,63,-27,45,84,-39,0,3,0,0
"11757","MIN","DAL",2015020257,16753,20152016,0,63.3,2,3,-1,5.45959045150382,4.83896177184852,0.6206286796553,24,36,-12,47,49,-2,66,66,0,6,6,0,0
"11758","MIN","BOS",2015020278,16758,20152016,0,60,2,4,-2,3.69776395310427,4.84381665302135,-1.14605269991708,26,38,-12,36,51,-15,52,61,-9,7,7,0,0
"11759","MIN","NSH",2015020302,16760,20152016,1,60,4,0,4,5.20807553705163,5.78553195827408,-0.57745642122245,27,23,4,36,32,4,50,44,6,5,3,0,0
"11760","MIN","VAN",2015020324,16764,20152016,1,60,2,3,-1,2.41016982806877,2.85872435200594,-0.448554523937162,33,28,5,42,38,4,56,54,2,3,1,0,0
"11761","MIN","WPG",2015020332,16766,20152016,1,60,1,3,-2,1.91040126024745,5.84513184474781,-3.93473058450036,15,29,-14,22,42,-20,34,52,-18,3,5,0,0
"11762","MIN","DAL",2015020349,16767,20152016,1,63.95,3,4,-1,5.7148960880877,4.67738474910584,1.03751133898186,26,44,-18,39,55,-16,47,71,-24,2,2,0,0
"11763","MIN","CHI",2015020365,16770,20152016,0,60,2,1,1,5.19115387995589,3.59229437037684,1.59885950957905,36,31,5,51,37,14,64,59,5,4,3,0,0
"11764","MIN","TOR",2015020379,16772,20152016,1,60,1,0,1,2.91402685388664,4.3378420877473,-1.42381523386066,28,28,0,34,37,-3,49,53,-4,3,2,0,0
"11765","MIN","COL",2015020395,16774,20152016,1,60,3,0,3,4.91506504091376,2.67033643573561,2.24472860517815,44,20,24,56,28,28,72,36,36,5,3,0,0
"11766","MIN","COL",2015020406,16776,20152016,0,63.5833333333333,1,2,-1,2.97567885485478,5.16146432896068,-2.1857854741059,20,20,0,34,31,3,47,41,6,3,1,0,0
"11767","MIN","ARI",2015020433,16780,20152016,0,60.5666666666667,1,2,-1,5.07099928897878,2.6265928784851,2.44440641049368,28,21,7,35,31,4,47,42,5,4,6,0,0
"11768","MIN","S.J",2015020444,16781,20152016,0,60,2,0,2,3.98215581018476,5.82001477849553,-1.83785896831078,30,25,5,37,37,0,54,55,-1,1,2,0,0
"11769","MIN","VAN",2015020460,16784,20152016,1,60,6,2,4,6.56528047543543,5.51168745799077,1.05359301744465,41,31,10,55,37,18,65,46,19,5,1,0,0
"11770","MIN","NYR",2015020472,16786,20152016,1,60,5,2,3,7.03520773065725,1.85014959906403,5.18505813159322,35,23,12,46,30,16,56,41,15,4,3,0,0
"11771","MIN","NSH",2015020490,16788,20152016,0,60,2,3,-1,3.41166050912943,6.45414897536102,-3.04248846623159,22,39,-17,30,53,-23,42,66,-24,2,5,0,0
"11772","MIN","DAL",2015020504,16790,20152016,1,60,3,6,-3,8.63682840869296,4.92167185028666,3.71515655840631,35,34,1,44,43,1,55,58,-3,1,3,0,0
"11773","MIN","MTL",2015020512,16791,20152016,1,60,2,1,1,6.19919124267471,1.91477749048499,4.28441375218972,22,25,-3,36,34,2,48,57,-9,1,1,0,0
"11774","MIN","PIT",2015020523,16795,20152016,1,60,1,3,-2,2.47954513551667,5.17648879282115,-2.69694365730447,26,32,-6,37,47,-10,47,61,-14,4,3,0,0
"11775","MIN","DET",2015020538,16797,20152016,1,60,3,1,2,4.2667978527752,4.58116184691607,-0.314363994140876,35,29,6,40,36,4,45,59,-14,3,3,0,0
"11776","MIN","STL",2015020559,16800,20152016,0,60,3,1,2,3.22858352771436,4.29447621987492,-1.06589269216056,29,34,-5,35,45,-10,44,62,-18,2,4,0,0
"11777","MIN","T.B",2015020571,16802,20152016,0,65,2,2,0,3.15048373339232,5.70955719168705,-2.55907345829473,32,30,2,40,47,-7,57,54,3,4,1,0,0
"11778","MIN","FLA",2015020580,16803,20152016,0,60,1,2,-1,4.72827123826357,2.81284080113983,1.91543043712375,40,29,11,46,35,11,53,43,10,4,5,0,0
"11779","MIN","CBJ",2015020593,16805,20152016,0,60,4,2,2,4.79026223750952,7.16990931349574,-2.37964707598621,33,31,2,44,44,0,58,67,-9,3,2,0,0
"11780","MIN","PHI",2015020603,16807,20152016,1,64.3833333333333,3,4,-1,4.06465167928945,5.52019281993853,-1.45554114064907,34,36,-2,43,58,-15,53,65,-12,2,3,0,0
"11781","MIN","DAL",2015020620,16809,20152016,0,60,2,1,1,2.87858658810728,5.79852263249859,-2.91993604439131,25,35,-10,32,56,-24,43,82,-39,2,3,0,0
"11782","MIN","N.J",2015020627,16810,20152016,1,60,1,2,-1,3.73662108415738,3.7467954766762,-0.0101743925188202,18,17,1,26,33,-7,37,49,-12,2,3,0,0
"11783","MIN","BUF",2015020637,16812,20152016,1,60,2,3,-1,6.04649373958819,3.64821671613026,2.39827702345792,30,23,7,41,36,5,54,48,6,1,2,0,0
"11784","MIN","WPG",2015020658,16815,20152016,1,60,0,1,-1,4.01437846681802,3.64673320483416,0.367645261983853,24,26,-2,41,35,6,54,45,9,3,2,0,0
"11785","MIN","NSH",2015020666,16816,20152016,0,60,0,3,-3,4.2576382955326,3.45679526139259,0.800843034140016,29,25,4,41,33,8,59,48,11,3,2,0,0
"11786","MIN","ANA",2015020692,16820,20152016,0,60,1,3,-2,4.29326779846451,4.1641684573298,0.129099341134708,26,27,-1,41,37,4,57,51,6,3,1,0,0
"11787","MIN","L.A",2015020702,16821,20152016,0,60,3,0,3,4.35278856627701,7.49253994096944,-3.13975137469242,28,32,-4,39,55,-16,49,76,-27,3,2,0,0
"11788","MIN","S.J",2015020710,16823,20152016,0,60,3,4,-1,4.6548541369848,3.64862879758584,1.00622533939895,28,33,-5,36,45,-9,52,68,-16,3,3,0,0
"11789","MIN","ARI",2015020730,16825,20152016,1,65,1,1,0,2.39760662075983,5.97795687621692,-3.58035025545709,35,24,11,42,41,1,61,56,5,2,3,0,0
"11790","MIN","NYI",2015020746,16833,20152016,0,60,3,5,-2,5.15188604194555,7.52737836184252,-2.37549231989698,43,38,5,53,55,-2,64,69,-5,4,1,0,0
"11791","MIN","NYR",2015020760,16835,20152016,0,60,2,4,-2,4.32162653264822,4.72091092464402,-0.399284391995792,18,30,-12,31,50,-19,43,66,-23,3,3,0,0
"11792","MIN","STL",2015020782,16837,20152016,0,60,1,4,-3,4.80468100942517,2.99176301781411,1.81291799161106,39,24,15,53,32,21,63,37,26,8,7,0,0
"11793","MIN","DAL",2015020802,16840,20152016,1,62.65,3,4,-1,5.54050587612437,4.40022623690311,1.14027963922126,40,30,10,49,46,3,68,60,8,3,3,0,0
"11794","MIN","WSH",2015020813,16842,20152016,1,60,3,4,-1,5.10507608680597,5.83455855826378,-0.729482471457807,36,33,3,55,44,11,72,56,16,5,5,0,0
"11795","MIN","BOS",2015020826,16844,20152016,1,60,2,4,-2,0,0,0,33,19,14,44,32,12,60,42,18,5,5,0,0
"11796","MIN","VAN",2015020846,16846,20152016,0,60,5,2,3,6.49910455927602,6.04874747450865,0.450357084767369,34,26,8,47,38,9,52,55,-3,4,4,0,0
"11797","MIN","CGY",2015020857,16848,20152016,0,60,5,3,2,4.47616593893235,2.81148008567958,1.66468585325277,24,28,-4,30,46,-16,35,64,-29,3,5,0,0
"11798","MIN","EDM",2015020866,16849,20152016,0,60,5,2,3,6.44664260698482,5.99589893146185,0.450743675522972,27,33,-6,33,51,-18,45,74,-29,3,2,0,0
"11799","MIN","CHI",2015020884,16852,20152016,1,60,6,1,5,4.98085876729056,2.89169447956491,2.08916428772565,33,32,1,44,43,1,50,63,-13,6,5,0,0
"11800","MIN","NYI",2015020898,16854,20152016,1,60,1,4,-3,4.43394876833599,5.78920920080054,-1.35526043246455,31,31,0,39,38,1,61,44,17,5,3,0,0
"11801","MIN","PHI",2015020906,16856,20152016,0,60,2,3,-1,4.9412942424533,8.67460386644422,-3.73330962399092,26,31,-5,33,41,-8,50,57,-7,3,1,0,0
"11802","MIN","WSH",2015020917,16857,20152016,0,60,2,3,-1,4.90426165382451,5.1264250583481,-0.222163404523599,32,27,5,45,36,9,64,52,12,3,1,0,0
"11803","MIN","FLA",2015020932,16859,20152016,1,60,3,1,2,5.77828206768027,3.9929196564517,1.78536241122856,27,18,9,43,27,16,51,40,11,7,5,0,0
"11804","MIN","COL",2015020948,16861,20152016,1,60,6,3,3,6.05388706564213,4.77797815969097,1.27590890595116,30,33,-3,41,44,-3,52,63,-11,3,3,0,0
"11805","MIN","TOR",2015020958,16863,20152016,0,60,2,1,1,5.58614208048675,5.08410136893508,0.502040711551672,22,22,0,36,34,2,48,56,-8,4,0,0,0
"11806","MIN","BUF",2015020969,16865,20152016,0,65,2,2,0,3.91344571116497,6.13112587198339,-2.21768016081842,30,32,-2,39,47,-8,53,58,-5,2,2,0,0
"11807","MIN","STL",2015020985,16866,20152016,1,60,2,4,-2,3.3763153130173,7.95793261833751,-4.58161730532021,32,35,-3,40,51,-11,63,59,4,4,1,0,0
"11808","MIN","EDM",2015021011,16870,20152016,1,60,1,2,-1,0,0,0,30,25,5,42,36,6,60,51,9,4,2,0,0
"11809","MIN","MTL",2015021021,16872,20152016,0,60,4,1,3,5.44907399789372,4.68261373872519,0.766460259168525,22,31,-9,29,41,-12,46,61,-15,2,2,0,0
"11810","MIN","OTT",2015021044,16875,20152016,0,64.4833333333333,2,3,-1,4.90518673078623,4.46927415360551,0.435912577180716,25,20,5,33,36,-3,45,61,-16,3,3,0,0
"11811","MIN","N.J",2015021053,16877,20152016,0,60,4,7,-3,7.33209782183985,3.65064190288613,3.68145591895372,32,25,7,42,31,11,50,39,11,3,1,0,0
"11812","MIN","CAR",2015021068,16879,20152016,1,65,2,2,0,2.9692685901509,4.02589490186074,-1.05662631170983,32,33,-1,41,39,2,53,47,6,2,2,0,0
"11813","MIN","CHI",2015021082,16880,20152016,0,65,2,2,0,4.51167238428025,4.05660142362467,0.455070960655576,34,31,3,45,43,2,66,56,10,3,1,0,0
"11814","MIN","L.A",2015021094,16882,20152016,1,60,2,1,1,2.79061812325381,5.63557991669222,-2.84496179343842,18,39,-21,23,55,-32,32,74,-42,5,2,0,0
"11815","MIN","CGY",2015021107,16884,20152016,1,60,6,2,4,4.53422002855223,5.59566964429588,-1.06144961574365,29,33,-4,37,46,-9,43,69,-26,5,5,0,0
"11816","MIN","COL",2015021117,16886,20152016,0,60,4,0,4,4.8486112478713,4.07215704162945,0.776454206241851,35,29,6,41,46,-5,59,59,0,5,5,0,0
"11817","MIN","CHI",2015021146,16889,20152016,1,60,4,1,3,3.59087918671139,4.5519136399962,-0.96103445328481,18,19,-1,31,35,-4,44,59,-15,2,3,0,0
"11818","MIN","OTT",2015021158,16891,20152016,1,60,2,3,-1,2.44682958708668,6.18050837400369,-3.73367878691701,25,22,3,38,32,6,47,44,3,2,1,0,0
"11819","MIN","DET",2015021162,16892,20152016,0,60,2,3,-1,3.80824476567796,5.96080608309421,-2.15256131741626,22,29,-7,32,45,-13,40,54,-14,2,3,0,0
"11820","MIN","WPG",2015021180,16894,20152016,0,60,1,5,-4,4.83999930158461,6.5898483969213,-1.74984909533669,29,34,-5,41,44,-3,60,58,2,3,4,0,0
"11821","MIN","S.J",2015021195,16896,20152016,1,60,0,3,-3,4.14998929079957,2.86535487706986,1.28463441372971,29,20,9,37,29,8,48,43,5,3,3,0,0
"11822","MIN","CGY",2015021224,16900,20152016,1,60,1,2,-1,4.23357806751712,3.93859218997272,0.294985877544393,36,25,11,51,30,21,68,39,29,7,4,0,0
"11823","MIN","DAL",2015030151,16905,20152016,0,60,0,4,-4,2.00845008050906,5.40737201838056,-3.39892193787149,22,32,-10,27,41,-14,46,62,-16,2,6,0,0
"11824","MIN","DAL",2015030152,16907,20152016,0,60,1,2,-1,2.06189577516488,4.07007986211623,-2.00818408695135,26,28,-2,40,51,-11,54,77,-23,5,5,0,0
"11825","MIN","DAL",2015030153,16909,20152016,1,60,5,3,2,5.87782331221388,3.59572503876552,2.28209827344836,25,17,8,37,23,14,54,47,7,3,3,0,0
"11826","MIN","DAL",2015030154,16911,20152016,1,60,2,3,-1,4.98409256676188,4.66764446924208,0.316448097519803,30,22,8,40,38,2,56,51,5,4,3,0,0
"11827","MIN","DAL",2015030155,16913,20152016,0,64.9166666666667,5,4,1,5.57033113574569,6.68243866274133,-1.11210752699564,24,41,-17,33,59,-26,47,93,-46,1,3,0,0
"11828","MIN","DAL",2015030156,16915,20152016,1,60,4,5,-1,4.10748547152616,3.05501124738657,1.05247422413959,29,24,5,37,30,7,54,49,5,4,2,0,0
"11829","MIN","STL",2016020011,17087,20162017,0,60,2,3,-1,1.77062789892079,3.56943644140847,-1.79880854248768,21,31,-10,36,41,-5,53,53,0,7,5,0,0
"11830","MIN","WPG",2016020024,17089,20162017,1,60,4,3,1,4.76313227253888,2.78279412584379,1.98033814669509,31,17,14,45,21,24,56,37,19,5,4,0,0
"11831","MIN","L.A",2016020044,17092,20162017,1,60,6,3,3,8.50884434627369,4.90809851861091,3.60074582766278,26,30,-4,31,47,-16,35,72,-37,4,5,0,0
"11832","MIN","TOR",2016020057,17094,20162017,1,60,3,2,1,2.16012477932964,4.64479753264459,-2.48467275331495,27,33,-6,37,43,-6,57,56,1,3,3,0,0
"11833","MIN","N.J",2016020069,17096,20162017,0,60.4833333333333,1,2,-1,2.81044952222146,3.38689145909491,-0.576441936873449,29,32,-3,34,37,-3,41,41,0,3,3,0,0
"11834","MIN","NYI",2016020078,17097,20162017,0,60,3,6,-3,4.61959226097679,4.80454508349067,-0.184952822513878,29,33,-4,48,42,6,71,53,18,6,3,0,0
"11835","MIN","BOS",2016020083,17099,20162017,0,60,5,0,5,4.15221231813484,4.67988005140614,-0.527667733271299,33,27,6,45,45,0,53,61,-8,5,4,0,0
"11836","MIN","BUF",2016020098,17101,20162017,0,60,4,0,4,4.10345560449059,5.32118766385247,-1.21773205936188,22,38,-16,33,50,-17,42,61,-19,2,2,0,0
"11837","MIN","DAL",2016020119,17103,20162017,1,60,4,0,4,4.970434208808,6.89455549680133,-1.92412128799333,15,29,-14,24,43,-19,36,64,-28,2,3,0,0
"11838","MIN","BUF",2016020137,17106,20162017,1,60,1,2,-1,7.11055123229744,2.67355102673173,4.43700020556571,28,24,4,42,32,10,60,41,19,1,1,0,0
"11839","MIN","COL",2016020161,17110,20162017,0,60,0,1,-1,4.64660101337358,5.51795414922828,-0.871353135854694,32,32,0,40,38,2,52,47,5,4,5,0,0
"11840","MIN","PIT",2016020197,17115,20162017,0,60,4,2,2,8.29848027246771,4.05443801404908,4.24404225841863,44,41,3,52,57,-5,75,73,2,3,4,0,0
"11841","MIN","PHI",2016020216,17117,20162017,0,60,2,3,-1,2.66074868579744,5.0403187936754,-2.37957010787795,27,36,-9,39,46,-7,58,60,-2,2,3,0,0
"11842","MIN","OTT",2016020225,17118,20162017,0,63.95,2,1,1,8.80317427571299,6.82740047555808,1.97577380015491,42,36,6,49,54,-5,67,65,2,3,4,0,0
"11843","MIN","CGY",2016020237,17120,20162017,1,60,0,1,-1,6.17065134405493,2.47830238840908,3.69234895564585,27,27,0,43,33,10,57,46,11,4,7,0,0
"11844","MIN","BOS",2016020250,17122,20162017,1,60,1,0,1,6.05391046925797,4.35484716994688,1.69906329931109,29,25,4,44,32,12,62,47,15,4,3,0,0
"11845","MIN","COL",2016020268,17124,20162017,1,60,2,3,-1,6.36228101979941,5.6633315968229,0.698949422976511,43,37,6,58,55,3,76,72,4,5,3,0,0
"11846","MIN","DAL",2016020280,17126,20162017,0,61.3833333333333,2,3,-1,4.31496587841119,5.43542461880861,-1.12045874039742,29,32,-3,46,52,-6,63,73,-10,3,2,0,0
"11847","MIN","WPG",2016020293,17128,20162017,1,60,3,1,2,4.9578306216863,1.5105379201877,3.4472927014986,26,16,10,33,25,8,43,39,4,3,2,0,0
"11848","MIN","PIT",2016020303,17130,20162017,1,60,6,2,4,3.11130972631958,6.31787020188654,-3.20656047556696,36,36,0,41,49,-8,60,64,-4,5,3,0,0
"11849","MIN","STL",2016020318,17131,20162017,0,65,3,3,0,4.35881462751422,6.29839933169569,-1.93958470418147,31,38,-7,43,53,-10,60,64,-4,2,2,0,0
"11850","MIN","VAN",2016020339,17134,20162017,0,60,4,5,-1,5.03450555774998,6.69403499260079,-1.65952943485081,42,35,7,47,43,4,56,55,1,2,3,0,0
"11851","MIN","CGY",2016020357,17137,20162017,0,65,2,2,0,4.8939864760614,4.70700060857803,0.186985867483372,25,31,-6,37,43,-6,46,63,-17,5,7,0,0
"11852","MIN","EDM",2016020376,17139,20162017,0,63.1833333333333,2,1,1,3.59738176583778,3.58952097097063,0.00786079486715607,33,29,4,45,44,1,58,62,-4,3,4,0,0
"11853","MIN","TOR",2016020391,17142,20162017,0,60,3,2,1,2.43991836055648,4.0123991988512,-1.57248083829472,20,37,-17,29,63,-34,41,87,-46,1,2,0,0
"11854","MIN","EDM",2016020408,17144,20162017,1,65,2,2,0,5.5670853361371,3.36035545775667,2.20672987838043,36,27,9,51,36,15,66,58,8,4,3,0,0
"11855","MIN","STL",2016020424,17146,20162017,1,60,3,1,2,3.81547351134941,2.75387039480847,1.06160311654094,25,23,2,33,34,-1,42,51,-9,3,3,0,0
"11856","MIN","FLA",2016020438,17148,20162017,1,60,5,1,4,1.9227936592784,3.27089895556855,-1.34810529629016,22,30,-8,32,42,-10,44,59,-15,2,5,0,0
"11857","MIN","NSH",2016020450,17150,20162017,0,60,5,2,3,5.05900460993871,6.46612291234487,-1.40711830240616,19,36,-17,31,54,-23,41,67,-26,2,3,0,0
"11858","MIN","ARI",2016020461,17152,20162017,1,60,4,1,3,4.82758033374557,5.471796491649,-0.644216157903429,30,28,2,47,38,9,67,49,18,3,1,0,0
"11859","MIN","COL",2016020488,17155,20162017,1,60,2,0,2,2.88212337514756,1.38811472279485,1.4940086523527,33,18,15,47,21,26,57,35,22,4,6,0,0
"11860","MIN","MTL",2016020498,17157,20162017,0,60,4,2,2,5.0857959225541,5.72364107815201,-0.637845155597915,27,34,-7,33,48,-15,47,71,-24,4,4,0,0
"11861","MIN","NYR",2016020506,17158,20162017,0,60,7,4,3,4.53108527910081,5.84658947197022,-1.31550419286941,21,35,-14,34,51,-17,43,73,-30,1,2,0,0
"11862","MIN","NSH",2016020522,17162,20162017,0,62.7666666666667,3,2,1,6.6611476088874,6.3876515867305,0.273496022156905,39,30,9,54,39,15,68,53,15,4,1,0,0
"11863","MIN","NYI",2016020538,17164,20162017,1,60,6,4,2,6.87063779926393,5.298349092016,1.57228870724794,36,28,8,49,41,8,67,58,9,3,5,0,0
"11864","MIN","CBJ",2016020550,17166,20162017,1,60,2,4,-2,7.53039886194892,3.26022972341161,4.27016913853731,31,25,6,42,36,6,53,44,9,4,3,0,0
"11865","MIN","S.J",2016020584,17171,20162017,0,60,5,4,1,3.4399823169224,3.67484139207927,-0.234859075156876,26,34,-8,44,43,1,58,62,-4,3,1,0,0
"11866","MIN","L.A",2016020593,17173,20162017,0,63.5333333333333,3,4,-1,3.34119207663025,6.72218773592613,-3.38099565929588,24,36,-12,31,53,-22,39,63,-24,3,3,0,0
"11867","MIN","ANA",2016020608,17174,20162017,0,60,2,1,1,3.90052316981019,3.73842473997854,0.162098429831644,36,24,12,47,42,5,68,52,16,5,4,0,0
"11868","MIN","MTL",2016020628,17178,20162017,1,60,7,1,6,1.84559749254549,5.7370391747483,-3.89144168220281,24,21,3,29,40,-11,41,54,-13,4,2,0,0
"11869","MIN","DAL",2016020648,17180,20162017,0,60,5,4,1,3.50460926538199,7.37172746661301,-3.86711820123102,32,38,-6,41,53,-12,59,70,-11,4,3,0,0
"11870","MIN","CHI",2016020653,17181,20162017,0,60,3,2,1,4.45511162024377,5.07596867828397,-0.620857058040201,32,35,-3,41,54,-13,51,69,-18,2,3,0,0
"11871","MIN","N.J",2016020667,17183,20162017,1,60,3,4,-1,5.70419816626236,4.25457769402419,1.44962047223817,35,26,9,45,40,5,59,51,8,3,1,0,0
"11872","MIN","ARI",2016020681,17185,20162017,1,60,4,3,1,2.05419845572338,3.1559333219775,-1.10173486625412,25,23,2,35,32,3,52,44,8,6,4,0,0
"11873","MIN","ANA",2016020699,17187,20162017,1,60,5,3,2,5.36735175378271,4.26644905516878,1.10090269861394,25,29,-4,38,39,-1,45,46,-1,2,2,0,0
"11874","MIN","NSH",2016020707,17188,20162017,1,60,2,4,-2,2.12503788567847,7.32844194557401,-5.20340405989555,23,32,-9,34,45,-11,46,59,-13,2,3,0,0
"11875","MIN","DAL",2016020723,17190,20162017,0,65,2,2,0,4.28027034793922,7.18815196634665,-2.90788161840743,33,37,-4,48,57,-9,59,72,-13,4,5,0,0
"11876","MIN","STL",2016020736,17192,20162017,1,60,5,1,4,5.00903731328435,4.88186846298049,0.12716885030386,33,25,8,48,39,9,60,57,3,2,2,0,0
"11877","MIN","EDM",2016020751,17197,20162017,0,60,5,2,3,4.25251699285582,5.75674421472903,-1.50422722187321,35,43,-8,43,61,-18,56,82,-26,1,3,0,0
"11878","MIN","CGY",2016020756,17198,20162017,0,60,1,5,-4,4.03199946049972,6.87026084547126,-2.83826138497154,29,36,-7,45,48,-3,57,64,-7,4,5,0,0
"11879","MIN","VAN",2016020782,17201,20162017,0,60,6,3,3,5.31219533766853,4.28998721342214,1.02220812424639,39,27,12,48,37,11,59,49,10,3,4,0,0
"11880","MIN","WPG",2016020799,17204,20162017,0,60,4,2,2,4.92703873894061,6.72319310196326,-1.79615436302265,25,40,-15,35,58,-23,50,72,-22,2,1,0,0
"11881","MIN","CHI",2016020801,17205,20162017,1,63.15,3,4,-1,3.79983873583842,3.423162718198,0.37667601764042,38,32,6,50,38,12,65,56,9,3,3,0,0
"11882","MIN","T.B",2016020813,17207,20162017,1,65,1,1,0,5.70944191519811,5.99493474993687,-0.285492834738761,38,27,11,48,43,5,57,63,-6,4,3,0,0
"11883","MIN","DET",2016020829,17209,20162017,1,60,6,3,3,6.02763455329114,5.536645955787,0.490988597504135,30,34,-4,38,48,-10,48,61,-13,5,2,0,0
"11884","MIN","ANA",2016020840,17211,20162017,1,60,0,1,-1,8.06912496421137,4.51839543665842,3.55072952755295,37,23,14,58,27,31,76,43,33,5,0,0,0
"11885","MIN","DAL",2016020852,17213,20162017,1,60,3,1,2,2.88902011721189,5.19189721872681,-2.30287710151492,26,35,-9,36,54,-18,47,80,-33,3,3,0,0
"11886","MIN","NSH",2016020865,17215,20162017,1,60,5,2,3,5.02621069938846,3.99241101622416,1.0337996831643,33,39,-6,42,52,-10,57,68,-11,5,3,0,0
"11887","MIN","CHI",2016020889,17218,20162017,1,60,3,5,-2,7.93857042738819,7.078899668144,0.859670759244182,32,39,-7,43,51,-8,58,67,-9,2,2,0,0
"11888","MIN","L.A",2016020921,17224,20162017,1,60.2,5,4,1,4.58130306261911,5.25124090610188,-0.669937843482778,35,30,5,45,45,0,55,63,-8,2,1,0,0
"11889","MIN","WPG",2016020929,17225,20162017,0,60,6,5,1,4.44097831033287,4.21915218812645,0.221826122206413,28,36,-8,31,43,-12,40,53,-13,3,5,0,0
"11890","MIN","CBJ",2016020940,17227,20162017,0,60,0,1,-1,4.9824600481079,4.17627715457638,0.806182893531513,38,40,-2,50,49,1,65,57,8,4,4,0,0
"11891","MIN","S.J",2016020965,17230,20162017,1,60,3,1,2,3.88325576743227,4.06432142015547,-0.181065652723191,28,21,7,38,27,11,58,37,21,3,3,0,0
"11892","MIN","STL",2016020977,17232,20162017,1,60,1,2,-1,6.85143815488846,3.04606164907455,3.80537650581391,33,20,13,44,26,18,58,34,24,1,1,0,0
"11893","MIN","T.B",2016020987,17234,20162017,0,60,1,4,-3,4.80070134823461,3.54060527221549,1.26009607601912,33,29,4,47,36,11,55,47,8,4,3,0,0
"11894","MIN","FLA",2016020997,17235,20162017,0,60,7,4,3,9.17876160170999,7.6931639128743,1.4855976888357,46,40,6,54,48,6,70,59,11,4,3,0,0
"11895","MIN","CHI",2016021012,17237,20162017,0,60,2,4,-2,6.15757257399628,5.56322282925248,0.594349744743795,44,22,22,55,35,20,72,43,29,1,3,0,0
"11896","MIN","WSH",2016021025,17239,20162017,0,60,2,4,-2,1.82947029387727,5.54011350568906,-3.71064321181179,32,40,-8,39,52,-13,54,67,-13,7,5,0,0
"11897","MIN","CAR",2016021040,17241,20162017,0,60,1,3,-2,3.88608481953218,7.28838730230927,-3.4023024827771,31,24,7,43,41,2,61,59,2,1,4,0,0
"11898","MIN","NYR",2016021059,17243,20162017,1,60,2,3,-1,2.71098825134007,5.75935742725812,-3.04836917591805,27,30,-3,36,35,1,52,51,1,4,4,0,0
"11899","MIN","WPG",2016021065,17244,20162017,0,60,4,5,-1,5.23873775530626,4.10955254912187,1.12918520618439,48,21,27,62,32,30,86,50,36,3,4,0,0
"11900","MIN","S.J",2016021082,17246,20162017,1,60,3,2,1,3.69844053867614,4.74674635627889,-1.04830581760275,27,23,4,37,33,4,52,47,5,3,1,0,0
"11901","MIN","PHI",2016021097,17248,20162017,1,60,1,3,-2,4.23939629008601,6.38854258935316,-2.14914629926716,25,27,-2,35,37,-2,49,48,1,2,1,0,0
"11902","MIN","VAN",2016021106,17250,20162017,1,60,2,4,-2,3.42041205911892,3.36528460064437,0.0551274584745443,27,21,6,43,33,10,56,39,17,3,2,0,0
"11903","MIN","DET",2016021119,17251,20162017,0,61.8666666666667,2,3,-1,4.10055572027341,2.07932635759062,2.02122936268279,26,19,7,36,28,8,51,34,17,2,2,0,0
"11904","MIN","WSH",2016021133,17253,20162017,1,61.8666666666667,4,5,-1,5.18905659332009,3.61133477221805,1.57772182110203,30,20,10,44,30,14,61,35,26,4,4,0,0
"11905","MIN","OTT",2016021147,17255,20162017,1,60,5,1,4,4.38358029926894,2.52056407294003,1.86301622632891,26,19,7,37,33,4,51,40,11,2,4,0,0
"11906","MIN","NSH",2016021158,17257,20162017,0,60,0,3,-3,6.10994583398497,4.53451901660446,1.5754268173805,31,36,-5,43,44,-1,53,61,-8,1,2,0,0
"11907","MIN","COL",2016021171,17258,20162017,1,60,5,2,3,3.99432449311462,4.10296853583684,-0.108644042722218,28,32,-4,43,43,0,54,60,-6,2,2,0,0
"11908","MIN","CAR",2016021186,17260,20162017,1,60,5,3,2,4.26310506975278,4.59527250119618,-0.332167431443397,36,30,6,46,42,4,61,51,10,1,4,0,0
"11909","MIN","COL",2016021201,17262,20162017,0,60,4,3,1,5.90227225961091,5.4561354580801,0.446136801530809,28,33,-5,39,40,-1,50,57,-7,2,4,0,0
"11910","MIN","ARI",2016021217,17264,20162017,0,60,3,1,2,8.28879591141595,3.46596066462371,4.82283524679224,45,21,24,58,32,26,64,37,27,3,1,0,0
"11911","MIN","STL",2016030161,17268,20162017,1,77.8,1,2,-1,11.1682638103069,5.62410602531545,5.54415778499149,52,26,26,69,40,29,90,57,33,3,4,0,0
"11912","MIN","STL",2016030162,17270,20162017,1,60,1,2,-1,2.72743505436442,3.73615145301892,-1.0087163986545,24,22,2,40,31,9,59,39,20,4,3,0,0
"11913","MIN","STL",2016030163,17272,20162017,0,60,1,3,-2,5.94421769838664,4.59433472636886,1.34988297201778,41,31,10,56,39,17,79,46,33,5,4,0,0
"11914","MIN","STL",2016030164,17275,20162017,0,60,2,0,2,2.36260706862959,4.41765351694441,-2.05504644831482,28,28,0,37,36,1,49,50,-1,3,3,0,0
"11915","MIN","STL",2016030165,17278,20162017,1,69.7,3,4,-1,6.77664476215819,5.6119826522081,1.16466210995009,37,27,10,50,39,11,72,54,18,7,5,0,0
"11916","MIN","DET",2017020009,17444,20172018,0,60,2,4,-2,4.14160282874047,4.07590954020327,0.0656932885372044,39,31,8,49,44,5,60,54,6,4,5,0,0
"11917","MIN","CAR",2017020023,17446,20172018,0,65,4,4,0,3.84848287515342,5.44155166251585,-1.59306878736243,27,42,-15,39,63,-24,56,79,-23,3,5,0,0
"11918","MIN","CHI",2017020054,17451,20172018,0,60,5,2,3,5.90367343908292,3.61457296603893,2.28910047304399,34,38,-4,41,46,-5,56,63,-7,5,6,0,0
"11919","MIN","CBJ",2017020070,17453,20172018,1,60.7833333333333,4,5,-1,1.8530894239957,4.11095551182017,-2.25786608782447,21,35,-14,28,43,-15,39,56,-17,3,3,0,0
"11920","MIN","WPG",2017020108,17459,20172018,0,60,3,4,-1,2.16897828239598,3.27964323559354,-1.11066495319756,27,30,-3,32,37,-5,42,46,-4,1,3,0,0
"11921","MIN","CGY",2017020120,17460,20172018,0,60,4,2,2,5.91747928070617,6.68407540941132,-0.766596128705146,32,37,-5,44,52,-8,54,74,-20,3,6,0,0
"11922","MIN","VAN",2017020133,17463,20172018,1,60,0,1,-1,4.71853962488831,6.81166108950487,-2.09312146461656,29,25,4,41,37,4,55,47,8,4,3,0,0
"11923","MIN","NYI",2017020146,17465,20172018,1,60,6,4,2,3.81679565004857,4.52739436344701,-0.710598713398437,33,33,0,43,45,-2,47,67,-20,3,5,0,0
"11924","MIN","PIT",2017020164,17467,20172018,1,60,2,1,1,3.20078144899162,4.41697669241694,-1.21619524342532,29,30,-1,37,41,-4,44,59,-15,4,3,0,0
"11925","MIN","WPG",2017020180,17470,20172018,1,60,1,2,-1,6.98098965745885,1.75147260303493,5.22951705442392,29,19,10,53,26,27,75,38,37,6,4,0,0
"11926","MIN","MTL",2017020192,17472,20172018,1,60,6,3,3,3.31695447604579,5.56550928906654,-2.24855481302075,27,31,-4,36,42,-6,48,53,-5,4,1,0,0
"11927","MIN","CHI",2017020208,17474,20172018,1,60,0,2,-2,4.71627959112811,7.81011557125862,-3.09383598013051,24,35,-11,39,50,-11,48,72,-24,2,3,0,0
"11928","MIN","BOS",2017020217,17476,20172018,0,60,3,5,-2,2.39120966497317,4.16874702004134,-1.77753735506817,27,34,-7,37,47,-10,43,59,-16,2,4,0,0
"11929","MIN","TOR",2017020232,17478,20172018,0,60,2,4,-2,4.70415851736919,4.11054865941696,0.593609857952231,37,19,18,53,27,26,71,42,29,4,2,0,0
"11930","MIN","MTL",2017020237,17479,20172018,0,60,3,0,3,4.74767096256147,6.72338491989441,-1.97571395733294,35,41,-6,52,52,0,74,80,-6,4,4,0,0
"11931","MIN","PHI",2017020255,17481,20172018,0,60,1,0,1,2.84511454624044,2.29774402398493,0.547370522255505,27,32,-5,34,43,-9,46,61,-15,3,3,0,0
"11932","MIN","PHI",2017020271,17484,20172018,1,60,3,0,3,4.36479536537081,6.34446903230855,-1.97967366693774,20,30,-10,27,41,-14,35,57,-22,1,2,0,0
"11933","MIN","NSH",2017020283,17486,20172018,1,60,6,4,2,5.84523793686472,3.37155969299041,2.4736782438743,36,30,6,49,42,7,63,51,12,5,3,0,0
"11934","MIN","WSH",2017020301,17488,20172018,0,60,1,3,-2,4.64769188768696,4.03399387630634,0.61369801138062,31,43,-12,42,47,-5,52,60,-8,4,6,0,0
"11935","MIN","N.J",2017020314,17490,20172018,1,60.8666666666667,3,4,-1,5.18295603078011,4.7684443523672,0.414511678412911,36,25,11,52,37,15,73,52,21,6,4,0,0
"11936","MIN","BUF",2017020319,17492,20172018,0,60,5,4,1,3.76970435310248,6.3344358976683,-2.56473154456581,32,34,-2,37,48,-11,44,63,-19,3,3,0,0
"11937","MIN","COL",2017020336,17494,20172018,1,65,2,2,0,3.61286316776091,2.94814741404587,0.664715753715035,27,30,-3,29,44,-15,42,58,-16,2,3,0,0
"11938","MIN","STL",2017020354,17495,20172018,0,60,3,6,-3,6.37614543418624,6.06481357732332,0.311331856862921,25,40,-15,37,53,-16,48,68,-20,3,8,0,0
"11939","MIN","WPG",2017020365,17497,20172018,0,60,2,7,-5,4.98605448677699,3.22194484170539,1.76410964507161,19,28,-9,27,36,-9,35,52,-17,3,7,0,0
"11940","MIN","VGK",2017020384,17500,20172018,1,60,4,2,2,6.25298646078727,3.29737757473049,2.95560888605678,32,31,1,45,41,4,57,59,-2,2,3,0,0
"11941","MIN","STL",2017020397,17502,20172018,1,60.65,2,1,1,3.38168382288541,5.74461280973628,-2.36292898685087,25,42,-17,35,58,-23,40,75,-35,3,5,0,0
"11942","MIN","L.A",2017020425,17505,20172018,0,60,2,5,-3,3.84358632458404,6.82864033326041,-2.98505400867637,21,28,-7,32,40,-8,43,53,-10,1,3,0,0
"11943","MIN","ANA",2017020443,17508,20172018,0,63.7166666666667,3,2,1,5.55471119425783,3.64870537376555,1.90600582049228,31,28,3,49,44,5,61,62,-1,3,4,0,0
"11944","MIN","S.J",2017020459,17510,20172018,0,63.4333333333333,4,3,1,1.84834211249836,6.54040018007722,-4.69205806757886,24,34,-10,36,57,-21,47,83,-36,3,7,0,0
"11945","MIN","CGY",2017020472,17512,20172018,1,65,1,1,0,4.04238610288328,5.59767042095067,-1.55528431806739,22,27,-5,36,45,-9,45,64,-19,2,3,0,0
"11946","MIN","TOR",2017020484,17514,20172018,1,60,2,0,2,4.48859228449874,3.45665365003515,1.03193863446359,26,28,-2,36,49,-13,44,70,-26,2,5,0,0
"11947","MIN","EDM",2017020496,17516,20172018,1,60,2,3,-1,5.71098629612703,4.35364376408004,1.357342532047,31,29,2,42,41,1,52,54,-2,4,6,0,0
"11948","MIN","CHI",2017020508,17517,20172018,0,60,1,4,-3,5.83963023505103,8.93717342592963,-3.0975431908786,28,46,-18,41,54,-13,53,78,-25,3,7,0,0
"11949","MIN","OTT",2017020520,17519,20172018,0,60,6,4,2,5.2309085176239,4.50253812439814,0.728370393225759,40,32,8,48,47,1,60,65,-5,4,4,0,0
"11950","MIN","FLA",2017020540,17522,20172018,0,60,2,4,-2,0,0,0,31,34,-3,45,38,7,52,50,2,5,3,0,0
"11951","MIN","T.B",2017020545,17523,20172018,0,60,0,3,-3,2.510412730393,5.07490869695837,-2.56449596656537,22,31,-9,27,53,-26,38,72,-34,6,6,0,0
"11952","MIN","DAL",2017020565,17527,20172018,1,60,4,2,2,4.17525832129468,4.49406144607201,-0.318803124777332,31,26,5,34,42,-8,45,57,-12,3,4,0,0
"11953","MIN","NSH",2017020581,17529,20172018,1,60,4,2,2,5.24161723861471,7.4444998896605,-2.20288265104579,38,43,-5,48,64,-16,59,81,-22,5,3,0,0
"11954","MIN","NSH",2017020591,17530,20172018,0,60,0,3,-3,2.69335307309939,5.22374573885463,-2.53039266575524,29,29,0,36,45,-9,48,63,-15,3,5,0,0
"11955","MIN","FLA",2017020608,17533,20172018,1,60,5,1,4,6.72849958813458,6.18248858667357,0.546011001461011,41,26,15,47,38,9,61,50,11,1,2,0,0
"11956","MIN","BUF",2017020622,17535,20172018,1,60,6,2,4,2.88842783066332,4.23619469081702,-1.3477668601537,27,31,-4,39,40,-1,52,48,4,1,3,0,0
"11957","MIN","COL",2017020635,17537,20172018,0,60,2,7,-5,5.58960252448445,4.424479004447,1.16512352003745,36,38,-2,43,47,-4,60,53,7,8,8,0,0
"11958","MIN","CGY",2017020659,17540,20172018,1,62.65,2,3,-1,4.57486751579319,2.08254928924365,2.49231822654954,35,29,6,47,38,9,59,51,8,7,6,0,0
"11959","MIN","CHI",2017020661,17541,20172018,0,60,2,1,1,3.9491680350352,4.80128547202207,-0.852117436986873,27,35,-8,36,54,-18,46,81,-35,3,3,0,0
"11960","MIN","WPG",2017020674,17544,20172018,1,60,4,1,3,0,0,0,41,33,8,51,44,7,68,57,11,4,2,0,0
"11961","MIN","VAN",2017020682,17545,20172018,1,62.8333333333333,2,3,-1,4.13116735778749,3.34418840409489,0.786978953692596,23,25,-2,33,40,-7,42,49,-7,1,1,0,0
"11962","MIN","T.B",2017020719,17551,20172018,1,60,5,2,3,5.90059974499599,4.57302184237051,1.32757790262549,35,23,12,39,41,-2,55,59,-4,4,5,0,0
"11963","MIN","OTT",2017020728,17553,20172018,1,60,3,1,2,5.91627013028483,6.68211922543214,-0.765849095147312,36,38,-2,52,51,1,68,64,4,2,2,0,0
"11964","MIN","PIT",2017020748,17556,20172018,0,60,3,6,-3,4.12712932447903,3.89024848767674,0.236880836802285,26,39,-13,35,49,-14,48,59,-11,5,2,0,0
"11965","MIN","CBJ",2017020766,17561,20172018,0,65,2,2,0,5.6002776618836,3.95574176721857,1.64453589466503,43,30,13,56,48,8,66,57,9,2,3,0,0
"11966","MIN","VGK",2017020791,17564,20172018,1,60,5,2,3,6.91965419071494,5.69843988865614,1.2212143020588,36,24,12,50,35,15,65,49,16,4,3,0,0
"11967","MIN","DAL",2017020801,17565,20172018,0,60,1,6,-5,2.63778674142668,3.98887094361862,-1.35108420219194,31,38,-7,37,47,-10,55,68,-13,2,2,0,0
"11968","MIN","STL",2017020819,17568,20172018,0,60,6,2,4,4.2945173344342,7.72007087922101,-3.42555354478681,20,37,-17,28,50,-22,42,69,-27,4,4,0,0
"11969","MIN","ARI",2017020832,17570,20172018,1,63.9166666666667,3,4,-1,2.37644017545972,5.3481888614624,-2.97174868600268,28,40,-12,38,57,-19,47,76,-29,1,1,0,0
"11970","MIN","CHI",2017020849,17572,20172018,1,60,3,0,3,1.98338429629803,6.74445615834766,-4.76107186204963,19,44,-25,26,59,-33,36,85,-49,4,4,0,0
"11971","MIN","NYR",2017020872,17575,20172018,1,60,3,2,1,3.44139298609662,3.5937849306938,-0.152391944597184,29,34,-5,34,43,-9,44,57,-13,2,4,0,0
"11972","MIN","WSH",2017020885,17577,20172018,1,60,2,5,-3,3.29093679018069,4.25546237031284,-0.964525580132147,34,27,7,43,38,5,55,49,6,5,2,0,0
"11973","MIN","ANA",2017020896,17579,20172018,1,65,2,2,0,3.66592516576929,6.68997970050953,-3.02405453474023,38,31,7,52,43,9,66,65,1,3,3,0,0
"11974","MIN","NYI",2017020912,17581,20172018,0,60,5,3,2,3.62908362462713,5.79681104419433,-2.1677274195672,32,35,-3,37,49,-12,50,75,-25,1,4,0,0
"11975","MIN","N.J",2017020931,17584,20172018,0,60,4,2,2,3.6807883787551,6.44302925208643,-2.76224087333134,25,40,-15,35,60,-25,45,73,-28,2,3,0,0
"11976","MIN","NYR",2017020941,17585,20172018,0,60,4,1,3,0,0,0,37,23,14,48,33,15,57,46,11,1,1,0,0
"11977","MIN","S.J",2017020961,17587,20172018,1,64.8,3,2,1,8.2480655683903,3.08558112961593,5.16248443877437,41,28,13,53,38,15,77,48,29,3,1,0,0
"11978","MIN","STL",2017020973,17589,20172018,1,60,8,3,5,6.44423121774685,4.58628434607239,1.85794687167446,33,25,8,42,40,2,51,56,-5,5,6,0,0
"11979","MIN","ARI",2017020988,17591,20172018,0,60,3,5,-2,5.70433579600649,4.15663086820859,1.54770492779789,35,25,10,53,39,14,66,56,10,5,3,0,0
"11980","MIN","COL",2017020995,17592,20172018,0,60,1,7,-6,5.98928664872074,5.48886923058308,0.500417418137658,32,26,6,46,37,9,62,52,10,3,3,0,0
"11981","MIN","DET",2017021013,17594,20172018,1,60,4,1,3,4.81202513648896,3.0503888425792,1.76163629390976,27,29,-2,41,42,-1,56,54,2,4,3,0,0
"11982","MIN","CAR",2017021026,17596,20172018,1,60,6,2,4,4.62145944710937,5.04888182791183,-0.427422380802454,31,31,0,47,43,4,58,60,-2,2,3,0,0
"11983","MIN","VAN",2017021047,17599,20172018,0,60,5,2,3,5.07877028644725,5.9731038765749,-0.894333590127644,36,32,4,43,46,-3,52,62,-10,2,1,0,0
"11984","MIN","EDM",2017021058,17600,20172018,0,60,1,4,-3,3.8821496156483,5.07538496164489,-1.19323534599658,33,28,5,48,36,12,68,51,17,4,3,0,0
"11985","MIN","COL",2017021075,17603,20172018,1,60,1,5,-4,5.28919699461799,4.43287329678788,0.856323697830117,34,22,12,52,33,19,66,49,17,6,5,0,0
"11986","MIN","VGK",2017021097,17606,20172018,0,60,4,2,2,5.17269960380509,7.2977176271088,-2.12501802330371,30,28,2,43,56,-13,58,74,-16,3,3,0,0
"11987","MIN","ARI",2017021106,17607,20172018,0,60,3,1,2,5.38074217072256,6.77484875687514,-1.39410658615259,33,31,2,42,49,-7,50,68,-18,5,2,0,0
"11988","MIN","L.A",2017021119,17609,20172018,1,64.4333333333333,3,4,-1,4.4589432960421,4.37201659029233,0.0869267057497645,27,30,-3,39,36,3,60,54,6,2,3,0,0
"11989","MIN","NSH",2017021161,17614,20172018,1,60,4,1,3,2.97287039395237,1.40656181614545,1.56630857780691,30,20,10,36,33,3,48,51,-3,6,3,0,0
"11990","MIN","BOS",2017021166,17615,20172018,1,60.4666666666667,1,2,-1,5.06159252616635,3.35067530971719,1.71091721644916,25,28,-3,39,42,-3,46,55,-9,2,2,0,0
"11991","MIN","NSH",2017021181,17617,20172018,0,65,1,1,0,3.01656026572442,5.94145345076686,-2.92489318504244,23,29,-6,29,39,-10,40,54,-14,3,5,0,0
"11992","MIN","DAL",2017021195,17619,20172018,1,60,5,2,3,3.02857240923913,3.08889793887853,-0.0603255296393943,22,31,-9,29,40,-11,37,58,-21,4,4,0,0
"11993","MIN","DAL",2017021214,17621,20172018,0,60,1,4,-3,6.5783642920513,4.46338178405858,2.11498250799272,34,36,-2,51,48,3,65,55,10,3,3,0,0
"11994","MIN","EDM",2017021227,17623,20172018,1,60,3,0,3,6.37238315982134,3.9936244811562,2.37875867866514,40,22,18,51,32,19,63,41,22,2,2,0,0
"11995","MIN","ANA",2017021240,17625,20172018,0,60,1,3,-2,2.3167486647726,8.01386117865331,-5.69711251388071,27,30,-3,33,49,-16,47,63,-16,3,3,0,0
"11996","MIN","L.A",2017021251,17626,20172018,0,60.3833333333333,4,5,-1,3.39074625047215,7.23610433250833,-3.84535808203619,27,28,-1,39,43,-4,52,61,-9,4,9,0,0
"11997","MIN","S.J",2017021271,17628,20172018,0,60,6,3,3,4.68458717194153,5.37088686069183,-0.686299688750296,24,30,-6,32,48,-16,55,70,-15,1,2,0,0
"11998","MIN","WPG",2017030161,17632,20172018,0,60,2,3,-1,1.47138334485444,9.08121973618108,-7.60983639132664,20,40,-20,31,60,-29,47,82,-35,1,2,0,0
"11999","MIN","WPG",2017030162,17634,20172018,0,60,1,4,-3,3.24807845964096,3.18988319032724,0.0581952693137282,17,44,-27,26,54,-28,40,70,-30,6,5,0,0
"12000","MIN","WPG",2017030163,17636,20172018,1,60,6,2,4,3.73061356290555,6.95163173312903,-3.22101817022349,29,31,-2,37,40,-3,45,60,-15,3,5,0,0
"12001","MIN","WPG",2017030164,17638,20172018,1,60,0,2,-2,4.7438116032863,5.72469633608125,-0.980884732794948,30,28,2,42,46,-4,56,69,-13,2,1,0,0
"12002","MIN","WPG",2017030165,17641,20172018,0,60,0,5,-5,4.99244478480047,5.1171479797049,-0.124703194904423,30,26,4,41,44,-3,63,54,9,3,2,0,0
"12003","MIN","COL",2018020013,17808,20182019,0,60,1,4,-3,3.42701142805163,5.04730616359529,-1.62029473554367,21,40,-19,32,52,-20,49,65,-16,5,5,0,0
"12004","MIN","VGK",2018020025,17810,20182019,1,65,1,1,0,6.93143184343489,6.81923726520389,0.112194578231005,30,42,-12,45,60,-15,49,78,-29,2,3,0,0
"12005","MIN","CHI",2018020056,17815,20182019,1,63.4166666666667,4,3,1,5.74708878729143,4.26835125189609,1.47873753539534,46,30,16,60,46,14,72,55,17,2,5,0,0
"12006","MIN","CAR",2018020060,17817,20182019,1,62.95,4,5,-1,4.02061546001237,7.23095873533748,-3.21034327532511,23,57,-34,26,65,-39,34,83,-49,7,11,0,0
"12007","MIN","NSH",2018020077,17819,20182019,0,60,2,4,-2,2.87551575100314,4.44117751321755,-1.56566176221442,31,28,3,40,41,-1,52,58,-6,4,3,0,0
"12008","MIN","ARI",2018020083,17820,20182019,1,60,2,1,1,3.72151925294838,4.57613802339672,-0.854618770448343,28,32,-4,36,45,-9,46,63,-17,3,4,0,0
"12009","MIN","DAL",2018020100,17823,20182019,0,60,3,1,2,4.96933625921183,2.47938574405271,2.48995051515912,36,34,2,48,41,7,67,62,5,2,3,0,0
"12010","MIN","T.B",2018020110,17824,20182019,1,63.7166666666667,5,4,1,5.39411557596068,5.58223910999368,-0.188123534032997,34,31,3,46,55,-9,60,65,-5,3,6,0,0
"12011","MIN","L.A",2018020138,17829,20182019,1,60,4,1,3,6.50878636492416,5.11939546943154,1.38939089549262,26,24,2,34,36,-2,47,51,-4,5,5,0,0
"12012","MIN","COL",2018020156,17831,20182019,1,60,3,2,1,6.49566034879535,5.18341098532254,1.31224936347282,28,32,-4,39,48,-9,54,66,-12,5,6,0,0
"12013","MIN","VAN",2018020166,17833,20182019,0,60,2,5,-3,3.77416764303027,5.57914055613219,-1.80497291310192,39,31,8,51,41,10,66,55,11,5,5,0,0
"12014","MIN","EDM",2018020174,17834,20182019,0,60,4,3,1,3.32434075849596,5.96175330306869,-2.63741254457273,28,37,-9,36,54,-18,52,72,-20,3,5,0,0
"12015","MIN","STL",2018020201,17838,20182019,0,60,5,1,4,4.06959257960261,3.11740255539371,0.952190024208903,45,16,29,59,23,36,72,38,34,5,2,0,0
"12016","MIN","S.J",2018020223,17841,20182019,0,60,3,4,-1,5.5217832615599,4.79001469761221,0.731768563947696,26,22,4,45,38,7,66,53,13,3,0,0,0
"12017","MIN","L.A",2018020235,17843,20182019,0,60,3,1,2,3.13649029348744,3.68181588159499,-0.545325588107545,24,28,-4,38,47,-9,52,65,-13,3,3,0,0
"12018","MIN","ANA",2018020241,17844,20182019,0,60,5,1,4,3.95075194470701,4.90036368254437,-0.949611737837358,43,21,22,52,33,19,67,44,23,3,2,0,0
"12019","MIN","STL",2018020253,17846,20182019,0,60,3,2,1,1.76089903571847,3.72830902900937,-1.96740999329091,18,31,-13,25,40,-15,33,63,-30,3,3,0,0
"12020","MIN","WSH",2018020269,17848,20182019,1,60,2,5,-3,5.49488590664987,5.95746705903189,-0.46258115238202,28,33,-5,42,40,2,62,49,13,7,3,0,0
"12021","MIN","VAN",2018020282,17850,20182019,1,60,6,2,4,8.0257936240896,4.02345339113867,4.00234023295093,29,27,2,39,36,3,50,44,6,2,6,0,0
"12022","MIN","BUF",2018020294,17852,20182019,1,60,2,3,-1,4.82854607116315,5.20949636609294,-0.380950294929789,39,29,10,51,45,6,63,57,6,3,1,0,0
"12023","MIN","CHI",2018020305,17853,20182019,0,60,1,3,-2,4.30144190473948,3.95862720555488,0.342814699184601,40,28,12,51,41,10,65,50,15,3,3,0,0
"12024","MIN","OTT",2018020327,17856,20182019,1,60,6,4,2,5.28647031871014,4.57864813425113,0.707822184459019,34,27,7,47,35,12,61,60,1,4,5,0,0
"12025","MIN","WPG",2018020336,17858,20182019,1,60,4,2,2,4.66934140608646,4.26427653825424,0.405064867832223,39,28,11,50,41,9,65,58,7,8,6,0,0
"12026","MIN","ARI",2018020372,17862,20182019,1,60,3,4,-1,3.45111179369269,2.37550428393297,1.07560750975972,25,14,11,39,22,17,53,34,19,2,1,0,0
"12027","MIN","CBJ",2018020383,17864,20182019,0,60,2,4,-2,4.42478691006545,2.22966057479951,2.19512633526594,25,29,-4,37,49,-12,49,64,-15,1,2,0,0
"12028","MIN","TOR",2018020403,17866,20182019,1,60,3,5,-2,6.38201961570303,3.596794084066,2.78522553163702,41,23,18,56,37,19,72,49,23,3,1,0,0
"12029","MIN","VAN",2018020423,17869,20182019,0,60,3,2,1,5.61695350808077,5.00611372478306,0.610839783297706,28,31,-3,35,41,-6,49,58,-9,3,3,0,0
"12030","MIN","CGY",2018020435,17871,20182019,0,60,0,2,-2,6.69959803870134,2.67701792769132,4.02258011101002,31,20,11,43,33,10,54,54,0,6,3,0,0
"12031","MIN","EDM",2018020442,17872,20182019,0,60,2,7,-5,3.15261182827817,2.70173753687413,0.450874291404034,33,32,1,47,47,0,61,63,-2,2,1,0,0
"12032","MIN","MTL",2018020472,17876,20182019,1,60,7,1,6,6.35440635103805,5.84907568645945,0.505330664578604,32,30,2,43,45,-2,51,62,-11,4,1,0,0
"12033","MIN","FLA",2018020484,17878,20182019,1,60,5,1,4,1.32741342407472,2.47365835800883,-1.14624493393412,26,31,-5,33,37,-4,45,58,-13,1,3,0,0
"12034","MIN","CGY",2018020495,17880,20182019,1,60,1,2,-1,5.184339244086,4.37155213672668,0.812787107359327,35,26,9,44,37,7,55,51,4,4,3,0,0
"12035","MIN","S.J",2018020521,17883,20182019,1,60,0,4,-4,2.76036912522977,6.15226186183281,-3.39189273660304,26,25,1,34,36,-2,48,52,-4,0,1,0,0
"12036","MIN","PIT",2018020533,17885,20182019,0,60,1,2,-1,2.8863864732557,3.72368252709049,-0.837296053834791,41,37,4,46,48,-2,62,56,6,3,4,0,0
"12037","MIN","DAL",2018020556,17887,20182019,1,64.8333333333333,1,2,-1,4.16028056728508,5.89383614200051,-1.73355557471543,31,27,4,46,43,3,65,52,13,3,4,0,0
"12038","MIN","CHI",2018020575,17892,20182019,0,60,2,5,-3,5.39043733610276,5.00322030051515,0.387217035587611,48,20,28,63,29,34,85,47,38,3,4,0,0
"12039","MIN","WPG",2018020584,17894,20182019,0,60,3,1,2,2.09072175861957,4.20492382982047,-2.11420207120091,25,27,-2,34,35,-1,45,59,-14,1,3,0,0
"12040","MIN","PIT",2018020603,17896,20182019,1,60,2,3,-1,4.92273503780598,5.81661211837491,-0.893877080568927,33,32,1,47,43,4,62,52,10,2,2,0,0
"12041","MIN","TOR",2018020621,17899,20182019,0,60,4,3,1,2.47489594538638,6.60618791571788,-4.1312919703315,34,41,-7,40,62,-22,53,80,-27,2,5,0,0
"12042","MIN","OTT",2018020637,17901,20182019,0,60,4,3,1,6.45569902141142,4.95205598446773,1.50364303694369,26,27,-1,42,42,0,58,60,-2,3,2,0,0
"12043","MIN","MTL",2018020654,17903,20182019,0,60,1,0,1,3.42702905548504,4.91352980060037,-1.48650074511534,25,32,-7,34,41,-7,55,60,-5,3,5,0,0
"12044","MIN","BOS",2018020657,17904,20182019,0,60,0,4,-4,4.31892514209903,4.97358667838853,-0.654661536289495,24,27,-3,33,39,-6,51,48,3,3,2,0,0
"12045","MIN","WPG",2018020678,17906,20182019,1,60,3,2,1,4.11664988540549,5.63289402583086,-1.51624414042537,22,28,-6,37,44,-7,44,66,-22,2,4,0,0
"12046","MIN","DET",2018020693,17908,20182019,1,60,2,5,-3,2.43297654320108,4.6486739784068,-2.21569743520573,18,37,-19,27,45,-18,35,61,-26,3,4,0,0
"12047","MIN","PHI",2018020708,17910,20182019,0,60,4,7,-3,4.48955389008011,6.31781315894381,-1.8282592688637,38,27,11,49,41,8,69,50,19,4,6,0,0
"12048","MIN","L.A",2018020717,17911,20182019,1,65,2,2,0,5.45124027717975,5.17212234452702,0.279117932652731,42,33,9,52,44,8,62,58,4,2,1,0,0
"12049","MIN","ANA",2018020731,17913,20182019,1,60,0,3,-3,4.33559152466478,2.75855534616858,1.5770361784962,37,23,14,50,34,16,67,45,22,4,4,0,0
"12050","MIN","CBJ",2018020748,17915,20182019,1,60,2,1,1,4.3040816022677,4.19214413340706,0.111937468860646,31,20,11,43,36,7,53,51,2,4,4,0,0
"12051","MIN","VGK",2018020757,17917,20182019,0,60,4,2,2,3.55125498003326,3.89918194594793,-0.347926965914667,22,32,-10,29,46,-17,47,65,-18,2,5,0,0
"12052","MIN","COL",2018020767,17919,20182019,0,60,5,2,3,3.86531486327294,3.20694284352696,0.658372019745978,28,22,6,38,38,0,60,62,-2,5,2,0,0
"12053","MIN","DAL",2018020788,17928,20182019,0,60,1,3,-2,4.55465087004995,5.73388752502875,-1.1792366549788,22,32,-10,32,42,-10,45,59,-14,1,1,0,0
"12054","MIN","CHI",2018020799,17929,20182019,1,61.3166666666667,3,4,-1,4.88816685541041,5.91236184634738,-1.02419499093697,31,31,0,42,41,1,56,49,7,4,6,0,0
"12055","MIN","BUF",2018020810,17932,20182019,0,65,4,4,0,8.20917196972005,7.11225122726207,1.09692074245797,45,39,6,58,45,13,70,54,16,3,2,0,0
"12056","MIN","EDM",2018020833,17934,20182019,1,60,1,4,-3,4.05611992834019,4.88195329408876,-0.825833365748565,36,23,13,50,30,20,65,35,30,2,3,0,0
"12057","MIN","N.J",2018020840,17936,20182019,0,60,4,2,2,4.68198951701424,4.30848173378035,0.37350778323389,33,18,15,45,28,17,59,43,16,3,2,0,0
"12058","MIN","NYI",2018020856,17937,20182019,0,60,1,2,-1,3.31014583506208,2.65665248042734,0.653493354634742,27,34,-7,38,44,-6,56,58,-2,3,6,0,0
"12059","MIN","PHI",2018020871,17939,20182019,1,60,4,5,-1,5.64517411520582,6.5644891370199,-0.919315021814087,39,26,13,54,36,18,74,40,34,5,4,0,0
"12060","MIN","N.J",2018020890,17942,20182019,1,63.3166666666667,4,5,-1,5.20586594147608,3.56290701206308,1.642958929413,32,28,4,45,40,5,59,57,2,2,4,0,0
"12061","MIN","STL",2018020905,17944,20182019,1,60,0,4,-4,6.90198156711995,5.29699079468763,1.60499077243232,31,30,1,47,36,11,61,49,12,5,5,0,0
"12062","MIN","ANA",2018020922,17946,20182019,1,60,0,4,-4,5.19681403351024,5.56478078121472,-0.367966747704486,31,24,7,50,32,18,69,48,21,3,4,0,0
"12063","MIN","NYR",2018020932,17948,20182019,0,60,4,1,3,6.67000585796859,8.33340456709266,-1.66339870912407,35,34,1,50,43,7,65,59,6,1,2,0,0
"12064","MIN","DET",2018020941,17949,20182019,0,60,3,2,1,4.27579178429005,4.54883962984726,-0.273047845557208,35,28,7,40,37,3,47,51,-4,3,2,0,0
"12065","MIN","STL",2018020960,17951,20182019,1,62.4833333333333,2,1,1,4.28086999833249,4.58016360543843,-0.299293607105938,35,28,7,46,41,5,58,51,7,3,2,0,0
"12066","MIN","WPG",2018020976,17953,20182019,0,60,3,2,1,6.71541706775193,4.598346426239,2.11707064151293,40,32,8,48,46,2,57,57,0,2,4,0,0
"12067","MIN","CGY",2018021008,17957,20182019,0,60,4,2,2,3.66236444737297,5.29179729210716,-1.6294328447342,23,37,-14,35,53,-18,44,77,-33,1,3,0,0
"12068","MIN","NSH",2018021015,17958,20182019,1,65,2,2,0,4.00198802366504,7.11183566847467,-3.10984764480963,26,43,-17,47,57,-10,64,72,-8,2,2,0,0
"12069","MIN","NSH",2018021024,17960,20182019,0,65,4,4,0,4.90406155008532,3.63833778254048,1.26572376754484,33,25,8,44,39,5,60,53,7,4,1,0,0
"12070","MIN","T.B",2018021037,17962,20182019,0,60,3,0,3,4.86769845538947,1.88250549542136,2.98519295996812,30,25,5,38,35,3,59,53,6,4,2,0,0
"12071","MIN","FLA",2018021044,17963,20182019,0,60,2,6,-4,4.38149817995648,4.97611014115409,-0.594611961197609,27,29,-2,41,42,-1,49,51,-2,4,4,0,0
"12072","MIN","S.J",2018021068,17966,20182019,1,60,0,3,-3,2.99573937742389,2.91257600316749,0.0831633742564009,24,29,-5,42,39,3,58,47,11,3,3,0,0
"12073","MIN","DAL",2018021088,17969,20182019,1,60,1,4,-3,1.76973176655883,6.06797038760851,-4.29823862104968,22,31,-9,28,40,-12,41,53,-12,1,1,0,0
"12074","MIN","NYR",2018021108,17971,20182019,1,60,5,2,3,9.14781269476953,3.4730471327639,5.67476556200563,47,28,19,64,37,27,76,63,13,4,3,0,0
"12075","MIN","NYI",2018021113,17972,20182019,1,61.0666666666667,2,3,-1,5.11105185665656,3.45730037408794,1.65375148256862,34,20,14,47,28,19,69,34,35,6,2,0,0
"12076","MIN","COL",2018021129,17974,20182019,1,60,1,3,-2,8.65362583563547,6.35842664371748,2.29519919191799,37,38,-1,50,50,0,65,68,-3,4,4,0,0
"12077","MIN","WSH",2018021148,17977,20182019,0,60,2,1,1,6.65646155194952,4.19719242254087,2.45926912940865,27,22,5,44,42,2,57,64,-7,2,4,0,0
"12078","MIN","CAR",2018021157,17978,20182019,0,60,1,5,-4,2.51287538503811,3.81443014873424,-1.30155476369612,25,33,-8,39,48,-9,56,61,-5,5,3,0,0
"12079","MIN","NSH",2018021174,17980,20182019,1,60,0,1,-1,5.11576242592308,2.82577131711938,2.2899911088037,29,19,10,52,28,24,69,43,26,5,5,0,0
"12080","MIN","VGK",2018021202,17984,20182019,0,60,3,2,1,5.01072642809595,6.07809718049808,-1.06737075240213,32,37,-5,42,51,-9,55,74,-19,4,2,0,0
"12081","MIN","ARI",2018021217,17986,20182019,0,60,0,4,-4,7.38210150233099,6.02224759120024,1.35985391113075,39,23,16,53,41,12,80,54,26,3,3,0,0
"12082","MIN","WPG",2018021234,17988,20182019,1,60,5,1,4,4.02748454251801,3.67234458142593,0.355139961092078,28,33,-5,36,46,-10,46,62,-16,2,2,0,0
"12083","MIN","BOS",2018021250,17990,20182019,1,60,0,3,-3,2.84705136455861,4.47230468035923,-1.62525331580062,26,35,-9,38,52,-14,52,67,-15,2,3,0,0
"12084","MIN","DAL",2018021267,17992,20182019,0,60,0,3,-3,3.21378989130608,6.48310874158051,-3.26931885027443,24,44,-20,32,58,-26,49,68,-19,3,4,0,0
"12085","MTL","BUF",2008020012,14162,20082009,0,65,1,1,0,0,0,0,28,36,-8,46,47,-1,59,64,-5,5,6,0,0
"12086","MTL","TOR",2008020016,14163,20082009,0,60,6,1,5,0,0,0,34,25,9,51,42,9,71,51,20,8,5,0,0
"12087","MTL","PHI",2008020035,14165,20082009,0,60,5,3,2,0,0,0,27,32,-5,39,44,-5,54,59,-5,5,8,0,0
"12088","MTL","BOS",2008020045,14167,20082009,1,65,3,3,0,0,0,0,28,34,-6,41,47,-6,63,73,-10,5,7,0,0
"12089","MTL","ARI",2008020064,14170,20082009,1,60,4,1,3,0,0,0,33,29,4,47,39,8,55,62,-7,5,4,0,0
"12090","MTL","FLA",2008020080,14172,20082009,1,60,3,1,2,0,0,0,34,36,-2,46,45,1,63,68,-5,7,4,0,0
"12091","MTL","ANA",2008020107,14177,20082009,1,60,4,6,-2,0,0,0,51,25,26,64,37,27,78,53,25,8,6,0,0
"12092","MTL","CAR",2008020129,14180,20082009,1,65,2,2,0,0,0,0,25,33,-8,40,48,-8,61,66,-5,8,7,0,0
"12093","MTL","MIN",2008020141,14182,20082009,0,60,2,1,1,0,0,0,21,29,-8,32,37,-5,40,54,-14,6,11,0,0
"12094","MTL","NYI",2008020155,14184,20082009,0,60,5,4,1,0,0,0,32,31,1,45,41,4,66,59,7,3,4,0,0
"12095","MTL","CBJ",2008020193,14190,20082009,0,65,3,3,0,0,0,0,37,28,9,45,40,5,62,52,10,7,8,0,0
"12096","MTL","TOR",2008020197,14191,20082009,0,60,3,6,-3,0,0,0,20,41,-21,28,58,-30,44,76,-32,7,7,0,0
"12097","MTL","OTT",2008020217,14194,20082009,1,60,4,0,4,0,0,0,31,28,3,42,44,-2,56,66,-10,5,5,0,0
"12098","MTL","BOS",2008020228,14196,20082009,0,60,1,6,-5,0,0,0,28,31,-3,34,38,-4,43,56,-13,2,4,0,0
"12099","MTL","PHI",2008020242,14198,20082009,1,60,1,2,-1,0,0,0,25,31,-6,38,46,-8,63,67,-4,4,2,0,0
"12100","MTL","STL",2008020253,14199,20082009,0,65,2,2,0,0,0,0,26,26,0,44,37,7,53,47,6,10,9,0,0
"12101","MTL","CAR",2008020263,14201,20082009,0,60,1,2,-1,0,0,0,29,48,-19,42,66,-24,55,91,-36,6,5,0,0
"12102","MTL","OTT",2008020273,14203,20082009,0,65,2,2,0,0,0,0,21,25,-4,30,39,-9,43,52,-9,2,6,0,0
"12103","MTL","BOS",2008020289,14205,20082009,1,65,2,2,0,0,0,0,35,27,8,48,41,7,77,56,21,5,3,0,0
"12104","MTL","NYI",2008020301,14207,20082009,1,65,3,3,0,0,0,0,26,25,1,48,35,13,73,45,28,7,5,0,0
"12105","MTL","DET",2008020316,14209,20082009,0,60,3,1,2,0,0,0,25,33,-8,31,40,-9,36,53,-17,3,3,0,0
"12106","MTL","WSH",2008020328,14211,20082009,0,60,0,3,-3,0,0,0,28,30,-2,34,43,-9,48,63,-15,3,3,0,0
"12107","MTL","BUF",2008020338,14212,20082009,1,60,3,2,1,0,0,0,34,28,6,52,36,16,76,48,28,6,6,0,0
"12108","MTL","ATL",2008020357,14215,20082009,1,60,5,4,1,0,0,0,33,26,7,43,37,6,61,50,11,3,3,0,0
"12109","MTL","NYR",2008020366,14217,20082009,1,60,6,2,4,0,0,0,39,20,19,48,34,14,62,59,3,5,4,0,0
"12110","MTL","N.J",2008020381,14219,20082009,1,60.5166666666667,1,2,-1,0,0,0,26,31,-5,38,45,-7,60,62,-2,5,4,0,0
"12111","MTL","CGY",2008020403,14222,20082009,1,60,4,1,3,0,0,0,31,33,-2,44,45,-1,58,58,0,5,6,0,0
"12112","MTL","T.B",2008020416,14224,20082009,1,60,1,3,-2,0,0,0,32,22,10,37,32,5,62,42,20,7,4,0,0
"12113","MTL","WSH",2008020432,14226,20082009,1,60,1,2,-1,0,0,0,33,26,7,45,41,4,59,58,1,8,5,0,0
"12114","MTL","CAR",2008020448,14229,20082009,0,60,2,3,-1,0,0,0,24,27,-3,37,40,-3,52,54,-2,2,11,0,0
"12115","MTL","PHI",2008020464,14231,20082009,1,60,5,2,3,0,0,0,31,31,0,44,47,-3,57,67,-10,7,3,0,0
"12116","MTL","BUF",2008020476,14233,20082009,1,64.5833333333333,4,3,1,0,0,0,46,34,12,60,52,8,84,72,12,8,4,0,0
"12117","MTL","CAR",2008020488,14234,20082009,1,61.7166666666667,2,3,-1,0,0,0,28,27,1,40,48,-8,57,64,-7,4,4,0,0
"12118","MTL","PIT",2008020517,14240,20082009,0,60,3,2,1,0,0,0,19,34,-15,30,48,-18,41,72,-31,1,5,0,0
"12119","MTL","FLA",2008020534,14242,20082009,0,60,5,2,3,0,0,0,29,28,1,44,40,4,50,56,-6,7,6,0,0
"12120","MTL","T.B",2008020542,14243,20082009,0,65,1,1,0,0,0,0,30,22,8,43,35,8,53,49,4,6,5,0,0
"12121","MTL","N.J",2008020559,14246,20082009,0,60,1,4,-3,0,0,0,34,29,5,38,41,-3,47,48,-1,4,3,0,0
"12122","MTL","FLA",2008020576,14248,20082009,1,65,5,5,0,0,0,0,45,35,10,61,55,6,78,71,7,7,8,0,0
"12123","MTL","NYR",2008020596,14251,20082009,0,60,6,3,3,0,0,0,25,39,-14,39,52,-13,47,65,-18,5,3,0,0
"12124","MTL","TOR",2008020601,14252,20082009,1,60,6,2,4,0,0,0,29,32,-3,40,51,-11,53,72,-19,11,9,0,0
"12125","MTL","WSH",2008020616,14254,20082009,1,60,5,4,1,0,0,0,35,35,0,47,47,0,64,79,-15,7,5,0,0
"12126","MTL","BOS",2008020631,14257,20082009,0,60,1,3,-2,0,0,0,35,29,6,39,41,-2,52,46,6,5,4,0,0
"12127","MTL","NSH",2008020648,14259,20082009,1,60,3,2,1,0,0,0,20,25,-5,34,37,-3,48,63,-15,3,2,0,0
"12128","MTL","OTT",2008020664,14261,20082009,0,65,4,4,0,0,0,0,32,27,5,43,38,5,62,52,10,6,2,0,0
"12129","MTL","ATL",2008020685,14264,20082009,0,60,2,4,-2,0,0,0,36,24,12,47,34,13,66,46,20,2,3,0,0
"12130","MTL","N.J",2008020692,14265,20082009,0,60,2,5,-3,0,0,0,28,34,-6,39,47,-8,47,55,-8,6,3,0,0
"12131","MTL","T.B",2008020705,14271,20082009,0,60,3,5,-2,0,0,0,34,24,10,41,31,10,54,38,16,6,9,0,0
"12132","MTL","FLA",2008020719,14273,20082009,0,60,1,5,-4,0,0,0,36,36,0,52,43,9,62,47,15,2,5,0,0
"12133","MTL","L.A",2008020732,14275,20082009,1,60,4,3,1,0,0,0,26,32,-6,37,44,-7,59,60,-1,6,6,0,0
"12134","MTL","BOS",2008020743,14276,20082009,1,60,1,3,-2,0,0,0,28,23,5,38,34,4,53,50,3,8,8,0,0
"12135","MTL","PIT",2008020753,14278,20082009,1,60,4,2,2,0,0,0,35,25,10,48,30,18,64,53,11,3,6,0,0
"12136","MTL","BUF",2008020772,14281,20082009,0,60,2,3,-1,0,0,0,37,22,15,45,32,13,60,46,14,4,5,0,0
"12137","MTL","TOR",2008020780,14282,20082009,1,60,2,5,-3,0,0,0,33,41,-8,46,48,-2,63,57,6,11,8,0,0
"12138","MTL","CGY",2008020794,14284,20082009,0,60,2,6,-4,0,0,0,24,41,-17,28,51,-23,38,69,-31,6,7,0,0
"12139","MTL","EDM",2008020809,14286,20082009,0,60,2,7,-5,0,0,0,38,27,11,47,29,18,58,37,21,6,7,0,0
"12140","MTL","COL",2008020824,14288,20082009,0,60,4,2,2,0,0,0,23,48,-25,32,54,-22,52,75,-23,2,5,0,0
"12141","MTL","VAN",2008020840,14290,20082009,0,60,2,4,-2,0,0,0,27,34,-7,38,46,-8,49,59,-10,0,2,0,0
"12142","MTL","WSH",2008020856,14293,20082009,0,65,3,3,0,0,0,0,33,35,-2,43,49,-6,60,72,-12,4,3,0,0
"12143","MTL","PIT",2008020861,14294,20082009,0,60,4,5,-1,0,0,0,27,28,-1,40,39,1,54,44,10,4,1,0,0
"12144","MTL","OTT",2008020875,14296,20082009,1,60,5,3,2,0,0,0,32,47,-15,39,59,-20,53,78,-25,7,10,0,0
"12145","MTL","VAN",2008020897,14299,20082009,1,60,3,0,3,0,0,0,17,34,-17,26,54,-28,44,71,-27,7,7,0,0
"12146","MTL","PHI",2008020918,14302,20082009,0,63.35,4,3,1,0,0,0,36,38,-2,46,57,-11,65,78,-13,6,9,0,0
"12147","MTL","S.J",2008020926,14303,20082009,1,60,3,2,1,0,0,0,21,48,-27,27,67,-40,37,91,-54,1,2,0,0
"12148","MTL","BUF",2008020953,14307,20082009,0,60,1,5,-4,0,0,0,39,27,12,48,43,5,62,53,9,6,4,0,0
"12149","MTL","ATL",2008020966,14309,20082009,0,60,0,2,-2,0,0,0,25,28,-3,30,43,-13,44,59,-15,8,11,0,0
"12150","MTL","DAL",2008020984,14311,20082009,0,60,3,1,2,0,0,0,19,31,-12,28,51,-23,36,75,-39,4,11,0,0
"12151","MTL","EDM",2008020993,14313,20082009,1,61.6666666666667,4,3,1,0,0,0,26,32,-6,45,36,9,58,51,7,3,3,0,0
"12152","MTL","NYI",2008021009,14315,20082009,1,60.4333333333333,2,3,-1,0,0,0,26,39,-13,41,47,-6,63,61,2,7,6,0,0
"12153","MTL","N.J",2008021024,14317,20082009,1,60,1,3,-2,0,0,0,23,48,-25,29,62,-33,45,90,-45,2,6,0,0
"12154","MTL","NYR",2008021041,14320,20082009,1,65,3,3,0,0,0,0,29,42,-13,38,55,-17,54,72,-18,6,4,0,0
"12155","MTL","OTT",2008021056,14322,20082009,0,60,4,5,-1,0,0,0,32,39,-7,41,45,-4,58,55,3,4,2,0,0
"12156","MTL","TOR",2008021071,14324,20082009,1,60,2,5,-3,0,0,0,28,37,-9,43,51,-8,60,63,-3,5,7,0,0
"12157","MTL","ATL",2008021090,14327,20082009,1,60,6,3,3,0,0,0,22,25,-3,35,38,-3,47,54,-7,8,8,0,0
"12158","MTL","T.B",2008021105,14329,20082009,1,61.75,3,2,1,0,0,0,36,19,17,56,25,31,90,34,56,9,2,0,0
"12159","MTL","BUF",2008021118,14331,20082009,1,65,3,3,0,0,0,0,35,37,-2,49,44,5,71,64,7,6,5,0,0
"12160","MTL","CHI",2008021139,14334,20082009,1,60,4,1,3,0,0,0,33,29,4,42,40,2,49,55,-6,5,6,0,0
"12161","MTL","NYI",2008021151,14336,20082009,0,60,5,1,4,0,0,0,38,27,11,57,36,21,73,48,25,8,3,0,0
"12162","MTL","TOR",2008021166,14338,20082009,0,60,6,2,4,0,0,0,29,36,-7,47,54,-7,65,71,-6,8,7,0,0
"12163","MTL","OTT",2008021182,14340,20082009,1,60,2,3,-1,0,0,0,22,23,-1,29,34,-5,41,55,-14,5,5,0,0
"12164","MTL","NYR",2008021185,14341,20082009,0,60,1,3,-2,0,0,0,25,44,-19,33,57,-24,49,71,-22,3,3,0,0
"12165","MTL","BOS",2008021199,14343,20082009,0,62.7,4,5,-1,0,0,0,39,33,6,45,40,5,52,48,4,13,10,0,0
"12166","MTL","PIT",2008021221,14345,20082009,1,60,1,3,-2,0,0,0,30,41,-11,40,56,-16,59,72,-13,3,5,0,0
"12167","MTL","BOS",2008030111,14350,20082009,0,60,2,4,-2,0,0,0,28,39,-11,39,49,-10,49,58,-9,4,6,0,0
"12168","MTL","BOS",2008030112,14352,20082009,0,60,1,5,-4,0,0,0,31,31,0,47,41,6,54,53,1,4,9,0,0
"12169","MTL","BOS",2008030113,14354,20082009,1,60,2,4,-2,0,0,0,25,30,-5,38,40,-2,61,57,4,5,3,0,0
"12170","MTL","BOS",2008030114,14356,20082009,1,60,1,4,-3,0,0,0,27,30,-3,38,45,-7,53,66,-13,3,6,0,0
"12171","MTL","TOR",2009020002,14518,20092010,0,64.7833333333333,4,3,1,0,0,0,27,46,-19,49,67,-18,64,92,-28,5,5,0,0
"12172","MTL","BUF",2009020011,14520,20092010,0,62.7,2,1,1,0,0,0,17,35,-18,29,45,-16,41,57,-16,9,10,0,0
"12173","MTL","CGY",2009020030,14523,20092010,0,60,3,4,-1,0,0,0,30,28,2,34,44,-10,51,56,-5,0,1,0,0
"12174","MTL","VAN",2009020034,14524,20092010,0,60,1,7,-6,0,0,0,28,35,-7,32,45,-13,43,62,-19,5,6,0,0
"12175","MTL","EDM",2009020060,14527,20092010,0,60,2,3,-1,0,0,0,35,19,16,50,36,14,71,48,23,2,3,0,0
"12176","MTL","COL",2009020082,14532,20092010,1,60,2,3,-1,0,0,0,31,23,8,50,31,19,65,42,23,6,4,0,0
"12177","MTL","OTT",2009020095,14534,20092010,1,60,1,3,-2,0,0,0,28,21,7,40,32,8,66,44,22,4,5,0,0
"12178","MTL","ATL",2009020110,14537,20092010,1,65,1,1,0,0,0,0,35,23,12,54,35,19,74,61,13,7,7,0,0
"12179","MTL","NYI",2009020118,14539,20092010,1,60,5,1,4,0,0,0,43,22,21,53,32,21,82,44,38,6,3,0,0
"12180","MTL","NYR",2009020130,14541,20092010,1,62.7,5,4,1,0,0,0,31,27,4,47,41,6,71,58,13,4,2,0,0
"12181","MTL","NYI",2009020149,14543,20092010,1,61.5333333333333,3,2,1,0,0,0,31,31,0,49,37,12,75,53,22,2,7,0,0
"12182","MTL","PIT",2009020159,14545,20092010,0,60,1,6,-5,0,0,0,24,37,-13,40,48,-8,55,57,-2,4,6,0,0
"12183","MTL","CHI",2009020176,14547,20092010,0,60,2,3,-1,0,0,0,22,36,-14,29,43,-14,46,58,-12,4,9,0,0
"12184","MTL","ATL",2009020200,14551,20092010,1,60,4,5,-1,0,0,0,38,30,8,57,42,15,67,56,11,4,5,0,0
"12185","MTL","BOS",2009020209,14553,20092010,0,65,1,1,0,0,0,0,26,43,-17,33,53,-20,35,62,-27,3,4,0,0
"12186","MTL","T.B",2009020228,14555,20092010,1,60,1,3,-2,0,0,0,37,21,16,55,30,25,75,40,35,2,4,0,0
"12187","MTL","CGY",2009020243,14558,20092010,1,60,0,1,-1,0,0,0,25,31,-6,34,50,-16,44,63,-19,5,8,0,0
"12188","MTL","ARI",2009020260,14560,20092010,0,60,4,2,2,0,0,0,20,20,0,32,30,2,41,51,-10,2,4,0,0
"12189","MTL","NSH",2009020277,14562,20092010,0,60,0,2,-2,0,0,0,20,55,-35,27,68,-41,37,78,-41,2,6,0,0
"12190","MTL","CAR",2009020290,14565,20092010,1,65,2,2,0,0,0,0,35,32,3,46,46,0,61,62,-1,4,5,0,0
"12191","MTL","WSH",2009020307,14568,20092010,0,60,3,2,1,0,0,0,22,34,-12,30,53,-23,43,79,-36,3,4,0,0
"12192","MTL","DET",2009020315,14569,20092010,1,65,2,2,0,0,0,0,18,34,-16,35,55,-20,43,84,-41,1,6,0,0
"12193","MTL","CBJ",2009020338,14572,20092010,1,60,5,3,2,0,0,0,29,36,-7,39,46,-7,58,71,-13,3,4,0,0
"12194","MTL","PIT",2009020343,14573,20092010,0,60,1,3,-2,0,0,0,19,30,-11,30,45,-15,39,63,-24,1,2,0,0
"12195","MTL","WSH",2009020370,14576,20092010,1,65,3,3,0,0,0,0,24,23,1,41,34,7,55,57,-2,4,3,0,0
"12196","MTL","TOR",2009020390,14579,20092010,1,60,0,3,-3,0,0,0,26,31,-5,41,46,-5,61,65,-4,2,2,0,0
"12197","MTL","BUF",2009020398,14581,20092010,0,60,2,6,-4,0,0,0,23,37,-14,38,42,-4,52,52,0,1,2,0,0
"12198","MTL","BOS",2009020410,14582,20092010,1,60,5,1,4,0,0,0,29,38,-9,36,57,-21,46,79,-33,4,7,0,0
"12199","MTL","PHI",2009020431,14585,20092010,1,60,3,1,2,0,0,0,13,15,-2,21,21,0,32,48,-16,3,4,0,0
"12200","MTL","OTT",2009020439,14586,20092010,0,60,4,1,3,0,0,0,27,46,-19,30,59,-29,37,73,-36,3,7,0,0
"12201","MTL","PIT",2009020454,14588,20092010,1,60,2,3,-1,0,0,0,21,41,-20,35,54,-19,46,80,-34,4,6,0,0
"12202","MTL","ATL",2009020471,14590,20092010,0,61.3,3,4,-1,0,0,0,19,34,-15,26,46,-20,34,67,-33,4,7,0,0
"12203","MTL","BUF",2009020485,14592,20092010,1,60,3,4,-1,0,0,0,24,27,-3,34,43,-9,50,73,-23,5,7,0,0
"12204","MTL","N.J",2009020494,14594,20092010,0,60,1,2,-1,0,0,0,18,27,-9,20,32,-12,32,43,-11,1,5,0,0
"12205","MTL","MIN",2009020502,14595,20092010,1,60,1,3,-2,0,0,0,31,21,10,46,32,14,64,42,22,2,1,0,0
"12206","MTL","NYI",2009020523,14597,20092010,0,60,3,0,3,0,0,0,28,40,-12,46,51,-5,58,75,-17,6,6,0,0
"12207","MTL","ATL",2009020535,14599,20092010,0,62.3833333333333,4,3,1,0,0,0,23,50,-27,33,56,-23,44,73,-29,3,6,0,0
"12208","MTL","CAR",2009020550,14601,20092010,0,60,5,1,4,0,0,0,25,47,-22,33,67,-34,45,84,-39,5,5,0,0
"12209","MTL","TOR",2009020558,14604,20092010,0,60.5666666666667,3,2,1,0,0,0,23,49,-26,31,76,-45,43,94,-51,2,4,0,0
"12210","MTL","OTT",2009020579,14606,20092010,0,60,2,4,-2,0,0,0,31,28,3,41,40,1,54,50,4,0,5,0,0
"12211","MTL","T.B",2009020593,14608,20092010,0,63.5333333333333,2,1,1,0,0,0,35,35,0,49,48,1,65,61,4,4,3,0,0
"12212","MTL","FLA",2009020598,14609,20092010,0,60,5,4,1,0,0,0,42,36,6,51,51,0,62,60,2,4,3,0,0
"12213","MTL","BUF",2009020623,14612,20092010,1,60,0,1,-1,0,0,0,30,30,0,42,34,8,50,50,0,2,1,0,0
"12214","MTL","WSH",2009020631,14614,20092010,0,60,2,4,-2,0,0,0,26,43,-17,40,62,-22,52,80,-28,4,5,0,0
"12215","MTL","FLA",2009020648,14616,20092010,1,60,2,0,2,0,0,0,39,38,1,52,51,1,75,77,-2,2,1,0,0
"12216","MTL","N.J",2009020663,14618,20092010,1,62.6333333333333,1,2,-1,0,0,0,30,28,2,43,40,3,64,61,3,5,5,0,0
"12217","MTL","DAL",2009020696,14623,20092010,1,60,5,3,2,0,0,0,28,36,-8,36,46,-10,53,65,-12,3,4,0,0
"12218","MTL","OTT",2009020712,14625,20092010,1,60,2,4,-2,0,0,0,32,28,4,43,40,3,67,54,13,6,2,0,0
"12219","MTL","NYR",2009020721,14626,20092010,0,60,2,6,-4,0,0,0,20,34,-14,36,46,-10,50,54,-4,9,10,0,0
"12220","MTL","STL",2009020742,14629,20092010,1,63.3166666666667,3,4,-1,0,0,0,38,28,10,48,43,5,63,61,2,5,5,0,0
"12221","MTL","N.J",2009020757,14631,20092010,0,60,3,1,2,0,0,0,24,32,-8,29,46,-17,40,57,-17,3,3,0,0
"12222","MTL","NYR",2009020762,14632,20092010,1,60,6,0,6,0,0,0,31,32,-1,41,47,-6,48,58,-10,7,4,0,0
"12223","MTL","FLA",2009020783,14635,20092010,0,60,1,2,-1,0,0,0,17,29,-12,32,44,-12,49,61,-12,2,4,0,0
"12224","MTL","T.B",2009020789,14636,20092010,0,60,0,3,-3,0,0,0,33,30,3,48,45,3,57,53,4,5,5,0,0
"12225","MTL","OTT",2009020807,14639,20092010,0,63.55,2,3,-1,0,0,0,29,37,-8,40,47,-7,59,59,0,4,4,0,0
"12226","MTL","VAN",2009020830,14642,20092010,1,60,3,2,1,0,0,0,28,47,-19,35,62,-27,42,70,-28,5,6,0,0
"12227","MTL","BOS",2009020841,14644,20092010,0,65,2,2,0,0,0,0,25,47,-22,42,60,-18,49,71,-22,2,6,0,0
"12228","MTL","PIT",2009020856,14646,20092010,1,60,5,3,2,0,0,0,32,21,11,46,31,15,71,52,19,7,3,0,0
"12229","MTL","BOS",2009020869,14647,20092010,1,60,0,3,-3,0,0,0,36,27,9,43,45,-2,58,63,-5,2,1,0,0
"12230","MTL","WSH",2009020886,14650,20092010,1,64.8666666666667,6,5,1,0,0,0,39,38,1,53,54,-1,68,80,-12,5,7,0,0
"12231","MTL","PHI",2009020899,14652,20092010,0,60,2,3,-1,0,0,0,25,33,-8,37,45,-8,66,63,3,3,8,0,0
"12232","MTL","PHI",2009020907,14653,20092010,1,60,2,6,-4,0,0,0,28,26,2,41,29,12,56,37,19,7,5,0,0
"12233","MTL","BOS",2009020923,14670,20092010,0,60,4,1,3,0,0,0,32,24,8,36,33,3,52,43,9,2,4,0,0
"12234","MTL","S.J",2009020949,14672,20092010,0,60,2,3,-1,0,0,0,30,40,-10,41,59,-18,51,85,-34,7,7,0,0
"12235","MTL","L.A",2009020963,14674,20092010,0,60,4,2,2,0,0,0,25,25,0,33,44,-11,39,59,-20,1,4,0,0
"12236","MTL","ANA",2009020973,14675,20092010,0,65,3,3,0,0,0,0,43,32,11,56,43,13,67,52,15,5,4,0,0
"12237","MTL","T.B",2009020979,14677,20092010,1,60,5,3,2,0,0,0,28,31,-3,35,46,-11,45,67,-22,2,4,0,0
"12238","MTL","EDM",2009020995,14679,20092010,1,65,4,4,0,0,0,0,26,25,1,42,36,6,57,44,13,7,4,0,0
"12239","MTL","BOS",2009021008,14681,20092010,1,60,3,2,1,0,0,0,27,23,4,38,35,3,51,49,2,5,5,0,0
"12240","MTL","NYR",2009021028,14684,20092010,0,60,3,1,2,0,0,0,35,20,15,40,35,5,47,45,2,5,6,0,0
"12241","MTL","TOR",2009021059,14688,20092010,0,65,2,2,0,0,0,0,27,33,-6,46,43,3,68,60,8,5,1,0,0
"12242","MTL","OTT",2009021078,14690,20092010,1,60,0,2,-2,0,0,0,29,27,2,44,37,7,58,52,6,5,2,0,0
"12243","MTL","BUF",2009021092,14692,20092010,0,65,2,2,0,0,0,0,28,42,-14,40,50,-10,44,68,-24,4,6,0,0
"12244","MTL","FLA",2009021103,14693,20092010,1,60,4,1,3,0,0,0,31,24,7,43,38,5,58,61,-3,3,6,0,0
"12245","MTL","N.J",2009021114,14695,20092010,1,60,2,4,-2,0,0,0,27,26,1,37,37,0,48,49,-1,5,3,0,0
"12246","MTL","CAR",2009021143,14699,20092010,1,60,1,2,-1,0,0,0,35,27,8,47,38,9,68,51,17,4,3,0,0
"12247","MTL","PHI",2009021158,14701,20092010,0,60,1,0,1,0,0,0,23,35,-12,34,53,-19,49,73,-24,3,3,0,0
"12248","MTL","BUF",2009021168,14702,20092010,1,60,3,0,3,0,0,0,38,29,9,47,43,4,58,57,1,6,4,0,0
"12249","MTL","NYI",2009021184,14705,20092010,0,65,3,3,0,0,0,0,31,42,-11,38,55,-17,52,81,-29,3,4,0,0
"12250","MTL","CAR",2009021199,14707,20092010,0,60,2,5,-3,0,0,0,32,33,-1,51,38,13,67,57,10,2,1,0,0
"12251","MTL","TOR",2009021214,14709,20092010,1,62.1,3,4,-1,0,0,0,37,28,9,56,32,24,74,46,28,6,2,0,0
"12252","MTL","WSH",2009030111,14714,20092010,0,73.3166666666667,3,2,1,0,0,0,38,47,-9,58,67,-9,88,94,-6,4,4,0,0
"12253","MTL","WSH",2009030112,14716,20092010,0,60.5166666666667,5,6,-1,0,0,0,24,37,-13,31,55,-24,42,85,-43,3,3,0,0
"12254","MTL","WSH",2009030113,14718,20092010,1,60,1,5,-4,0,0,0,27,36,-9,34,48,-14,50,68,-18,5,7,0,0
"12255","MTL","WSH",2009030114,14720,20092010,1,60,3,6,-3,0,0,0,39,38,1,44,51,-7,58,73,-15,4,5,0,0
"12256","MTL","WSH",2009030115,14722,20092010,0,60,2,1,1,0,0,0,28,38,-10,43,49,-6,58,68,-10,6,5,0,0
"12257","MTL","WSH",2009030116,14725,20092010,1,60,4,1,3,0,0,0,22,54,-32,35,71,-36,47,94,-47,6,7,0,0
"12258","MTL","WSH",2009030117,14727,20092010,0,60,2,1,1,0,0,0,16,42,-26,27,53,-26,38,94,-56,4,4,0,0
"12259","MTL","PIT",2009030211,14729,20092010,0,60,3,6,-3,0,0,0,31,24,7,39,36,3,61,51,10,7,7,0,0
"12260","MTL","PIT",2009030212,14731,20092010,0,60,3,1,2,0,0,0,21,39,-18,27,52,-25,34,67,-33,2,3,0,0
"12261","MTL","PIT",2009030213,14733,20092010,1,60,0,2,-2,0,0,0,18,25,-7,31,36,-5,49,52,-3,4,6,0,0
"12262","MTL","PIT",2009030214,14735,20092010,1,60,3,2,1,0,0,0,25,35,-10,32,50,-18,42,73,-31,2,4,0,0
"12263","MTL","PIT",2009030215,14737,20092010,0,60,1,2,-1,0,0,0,33,25,8,40,51,-11,58,73,-15,3,3,0,0
"12264","MTL","PIT",2009030216,14739,20092010,1,60,4,3,1,0,0,0,25,37,-12,37,53,-16,57,74,-17,4,6,0,0
"12265","MTL","PIT",2009030217,14741,20092010,0,60,5,2,3,0,0,0,20,39,-19,28,56,-28,31,82,-51,5,7,0,0
"12266","MTL","PHI",2009030311,14745,20092010,0,60,0,6,-6,0,0,0,28,25,3,42,35,7,58,55,3,4,6,0,0
"12267","MTL","PHI",2009030312,14747,20092010,0,60,0,3,-3,0,0,0,30,23,7,36,29,7,52,44,8,4,4,0,0
"12268","MTL","PHI",2009030313,14749,20092010,1,60,5,1,4,0,0,0,38,26,12,52,35,17,68,48,20,10,7,0,0
"12269","MTL","PHI",2009030314,14751,20092010,1,60,0,3,-3,0,0,0,17,25,-8,27,38,-11,54,52,2,4,4,0,0
"12270","MTL","PHI",2009030315,14753,20092010,0,60,2,4,-2,0,0,0,27,26,1,37,35,2,56,57,-1,5,6,0,0
"12271","MTL","TOR",2010020001,14889,20102011,0,60,2,3,-1,5.33678685064097,3.87501285829785,1.46177399234312,28,24,4,43,33,10,65,54,11,3,5,0,0
"12272","MTL","PIT",2010020016,14891,20102011,0,60,3,2,1,5.02284803253133,6.81316375341521,-1.79031572088388,27,38,-11,38,50,-12,45,61,-16,4,6,0,0
"12273","MTL","T.B",2010020038,14895,20102011,1,64.15,3,4,-1,3.59471889666218,6.18574050187478,-2.5910216052126,27,48,-21,41,68,-27,55,85,-30,5,6,0,0
"12274","MTL","BUF",2010020052,14897,20102011,0,60,2,1,1,3.19258488895139,4.98129586243886,-1.78871097348747,28,23,5,45,31,14,61,47,14,3,1,0,0
"12275","MTL","OTT",2010020055,14898,20102011,1,60,4,3,1,4.76705877513713,2.02959808334708,2.73746069179005,40,19,21,51,23,28,64,34,30,7,4,0,0
"12276","MTL","N.J",2010020086,14903,20102011,1,60,0,3,-3,4.25421049852829,3.24675283569377,1.00745766283453,29,20,9,42,28,14,63,42,21,3,4,0,0
"12277","MTL","OTT",2010020099,14905,20102011,0,60,3,0,3,2.97246455710228,2.39488172443816,0.57758283266412,34,19,15,40,37,3,56,48,8,5,4,0,0
"12278","MTL","ARI",2010020115,14907,20102011,1,61.4166666666667,3,2,1,3.22279717602337,3.15663784614298,0.0661593298803851,29,29,0,39,38,1,51,59,-8,5,5,0,0
"12279","MTL","NYI",2010020125,14909,20102011,1,60,5,3,2,5.64402785861838,3.20673473289753,2.43729312572085,35,21,14,49,26,23,63,39,24,4,4,0,0
"12280","MTL","NYI",2010020137,14911,20102011,0,60,3,1,2,5.37646588645028,3.55147696955819,1.82498891689209,26,31,-5,41,48,-7,50,74,-24,3,7,0,0
"12281","MTL","FLA",2010020144,14912,20102011,1,60,1,3,-2,3.92039100462105,5.18424466097457,-1.26385365635352,41,31,10,55,44,11,73,55,18,5,4,0,0
"12282","MTL","CBJ",2010020161,14915,20102011,0,60,0,3,-3,4.07398175312846,5.1420250593219,-1.06804330619343,29,24,5,41,32,9,65,40,25,3,3,0,0
"12283","MTL","BUF",2010020181,14918,20102011,0,60,3,2,1,5.85789859708166,3.09704918979696,2.7608494072847,32,31,1,46,40,6,60,53,7,4,5,0,0
"12284","MTL","OTT",2010020190,14919,20102011,1,60,2,3,-1,1.84826887505795,2.08243022970436,-0.234161354646403,23,31,-8,35,38,-3,45,49,-4,2,6,0,0
"12285","MTL","VAN",2010020206,14922,20102011,1,60,2,0,2,3.77275278097852,3.94926718420174,-0.176514403223225,29,34,-5,40,48,-8,51,69,-18,3,4,0,0
"12286","MTL","BOS",2010020217,14924,20102011,0,60,3,1,2,3.65544266358341,2.97356729972709,0.681875363856316,41,35,6,51,45,6,66,59,7,6,5,0,0
"12287","MTL","CAR",2010020236,14926,20102011,1,60,7,2,5,4.73892871671263,3.67487731782268,1.06405139888995,33,30,3,46,43,3,51,62,-11,7,7,0,0
"12288","MTL","PHI",2010020255,14929,20102011,1,60,3,0,3,3.57165460352288,3.37809277984044,0.193561823682439,28,41,-13,40,50,-10,49,65,-16,10,8,0,0
"12289","MTL","NSH",2010020272,14931,20102011,1,60,0,3,-3,4.31186626898125,2.30381047960377,2.00805578937748,30,30,0,41,38,3,59,51,8,4,3,0,0
"12290","MTL","TOR",2010020285,14933,20102011,1,60,2,0,2,2.87424840104495,2.99687452564103,-0.122626124596081,39,30,9,51,41,10,70,54,16,1,3,0,0
"12291","MTL","PHI",2010020301,14935,20102011,0,60,2,3,-1,4.11675282289798,8.12897172355861,-4.01221890066063,31,45,-14,43,57,-14,58,75,-17,4,3,0,0
"12292","MTL","L.A",2010020311,14937,20102011,1,60,4,1,3,2.44503192135992,5.98348751459162,-3.5384555932317,33,25,8,43,33,10,57,53,4,4,4,0,0
"12293","MTL","ATL",2010020330,14939,20102011,0,60,0,3,-3,3.2734720142045,7.22961567380116,-3.95614365959666,25,47,-22,30,57,-27,46,68,-22,4,8,0,0
"12294","MTL","BUF",2010020336,14940,20102011,1,60,3,1,2,4.96774682629461,3.71798718208447,1.24975964421014,33,36,-3,52,43,9,65,64,1,8,7,0,0
"12295","MTL","EDM",2010020358,14944,20102011,1,62.4666666666667,3,4,-1,3.21028217151545,4.94484925762578,-1.73456708611032,39,32,7,50,42,8,67,52,15,3,5,0,0
"12296","MTL","N.J",2010020367,14945,20102011,0,60,5,1,4,4.71206272262498,3.76846084451245,0.943601878112531,32,28,4,43,32,11,50,46,4,3,3,0,0
"12297","MTL","S.J",2010020380,14947,20102011,1,60,3,1,2,2.29078357115111,2.7109453062003,-0.420161735049192,19,27,-8,28,35,-7,39,58,-19,0,2,0,0
"12298","MTL","OTT",2010020402,14950,20102011,1,60,4,1,3,6.50520163332112,3.57903235591948,2.92616927740164,35,28,7,51,35,16,66,53,13,5,4,0,0
"12299","MTL","DET",2010020419,14953,20102011,0,60,2,4,-2,4.41378725187678,8.08793168608099,-3.67414443420421,38,32,6,42,49,-7,53,60,-7,1,6,0,0
"12300","MTL","TOR",2010020427,14954,20102011,0,60,1,3,-2,4.44370834512745,6.3585033917916,-1.91479504666415,23,24,-1,39,42,-3,56,67,-11,3,5,0,0
"12301","MTL","PHI",2010020454,14958,20102011,1,60,3,5,-2,0,0,0,41,30,11,62,37,25,84,49,35,2,3,0,0
"12302","MTL","BOS",2010020463,14959,20102011,1,60,4,3,1,7.33134101858694,4.7218975258617,2.60944349272524,41,37,4,47,53,-6,61,71,-10,3,4,0,0
"12303","MTL","COL",2010020487,14962,20102011,0,60,2,3,-1,5.38407648951397,3.94296329393215,1.44111319558182,29,28,1,43,33,10,63,45,18,5,3,0,0
"12304","MTL","DAL",2010020499,14964,20102011,0,60,2,5,-3,4.7724480741017,2.68019871737147,2.09224935673024,29,17,12,53,28,25,73,38,35,5,3,0,0
"12305","MTL","CAR",2010020511,14966,20102011,0,60,3,2,1,5.43890994272078,3.79588509356836,1.64302484915243,29,24,5,43,34,9,57,49,8,2,3,0,0
"12306","MTL","NYI",2010020521,14969,20102011,0,60,1,4,-3,5.45759007479994,2.07542234803306,3.38216772676688,39,25,14,56,35,21,73,43,30,3,7,0,0
"12307","MTL","WSH",2010020538,14971,20102011,0,60,0,3,-3,3.64101689805411,4.53263600554783,-0.891619107493719,25,30,-5,40,45,-5,58,64,-6,6,8,0,0
"12308","MTL","T.B",2010020553,14973,20102011,0,60,1,4,-3,5.30799528790672,4.15924221077148,1.14875307713524,28,23,5,39,35,4,59,48,11,5,7,0,0
"12309","MTL","FLA",2010020558,14974,20102011,0,63.6833333333333,3,2,1,6.73287537532417,4.64931980558322,2.08355556974095,48,22,26,58,34,24,71,47,24,4,6,0,0
"12310","MTL","ATL",2010020573,14976,20102011,1,63.7166666666667,3,4,-1,6.36892664418755,3.54359115561512,2.82533548857244,50,28,22,71,39,32,91,52,39,3,2,0,0
"12311","MTL","PIT",2010020600,14980,20102011,1,65,1,1,0,3.64565559991732,4.17272795699796,-0.527072357080641,23,32,-9,36,42,-6,57,62,-5,5,2,0,0
"12312","MTL","BOS",2010020614,14982,20102011,1,63.7166666666667,3,2,1,7.64277479492011,4.22906860124203,3.41370619367808,42,29,13,62,41,21,80,53,27,3,3,0,0
"12313","MTL","NYR",2010020635,14985,20102011,0,60,2,1,1,3.95912504971413,4.08599207713269,-0.126867027418557,38,26,12,44,40,4,59,51,8,3,3,0,0
"12314","MTL","PIT",2010020642,14986,20102011,1,60,2,5,-3,3.63784867060576,4.39252552484959,-0.754676854243826,22,36,-14,31,44,-13,48,61,-13,4,7,0,0
"12315","MTL","NYR",2010020662,14989,20102011,1,60,3,2,1,6.53509169165483,5.31785177190613,1.2172399197487,41,33,8,52,45,7,65,58,7,6,6,0,0
"12316","MTL","CGY",2010020680,14991,20102011,1,61.1,5,4,1,6.56271530786034,5.73450490786753,0.828210399992816,29,28,1,39,45,-6,58,64,-6,3,4,0,0
"12317","MTL","BUF",2010020683,14992,20102011,0,61.15,1,2,-1,3.67345688731701,7.96179975452529,-4.28834286720828,30,39,-9,39,54,-15,55,72,-17,5,6,0,0
"12318","MTL","OTT",2010020709,14995,20102011,0,60,7,1,6,3.27286011040269,6.46084310958031,-3.18798299917762,35,34,1,43,42,1,55,53,2,4,4,0,0
"12319","MTL","ANA",2010020716,14996,20102011,1,65,3,3,0,4.74725097029339,3.10978168699103,1.63746928330236,40,26,14,51,34,17,77,43,34,6,4,0,0
"12320","MTL","PHI",2010020735,14999,20102011,0,60,2,5,-3,6.44838524556933,5.54622229604301,0.902162949526321,31,35,-4,53,46,7,84,54,30,9,7,0,0
"12321","MTL","WSH",2010020754,15006,20102011,0,65,2,2,0,6.44592779886443,2.71766060256186,3.72826719630257,38,29,9,56,36,20,69,56,13,6,3,0,0
"12322","MTL","FLA",2010020766,15007,20102011,1,60,3,2,1,7.08375096046029,3.94294212119712,3.14080883926317,40,35,5,59,49,10,74,72,2,5,3,0,0
"12323","MTL","NYR",2010020783,15010,20102011,1,60,2,0,2,2.534599989792,6.85571103284846,-4.32111104305646,29,35,-6,36,48,-12,52,68,-16,4,6,0,0
"12324","MTL","N.J",2010020794,15011,20102011,1,60,1,4,-3,4.90703654411482,4.33484241273254,0.572194131382275,26,30,-4,38,39,-1,56,54,2,1,2,0,0
"12325","MTL","BOS",2010020808,15014,20102011,0,60,6,8,-2,3.74483251168585,4.2074268568831,-0.46259434519725,33,34,-1,41,37,4,47,44,3,16,10,0,0
"12326","MTL","NYI",2010020819,15015,20102011,1,65,3,3,0,5.24255437203101,5.64482755344943,-0.402273181418423,40,33,7,54,48,6,76,62,14,4,5,0,0
"12327","MTL","TOR",2010020831,15017,20102011,1,60,3,0,3,3.26937209439717,2.3826948874048,0.886677206992375,39,27,12,48,33,15,68,52,16,6,5,0,0
"12328","MTL","BUF",2010020849,15020,20102011,1,65,2,2,0,5.03955606749514,3.99224633976701,1.04730972772813,34,32,2,47,42,5,65,62,3,5,2,0,0
"12329","MTL","EDM",2010020867,15022,20102011,0,60,1,4,-3,4.63870491051784,5.2685783074412,-0.629873396923358,37,28,9,52,38,14,73,57,16,1,2,0,0
"12330","MTL","CGY",2010020890,15025,20102011,0,60,0,4,-4,7.92771795105485,7.36606220110224,0.56165574995261,39,37,2,51,50,1,68,63,5,1,4,0,0
"12331","MTL","VAN",2010020901,15027,20102011,0,60,3,2,1,4.08750709851358,5.49832753092051,-1.41082043240693,25,39,-14,37,53,-16,44,75,-31,3,6,0,0
"12332","MTL","TOR",2010020911,15029,20102011,1,60,4,5,-1,6.2942460122662,1.50011256129646,4.79413345096974,35,28,7,52,32,20,69,44,25,7,8,0,0
"12333","MTL","CAR",2010020928,15031,20102011,1,60,4,3,1,3.18802518080099,3.16432717643329,0.0236980043676982,27,31,-4,37,42,-5,53,58,-5,1,3,0,0
"12334","MTL","ATL",2010020945,15034,20102011,0,60,3,1,2,0,0,0,23,41,-18,28,52,-24,40,69,-29,6,7,0,0
"12335","MTL","FLA",2010020963,15036,20102011,0,60,4,0,4,6.9452561275012,5.92324359532358,1.02201253217762,31,30,1,43,45,-2,59,57,2,1,3,0,0
"12336","MTL","T.B",2010020979,15038,20102011,0,60,4,2,2,2.28278261936444,4.94862532237312,-2.66584270300868,23,45,-22,37,57,-20,51,81,-30,4,6,0,0
"12337","MTL","BOS",2010020996,15041,20102011,1,60,4,1,3,5.14754449295551,3.78635991628729,1.36118457666822,26,31,-5,40,42,-2,49,77,-28,4,5,0,0
"12338","MTL","STL",2010021011,15043,20102011,0,60,1,4,-3,0,0,0,28,27,1,44,40,4,61,53,8,4,4,0,0
"12339","MTL","PIT",2010021023,15045,20102011,0,60,3,0,3,1.58111332415592,4.6163444135309,-3.03523108937497,20,26,-6,28,48,-20,35,63,-28,3,4,0,0
"12340","MTL","WSH",2010021045,15048,20102011,1,60,2,4,-2,2.48988847640903,3.75765813414976,-1.26776965774074,26,41,-15,35,52,-17,45,63,-18,4,6,0,0
"12341","MTL","T.B",2010021057,15050,20102011,1,65,2,2,0,5.15444953656697,7.10345332763973,-1.94900379107276,29,37,-8,41,54,-13,60,82,-22,2,5,0,0
"12342","MTL","NYR",2010021067,15051,20102011,0,60,3,6,-3,3.67687640705844,3.45417113978669,0.222705267271758,25,31,-6,34,47,-13,48,60,-12,6,7,0,0
"12343","MTL","MIN",2010021083,15053,20102011,0,60,8,1,7,4.04873143642908,4.33785787305761,-0.289126436628528,32,31,1,41,43,-2,48,58,-10,6,4,0,0
"12344","MTL","BUF",2010021092,15055,20102011,1,60,0,2,-2,3.00126071897227,3.20616782635625,-0.204907107383977,31,24,7,40,41,-1,52,58,-6,2,5,0,0
"12345","MTL","BOS",2010021102,15057,20102011,0,60,0,7,-7,2.38004178289884,4.60003894100056,-2.21999715810172,24,41,-17,33,57,-24,44,70,-26,6,6,0,0
"12346","MTL","WSH",2010021119,15059,20102011,1,60,0,2,-2,3.06534879458933,4.5359568031854,-1.47060800859607,18,33,-15,33,48,-15,48,63,-15,3,4,0,0
"12347","MTL","ATL",2010021139,15062,20102011,1,60,3,1,2,3.8179266913794,5.06610075172958,-1.24817406035018,31,28,3,40,43,-3,53,57,-4,6,4,0,0
"12348","MTL","CAR",2010021147,15063,20102011,0,60,2,6,-4,7.41855467333517,7.18095712500508,0.237597548330086,40,35,5,50,51,-1,73,65,8,3,4,0,0
"12349","MTL","N.J",2010021169,15066,20102011,0,60,3,1,2,2.73559017041043,3.46617871918716,-0.730588548776723,29,21,8,33,26,7,35,28,7,3,3,0,0
"12350","MTL","CHI",2010021187,15069,20102011,1,61.3166666666667,2,1,1,8.23652580005728,7.87066904111566,0.365856758941618,35,43,-8,54,58,-4,67,83,-16,4,5,0,0
"12351","MTL","OTT",2010021202,15071,20102011,0,61.2666666666667,2,3,-1,3.51585909875575,3.95956946225488,-0.443710363499122,29,32,-3,42,40,2,57,50,7,2,2,0,0
"12352","MTL","TOR",2010021217,15073,20102011,0,60,4,1,3,5.53810810120942,4.54959501710128,0.988513084108142,34,28,6,52,41,11,63,59,4,3,5,0,0
"12353","MTL","BOS",2010030131,15078,20102011,0,60,2,0,2,3.87053559657277,4.06071654922562,-0.190180952652844,20,31,-11,30,40,-10,43,59,-16,4,3,0,0
"12354","MTL","BOS",2010030132,15080,20102011,0,60,3,1,2,3.06491464513022,5.04387556337943,-1.97896091824921,26,35,-9,30,46,-16,38,73,-35,3,4,0,0
"12355","MTL","BOS",2010030133,15082,20102011,1,60,2,4,-2,8.39259066239356,3.58000628357357,4.81258437881999,36,25,11,45,39,6,67,56,11,5,4,0,0
"12356","MTL","BOS",2010030134,15085,20102011,1,61.9833333333333,4,5,-1,6.50663738849107,4.92318095987335,1.58345642861772,38,35,3,54,54,0,71,70,1,2,1,0,0
"12357","MTL","BOS",2010030137,15091,20102011,0,65.7166666666667,3,4,-1,4.8300170393444,6.3618588312529,-1.53184179190851,37,34,3,41,41,0,54,59,-5,4,2,0,0
"12358","MTL","TOR",2011020002,15253,20112012,0,60,0,2,-2,4.14950016102592,2.23819226528576,1.91130789574016,32,18,14,41,36,5,61,48,13,5,4,0,0
"12359","MTL","WPG",2011020023,15256,20112012,0,60,5,1,4,2.23256531530951,3.42051014259778,-1.18794482728826,22,31,-9,32,43,-11,39,57,-18,5,8,0,0
"12360","MTL","CGY",2011020040,15260,20112012,1,60,1,4,-3,5.59079994716693,2.10109337756148,3.48970656960544,36,21,15,45,28,17,69,46,23,4,4,0,0
"12361","MTL","COL",2011020050,15262,20112012,1,65,5,5,0,7.18287661060924,4.24882233986285,2.93405427074639,43,30,13,58,40,18,82,60,22,4,5,0,0
"12362","MTL","BUF",2011020072,15265,20112012,1,60,1,3,-2,4.71519059239654,7.39758404626627,-2.68239345386974,41,23,18,59,33,26,82,49,33,5,1,0,0
"12363","MTL","PIT",2011020082,15267,20112012,0,60,1,3,-2,1.61949022735896,6.66191573289689,-5.04242550553793,28,32,-4,37,45,-8,48,58,-10,4,5,0,0
"12364","MTL","TOR",2011020098,15269,20112012,1,61.3833333333333,4,5,-1,2.21340370565269,4.04110784791163,-1.82770414225894,28,27,1,37,39,-2,54,54,0,4,7,0,0
"12365","MTL","FLA",2011020111,15271,20112012,1,60,1,2,-1,6.39238706441392,4.86029885525932,1.53208820915461,41,31,10,49,43,6,58,57,1,3,3,0,0
"12366","MTL","PHI",2011020122,15273,20112012,1,60,5,1,4,6.74779465025229,4.37208338858909,2.3757112616632,28,22,6,42,38,4,57,57,0,6,5,0,0
"12367","MTL","BOS",2011020125,15274,20112012,0,60,2,1,1,3.20106406066814,3.38829642516794,-0.187232364499799,35,30,5,42,40,2,49,61,-12,4,8,0,0
"12368","MTL","BOS",2011020143,15276,20112012,1,60,4,2,2,4.24103825583006,4.56152640646724,-0.320488150637175,27,28,-1,44,40,4,56,69,-13,7,2,0,0
"12369","MTL","OTT",2011020180,15282,20112012,0,60,2,1,1,4.37983720898046,6.79284067358822,-2.41300346460775,26,34,-8,36,47,-11,45,66,-21,2,4,0,0
"12370","MTL","NYR",2011020188,15283,20112012,0,60,3,5,-2,4.25471624887723,6.20396305975737,-1.94924681088014,28,29,-1,45,38,7,60,44,16,3,10,0,0
"12371","MTL","EDM",2011020206,15286,20112012,1,60,1,3,-2,5.38572946481872,4.04943508698125,1.33629437783748,29,14,15,42,27,15,54,38,16,6,2,0,0
"12372","MTL","ARI",2011020219,15288,20112012,0,61.75,3,2,1,6.09840103526949,4.15478929472738,1.94361174054211,36,34,2,58,47,11,79,64,15,1,2,0,0
"12373","MTL","NSH",2011020235,15290,20112012,0,62.5166666666667,2,1,1,4.76014657935593,3.15809101412957,1.60205556522636,25,26,-1,36,34,2,46,50,-4,4,5,0,0
"12374","MTL","BUF",2011020245,15292,20112012,1,65,2,2,0,2.71018350841337,4.2000555515157,-1.48987204310233,27,32,-5,42,39,3,56,55,1,7,5,0,0
"12375","MTL","CAR",2011020256,15294,20112012,1,60,4,0,4,5.02934342349181,4.83451239642454,0.194831027067266,36,25,11,41,36,5,66,57,9,5,8,0,0
"12376","MTL","NYI",2011020261,15295,20112012,0,60,3,4,-1,2.80930783848739,7.36173904443353,-4.55243120594614,29,33,-4,40,46,-6,56,56,0,4,3,0,0
"12377","MTL","NYR",2011020278,15297,20112012,1,60,4,0,4,4.46326693962328,2.09270622906942,2.37056071055386,31,17,14,45,29,16,65,46,19,8,5,0,0
"12378","MTL","BOS",2011020294,15299,20112012,1,60,0,1,-1,6.68752592292731,1.91316397003175,4.77436195289556,33,18,15,53,29,24,70,41,29,3,1,0,0
"12379","MTL","CAR",2011020305,15301,20112012,0,65,3,3,0,0,0,0,34,33,1,54,43,11,65,57,8,2,4,0,0
"12380","MTL","PHI",2011020315,15303,20112012,0,60,1,3,-2,5.60766108650387,5.20322913046468,0.40443195603919,24,36,-12,41,43,-2,53,61,-8,5,4,0,0
"12381","MTL","PIT",2011020331,15304,20112012,1,62.15,3,4,-1,3.6224434701362,3.96592737875399,-0.343483908617785,27,42,-15,35,53,-18,46,76,-30,4,3,0,0
"12382","MTL","ANA",2011020357,15308,20112012,0,60,1,4,-3,2.11164184089284,4.22036699938485,-2.10872515849201,20,27,-7,34,40,-6,47,61,-14,7,6,0,0
"12383","MTL","S.J",2011020365,15309,20112012,0,65,3,3,0,3.50226948701311,4.55693693237845,-1.05466744536534,32,41,-9,39,53,-14,57,76,-19,1,1,0,0
"12384","MTL","L.A",2011020372,15311,20112012,0,60,2,1,1,4.53018906343675,4.84073511592785,-0.310546052491098,27,27,0,34,34,0,43,49,-6,5,6,0,0
"12385","MTL","CBJ",2011020394,15314,20112012,1,65,2,2,0,3.06104099645745,3.09136542581837,-0.0303244293609168,20,28,-8,34,45,-11,46,60,-14,3,4,0,0
"12386","MTL","VAN",2011020411,15316,20112012,1,65,3,3,0,2.71542558113288,4.19980354908432,-1.48437796795145,23,31,-8,31,39,-8,46,65,-19,4,4,0,0
"12387","MTL","N.J",2011020421,15318,20112012,0,60,2,1,1,2.85154650107143,1.95797686807806,0.893569632993362,24,29,-5,28,38,-10,37,46,-9,5,4,0,0
"12388","MTL","NYI",2011020443,15321,20112012,1,60,5,3,2,5.98120844137156,4.27871952385934,1.70248891751223,29,32,-3,38,43,-5,60,57,3,5,3,0,0
"12389","MTL","PHI",2011020454,15323,20112012,1,60,3,4,-1,5.56534769606034,2.76807856466621,2.79726913139412,31,25,6,42,30,12,60,49,11,9,6,0,0
"12390","MTL","N.J",2011020468,15325,20112012,1,60,3,5,-2,2.61531345184406,4.3898504749009,-1.77453702305683,26,35,-9,35,42,-7,48,65,-17,4,5,0,0
"12391","MTL","BOS",2011020481,15327,20112012,0,60,2,3,-1,4.25799186812947,4.11241595947013,0.145575908659339,35,31,4,40,45,-5,51,58,-7,2,2,0,0
"12392","MTL","CHI",2011020495,15329,20112012,0,60,1,5,-4,2.22326921898639,2.60090550199206,-0.377636283005671,21,28,-7,30,39,-9,35,57,-22,3,2,0,0
"12393","MTL","WPG",2011020504,15330,20112012,0,60,0,4,-4,3.26555192931846,3.91937458756276,-0.653822658244302,27,34,-7,44,45,-1,60,56,4,4,1,0,0
"12394","MTL","OTT",2011020531,15335,20112012,0,60,6,2,4,6.82836911431572,2.56221560892144,4.26615350539428,28,35,-7,38,42,-4,52,56,-4,6,5,0,0
"12395","MTL","T.B",2011020545,15337,20112012,0,60,3,4,-1,5.0018244765257,2.75683982839109,2.2449846481346,34,22,12,45,28,17,69,40,29,3,3,0,0
"12396","MTL","FLA",2011020559,15339,20112012,0,60,2,3,-1,5.90514207639424,7.68364557522128,-1.77850349882704,28,35,-7,41,45,-4,55,54,1,5,8,0,0
"12397","MTL","WPG",2011020580,15343,20112012,1,60,7,3,4,5.95999192365025,3.64060449655517,2.31938742709508,31,27,4,39,42,-3,57,56,1,5,3,0,0
"12398","MTL","T.B",2011020604,15346,20112012,1,60,3,1,2,5.61583157730547,4.42033338127658,1.19549819602889,28,24,4,44,33,11,60,52,8,2,1,0,0
"12399","MTL","STL",2011020622,15349,20112012,1,60,0,3,-3,0,0,0,19,25,-6,31,35,-4,43,53,-10,4,5,0,0
"12400","MTL","BOS",2011020631,15351,20112012,0,60,1,2,-1,4.13048089337245,3.95077751191275,0.179703381459699,34,30,4,40,43,-3,54,57,-3,3,6,0,0
"12401","MTL","OTT",2011020650,15353,20112012,1,65,2,2,0,5.53727346227074,4.22222314713235,1.31505031513838,35,25,10,42,40,2,60,60,0,5,6,0,0
"12402","MTL","NYR",2011020660,15354,20112012,1,60,4,1,3,2.52037044608733,5.20530829737861,-2.68493785129128,29,29,0,39,52,-13,51,70,-19,1,1,0,0
"12403","MTL","WSH",2011020681,15357,20112012,1,60,0,3,-3,5.90776953806494,1.91495834744637,3.99281119061857,31,16,15,47,21,26,72,36,36,6,4,0,0
"12404","MTL","TOR",2011020702,15360,20112012,0,60,3,1,2,4.04556730018033,4.60812455153291,-0.562557251352581,23,33,-10,33,49,-16,48,68,-20,3,3,0,0
"12405","MTL","DET",2011020735,15364,20112012,1,60,7,2,5,3.19143036473542,5.26559464843012,-2.0741642836947,25,28,-3,38,35,3,54,59,-5,3,4,0,0
"12406","MTL","BUF",2011020741,15370,20112012,1,60,1,3,-2,3.03328483784571,6.32559793480323,-3.29231309695751,28,40,-12,36,58,-22,52,79,-27,2,4,0,0
"12407","MTL","N.J",2011020755,15372,20112012,0,60,3,5,-2,3.32430473821504,3.80623665414804,-0.481931915933,30,22,8,30,24,6,36,29,7,3,4,0,0
"12408","MTL","WSH",2011020769,15374,20112012,1,60,0,3,-3,5.94695288091275,2.05486440047389,3.89208848043886,30,23,7,41,29,12,68,45,23,1,5,0,0
"12409","MTL","WPG",2011020782,15375,20112012,1,60,3,0,3,2.63568769885393,4.25700208238095,-1.62131438352702,23,23,0,32,47,-15,50,59,-9,4,5,0,0
"12410","MTL","NYI",2011020802,15379,20112012,0,60,4,2,2,7.74233828607248,4.71375392313348,3.028584362939,32,33,-1,43,46,-3,58,65,-7,1,2,0,0
"12411","MTL","TOR",2011020822,15381,20112012,0,60,5,0,5,2.99587364324179,4.31214096494659,-1.3162673217048,18,32,-14,31,55,-24,44,76,-32,2,5,0,0
"12412","MTL","CAR",2011020835,15383,20112012,1,60,3,5,-2,6.73543450102443,5.94682334974021,0.788611151284215,33,35,-2,44,52,-8,65,71,-6,8,8,0,0
"12413","MTL","BOS",2011020847,15385,20112012,1,65,3,3,0,7.4711176820893,5.47908841492608,1.99202926716321,29,34,-5,35,44,-9,58,61,-3,5,6,0,0
"12414","MTL","BUF",2011020860,15387,20112012,0,65,3,3,0,3.27668721277291,6.0852095621023,-2.80852234932939,19,30,-11,28,43,-15,42,59,-17,3,4,0,0
"12415","MTL","N.J",2011020877,15389,20112012,1,60,1,3,-2,5.17976022879884,5.49090055244938,-0.311140323650534,22,25,-3,34,36,-2,67,51,16,3,0,0,0
"12416","MTL","DAL",2011020889,15391,20112012,1,60,0,3,-3,4.06605014613888,5.37890369399322,-1.31285354785435,31,36,-5,38,48,-10,54,60,-6,4,1,0,0
"12417","MTL","WSH",2011020910,15394,20112012,0,60,1,4,-3,4.0173043206305,4.24272263195598,-0.225418311325484,31,24,7,40,30,10,50,53,-3,4,6,0,0
"12418","MTL","FLA",2011020929,15396,20112012,0,60,2,4,-2,2.09753052896122,4.46515821386754,-2.36762768490632,20,32,-12,32,48,-16,37,57,-20,7,7,0,0
"12419","MTL","T.B",2011020942,15398,20112012,0,60,1,2,-1,3.83998873086782,3.88587181185721,-0.0458830809893982,24,22,2,43,32,11,62,41,21,3,4,0,0
"12420","MTL","MIN",2011020951,15400,20112012,1,65,4,4,0,4.52563861401966,4.37699837314608,0.14864024087358,28,30,-2,44,44,0,58,62,-4,10,7,0,0
"12421","MTL","TOR",2011020966,15402,20112012,1,60,1,3,-2,2.25126643525417,7.46009229272022,-5.20882585746605,22,42,-20,30,52,-22,43,70,-27,3,4,0,0
"12422","MTL","CGY",2011020993,15405,20112012,0,60,4,5,-1,4.73684451275039,4.07101252263828,0.66583199011211,28,34,-6,37,42,-5,51,52,-1,3,3,0,0
"12423","MTL","EDM",2011021008,15407,20112012,0,60,5,3,2,5.31064491948405,4.3761194676481,0.934525451835952,31,27,4,48,35,13,67,46,21,4,4,0,0
"12424","MTL","VAN",2011021024,15409,20112012,0,60,4,1,3,4.55254511097991,4.36864475321545,0.183900357764458,35,33,2,44,47,-3,59,65,-6,6,6,0,0
"12425","MTL","BUF",2011021033,15411,20112012,0,62.0166666666667,2,3,-1,3.35767133231275,6.88440154930473,-3.52673021699198,28,36,-8,34,50,-16,47,62,-15,2,2,0,0
"12426","MTL","OTT",2011021047,15413,20112012,1,65,2,2,0,3.30556191715486,5.93353368903627,-2.6279717718814,26,37,-11,41,49,-8,61,71,-10,4,5,0,0
"12427","MTL","OTT",2011021060,15415,20112012,0,63.1166666666667,1,2,-1,1.51180069443123,6.78072972601285,-5.26892903158162,14,33,-19,17,54,-37,28,79,-51,5,10,0,0
"12428","MTL","NYI",2011021068,15416,20112012,1,65,2,2,0,5.06574341416854,5.95010752187227,-0.884364107703732,30,38,-8,40,51,-11,59,70,-11,5,4,0,0
"12429","MTL","BUF",2011021097,15420,20112012,0,60,0,3,-3,3.76275923998332,2.58655119088505,1.17620804909827,34,31,3,44,40,4,55,50,5,3,7,0,0
"12430","MTL","OTT",2011021114,15422,20112012,1,60,5,1,4,6.32378237563466,8.54024301296454,-2.21646063732987,32,38,-6,39,52,-13,48,67,-19,11,6,0,0
"12431","MTL","PHI",2011021121,15423,20112012,0,60,1,4,-3,6.68372819869546,4.65260876372076,2.0311194349747,24,33,-9,37,47,-10,46,68,-22,6,6,0,0
"12432","MTL","FLA",2011021145,15426,20112012,1,65,2,2,0,4.42999050481012,6.18926962895785,-1.75927912414772,29,36,-7,37,50,-13,48,70,-22,2,3,0,0
"12433","MTL","NYR",2011021161,15429,20112012,0,60,1,4,-3,2.85654761067053,2.49554454098688,0.361003069683647,20,29,-9,29,33,-4,47,45,2,3,4,0,0
"12434","MTL","WSH",2011021172,15430,20112012,0,65,2,2,0,5.16558756084123,6.3158679476453,-1.15028038680407,41,33,8,52,48,4,68,68,0,4,5,0,0
"12435","MTL","T.B",2011021199,15434,20112012,1,60,5,2,3,4.77176759256326,3.74799570127493,1.02377189128833,25,16,9,31,26,5,53,41,12,5,4,0,0
"12436","MTL","CAR",2011021206,15435,20112012,0,65,1,1,0,7.31626755748584,5.79727658160045,1.5189909758854,31,29,2,45,41,4,60,52,8,7,7,0,0
"12437","MTL","TOR",2011021222,15437,20112012,1,60,4,1,3,8.56033502414357,3.59612441106377,4.9642106130798,27,31,-4,40,43,-3,47,64,-17,4,6,0,0
"12438","MTL","TOR",2012020005,15724,20122013,1,60,1,2,-1,4.68317480461033,4.38014957054111,0.303025234069228,22,26,-4,34,33,1,48,43,5,5,5,0,0
"12439","MTL","FLA",2012020029,15727,20122013,1,60,4,1,3,5.88592963668452,5.89858423639089,-0.0126545997063658,33,28,5,47,38,9,59,48,11,7,8,0,0
"12440","MTL","WSH",2012020042,15729,20122013,0,60,4,1,3,3.63403856474906,2.9690929529589,0.664945611790159,22,31,-9,30,47,-17,40,66,-26,6,4,0,0
"12441","MTL","N.J",2012020067,15732,20122013,1,64.3666666666667,4,3,1,3.60998756746267,3.7158473539817,-0.105859786519034,32,25,7,47,38,9,61,45,16,5,4,0,0
"12442","MTL","WPG",2012020081,15734,20122013,1,60,4,3,1,3.70254552447559,2.73818074483583,0.964364779639759,26,21,5,38,33,5,49,49,0,6,7,0,0
"12443","MTL","OTT",2012020088,15735,20122013,0,60,1,5,-4,3.70831437118678,4.46608849651511,-0.757774125328332,32,27,5,44,36,8,63,51,12,9,8,0,0
"12444","MTL","BUF",2012020109,15738,20122013,1,60,6,1,5,5.69543516828594,5.56645123321596,0.128983935069982,32,31,1,49,42,7,61,52,9,8,6,0,0
"12445","MTL","OTT",2012020120,15739,20122013,1,60,2,1,1,4.1274768175208,5.5600803568534,-1.4326035393326,32,33,-1,48,43,5,60,68,-8,6,4,0,0
"12446","MTL","BOS",2012020138,15742,20122013,1,60,1,2,-1,3.89696546539199,5.58086271239761,-1.68389724700562,21,23,-2,28,33,-5,52,45,7,7,5,0,0
"12447","MTL","BUF",2012020141,15743,20122013,0,65,4,4,0,5.95722365191506,6.13129761460004,-0.174073962684986,32,40,-8,42,56,-14,53,68,-15,5,8,0,0
"12448","MTL","TOR",2012020160,15745,20122013,1,60,0,6,-6,6.70567090528141,3.19395517764497,3.51171572763644,37,28,9,51,37,14,67,55,12,8,10,0,0
"12449","MTL","T.B",2012020181,15748,20122013,0,65,3,3,0,3.26079368178034,3.38890233754557,-0.128108655765232,34,24,10,47,32,15,58,47,11,8,6,0,0
"12450","MTL","FLA",2012020194,15750,20122013,0,62.1666666666667,1,0,1,2.9888374695438,3.27904694441531,-0.290209474871517,32,26,6,38,34,4,48,46,2,3,2,0,0
"12451","MTL","PHI",2012020206,15752,20122013,1,60,4,1,3,3.57729566817386,2.25548073939657,1.32181492877729,29,19,10,39,31,8,56,42,14,5,5,0,0
"12452","MTL","CAR",2012020222,15754,20122013,1,60,3,0,3,5.55325774871744,4.09385569389997,1.45940205481747,26,19,7,35,30,5,50,40,10,5,4,0,0
"12453","MTL","NYR",2012020227,15755,20122013,0,60,3,1,2,3.52481935385731,3.1952503741195,0.329568979737815,18,25,-7,28,37,-9,48,53,-5,1,2,0,0
"12454","MTL","NYI",2012020241,15757,20122013,1,63.2,3,4,-1,3.55100752803264,2.9271723969141,0.62383513111854,33,25,8,41,31,10,63,55,8,6,5,0,0
"12455","MTL","NYR",2012020255,15759,20122013,1,60,3,0,3,2.76354937236374,1.71683765909984,1.0467117132639,18,17,1,35,34,1,54,52,2,5,3,0,0
"12456","MTL","OTT",2012020271,15761,20122013,0,65,1,1,0,4.72663412816473,3.98333313316726,0.743300994997478,45,24,21,56,33,23,68,42,26,4,1,0,0
"12457","MTL","TOR",2012020284,15763,20122013,0,60,5,2,3,8.34074756409973,5.63915791967884,2.70158964442089,40,23,17,56,38,18,74,56,18,0,1,0,0
"12458","MTL","BOS",2012020316,15767,20122013,0,60,4,3,1,4.79041523009073,6.15891983385063,-1.3685046037599,26,34,-8,34,49,-15,48,69,-21,6,3,0,0
"12459","MTL","NYI",2012020325,15769,20122013,0,60,3,6,-3,3.69825021293946,3.51165192585904,0.186598287080415,32,24,8,42,30,12,60,45,15,5,5,0,0
"12460","MTL","CAR",2012020344,15771,20122013,0,60,4,2,2,2.11384486648603,3.8259659955952,-1.71212112910916,28,43,-15,35,56,-21,47,70,-23,8,7,0,0
"12461","MTL","T.B",2012020361,15773,20122013,0,60,4,3,1,5.21629209015191,3.24109639567905,1.97519569447286,29,23,6,43,27,16,55,41,14,4,3,0,0
"12462","MTL","FLA",2012020367,15774,20122013,0,60,5,2,3,5.04238421602713,3.41690554283559,1.62547867319154,38,17,21,55,23,32,62,33,29,7,2,0,0
"12463","MTL","OTT",2012020388,15777,20122013,1,65,3,3,0,5.84649345441721,4.31430288463525,1.53219056978196,45,32,13,58,42,16,80,64,16,7,5,0,0
"12464","MTL","N.J",2012020410,15780,20122013,0,60,2,1,1,2.87365548335947,2.98113294858032,-0.107477465220853,22,33,-11,29,41,-12,36,56,-20,3,3,0,0
"12465","MTL","BUF",2012020433,15783,20122013,1,62.2666666666667,2,3,-1,5.95397120206076,2.87499314179877,3.07897806026199,34,21,13,58,26,32,81,37,44,2,4,0,0
"12466","MTL","NYI",2012020444,15785,20122013,0,60,5,2,3,2.70569409185555,6.03598027435464,-3.33028618249909,29,27,2,40,40,0,49,60,-11,4,4,0,0
"12467","MTL","BUF",2012020460,15787,20122013,1,60,1,2,-1,7.51026435792664,3.14416571224592,4.36609864568072,39,18,21,54,22,32,85,31,54,3,3,0,0
"12468","MTL","BOS",2012020488,15791,20122013,0,65,5,5,0,4.32758409714934,5.9362918489845,-1.60870775183515,28,41,-13,37,51,-14,51,67,-16,7,5,0,0
"12469","MTL","NYR",2012020512,15794,20122013,1,60,3,0,3,3.35072755737929,4.78795567633642,-1.43722811895714,26,34,-8,42,48,-6,58,72,-14,2,1,0,0
"12470","MTL","CAR",2012020524,15796,20122013,1,60,4,1,3,3.70312209400024,4.30880432248523,-0.605682228484994,29,19,10,41,39,2,54,58,-4,3,5,0,0
"12471","MTL","PHI",2012020539,15798,20122013,0,60,3,5,-2,1.80847639540298,3.39332864957808,-1.58485225417511,17,34,-17,29,38,-9,42,48,-6,4,4,0,0
"12472","MTL","WPG",2012020547,15799,20122013,1,60,4,1,3,3.71308249630965,5.334692073724,-1.62160957741435,24,34,-10,29,41,-12,45,68,-23,3,4,0,0
"12473","MTL","BOS",2012020562,15801,20122013,1,60,2,1,1,4.39863424397481,6.86833493322774,-2.46970068925293,29,27,2,43,41,2,56,64,-8,2,2,0,0
"12474","MTL","WSH",2012020585,15804,20122013,1,60,2,3,-1,5.49783681867484,7.52996233326849,-2.03212551459364,29,27,2,42,36,6,76,46,30,1,1,0,0
"12475","MTL","BUF",2012020597,15806,20122013,0,60,5,1,4,6.0041742704557,2.04084803781006,3.96332623264564,42,15,27,55,22,33,69,35,34,8,3,0,0
"12476","MTL","TOR",2012020612,15808,20122013,0,60,1,5,-4,3.70473968230152,5.57665937556885,-1.87191969326733,37,28,9,55,39,16,77,49,28,5,6,0,0
"12477","MTL","PHI",2012020626,15810,20122013,1,60,3,7,-4,4.81247333557522,4.97126836335572,-0.158795027780503,28,33,-5,44,40,4,62,47,15,10,7,0,0
"12478","MTL","T.B",2012020646,15813,20122013,1,60,3,2,1,3.62386807108851,4.26958675530041,-0.6457186842119,35,34,1,47,49,-2,64,62,2,6,2,0,0
"12479","MTL","WSH",2012020662,15815,20122013,1,60,1,5,-4,5.89777571900294,4.8622978622152,1.03547785678774,36,25,11,50,32,18,72,50,22,6,4,0,0
"12480","MTL","N.J",2012020681,15818,20122013,0,60,2,3,-1,1.84140857905004,3.47832771646324,-1.6369191374132,21,24,-3,25,29,-4,29,38,-9,4,4,0,0
"12481","MTL","WPG",2012020700,15820,20122013,0,60,4,2,2,5.74647971976083,1.27080176313757,4.47567795662326,30,25,5,47,35,12,65,47,18,5,3,0,0
"12482","MTL","TOR",2012020708,15822,20122013,0,60,4,1,3,2.84224606189214,1.69191392728885,1.15033213460329,28,17,11,45,33,12,62,48,14,7,8,0,0
"12483","MTL","OTT",2012030121,15827,20122013,1,60,2,4,-2,9.68971631592296,4.34217949251297,5.34753682340999,50,31,19,61,36,25,80,57,23,4,3,0,0
"12484","MTL","OTT",2012030122,15828,20122013,1,60,3,1,2,4.20625871515018,3.50120171828894,0.705056996861244,34,30,4,47,37,10,59,71,-12,4,6,0,0
"12485","MTL","OTT",2012030123,15830,20122013,0,60,1,6,-5,5.3959196124405,4.27815945310142,1.11776015933908,34,30,4,43,48,-5,54,59,-5,11,17,0,0
"12486","MTL","OTT",2012030124,15832,20122013,0,62.5333333333333,2,3,-1,6.97629779548879,7.48680245107971,-0.510504655590921,28,34,-6,40,49,-9,61,63,-2,1,3,0,0
"12487","MTL","OTT",2012030125,15834,20122013,1,60,1,6,-5,3.82436125930246,7.23164172056568,-3.40728046126321,34,29,5,48,42,6,59,60,-1,6,6,0,0
"12488","MTL","TOR",2013020001,15979,20132014,1,60,3,4,-1,4.26553568610325,4.45449228904435,-0.188956602941097,37,38,-1,53,46,7,70,61,9,6,8,0,0
"12489","MTL","PHI",2013020023,15983,20132014,1,60,4,1,3,5.52349878801033,2.78190767798523,2.7415911100251,34,23,11,51,36,15,75,48,27,11,7,0,0
"12490","MTL","CGY",2013020046,15987,20132014,0,60,2,3,-1,6.53893977947882,4.63440088473726,1.90453889474156,35,25,10,49,34,15,63,50,13,3,3,0,0
"12491","MTL","EDM",2013020055,15988,20132014,0,60,4,1,3,3.27363143095882,2.80190928839147,0.471722142567351,27,28,-1,38,38,0,59,59,0,2,4,0,0
"12492","MTL","VAN",2013020073,15990,20132014,0,60,4,1,3,7.72722339555912,4.33999833349662,3.3872250620625,39,40,-1,53,51,2,69,68,1,4,3,0,0
"12493","MTL","WPG",2013020091,15993,20132014,0,60,3,0,3,4.9121935149351,7.94930389384854,-3.03711037891344,25,36,-11,41,53,-12,51,79,-28,6,4,0,0
"12494","MTL","CBJ",2013020100,15995,20132014,1,60,5,3,2,5.17004569031269,4.44556635257322,0.724479337739467,36,33,3,44,44,0,57,60,-3,4,6,0,0
"12495","MTL","NSH",2013020113,15997,20132014,1,60,1,2,-1,3.80121195179913,6.17541814331548,-2.37420619151635,29,37,-8,36,49,-13,54,59,-5,6,7,0,0
"12496","MTL","EDM",2013020132,16000,20132014,1,60,3,4,-1,4.64806576080058,3.9406543009971,0.707411459803481,32,32,0,44,39,5,74,57,17,5,4,0,0
"12497","MTL","ANA",2013020142,16002,20132014,1,60,4,1,3,6.009107146936,4.56814452569506,1.44096262124094,25,32,-7,40,41,-1,61,58,3,6,3,0,0
"12498","MTL","S.J",2013020157,16004,20132014,1,60,0,2,-2,4.93586563663672,5.83005014449736,-0.894184507860643,22,37,-15,31,52,-21,43,70,-27,1,4,0,0
"12499","MTL","NYR",2013020173,16006,20132014,0,60,2,0,2,2.90106677366788,1.75198206735801,1.14908470630987,27,27,0,35,36,-1,46,64,-18,7,6,0,0
"12500","MTL","DAL",2013020178,16007,20132014,1,60,2,1,1,2.71391217492055,3.25930661798463,-0.545394443064083,24,27,-3,39,35,4,50,64,-14,4,2,0,0
"12501","MTL","MIN",2013020196,16010,20132014,0,60,3,4,-1,6.65852725643432,5.5238104085438,1.13471684789052,31,25,6,48,33,15,69,49,20,2,1,0,0
"12502","MTL","COL",2013020209,16011,20132014,0,60,1,4,-3,3.95766153582372,5.12792312103556,-1.17026158521185,30,31,-1,38,46,-8,53,54,-1,3,2,0,0
"12503","MTL","STL",2013020220,16014,20132014,1,65,2,2,0,1.44499267772403,4.87594538103167,-3.43095270330764,27,32,-5,32,41,-9,43,79,-36,2,4,0,0
"12504","MTL","OTT",2013020231,16016,20132014,0,60,1,4,-3,2.32423700993641,4.60862390651891,-2.2843868965825,34,24,10,50,32,18,68,54,14,7,7,0,0
"12505","MTL","NYI",2013020255,16019,20132014,1,60,4,2,2,7.10092316300143,3.4846168545543,3.61630630844712,31,26,5,46,37,9,59,60,-1,4,4,0,0
"12506","MTL","T.B",2013020268,16021,20132014,1,65,1,1,0,3.30488182738191,6.55951625380358,-3.25463442642168,29,45,-16,46,55,-9,61,80,-19,3,4,0,0
"12507","MTL","CBJ",2013020288,16024,20132014,0,65,2,2,0,6.40966583182308,5.94500898409751,0.464656847725564,40,25,15,52,38,14,67,52,15,5,4,0,0
"12508","MTL","NYR",2013020295,16025,20132014,1,60,0,1,-1,3.94927379947126,6.75606916222023,-2.80679536274897,22,34,-12,35,52,-17,56,67,-11,2,3,0,0
"12509","MTL","MIN",2013020315,16028,20132014,1,60,6,2,4,4.20847908902215,3.04235388736285,1.1661252016593,28,27,1,40,33,7,52,56,-4,5,3,0,0
"12510","MTL","WSH",2013020337,16031,20132014,0,60,3,2,1,2.61901930955355,3.26404186649233,-0.645022556938784,31,27,4,42,49,-7,57,66,-9,5,2,0,0
"12511","MTL","BUF",2013020365,16036,20132014,0,60,3,1,2,5.91548297082772,3.54704115488937,2.36844181593835,31,25,6,39,36,3,53,49,4,4,1,0,0
"12512","MTL","WSH",2013020386,16038,20132014,0,65,2,2,0,5.58361088348277,3.43140806357405,2.15220281990872,37,26,11,48,38,10,61,54,7,3,5,0,0
"12513","MTL","TOR",2013020394,16039,20132014,1,60,4,2,2,0,0,0,39,36,3,50,43,7,61,61,0,3,5,0,0
"12514","MTL","N.J",2013020407,16041,20132014,1,60,3,2,1,2.27008708584909,4.01146421532214,-1.74137712947305,17,30,-13,26,41,-15,39,63,-24,2,3,0,0
"12515","MTL","N.J",2013020419,16043,20132014,0,65,3,3,0,4.68477425585185,4.0435050978686,0.641269157983245,30,34,-4,38,50,-12,44,64,-20,3,2,0,0
"12516","MTL","BOS",2013020425,16044,20132014,1,60,2,1,1,5.41693627217319,7.1424078362179,-1.72547156404471,27,33,-6,36,46,-10,51,68,-17,4,2,0,0
"12517","MTL","BUF",2013020439,16046,20132014,1,60,3,2,1,2.96498372552742,3.84117343864636,-0.876189713118947,19,25,-6,29,32,-3,41,48,-7,1,1,0,0
"12518","MTL","L.A",2013020461,16049,20132014,1,60,0,6,-6,4.97199048567563,5.18733488135279,-0.215344395677157,31,30,1,47,43,4,63,62,1,5,3,0,0
"12519","MTL","PHI",2013020474,16051,20132014,0,60,1,2,-1,4.58107727711504,3.54587792836537,1.03519934874966,21,27,-6,28,41,-13,43,65,-22,3,5,0,0
"12520","MTL","NYI",2013020493,16053,20132014,0,61.85,1,0,1,4.62536591810931,1.60779839759925,3.01756752051006,25,21,4,38,24,14,56,47,9,3,4,0,0
"12521","MTL","FLA",2013020501,16054,20132014,1,60,1,2,-1,3.93676453194348,3.9564961187406,-0.0197315867971168,18,25,-7,30,35,-5,52,54,-2,4,2,0,0
"12522","MTL","ARI",2013020513,16056,20132014,1,60,3,1,2,6.43547352426685,3.43587684934027,2.99959667492658,28,27,1,44,43,1,58,70,-12,4,4,0,0
"12523","MTL","STL",2013020530,16058,20132014,0,60,1,5,-4,3.65966575406492,3.90551681437978,-0.245851060314862,26,29,-3,31,36,-5,44,52,-8,5,7,0,0
"12524","MTL","NSH",2013020548,16060,20132014,0,61.7166666666667,4,3,1,3.12277081444336,7.38033707617433,-4.25756626173097,23,34,-11,34,47,-13,42,61,-19,2,2,0,0
"12525","MTL","T.B",2013020578,16067,20132014,0,65,1,1,0,3.89980662119342,3.84105521661695,0.0587514045764692,21,24,-3,41,38,3,51,55,-4,3,3,0,0
"12526","MTL","FLA",2013020586,16068,20132014,0,60,1,4,-3,1.92499653563891,3.74388684320729,-1.81889030756838,22,25,-3,32,38,-6,41,52,-11,4,4,0,0
"12527","MTL","CAR",2013020603,16070,20132014,0,63.45,4,5,-1,2.67876156994816,7.35215530422213,-4.67339373427396,25,42,-17,36,66,-30,45,100,-55,7,10,0,0
"12528","MTL","DAL",2013020618,16072,20132014,0,60,6,4,2,5.38320354582905,2.97841393642011,2.40478960940894,28,32,-4,42,51,-9,56,72,-16,5,5,0,0
"12529","MTL","OTT",2013020630,16074,20132014,1,60.9666666666667,3,4,-1,2.28369695844594,5.7798947384581,-3.49619778001215,29,34,-5,40,42,-2,53,61,-8,5,4,0,0
"12530","MTL","FLA",2013020645,16076,20132014,1,60,2,1,1,5.63694852535446,5.45940189016983,0.177546635184626,35,27,8,44,39,5,56,65,-9,3,3,0,0
"12531","MTL","PHI",2013020657,16078,20132014,0,60,1,3,-2,5.57150315381256,2.99485311823082,2.57665003558174,20,27,-7,31,39,-8,52,50,2,4,4,0,0
"12532","MTL","CHI",2013020676,16081,20132014,1,61.4666666666667,2,1,1,5.97858884917139,1.72715872752087,4.25143012165051,38,20,18,50,28,22,65,45,20,3,1,0,0
"12533","MTL","N.J",2013020700,16084,20132014,1,60,1,4,-3,4.04280454553811,2.83460478872121,1.2081997568169,30,19,11,44,35,9,57,50,7,3,3,0,0
"12534","MTL","OTT",2013020712,16086,20132014,0,60.3833333333333,5,4,1,3.32241272361716,3.98348530488392,-0.661072581266759,23,44,-21,33,53,-20,41,67,-26,1,1,0,0
"12535","MTL","TOR",2013020727,16088,20132014,0,60,3,5,-2,5.05905228381744,6.14363183293608,-1.08457954911864,33,30,3,50,40,10,67,53,14,4,3,0,0
"12536","MTL","DET",2013020771,16094,20132014,0,60,1,4,-3,3.83208753775671,3.13363721807036,0.698450319686344,31,26,5,41,39,2,51,48,3,5,7,0,0
"12537","MTL","WSH",2013020777,16095,20132014,1,60,0,5,-5,4.54862035509996,4.59855306497775,-0.049932709877794,21,34,-13,32,44,-12,52,60,-8,4,7,0,0
"12538","MTL","CAR",2013020800,16098,20132014,1,60,3,0,3,3.30609034224317,8.41127479415811,-5.10518445191494,30,36,-6,38,48,-10,48,75,-27,2,3,0,0
"12539","MTL","BOS",2013020809,16100,20132014,0,60,4,1,3,5.16500457026268,5.7768537088632,-0.611849138600519,33,35,-2,45,46,-1,58,62,-4,5,4,0,0
"12540","MTL","T.B",2013020825,16102,20132014,1,64.6,1,2,-1,5.6457040688706,6.77144865400442,-1.12574458513382,29,36,-7,42,48,-6,54,67,-13,6,6,0,0
"12541","MTL","WPG",2013020836,16103,20132014,1,60,1,2,-1,4.43140682356898,7.3861557585642,-2.95474893499522,31,35,-4,42,46,-4,63,69,-6,7,8,0,0
"12542","MTL","CGY",2013020847,16105,20132014,1,60,2,0,2,6.78920187731273,5.51410686489544,1.2750950124173,27,27,0,42,40,2,62,63,-1,3,4,0,0
"12543","MTL","VAN",2013020860,16107,20132014,1,60,5,2,3,6.33044413512208,7.61392204543517,-1.2834779103131,29,44,-15,38,55,-17,52,74,-22,3,5,0,0
"12544","MTL","CAR",2013020876,16109,20132014,0,60,4,1,3,2.57202826847788,5.34503764181864,-2.77300937334076,24,32,-8,32,50,-18,42,70,-28,1,2,0,0
"12545","MTL","DET",2013020883,16127,20132014,1,64.5333333333333,1,2,-1,3.76573034690227,4.81881921715103,-1.05308887024876,20,30,-10,31,42,-11,53,62,-9,3,2,0,0
"12546","MTL","TOR",2013020909,16130,20132014,1,63.4666666666667,4,3,1,5.91469811286943,3.49386559569393,2.4208325171755,30,25,5,45,32,13,59,53,6,6,4,0,0
"12547","MTL","L.A",2013020923,16132,20132014,0,60,1,2,-1,3.13121059870173,4.08382106088243,-0.952610462180701,18,22,-4,31,40,-9,36,56,-20,3,4,0,0
"12548","MTL","ANA",2013020937,16134,20132014,0,65,3,3,0,4.56635609191036,5.70451214819809,-1.13815605628773,31,42,-11,53,60,-7,68,76,-8,5,6,0,0
"12549","MTL","ARI",2013020945,16135,20132014,0,60,2,5,-3,4.10291342146229,4.66305997993913,-0.560146558476845,26,23,3,35,32,3,52,43,9,5,3,0,0
"12550","MTL","S.J",2013020962,16137,20132014,0,60,0,4,-4,2.56507550838745,5.0237190164038,-2.45864350801636,27,33,-6,33,45,-12,47,57,-10,8,9,0,0
"12551","MTL","BOS",2013020985,16141,20132014,1,60,1,4,-3,5.06004451867193,5.69522970894101,-0.635185190269076,36,32,4,55,38,17,73,51,22,4,3,0,0
"12552","MTL","OTT",2013021006,16144,20132014,1,61.4333333333333,5,4,1,6.11372774840856,5.81918801912241,0.294539729286157,48,34,14,61,47,14,86,61,25,8,4,0,0
"12553","MTL","BUF",2013021018,16145,20132014,0,60,2,0,2,4.3400750396213,4.18630815888901,0.153766880732292,32,29,3,42,35,7,51,46,5,4,3,0,0
"12554","MTL","COL",2013021030,16147,20132014,1,60,6,3,3,5.43064080250042,4.36599499642796,1.06464580607246,36,28,8,47,39,8,62,58,4,3,3,0,0
"12555","MTL","CBJ",2013021044,16149,20132014,1,60,2,3,-1,2.34113103931438,6.6824725985813,-4.34134155926692,27,40,-13,35,60,-25,53,83,-30,4,7,0,0
"12556","MTL","TOR",2013021060,16151,20132014,0,60,4,3,1,7.61489516685833,6.48568918972887,1.12920597712946,36,36,0,50,50,0,62,73,-11,2,2,0,0
"12557","MTL","BOS",2013021075,16153,20132014,0,65,1,1,0,2.93824234917044,2.81700516608566,0.121237183084779,22,29,-7,32,45,-13,47,65,-18,6,6,0,0
"12558","MTL","BUF",2013021083,16154,20132014,1,60,2,0,2,6.73521562403766,2.69311068168543,4.04210494235224,35,24,11,42,30,12,61,46,15,7,4,0,0
"12559","MTL","DET",2013021095,16156,20132014,0,60,5,4,1,5.10214040928986,2.23404240819218,2.86809800109768,29,30,-1,37,42,-5,47,52,-5,4,3,0,0
"12560","MTL","FLA",2013021112,16158,20132014,0,60,4,1,3,2.99130345909651,3.55197079558414,-0.560667336487623,19,37,-18,29,51,-22,34,63,-29,6,5,0,0
"12561","MTL","T.B",2013021135,16161,20132014,0,60,1,3,-2,3.59521439701348,2.98605193087519,0.609162466138287,26,33,-7,37,47,-10,46,63,-17,5,8,0,0
"12562","MTL","OTT",2013021153,16164,20132014,0,60,7,4,3,3.97745385677266,6.55616085218123,-2.57870699540857,23,43,-20,27,64,-37,30,78,-48,6,7,0,0
"12563","MTL","DET",2013021164,16165,20132014,1,60,5,3,2,4.32925778767094,5.07388874148558,-0.744630953814641,26,37,-11,31,49,-18,43,67,-24,4,6,0,0
"12564","MTL","CHI",2013021190,16169,20132014,0,60.7166666666667,2,3,-1,3.04744699766161,4.43580948357703,-1.38836248591542,30,28,2,37,36,1,44,60,-16,0,2,0,0
"12565","MTL","NYI",2013021196,16170,20132014,1,60,0,2,-2,2.99439552373951,5.40651435116888,-2.41211882742937,19,30,-11,27,48,-21,45,71,-26,4,1,0,0
"12566","MTL","NYR",2013021214,16172,20132014,1,62.0666666666667,1,0,1,3.47616736171949,6.07642703040906,-2.60025966868957,27,41,-14,40,54,-14,57,66,-9,6,5,0,0
"12567","MTL","T.B",2013030121,16176,20132014,0,78.1333333333333,5,4,1,7.25740269123025,4.88293936394621,2.37446332728405,44,25,19,61,41,20,74,52,22,3,3,0,0
"12568","MTL","T.B",2013030122,16178,20132014,0,60,4,1,3,4.49740704279975,3.86458846075402,0.632818582045729,26,27,-1,38,37,1,47,51,-4,5,5,0,0
"12569","MTL","T.B",2013030123,16180,20132014,1,60,3,2,1,4.6603737634141,5.31224089565585,-0.65186713224175,31,29,2,45,32,13,60,53,7,5,3,0,0
"12570","MTL","T.B",2013030124,16182,20132014,1,60,4,3,1,5.36877398774959,3.95106170605868,1.41771228169091,37,23,14,49,40,9,66,63,3,2,1,0,0
"12571","MTL","BOS",2013030211,16191,20132014,0,80,3,3,0,8.53721156940901,7.37551358920609,1.16169798020292,29,50,-21,40,66,-26,52,96,-44,3,3,0,0
"12572","MTL","BOS",2013030212,16193,20132014,0,60,3,5,-2,5.77379609322776,5.21509563327618,0.558700459951585,28,35,-7,40,46,-6,54,63,-9,9,6,0,0
"12573","MTL","BOS",2013030213,16196,20132014,1,60,4,2,2,5.35221623361576,3.01163373383497,2.34058249978079,26,28,-2,33,38,-5,53,67,-14,1,1,0,0
"12574","MTL","BOS",2013030214,16198,20132014,1,61.3166666666667,0,1,-1,3.01702844974352,5.57081813663899,-2.55378968689547,33,35,-2,43,49,-6,55,69,-14,1,2,0,0
"12575","MTL","BOS",2013030215,16200,20132014,0,60,2,4,-2,4.82536990765948,3.957031616721,0.868338290938482,31,30,1,42,42,0,60,58,2,6,5,0,0
"12576","MTL","BOS",2013030216,16202,20132014,1,60,4,0,4,5.73327497670519,5.6571132698773,0.0761617068278886,28,26,2,41,43,-2,58,63,-5,7,5,0,0
"12577","MTL","BOS",2013030217,16204,20132014,0,60,3,1,2,2.43465721614664,2.90516545627969,-0.470508240133055,18,30,-12,32,40,-8,47,54,-7,6,4,0,0
"12578","MTL","NYR",2013030311,16207,20132014,1,60,2,7,-5,3.42651302251033,3.91799856431317,-0.491485541802831,22,28,-6,29,41,-12,52,62,-10,3,7,0,0
"12579","MTL","NYR",2013030312,16209,20132014,1,60,1,3,-2,4.6830213538413,7.94013609144818,-3.25711473760689,41,30,11,63,36,27,80,44,36,6,5,0,0
"12580","MTL","NYR",2013030313,16212,20132014,0,61.2,3,2,1,6.38702457337602,6.44867759628788,-0.0616530229118535,25,37,-12,38,53,-15,53,75,-22,2,2,0,0
"12581","MTL","NYR",2013030314,16215,20132014,0,66.0333333333333,2,3,-1,4.12509771020268,5.71307437583701,-1.58797666563433,29,29,0,42,39,3,56,56,0,9,4,0,0
"12582","MTL","NYR",2013030315,16217,20132014,1,60,7,4,3,4.48529940404465,3.28415967547039,1.20113972857426,28,27,1,40,37,3,47,56,-9,7,11,0,0
"12583","MTL","NYR",2013030316,16219,20132014,0,60,0,1,-1,1.87481940202497,3.50823589025822,-1.63341648823325,18,32,-14,26,42,-16,36,58,-22,2,4,0,0
"12584","MTL","TOR",2014020001,16351,20142015,0,60,4,3,1,5.19061422754252,2.77634502560858,2.41426920193394,32,27,5,47,37,10,58,57,1,2,2,0,0
"12585","MTL","WSH",2014020008,16352,20142015,0,65,1,1,0,3.11243566925884,4.38111282704159,-1.26867715778275,24,30,-6,30,45,-15,46,65,-19,7,7,0,0
"12586","MTL","PHI",2014020024,16354,20142015,0,65,3,3,0,5.76901263780792,5.24371038173411,0.525302256073805,38,32,6,59,42,17,91,66,25,4,6,0,0
"12587","MTL","BOS",2014020053,16359,20142015,1,60,6,4,2,4.8044481741963,7.57083530091759,-2.7663871267213,26,29,-3,33,41,-8,49,60,-11,4,4,0,0
"12588","MTL","COL",2014020064,16361,20142015,1,60,3,2,1,8.6699219527776,4.14497385348659,4.52494809929101,36,34,2,52,40,12,75,55,20,3,4,0,0
"12589","MTL","DET",2014020082,16364,20142015,1,60.9333333333333,2,1,1,8.16241275283392,3.54244971470325,4.61996303813066,36,28,8,43,36,7,60,55,5,2,4,0,0
"12590","MTL","NYR",2014020108,16368,20142015,1,60,3,1,2,4.43937443150207,4.41884741889953,0.0205270126025425,30,35,-5,39,48,-9,51,68,-17,1,2,0,0
"12591","MTL","EDM",2014020123,16370,20142015,0,60,0,3,-3,0,0,0,29,19,10,40,30,10,61,43,18,4,6,0,0
"12592","MTL","CGY",2014020134,16371,20142015,0,65,1,1,0,4.75816797143489,4.7751699401415,-0.0170019687066087,19,38,-19,30,54,-24,47,70,-23,5,9,0,0
"12593","MTL","VAN",2014020147,16373,20142015,0,62.75,2,3,-1,2.76307465938919,4.56284598546335,-1.79977132607417,25,30,-5,36,45,-9,49,60,-11,3,2,0,0
"12594","MTL","CGY",2014020166,16376,20142015,1,60,2,6,-4,0,0,0,20,36,-16,31,47,-16,57,65,-8,3,8,0,0
"12595","MTL","CHI",2014020177,16378,20142015,1,60,0,5,-5,4.30927388387499,7.22307175263995,-2.91379786876496,28,32,-4,35,46,-11,50,70,-20,6,5,0,0
"12596","MTL","BUF",2014020184,16379,20142015,0,65,1,1,0,6.23426742968149,2.47492241301813,3.75934501666336,32,32,0,45,41,4,59,48,11,1,4,0,0
"12597","MTL","MIN",2014020205,16382,20142015,1,60,4,1,3,4.28033624718046,5.60119124982157,-1.32085500264111,31,31,0,36,46,-10,45,70,-25,3,4,0,0
"12598","MTL","WPG",2014020224,16385,20142015,1,60,3,0,3,4.33206201213761,5.89554625100118,-1.56348423886357,27,29,-2,33,44,-11,43,67,-24,4,3,0,0
"12599","MTL","BOS",2014020235,16387,20142015,1,60,5,1,4,5.36423136666417,2.84613187066861,2.51809949599556,34,22,12,45,27,18,57,51,6,7,4,0,0
"12600","MTL","PHI",2014020252,16389,20142015,1,60,6,3,3,4.68955796912633,5.69557227491168,-1.00601430578536,28,29,-1,38,44,-6,49,67,-18,3,5,0,0
"12601","MTL","DET",2014020262,16390,20142015,0,60,4,1,3,4.69033129280433,3.44773258343048,1.24259870937385,19,29,-10,31,43,-12,37,56,-19,5,7,0,0
"12602","MTL","STL",2014020282,16394,20142015,1,60,4,1,3,3.63824259239482,6.10660484991422,-2.4683622575194,30,32,-2,40,44,-4,57,56,1,2,0,0,0
"12603","MTL","BOS",2014020296,16396,20142015,0,60,2,0,2,3.88501216191798,5.91449822057189,-2.0294860586539,23,33,-10,34,49,-15,44,64,-20,3,2,0,0
"12604","MTL","NYR",2014020309,16397,20142015,0,60,0,5,-5,2.89430133559007,2.58248504360654,0.311816291983533,21,34,-13,36,44,-8,47,61,-14,3,4,0,0
"12605","MTL","BUF",2014020337,16402,20142015,0,60,1,2,-1,3.53003989475019,3.8282203694107,-0.298180474660512,31,25,6,45,32,13,63,45,18,3,4,0,0
"12606","MTL","BUF",2014020345,16403,20142015,1,65,3,3,0,7.72854105720762,6.61093554995023,1.11760550725739,44,26,18,60,30,30,90,42,48,2,1,0,0
"12607","MTL","COL",2014020359,16405,20142015,0,60,4,3,1,5.11279103771176,4.96699681453174,0.145794223180019,30,29,1,42,37,5,59,50,9,2,1,0,0
"12608","MTL","MIN",2014020372,16407,20142015,0,60,1,2,-1,3.05870323347776,5.13399856787873,-2.07529533440097,19,35,-16,31,48,-17,47,62,-15,1,4,0,0
"12609","MTL","CHI",2014020389,16409,20142015,0,60,3,4,-1,5.99743197092175,4.38737557105135,1.6100563998704,41,36,5,50,44,6,61,64,-3,4,4,0,0
"12610","MTL","DAL",2014020399,16410,20142015,0,60,1,4,-3,3.33748971793102,4.46127840146801,-1.12378868353699,17,29,-12,26,51,-25,44,67,-23,3,7,0,0
"12611","MTL","VAN",2014020413,16413,20142015,1,60,3,1,2,7.16444364781717,2.60583992539455,4.55860372242262,25,16,9,43,21,22,69,30,39,5,2,0,0
"12612","MTL","L.A",2014020432,16416,20142015,1,60,6,2,4,4.30721878073774,7.80049239120035,-3.49327361046261,20,46,-26,30,60,-30,41,92,-51,3,5,0,0
"12613","MTL","CAR",2014020455,16420,20142015,1,60,4,1,3,4.47945861137123,6.26252280399649,-1.78306419262526,29,26,3,42,44,-2,53,61,-8,5,4,0,0
"12614","MTL","ANA",2014020471,16422,20142015,1,60,1,2,-1,3.07096410386293,3.6494841014287,-0.578519997565763,24,23,1,35,35,0,53,58,-5,4,4,0,0
"12615","MTL","OTT",2014020482,16424,20142015,1,60,4,1,3,4.17960353265516,2.28519357213046,1.89440996052471,29,25,4,36,38,-2,54,61,-7,4,3,0,0
"12616","MTL","NYI",2014020505,16427,20142015,0,60,3,1,2,5.83509447146207,4.64668169982906,1.18841277163301,21,38,-17,30,48,-18,48,70,-22,4,3,0,0
"12617","MTL","CAR",2014020532,16433,20142015,0,60,3,1,2,2.94490392284933,3.7702172991232,-0.825313376273868,19,29,-10,27,38,-11,35,55,-20,1,2,0,0
"12618","MTL","FLA",2014020541,16434,20142015,0,65,1,1,0,3.92195644098683,3.45479392295965,0.46716251802718,34,37,-3,43,49,-6,52,64,-12,2,3,0,0
"12619","MTL","N.J",2014020559,16437,20142015,0,60,4,2,2,2.9440801279926,2.74604545371403,0.198034674278571,26,24,2,34,33,1,43,41,2,4,3,0,0
"12620","MTL","T.B",2014020586,16441,20142015,1,60,2,4,-2,2.31738023981387,4.79434955663601,-2.47696931682214,22,36,-14,31,47,-16,44,64,-20,3,6,0,0
"12621","MTL","CBJ",2014020640,16449,20142015,0,60,3,2,1,3.40727658598917,3.78476920376329,-0.377492617774124,31,16,15,44,29,15,61,36,25,8,3,0,0
"12622","MTL","OTT",2014020647,16450,20142015,0,60,1,4,-3,4.81942808918834,4.04235129389053,0.777076795297802,26,35,-9,42,47,-5,61,65,-4,4,4,0,0
"12623","MTL","NYI",2014020662,16452,20142015,1,60,6,4,2,3.11451643929132,4.78043435933068,-1.66591792003936,35,31,4,47,47,0,60,70,-10,4,3,0,0
"12624","MTL","NSH",2014020686,16455,20142015,1,64.1333333333333,2,1,1,5.54279129976103,8.46318211638906,-2.92039081662803,27,37,-10,42,48,-6,61,61,0,4,2,0,0
"12625","MTL","DAL",2014020702,16462,20142015,1,60,3,2,1,5.77846385502471,7.97060346871717,-2.19213961369246,26,42,-16,34,58,-24,46,79,-33,5,4,0,0
"12626","MTL","NYR",2014020712,16464,20142015,0,60,1,0,1,5.82303077490011,2.05852092776331,3.7645098471368,26,24,2,44,37,7,56,49,7,6,5,0,0
"12627","MTL","WSH",2014020727,16466,20142015,1,63.1333333333333,1,0,1,3.96832518544441,4.62723274005111,-0.658907554606699,30,36,-6,42,49,-7,62,69,-7,5,7,0,0
"12628","MTL","ARI",2014020738,16467,20142015,1,60,2,3,-1,3.56010120222345,6.39857607442332,-2.83847487219987,20,32,-12,33,42,-9,53,56,-3,2,2,0,0
"12629","MTL","BUF",2014020749,16469,20142015,1,60,2,3,-1,8.67360832647228,2.70527493438567,5.96833339208661,34,18,16,57,26,31,92,40,52,2,1,0,0
"12630","MTL","N.J",2014020778,16473,20142015,1,60,6,2,4,6.41356554994127,2.46809632243037,3.9454692275109,44,23,21,56,31,25,77,43,34,3,2,0,0
"12631","MTL","BOS",2014020791,16474,20142015,0,60,3,1,2,5.57031005391036,6.40610894519864,-0.835798891288277,34,35,-1,45,49,-4,58,70,-12,3,0,0,0
"12632","MTL","PHI",2014020801,16476,20142015,1,63.45,2,1,1,9.71071424628099,2.28736908581777,7.42334516046321,41,24,17,65,30,35,90,44,46,3,1,0,0
"12633","MTL","EDM",2014020811,16478,20142015,1,61.7833333333333,3,4,-1,3.7919199867174,6.82221098617538,-3.03029099945797,26,38,-12,37,52,-15,55,65,-10,3,3,0,0
"12634","MTL","TOR",2014020824,16480,20142015,1,65,1,1,0,7.16391867273205,3.90467846101021,3.25924021172185,32,29,3,45,35,10,68,52,16,4,5,0,0
"12635","MTL","DET",2014020840,16482,20142015,0,60,2,0,2,4.9926515663974,5.71915539697511,-0.726503830577713,29,25,4,35,35,0,43,54,-11,3,4,0,0
"12636","MTL","OTT",2014020853,16484,20142015,0,60,2,4,-2,8.02713672752716,7.46633731648035,0.560799411046816,44,39,5,52,51,1,63,69,-6,2,3,0,0
"12637","MTL","FLA",2014020864,16485,20142015,1,65,2,2,0,6.65673502032951,4.23070089530665,2.42603412502285,39,21,18,48,30,18,59,43,16,1,1,0,0
"12638","MTL","CBJ",2014020876,16487,20142015,1,60,3,1,2,7.58232577255694,5.27396916765429,2.30835660490266,24,32,-8,31,39,-8,50,69,-19,3,4,0,0
"12639","MTL","STL",2014020899,16490,20142015,0,60,5,2,3,3.9445420834423,3.79756706001373,0.146975023428567,23,29,-6,37,46,-9,46,61,-15,3,3,0,0
"12640","MTL","CBJ",2014020910,16492,20142015,0,60,5,2,3,3.4583034091338,3.21636461479284,0.241938794340967,27,27,0,34,36,-2,46,48,-2,2,2,0,0
"12641","MTL","TOR",2014020928,16494,20142015,1,60,4,0,4,0,0,0,23,30,-7,37,41,-4,49,60,-11,4,4,0,0
"12642","MTL","S.J",2014020941,16496,20142015,0,60,0,4,-4,2.52968909440096,5.99450747214723,-3.46481837774627,20,37,-17,30,50,-20,48,71,-23,0,3,0,0
"12643","MTL","ANA",2014020955,16498,20142015,0,60,1,3,-2,4.89326207149406,4.66141410035809,0.231847971135977,38,33,5,47,45,2,61,57,4,3,1,0,0
"12644","MTL","L.A",2014020963,16499,20142015,0,65,3,3,0,2.97393945872318,4.17094152965001,-1.19700207092683,18,29,-11,31,48,-17,42,66,-24,3,5,0,0
"12645","MTL","ARI",2014020977,16501,20142015,0,60,2,0,2,6.51883792451088,2.79389076327425,3.72494716123663,35,28,7,48,46,2,63,63,0,2,3,0,0
"12646","MTL","T.B",2014020994,16504,20142015,1,61.05,0,1,-1,4.51552662758331,4.08478697351529,0.43073965406802,19,36,-17,24,43,-19,38,75,-37,1,4,0,0
"12647","MTL","OTT",2014021005,16506,20142015,1,60,2,5,-3,5.19798841048032,5.56364037332128,-0.36565196284096,29,28,1,45,41,4,60,62,-2,3,3,0,0
"12648","MTL","NYI",2014021023,16508,20142015,0,60,3,1,2,3.38669098986111,5.5850100409064,-2.19831905104529,30,36,-6,36,48,-12,45,72,-27,4,5,0,0
"12649","MTL","T.B",2014021038,16510,20142015,0,60,2,4,-2,5.15870898176217,5.58305875718309,-0.424349775420911,34,34,0,45,45,0,57,56,1,5,5,0,0
"12650","MTL","FLA",2014021044,16511,20142015,0,60,3,2,1,5.46815984807614,4.11969073620515,1.34846911187099,25,43,-18,34,52,-18,39,67,-28,5,5,0,0
"12651","MTL","CAR",2014021054,16513,20142015,1,60,4,0,4,3.81325870798901,6.55973389233009,-2.74647518434109,22,31,-9,27,44,-17,47,63,-16,2,2,0,0
"12652","MTL","S.J",2014021069,16515,20142015,1,60,2,0,2,7.12846672520825,5.43295944821875,1.6955072769895,29,29,0,41,50,-9,60,72,-12,1,3,0,0
"12653","MTL","NSH",2014021096,16518,20142015,0,61.9,2,3,-1,4.74327376496512,4.69670970461448,0.0465640603506472,29,31,-2,37,41,-4,59,55,4,1,4,0,0
"12654","MTL","WPG",2014021110,16520,20142015,0,60,2,5,-3,4.99451700964939,2.05788275285158,2.93663425679781,41,22,19,48,32,16,59,45,14,6,3,0,0
"12655","MTL","FLA",2014021122,16522,20142015,1,62.9833333333333,3,2,1,4.88224150179303,1.90963180772087,2.97260969407216,25,23,2,34,31,3,55,51,4,5,2,0,0
"12656","MTL","T.B",2014021136,16524,20142015,1,60,3,5,-2,3.67541786597576,5.29800597951726,-1.6225881135415,28,44,-16,37,53,-16,58,66,-8,4,6,0,0
"12657","MTL","WSH",2014021154,16527,20142015,1,65,4,4,0,4.23745613984647,3.01515486765311,1.22230127219336,27,19,8,35,28,7,65,49,16,4,4,0,0
"12658","MTL","N.J",2014021163,16528,20142015,0,65,2,2,0,3.76578782292199,2.2590139914271,1.5067738314949,33,18,15,40,23,17,46,35,11,6,2,0,0
"12659","MTL","FLA",2014021181,16530,20142015,0,60,4,1,3,4.38473810767755,5.56083298907015,-1.1760948813926,28,25,3,40,39,1,51,58,-7,7,4,0,0
"12660","MTL","T.B",2014021194,16356,20142015,0,60,1,7,-6,3.92988229889306,6.58237516482907,-2.65249286593601,17,41,-24,30,51,-21,48,60,-12,6,7,0,0
"12661","MTL","DET",2014021205,16534,20142015,1,61.35,4,3,1,7.43721960327821,2.57455585265733,4.86266375062088,26,27,-1,36,38,-2,44,49,-5,4,5,0,0
"12662","MTL","TOR",2014021221,16536,20142015,0,65,3,3,0,5.48453761137887,3.96852187064724,1.51601574073163,33,22,11,49,37,12,70,50,20,5,7,0,0
"12663","MTL","T.B",2014030211,16556,20142015,1,80,1,1,0,10.0433503160748,5.68957837222842,4.35377194384637,44,33,11,56,41,15,82,75,7,3,4,0,0
"12664","MTL","T.B",2014030212,16558,20142015,1,60,2,6,-4,5.48112794540498,3.66970146227115,1.81142648313383,29,24,5,38,25,13,54,35,19,4,9,0,0
"12665","MTL","T.B",2014030213,16561,20142015,0,60,1,2,-1,5.64089974598028,4.29341584100621,1.34748390497407,31,19,12,52,31,21,69,41,28,2,3,0,0
"12666","MTL","T.B",2014030214,16562,20142015,0,60,6,2,4,4.49508498137584,2.1978730604751,2.29721192090074,40,24,16,46,30,16,56,41,15,4,4,0,0
"12667","MTL","T.B",2014030215,16564,20142015,1,60,2,1,1,5.89678231324069,4.75074309094634,1.14603922229435,29,25,4,45,35,10,62,54,8,6,4,0,0
"12668","MTL","T.B",2014030216,16567,20142015,0,60,1,4,-3,3.11550664086826,6.33458884999527,-3.21908220912701,19,28,-9,29,35,-6,40,47,-7,2,2,0,0
"12669","MTL","TOR",2015020001,16715,20152016,0,60,3,1,2,4.62512594097029,4.51718400196114,0.107941939009152,29,37,-8,45,51,-6,54,66,-12,2,4,0,0
"12670","MTL","BOS",2015020018,16718,20152016,0,60,4,2,2,6.27883444321924,3.47579101467858,2.80304342854066,38,21,17,51,31,20,62,43,19,6,3,0,0
"12671","MTL","OTT",2015020031,16719,20152016,0,60,3,1,2,6.00009783778682,5.12232950470283,0.877768333083983,34,21,13,48,38,10,71,55,16,9,6,0,0
"12672","MTL","NYR",2015020053,16723,20152016,1,60,3,0,3,3.96780336330397,6.00835395872637,-2.0405505954224,32,25,7,42,41,1,55,58,-3,6,6,0,0
"12673","MTL","DET",2015020065,16725,20152016,1,60,4,1,3,8.67592760397989,3.71949284019065,4.95643476378924,41,22,19,52,32,20,69,44,25,5,3,0,0
"12674","MTL","STL",2015020085,16728,20152016,1,60,3,0,3,6.35104134938484,6.3269715344868,0.0240698148980414,36,38,-2,44,47,-3,56,65,-9,2,3,0,0
"12675","MTL","BUF",2015020100,16731,20152016,0,60,7,2,5,4.04093558398754,4.08050989460025,-0.039574310612716,26,36,-10,37,47,-10,51,61,-10,3,4,0,0
"12676","MTL","TOR",2015020108,16732,20152016,1,60,5,3,2,5.43308822956169,7.6565284120361,-2.22344018247441,27,52,-25,37,73,-36,49,85,-36,5,6,0,0
"12677","MTL","VAN",2015020133,16735,20152016,0,60,1,5,-4,3.05037181969965,2.61639737071937,0.43397444898028,26,28,-2,34,36,-2,44,45,-1,2,2,0,0
"12678","MTL","EDM",2015020144,16737,20152016,0,60,3,4,-1,3.34779299599177,4.51575887108629,-1.16796587509452,21,27,-6,28,37,-9,39,54,-15,3,5,0,0
"12679","MTL","CGY",2015020152,16738,20152016,0,60,6,2,4,0,0,0,31,32,-1,42,43,-1,55,59,-4,4,4,0,0
"12680","MTL","WPG",2015020166,16740,20152016,1,60,5,1,4,4.29443114495371,2.16400713683106,2.13042400812265,26,19,7,37,28,9,53,48,5,7,5,0,0
"12681","MTL","OTT",2015020175,16742,20152016,1,60.5666666666667,1,2,-1,4.17291779950756,3.75585524376947,0.417062555738084,37,27,10,48,34,14,71,42,29,3,1,0,0
"12682","MTL","NYI",2015020187,16744,20152016,1,60,4,1,3,5.65117274832963,3.04526935255853,2.6059033957711,24,18,6,35,29,6,45,42,3,3,4,0,0
"12683","MTL","BOS",2015020202,16746,20152016,1,60,4,2,2,5.61438036293539,4.2012044765288,1.41317588640659,33,31,2,47,41,6,64,50,14,3,4,0,0
"12684","MTL","COL",2015020250,16753,20152016,1,60,1,6,-5,5.71195990077103,5.60802267014515,0.103937230625888,40,24,16,53,31,22,75,40,35,4,2,0,0
"12685","MTL","VAN",2015020263,16755,20152016,1,63.4166666666667,4,3,1,0,0,0,36,26,10,46,34,12,67,47,20,4,5,0,0
"12686","MTL","ARI",2015020282,16758,20152016,1,60,2,3,-1,4.27180235555666,6.21115485421615,-1.93935249865948,33,20,13,54,37,17,75,49,26,5,2,0,0
"12687","MTL","NYI",2015020290,16759,20152016,0,60,5,3,2,2.89231891595409,2.02197910039058,0.870339815563511,28,36,-8,40,43,-3,50,62,-12,2,4,0,0
"12688","MTL","NYI",2015020306,16761,20152016,1,60,4,2,2,3.93281984273062,3.54650486937767,0.386314973352954,27,23,4,41,33,8,58,45,13,5,5,0,0
"12689","MTL","NYR",2015020320,16764,20152016,0,60,5,1,4,2.95584862976884,4.87810833565891,-1.92225970589007,25,34,-9,35,40,-5,47,53,-6,4,5,0,0
"12690","MTL","N.J",2015020336,16766,20152016,0,65,2,2,0,2.76683119569134,3.55554754938767,-0.78871635369633,27,27,0,36,32,4,51,37,14,4,4,0,0
"12691","MTL","N.J",2015020344,16767,20152016,1,62.5166666666667,2,3,-1,6.68860834665429,3.71990466327406,2.96870368338023,32,31,1,42,41,1,60,55,5,2,2,0,0
"12692","MTL","CBJ",2015020360,16770,20152016,1,60,2,1,1,5.19457247858225,3.0569739936509,2.13759848493135,26,23,3,39,33,6,54,50,4,4,0,0,0
"12693","MTL","WSH",2015020375,16772,20152016,1,60,2,3,-1,3.52112443313308,3.59176530155673,-0.0706408684236521,35,19,16,47,30,17,73,43,30,3,3,0,0
"12694","MTL","CAR",2015020392,16774,20152016,0,60,2,3,-1,8.5886805082082,6.89876551180214,1.68991499640606,38,29,9,55,52,3,68,65,3,4,4,0,0
"12695","MTL","BOS",2015020417,16778,20152016,1,60,1,3,-2,6.69263689615764,2.8032141778649,3.88942271829274,33,23,10,47,27,20,72,41,31,4,3,0,0
"12696","MTL","DET",2015020421,16779,20152016,0,60,2,3,-1,0,0,0,25,29,-4,31,42,-11,41,57,-16,3,7,0,0
"12697","MTL","OTT",2015020437,16781,20152016,1,60,3,1,2,5.39040929562179,2.47152901894879,2.91888027667301,42,26,16,52,34,18,69,53,16,4,2,0,0
"12698","MTL","S.J",2015020458,16784,20152016,1,60,1,3,-2,4.19033464670065,1.16813041071873,3.02220423598192,27,18,9,40,27,13,68,38,30,2,0,0,0
"12699","MTL","L.A",2015020470,16786,20152016,1,60,0,3,-3,7.26899170513207,5.07135350607132,2.19763819906075,45,20,25,53,28,25,74,44,30,3,2,0,0
"12700","MTL","DAL",2015020489,16788,20152016,0,60,2,6,-4,5.56099926318529,3.55760734231444,2.00339192087085,23,27,-4,37,40,-3,50,53,-3,6,8,0,0
"12701","MTL","NSH",2015020503,16790,20152016,0,60,1,5,-4,7.9904212798865,2.35447038616985,5.63595089371665,36,19,17,50,27,23,63,32,31,5,4,0,0
"12702","MTL","MIN",2015020512,16791,20152016,0,60,1,2,-1,1.91477749048499,6.19919124267471,-4.28441375218972,25,22,3,34,36,-2,57,48,9,1,1,0,0
"12703","MTL","WSH",2015020519,16795,20152016,0,60,1,3,-2,7.78393447007966,4.29545110620525,3.48848336387441,30,33,-3,42,39,3,61,52,9,3,3,0,0
"12704","MTL","T.B",2015020536,16797,20152016,0,65,3,3,0,3.82582249910577,3.55271357319725,0.27310892590852,34,39,-5,46,52,-6,51,68,-17,1,3,0,0
"12705","MTL","FLA",2015020545,16798,20152016,0,60,1,3,-2,2.98746904949394,4.18059576496307,-1.19312671546913,30,30,0,38,43,-5,40,49,-9,4,6,0,0
"12706","MTL","BOS",2015020565,16801,20152016,0,60,5,1,4,2.19324734702865,4.95257126382046,-2.75932391679181,30,28,2,45,35,10,59,43,16,8,7,0,0
"12707","MTL","PHI",2015020591,16805,20152016,0,60,3,4,-1,6.83327136873862,4.2264387733303,2.60683259540832,24,31,-7,40,40,0,65,47,18,4,3,0,0
"12708","MTL","N.J",2015020596,16806,20152016,1,60,2,1,1,4.66094587683392,5.89457216892376,-1.23362629208984,25,20,5,39,30,9,57,48,9,4,3,0,0
"12709","MTL","PIT",2015020616,16809,20152016,1,60,1,3,-2,5.19705370448355,7.07322152704,-1.87616782255645,34,32,2,41,48,-7,61,62,-1,4,4,0,0
"12710","MTL","CHI",2015020648,16814,20152016,1,60,1,2,-1,7.82169009857898,4.3535747062997,3.46811539227929,40,33,7,47,43,4,68,52,16,1,1,0,0
"12711","MTL","STL",2015020665,16816,20152016,0,62.0666666666667,3,4,-1,6.24223135481589,3.91003384913576,2.33219750568012,49,22,27,61,33,28,75,43,32,11,6,0,0
"12712","MTL","CHI",2015020674,16817,20152016,0,60,2,5,-3,4.1055964266161,5.64888218676788,-1.54328576015178,29,33,-4,43,41,2,63,52,11,2,4,0,0
"12713","MTL","BOS",2015020686,16819,20152016,1,60,1,4,-3,6.39257544035143,5.14250286801058,1.25007257234085,39,24,15,46,33,13,71,50,21,5,3,0,0
"12714","MTL","TOR",2015020712,16823,20152016,0,65,2,2,0,5.69567639002344,2.43475696718087,3.26091942284256,29,19,10,53,32,21,69,53,16,4,2,0,0
"12715","MTL","CBJ",2015020728,16825,20152016,0,60,2,5,-3,6.1831858609803,3.60518930212129,2.57799655885901,34,25,9,44,38,6,61,50,11,3,2,0,0
"12716","MTL","CBJ",2015020734,16826,20152016,1,60,2,5,-3,4.48612350409495,4.47629011813638,0.00983338595857308,30,26,4,41,32,9,68,46,22,6,3,0,0
"12717","MTL","PHI",2015020747,16833,20152016,0,60,2,4,-2,6.23731910535464,6.87085403700816,-0.633534931653521,32,36,-4,41,50,-9,59,67,-8,5,6,0,0
"12718","MTL","BUF",2015020756,16834,20152016,1,60,2,4,-2,7.91139346491354,6.6039359412523,1.30745752366124,35,32,3,42,41,1,57,62,-5,2,3,0,0
"12719","MTL","EDM",2015020777,16837,20152016,1,60,5,1,4,5.66521867511801,4.43334977491759,1.23186890020042,36,24,12,41,34,7,54,50,4,4,4,0,0
"12720","MTL","CAR",2015020788,16838,20152016,1,65,1,1,0,4.76948635501321,6.28108374839343,-1.51159739338021,34,35,-1,39,45,-6,52,61,-9,2,2,0,0
"12721","MTL","T.B",2015020799,16840,20152016,1,60,4,2,2,5.56517778220586,5.75998818760854,-0.194810405402677,27,39,-12,39,57,-18,50,79,-29,2,3,0,0
"12722","MTL","BUF",2015020818,16843,20152016,0,60,4,6,-2,5.83686815475812,3.33710717444774,2.49976098031038,30,22,8,49,27,22,62,35,27,4,3,0,0
"12723","MTL","ARI",2015020845,16846,20152016,0,60,2,6,-4,1.76181294893382,2.33199941762723,-0.570186468693407,19,27,-8,34,42,-8,44,55,-11,4,3,0,0
"12724","MTL","COL",2015020856,16848,20152016,0,60,2,3,-1,5.94153009506408,2.9727097038899,2.96882039117418,34,28,6,45,33,12,62,51,11,4,4,0,0
"12725","MTL","PHI",2015020872,16850,20152016,1,65,2,2,0,3.83249245137984,4.67930595701346,-0.846813505633627,31,37,-6,40,47,-7,62,66,-4,4,3,0,0
"12726","MTL","NSH",2015020891,16853,20152016,1,65,1,1,0,3.04789255245851,5.16848881894839,-2.12059626648988,29,30,-1,35,43,-8,52,51,1,1,1,0,0
"12727","MTL","WSH",2015020902,16855,20152016,0,60,4,3,1,5.466139899263,3.75160730443167,1.71453259483133,34,36,-2,47,53,-6,60,68,-8,5,4,0,0
"12728","MTL","TOR",2015020926,16858,20152016,1,60,4,1,3,4.71046209056436,6.24569648242525,-1.53523439186088,36,32,4,44,41,3,64,56,8,4,2,0,0
"12729","MTL","S.J",2015020942,16860,20152016,0,60,2,6,-4,4.96014975340222,5.21303565062948,-0.252885897227259,23,36,-13,38,49,-11,55,67,-12,3,2,0,0
"12730","MTL","ANA",2015020953,16862,20152016,0,65,2,2,0,3.98843123514962,5.6264988279072,-1.63806759275758,27,35,-8,41,50,-9,64,62,2,4,6,0,0
"12731","MTL","L.A",2015020965,16863,20152016,0,60,2,3,-1,2.54252007041941,6.41671603572797,-3.87419596530856,15,31,-16,23,49,-26,37,59,-22,4,6,0,0
"12732","MTL","WPG",2015020977,16865,20152016,0,60,2,4,-2,5.14447646588087,8.28055819054134,-3.13608172466047,28,30,-2,39,40,-1,49,51,-2,2,3,0,0
"12733","MTL","DAL",2015020997,16868,20152016,1,61.9833333333333,4,3,1,6.46187121151888,4.91876750008669,1.5431037114322,28,33,-5,38,43,-5,58,61,-3,2,3,0,0
"12734","MTL","BUF",2015021008,16870,20152016,1,60,3,2,1,8.65285338024281,5.8653602392636,2.78749314097921,34,38,-4,53,52,1,69,71,-2,4,2,0,0
"12735","MTL","MIN",2015021021,16872,20152016,1,60,1,4,-3,4.68261373872519,5.44907399789372,-0.766460259168525,31,22,9,41,29,12,61,46,15,2,2,0,0
"12736","MTL","FLA",2015021043,16875,20152016,1,60,1,4,-3,5.95803758403054,4.8628653929336,1.09517219109694,28,36,-8,35,43,-8,48,60,-12,2,4,0,0
"12737","MTL","BUF",2015021047,16876,20152016,0,63.25,3,2,1,5.39625588874333,4.37109060492433,1.02516528381899,23,43,-20,35,56,-21,44,68,-24,11,9,0,0
"12738","MTL","OTT",2015021071,16879,20152016,0,60,0,5,-5,4.95252001011977,7.97823523313855,-3.02571522301878,30,44,-14,43,52,-9,66,68,-2,5,3,0,0
"12739","MTL","CGY",2015021081,16880,20152016,1,60,1,4,-3,0,0,0,22,35,-13,28,40,-12,44,57,-13,2,4,0,0
"12740","MTL","ANA",2015021091,16882,20152016,1,60,4,3,1,6.41149457718711,7.06134486303141,-0.649850285844295,23,35,-12,27,45,-18,44,69,-25,1,2,0,0
"12741","MTL","DET",2015021105,16884,20152016,0,60,3,4,-1,4.73365249490777,5.17575198868872,-0.442099493780944,29,40,-11,36,58,-22,43,70,-27,4,7,0,0
"12742","MTL","NYR",2015021120,16886,20152016,1,60,2,5,-3,5.97592309809988,5.8395378581216,0.136385239978289,26,23,3,39,39,0,53,56,-3,7,4,0,0
"12743","MTL","DET",2015021143,16889,20152016,1,60,4,3,1,4.22444290739077,8.72800462389266,-4.50356171650189,27,42,-15,41,56,-15,48,83,-35,6,3,0,0
"12744","MTL","T.B",2015021156,16891,20152016,0,60,3,0,3,3.15823371130591,2.6900539034611,0.46817980784481,24,26,-2,35,39,-4,46,57,-11,1,4,0,0
"12745","MTL","FLA",2015021172,16893,20152016,0,60,3,4,-1,3.33643888350775,5.66160559514537,-2.32516671163762,28,39,-11,36,50,-14,43,58,-15,1,2,0,0
"12746","MTL","FLA",2015021192,16896,20152016,1,60,1,4,-3,5.27052594738439,2.72069808002925,2.54982786735513,33,19,14,46,26,20,61,34,27,6,5,0,0
"12747","MTL","CAR",2015021207,16898,20152016,0,60,4,2,2,6.11567342534545,5.86805662441475,0.2476168009307,31,28,3,43,41,2,57,49,8,0,1,0,0
"12748","MTL","T.B",2015021220,16900,20152016,1,60,5,2,3,5.44328283327542,3.2197288008465,2.22355403242892,29,23,6,43,32,11,53,49,4,7,2,0,0
"12749","MTL","BUF",2016020005,17087,20162017,0,60,4,1,3,2.81128614657865,3.49921786329378,-0.687931716715127,24,31,-7,36,41,-5,44,53,-9,3,6,0,0
"12750","MTL","OTT",2016020018,17089,20162017,0,65,3,3,0,3.50656319456175,5.88209632108919,-2.37553312652744,24,38,-14,33,52,-19,48,63,-15,5,5,0,0
"12751","MTL","PIT",2016020040,17092,20162017,1,60,4,0,4,3.14430361370614,2.66222067519136,0.482082938514782,32,36,-4,42,51,-9,52,60,-8,7,7,0,0
"12752","MTL","ARI",2016020054,17094,20162017,1,60,5,2,3,7.9611040905662,3.02879376051533,4.93231033005087,43,29,14,60,39,21,77,58,19,5,3,0,0
"12753","MTL","BOS",2016020065,17096,20162017,0,60,4,2,2,3.97085284561035,4.15791209321469,-0.187059247604338,29,21,8,44,38,6,50,55,-5,7,7,0,0
"12754","MTL","PHI",2016020081,17098,20162017,1,60,3,1,2,6.18774441687856,5.0965573442,1.09118707267856,33,32,1,38,45,-7,51,61,-10,4,1,0,0
"12755","MTL","NYI",2016020094,17100,20162017,0,60,3,2,1,4.49790111241327,4.21980334448745,0.278097767925829,29,28,1,46,36,10,74,54,20,1,2,0,0
"12756","MTL","T.B",2016020102,17101,20162017,1,60,3,1,2,5.67226519688847,6.35974119714228,-0.68747600025381,26,31,-5,32,43,-11,45,61,-16,3,3,0,0
"12757","MTL","TOR",2016020114,17103,20162017,1,60,2,1,1,3.96402448236635,4.03317698884348,-0.0691525064771294,31,38,-7,40,48,-8,59,74,-15,5,6,0,0
"12758","MTL","VAN",2016020143,17107,20162017,1,60,3,0,3,5.00808104095995,6.89137514026149,-1.88329409930154,22,42,-20,28,50,-22,40,74,-34,3,5,0,0
"12759","MTL","CBJ",2016020158,17109,20162017,0,60,0,10,-10,3.57361126149004,7.93220669205766,-4.35859543056762,30,40,-10,43,50,-7,60,59,1,2,5,0,0
"12760","MTL","PHI",2016020164,17110,20162017,1,60,5,4,1,3.54782884979977,4.91611877883111,-1.36828992903133,17,38,-21,25,48,-23,45,70,-25,3,4,0,0
"12761","MTL","BOS",2016020189,17113,20162017,1,60,3,2,1,3.85708559452905,8.83396131469635,-4.9768757201673,23,43,-20,35,55,-20,56,83,-27,2,2,0,0
"12762","MTL","L.A",2016020199,17115,20162017,1,60,4,1,3,4.55894979015284,4.52561912103556,0.0333306691172766,23,24,-1,35,32,3,48,48,0,2,4,0,0
"12763","MTL","DET",2016020212,17117,20162017,1,60,5,0,5,5.69526233434942,4.14341356849026,1.55184876585916,37,25,12,53,35,18,68,59,9,4,5,0,0
"12764","MTL","CHI",2016020226,17118,20162017,0,60,2,3,-1,3.8223729344121,5.45376870837936,-1.63139577396726,23,35,-12,32,47,-15,54,55,-1,3,3,0,0
"12765","MTL","FLA",2016020234,17120,20162017,1,62.9833333333333,3,4,-1,7.13004283381815,2.62546697468497,4.50457585913318,37,24,13,44,35,9,61,48,13,3,3,0,0
"12766","MTL","CAR",2016020258,17123,20162017,0,60,2,3,-1,8.36272960207134,4.25535903027048,4.10737057180086,33,18,15,50,31,19,64,47,17,1,3,0,0
"12767","MTL","TOR",2016020264,17124,20162017,1,60,2,1,1,4.98905213834951,4.56861804695141,0.420434091398093,29,32,-3,38,40,-2,51,67,-16,6,5,0,0
"12768","MTL","OTT",2016020285,17127,20162017,1,60,3,4,-1,5.67174206278287,4.13471731962636,1.53702474315651,39,23,16,52,29,23,79,42,37,10,6,0,0
"12769","MTL","CAR",2016020300,17129,20162017,1,60,2,1,1,2.04968147241743,4.53699127002619,-2.48730979760876,22,32,-10,30,45,-15,42,65,-23,2,3,0,0
"12770","MTL","DET",2016020315,17131,20162017,0,63.6166666666667,2,1,1,4.89509444879513,5.47760449160705,-0.582510042811919,24,33,-9,37,46,-9,50,58,-8,2,4,0,0
"12771","MTL","ANA",2016020340,17134,20162017,0,60,1,2,-1,8.10809633155441,5.83272846776526,2.27536786378914,40,38,2,56,52,4,74,62,12,4,4,0,0
"12772","MTL","S.J",2016020358,17137,20162017,0,60,1,2,-1,6.32160672894679,2.50607922258496,3.81552750636183,32,30,2,47,39,8,62,51,11,3,3,0,0
"12773","MTL","L.A",2016020377,17139,20162017,0,65,4,4,0,4.62908971903744,5.19045477785403,-0.561365058816591,30,31,-1,42,45,-3,59,53,6,5,4,0,0
"12774","MTL","STL",2016020386,17141,20162017,0,63.6333333333333,2,3,-1,3.77374322715332,5.87403290666407,-2.10028967951075,30,31,-1,42,41,1,57,51,6,5,4,0,0
"12775","MTL","N.J",2016020398,17143,20162017,1,60,5,2,3,7.57907006275866,2.55683632247383,5.02223374028484,49,21,28,66,27,39,83,44,39,3,4,0,0
"12776","MTL","COL",2016020414,17145,20162017,1,60,10,1,9,4.38018589554849,1.42765485774726,2.95253103780124,36,16,20,47,21,26,60,31,29,4,5,0,0
"12777","MTL","BOS",2016020430,17147,20162017,1,63.3333333333333,1,2,-1,3.98369953071233,3.85652642470902,0.127173106003312,31,29,2,49,39,10,74,47,27,6,2,0,0
"12778","MTL","S.J",2016020455,17151,20162017,1,60,2,4,-2,4.17239684347275,2.49536976064896,1.6770270828238,28,23,5,41,33,8,73,47,26,3,5,0,0
"12779","MTL","WSH",2016020465,17152,20162017,0,60,2,1,1,3.45156925525398,4.50745773266044,-1.05588847740646,25,21,4,40,37,3,44,58,-14,3,5,0,0
"12780","MTL","ANA",2016020485,17155,20162017,1,60,5,1,4,3.17034961471787,2.52167664974695,0.648672964970917,34,13,21,46,16,30,58,19,39,6,3,0,0
"12781","MTL","MIN",2016020498,17157,20162017,1,60,2,4,-2,5.72364107815201,5.0857959225541,0.637845155597915,34,27,7,48,33,15,71,47,24,4,4,0,0
"12782","MTL","CBJ",2016020509,17158,20162017,0,60,1,2,-1,3.10621744230144,3.30211506361957,-0.195897621318124,37,24,13,52,33,19,67,41,26,2,4,0,0
"12783","MTL","T.B",2016020529,17163,20162017,0,61.6,3,4,-1,2.85103295178851,4.25483505276497,-1.40380210097646,22,30,-8,30,37,-7,39,51,-12,2,3,0,0
"12784","MTL","FLA",2016020536,17164,20162017,0,60.65,3,2,1,6.54488467151532,8.4020075961324,-1.85712292461708,41,33,8,52,53,-1,63,66,-3,2,3,0,0
"12785","MTL","PIT",2016020552,17166,20162017,0,61.9,3,4,-1,6.8438030881581,5.36070008337265,1.48310300478545,40,41,-1,46,51,-5,58,68,-10,2,5,0,0
"12786","MTL","NSH",2016020570,17169,20162017,0,64.5,2,1,1,5.5370627479133,3.48473737854511,2.05232536936819,43,23,20,55,35,20,76,49,27,4,3,0,0
"12787","MTL","DAL",2016020574,17170,20162017,0,60.3166666666667,4,3,1,3.53204404108692,5.87877369274645,-2.34672965165953,33,42,-9,45,56,-11,62,74,-12,3,2,0,0
"12788","MTL","TOR",2016020594,17173,20162017,0,60,5,3,2,5.04062988882652,3.93232927194725,1.10830061687927,31,36,-5,45,44,1,49,67,-18,10,8,0,0
"12789","MTL","WSH",2016020610,17175,20162017,1,60,1,4,-3,5.25085772277089,6.06197651157709,-0.811118788806198,23,39,-16,38,50,-12,62,68,-6,4,2,0,0
"12790","MTL","WPG",2016020621,17177,20162017,0,60,7,4,3,3.86673429817893,4.4265997808165,-0.559865482637576,30,27,3,36,40,-4,45,54,-9,2,4,0,0
"12791","MTL","MIN",2016020628,17178,20162017,0,60,1,7,-6,5.7370391747483,1.84559749254549,3.89144168220281,21,24,-3,40,29,11,54,41,13,2,4,0,0
"12792","MTL","NYR",2016020642,17180,20162017,1,60,5,4,1,6.05561605765251,5.76241924492206,0.293196812730457,32,33,-1,40,43,-3,58,62,-4,2,2,0,0
"12793","MTL","DET",2016020658,17182,20162017,0,60,0,1,-1,2.4477463416988,3.31245748422828,-0.864711142529472,18,20,-2,27,33,-6,41,42,-1,1,4,0,0
"12794","MTL","PIT",2016020672,17184,20162017,1,60,1,4,-3,4.8682141029858,3.38293802953558,1.48527607345022,20,26,-6,32,41,-9,52,52,0,1,2,0,0
"12795","MTL","N.J",2016020688,17186,20162017,0,60,3,1,2,3.65650816287962,1.56303271838169,2.09347544449793,26,17,9,38,21,17,50,30,20,4,3,0,0
"12796","MTL","BUF",2016020694,17187,20162017,1,61.8,2,3,-1,5.39822323422413,6.0292122539322,-0.630989019708068,38,38,0,47,43,4,55,63,-8,1,3,0,0
"12797","MTL","CGY",2016020718,17190,20162017,1,60,5,1,4,2.08785746313515,3.31875413495072,-1.23089667181557,20,31,-11,33,36,-3,53,52,1,4,6,0,0
"12798","MTL","NYI",2016020730,17192,20162017,0,60,1,3,-2,1.41410967138096,4.52686497963441,-3.11275530825345,22,42,-20,27,52,-25,40,61,-21,4,5,0,0
"12799","MTL","BUF",2016020745,17197,20162017,1,60,5,2,3,4.53307371135452,9.17458805794013,-4.64151434658561,35,39,-4,48,49,-1,69,65,4,1,3,0,0
"12800","MTL","PHI",2016020759,17199,20162017,0,60,1,3,-2,4.94283253190224,3.97721386083867,0.965618671063567,16,24,-8,30,34,-4,44,60,-16,1,3,0,0
"12801","MTL","WSH",2016020771,17201,20162017,1,60,2,3,-1,2.92242763245807,3.45014786940584,-0.527720236947765,22,30,-8,31,36,-5,49,51,-2,3,4,0,0
"12802","MTL","EDM",2016020785,17202,20162017,1,65,0,0,0,3.5191945553504,2.96608270968318,0.553111845667217,22,32,-10,35,41,-6,49,62,-13,1,4,0,0
"12803","MTL","COL",2016020800,17204,20162017,0,60,0,4,-4,4.94608521298505,3.1503676894614,1.79571752352365,27,26,1,40,38,2,53,48,5,6,3,0,0
"12804","MTL","ARI",2016020812,17206,20162017,0,62.2166666666667,5,4,1,5.92150107040652,4.00176439380555,1.91973667660097,40,25,15,65,36,29,82,48,34,2,3,0,0
"12805","MTL","STL",2016020822,17208,20162017,1,60,2,4,-2,5.65270759761916,5.45060769822666,0.202099899392493,30,22,8,42,30,12,66,37,29,1,1,0,0
"12806","MTL","BOS",2016020832,17209,20162017,0,60,0,4,-4,2.37236722921656,5.13355537491384,-2.76118814569728,25,36,-11,37,44,-7,47,51,-4,6,6,0,0
"12807","MTL","WPG",2016020859,17215,20162017,1,60,1,3,-2,1.76231718575582,5.81751638634887,-4.05519920059305,20,33,-13,31,42,-11,49,59,-10,4,3,0,0
"12808","MTL","NYR",2016020883,17218,20162017,0,65,2,2,0,4.75792880088557,4.95845911560536,-0.200530314719799,28,30,-2,42,42,0,52,55,-3,3,4,0,0
"12809","MTL","NYI",2016020895,17220,20162017,1,60,0,3,-3,2.67991900251945,4.63767709043168,-1.95775808791223,24,24,0,34,30,4,61,46,15,2,3,0,0
"12810","MTL","TOR",2016020907,17222,20162017,0,61.1,3,2,1,5.2112381826073,3.9648796071829,1.24635857542441,28,34,-6,45,45,0,60,57,3,4,2,0,0
"12811","MTL","N.J",2016020919,17224,20162017,0,62.9,4,3,1,6.189910585701,2.79745540622389,3.39245517947711,33,37,-4,44,45,-1,56,57,-1,3,3,0,0
"12812","MTL","CBJ",2016020926,17225,20162017,1,63.8833333333333,1,0,1,6.54872209766472,4.57963538714275,1.96908671052197,30,26,4,42,41,1,65,58,7,4,2,0,0
"12813","MTL","NSH",2016020941,17227,20162017,1,60,2,1,1,4.48137109632808,4.53859501058469,-0.0572239142566104,26,25,1,34,40,-6,53,58,-5,3,2,0,0
"12814","MTL","NYR",2016020956,17229,20162017,0,60,4,1,3,3.25347089505522,4.74854974495247,-1.49507884989725,35,27,8,49,38,11,60,49,11,2,1,0,0
"12815","MTL","VAN",2016020980,17232,20162017,0,61.2166666666667,2,1,1,5.79195012763739,2.16615656067165,3.62579356696574,38,28,10,44,36,8,58,54,4,3,1,0,0
"12816","MTL","CGY",2016020990,17234,20162017,0,60,0,5,-5,2.85750399391691,4.72083848952843,-1.86333449561153,24,38,-14,29,53,-24,38,70,-32,2,1,0,0
"12817","MTL","EDM",2016021013,17237,20162017,0,60,4,1,3,8.18597912756377,2.24046055972576,5.94551856783801,41,25,16,55,33,22,69,51,18,3,3,0,0
"12818","MTL","CHI",2016021027,17239,20162017,1,60,2,4,-2,7.1932699343306,6.81500384236278,0.378266091967816,42,24,18,59,34,25,90,51,39,2,1,0,0
"12819","MTL","OTT",2016021056,17243,20162017,0,65,3,3,0,5.09633654725621,7.45474581238523,-2.35840926512901,32,31,1,38,45,-7,54,66,-12,2,4,0,0
"12820","MTL","OTT",2016021068,17244,20162017,1,60,4,1,3,5.66652937990616,6.0738577236621,-0.407328343755944,37,31,6,47,39,8,63,52,11,7,6,0,0
"12821","MTL","DET",2016021079,17246,20162017,1,64.1666666666667,1,2,-1,6.23964447889011,4.93245281570125,1.30719166318886,36,36,0,53,44,9,73,57,16,3,1,0,0
"12822","MTL","CAR",2016021092,17248,20162017,1,60,1,4,-3,6.86064845288638,4.03464637446268,2.8260020784237,22,23,-1,37,34,3,48,55,-7,1,2,0,0
"12823","MTL","OTT",2016021108,17250,20162017,1,60,3,1,2,2.64412761597709,3.05874700799356,-0.414619392016476,24,32,-8,37,43,-6,51,64,-13,7,7,0,0
"12824","MTL","DAL",2016021132,17253,20162017,1,60,4,1,3,5.26927517983131,2.16669608947996,3.10257909035136,36,28,8,47,35,12,73,51,22,1,1,0,0
"12825","MTL","FLA",2016021144,17255,20162017,1,60,6,2,4,4.35138521126009,2.47365196946087,1.87773324179922,33,31,2,45,38,7,63,55,8,3,5,0,0
"12826","MTL","T.B",2016021160,17257,20162017,0,60.85,2,1,1,3.95765962576843,5.58569687654381,-1.62803725077538,36,22,14,55,39,16,67,55,12,2,2,0,0
"12827","MTL","FLA",2016021178,17259,20162017,0,60,4,1,3,3.64575788177171,7.54251657921421,-3.89675869744249,31,32,-1,47,44,3,56,49,7,2,2,0,0
"12828","MTL","BUF",2016021192,17261,20162017,0,60,1,2,-1,5.25299581239233,3.41445514593215,1.83854066646018,32,30,2,48,41,7,53,49,4,1,0,0,0
"12829","MTL","T.B",2016021206,17263,20162017,1,60,2,4,-2,6.68663202921016,3.7269486535634,2.95968337564676,29,22,7,43,30,13,59,35,24,4,2,0,0
"12830","MTL","DET",2016021212,17264,20162017,0,61.7,3,2,1,2.32499065890443,2.01160189275106,0.313388766153366,30,27,3,35,36,-1,48,44,4,1,0,0,0
"12831","MTL","NYR",2016030111,17268,20162017,1,60,0,2,-2,4.24117445062389,7.44652538167429,-3.2053509310504,31,31,0,44,42,2,68,60,8,4,5,0,0
"12832","MTL","NYR",2016030112,17270,20162017,1,78.5666666666667,4,3,1,11.3988286334953,9.36659133075032,2.03223730274496,58,38,20,75,52,23,103,69,34,5,4,0,0
"12833","MTL","NYR",2016030113,17272,20162017,0,60,3,1,2,3.8819652623949,3.04084018742287,0.841125074972027,29,21,8,38,32,6,51,47,4,2,3,0,0
"12834","MTL","NYR",2016030114,17274,20162017,0,60,1,2,-1,3.47664267523214,2.98197359960917,0.494669075622973,24,32,-8,37,42,-5,50,60,-10,3,2,0,0
"12835","MTL","NYR",2016030115,17276,20162017,1,74.3666666666667,2,3,-1,4.79995194361052,5.07459774739436,-0.274645803783848,36,36,0,52,44,8,80,72,8,4,2,0,0
"12836","MTL","NYR",2016030116,17278,20162017,0,60,1,3,-2,3.69061720406171,6.55723771464545,-2.86662051058374,28,23,5,40,37,3,67,51,16,4,2,0,0
"12837","MTL","BUF",2017020006,17444,20172018,0,65,2,2,0,6.82251751257502,7.80542884868919,-0.982911336114171,40,45,-5,48,61,-13,63,69,-6,4,5,0,0
"12838","MTL","WSH",2017020022,17446,20172018,0,60,1,6,-5,6.44240249100747,3.96687802109409,2.47552446991338,39,23,16,55,29,26,70,37,33,4,4,0,0
"12839","MTL","NYR",2017020031,17447,20172018,0,60,0,2,-2,5.49860945219064,3.27319899032591,2.22541046186473,34,25,9,46,34,12,63,43,20,1,3,0,0
"12840","MTL","CHI",2017020041,17449,20172018,1,60,1,3,-2,6.74530485265791,5.2127047616701,1.53260009098781,42,25,17,60,35,25,83,46,37,5,2,0,0
"12841","MTL","TOR",2017020063,17453,20172018,1,60.8,3,4,-1,7.15337327588689,3.44406630905723,3.70930696682966,34,22,12,41,30,11,55,57,-2,2,2,0,0
"12842","MTL","S.J",2017020091,17456,20172018,0,60,2,5,-3,5.09084963960777,8.21941910935533,-3.12856946974756,30,35,-5,40,49,-9,60,65,-5,6,7,0,0
"12843","MTL","L.A",2017020094,17457,20172018,0,60,1,5,-4,4.27026805588321,5.11369444804378,-0.843426392160572,37,42,-5,54,61,-7,72,80,-8,4,3,0,0
"12844","MTL","ANA",2017020109,17459,20172018,0,60,2,6,-4,6.89516234452799,7.37175874113644,-0.476596396608452,51,45,6,68,54,14,80,63,17,8,6,0,0
"12845","MTL","FLA",2017020130,17463,20172018,1,60,5,1,4,5.17399556812597,1.34853261846001,3.82546294966596,37,27,10,47,29,18,70,41,29,4,2,0,0
"12846","MTL","L.A",2017020142,17465,20172018,1,60,0,4,-4,4.31516445122179,5.92646493241773,-1.61130048119594,40,28,12,54,33,21,73,51,22,5,1,0,0
"12847","MTL","NYR",2017020158,17467,20172018,1,60,5,4,1,4.72605076070977,4.08292441873496,0.643126341974806,43,26,17,57,41,16,71,61,10,6,5,0,0
"12848","MTL","OTT",2017020173,17469,20172018,0,60,8,3,5,2.69816836223526,5.39630389937355,-2.69813553713828,29,28,1,40,42,-2,57,61,-4,7,8,0,0
"12849","MTL","MIN",2017020192,17472,20172018,0,60,3,6,-3,5.56550928906654,3.31695447604579,2.24855481302075,31,27,4,42,36,6,53,48,5,1,4,0,0
"12850","MTL","WPG",2017020206,17474,20172018,0,63.1166666666667,5,4,1,8.11417908588162,3.60449486854958,4.50968421733204,50,23,27,69,31,38,81,39,42,6,3,0,0
"12851","MTL","CHI",2017020215,17475,20172018,0,60,2,0,2,4.16219189754293,3.16860973963048,0.993582157912442,35,38,-3,47,51,-4,64,69,-5,3,3,0,0
"12852","MTL","VGK",2017020229,17477,20172018,1,60,3,2,1,5.07178899575956,9.31282020394377,-4.24103120818421,28,31,-3,41,48,-7,51,65,-14,2,2,0,0
"12853","MTL","MIN",2017020237,17479,20172018,1,60,0,3,-3,6.72338491989441,4.74767096256147,1.97571395733294,41,35,6,52,52,0,80,74,6,4,4,0,0
"12854","MTL","BUF",2017020251,17481,20172018,1,63.1333333333333,2,1,1,3.75501864361559,4.90604845841881,-1.15102981480322,29,35,-6,41,44,-3,53,50,3,1,3,0,0
"12855","MTL","CBJ",2017020268,17484,20172018,1,61.15,1,2,-1,3.42509915103346,4.630169524331,-1.20507037329753,29,25,4,41,36,5,67,58,9,2,2,0,0
"12856","MTL","ARI",2017020280,17486,20172018,1,60,4,5,-1,4.43143184669316,5.02639690319393,-0.594965056500769,37,32,5,52,44,8,72,55,17,6,7,0,0
"12857","MTL","TOR",2017020298,17488,20172018,1,60,0,6,-6,4.36445847882715,7.13362113962648,-2.76916266079934,33,31,2,41,44,-3,60,59,1,4,6,0,0
"12858","MTL","DAL",2017020318,17491,20172018,0,60,1,3,-2,0,0,0,30,29,1,47,44,3,56,61,-5,6,4,0,0
"12859","MTL","NSH",2017020329,17492,20172018,0,65,2,2,0,3.10079213387507,3.73786859575193,-0.637076461876859,29,33,-4,38,46,-8,50,59,-9,6,6,0,0
"12860","MTL","BUF",2017020349,17495,20172018,1,60,3,0,3,3.15006510462899,4.92035843139456,-1.77029332676557,26,36,-10,37,48,-11,52,78,-26,2,2,0,0
"12861","MTL","CBJ",2017020364,17497,20172018,1,60,3,1,2,4.22486953629414,4.14220345861395,0.0826660776801873,28,38,-10,37,50,-13,52,72,-20,3,5,0,0
"12862","MTL","OTT",2017020378,17499,20172018,1,60,2,1,1,4.4103326305136,4.55304080815404,-0.142708177640436,31,28,3,45,38,7,61,65,-4,3,3,0,0
"12863","MTL","DET",2017020382,17500,20172018,0,60,6,3,3,3.70432119312864,4.68863969446145,-0.984318501332812,25,31,-6,28,42,-14,41,57,-16,4,4,0,0
"12864","MTL","DET",2017020398,17502,20172018,1,60,10,1,9,2.77773540775524,6.04934795189263,-3.27161254413738,34,23,11,39,34,5,54,48,6,3,2,0,0
"12865","MTL","STL",2017020418,17505,20172018,1,60,3,4,-1,4.10753917958021,5.54757010073899,-1.44003092115878,25,30,-5,35,39,-4,49,58,-9,3,5,0,0
"12866","MTL","CGY",2017020432,17507,20172018,1,61.2333333333333,2,3,-1,8.71462787759839,7.7546541695192,0.95997370807919,37,37,0,54,54,0,73,76,-3,1,4,0,0
"12867","MTL","EDM",2017020445,17509,20172018,1,60,2,6,-4,3.39273046288872,6.79205520654796,-3.39932474365924,24,40,-16,36,55,-19,62,65,-3,3,4,0,0
"12868","MTL","N.J",2017020482,17514,20172018,1,61.8666666666667,2,1,1,6.36861719384774,8.20523143542224,-1.8366142415745,36,32,4,51,47,4,76,69,7,3,3,0,0
"12869","MTL","OTT",2017020498,17516,20172018,0,60,0,3,-3,4.55473296484679,8.71165229273,-4.15691932788322,28,38,-10,34,48,-14,53,67,-14,1,3,0,0
"12870","MTL","VAN",2017020524,17519,20172018,0,60,7,5,2,4.9855438074519,5.06514631466416,-0.0796025072122575,32,39,-7,38,52,-14,49,72,-23,3,3,0,0
"12871","MTL","CGY",2017020541,17522,20172018,0,60,3,2,1,5.28849566204008,4.30346465687035,0.985031005169731,35,23,12,48,45,3,55,66,-11,1,3,0,0
"12872","MTL","EDM",2017020552,17523,20172018,0,60,1,4,-3,5.85751149134012,6.03398921880139,-0.176477727461275,30,35,-5,41,53,-12,62,69,-7,2,3,0,0
"12873","MTL","CAR",2017020563,17527,20172018,0,60,1,3,-2,4.33676294360339,7.80342094832304,-3.46665800471965,24,36,-12,32,50,-18,44,65,-21,2,3,0,0
"12874","MTL","T.B",2017020570,17528,20172018,0,60,1,3,-2,2.5357772551678,4.97711154131684,-2.44133428614904,32,34,-2,45,47,-2,61,62,-1,4,7,0,0
"12875","MTL","FLA",2017020588,17530,20172018,0,60,0,2,-2,6.22445907871228,5.45450042613083,0.769958652581443,38,33,5,46,46,0,63,61,2,0,3,0,0
"12876","MTL","S.J",2017020606,17533,20172018,1,60,1,4,-3,4.59757850524335,5.82717879682134,-1.22960029157799,31,33,-2,42,47,-5,57,57,0,5,4,0,0
"12877","MTL","T.B",2017020620,17535,20172018,1,65,1,1,0,5.0102223226786,5.85000848214267,-0.839786159464069,38,45,-7,44,54,-10,73,73,0,2,2,0,0
"12878","MTL","VAN",2017020648,17538,20172018,1,60,5,2,3,7.52943326490868,3.80367919921412,3.72575406569456,45,36,9,55,47,8,79,60,19,3,3,0,0
"12879","MTL","BOS",2017020672,17544,20172018,1,65,3,3,0,5.06047549497453,2.89882468117526,2.16165081379927,30,32,-2,46,36,10,61,50,11,5,2,0,0
"12880","MTL","NYI",2017020686,17546,20172018,1,61.85,4,5,-1,11.8336130031603,2.1805063648535,9.65310663830678,56,24,32,69,33,36,85,51,34,4,2,0,0
"12881","MTL","BOS",2017020693,17548,20172018,0,60,1,4,-3,4.69177885481622,5.50690838446747,-0.815129529651244,22,32,-10,29,42,-13,39,63,-24,2,3,0,0
"12882","MTL","WSH",2017020706,17550,20172018,0,60,3,2,1,4.04894444507346,3.05268363113811,0.996260813935347,26,26,0,48,43,5,67,61,6,5,4,0,0
"12883","MTL","BOS",2017020712,17551,20172018,1,60,1,4,-3,3.40812155535241,5.04353584803175,-1.63541429267934,25,31,-6,32,39,-7,45,61,-16,1,3,0,0
"12884","MTL","COL",2017020734,17554,20172018,1,60,4,2,2,6.29853512751288,3.73142966794853,2.56710545956435,40,22,18,51,31,20,65,48,17,4,4,0,0
"12885","MTL","CAR",2017020749,17556,20172018,1,60,5,6,-1,4.6020041559641,4.43573195157251,0.166272204391589,31,29,2,39,37,2,53,61,-8,3,2,0,0
"12886","MTL","STL",2017020767,17561,20172018,0,60,1,3,-2,3.6268825272582,5.39615517692886,-1.76927264967065,34,31,3,45,42,3,65,63,2,1,3,0,0
"12887","MTL","CAR",2017020780,17563,20172018,0,60,0,2,-2,7.0576772322529,6.60181154725797,0.455865684994933,27,30,-3,42,49,-7,55,64,-9,1,3,0,0
"12888","MTL","ANA",2017020792,17565,20172018,1,60,5,2,3,0,0,0,29,45,-16,38,63,-25,54,90,-36,7,4,0,0
"12889","MTL","OTT",2017020806,17566,20172018,1,60,4,1,3,7.4266969083983,6.34365352758323,1.08304338081507,35,26,9,45,34,11,70,54,16,3,2,0,0
"12890","MTL","PHI",2017020828,17570,20172018,0,60,3,5,-2,3.61676784635478,5.08063381658576,-1.46386597023098,28,28,0,42,35,7,58,43,15,4,5,0,0
"12891","MTL","NSH",2017020845,17572,20172018,1,65,2,2,0,5.96005333596736,5.21564495603565,0.744408379931705,49,32,17,63,43,20,85,66,19,4,4,0,0
"12892","MTL","COL",2017020877,17576,20172018,0,60,0,2,-2,9.43565062404377,2.99535183305852,6.44029879098525,44,25,19,61,34,27,79,47,32,4,2,0,0
"12893","MTL","ARI",2017020887,17577,20172018,0,60,2,5,-3,5.92522674566135,2.72512215177204,3.20010459388931,36,21,15,61,29,32,85,47,38,4,3,0,0
"12894","MTL","VGK",2017020900,17579,20172018,0,60,3,6,-3,3.99922926758882,4.50305407455381,-0.503824806964994,33,34,-1,47,43,4,65,59,6,2,2,0,0
"12895","MTL","PHI",2017020920,17582,20172018,0,61.4333333333333,2,3,-1,4.9835586930284,4.2922881556151,0.691270537413304,27,33,-6,39,52,-13,55,79,-24,0,3,0,0
"12896","MTL","NYR",2017020933,17584,20172018,1,60,3,1,2,5.5634567785263,6.88368782717378,-1.32023104864747,41,32,9,51,49,2,75,63,12,5,4,0,0
"12897","MTL","T.B",2017020949,17586,20172018,1,65,3,3,0,6.79102877585683,6.67041299419662,0.120615781660211,32,39,-7,45,62,-17,62,83,-21,5,6,0,0
"12898","MTL","PHI",2017020965,17588,20172018,1,65,0,0,0,5.93828494497575,6.10695560323074,-0.168670658254996,28,33,-5,40,49,-9,56,66,-10,3,5,0,0
"12899","MTL","NYI",2017020978,17590,20172018,1,60,3,1,2,2.38719246041728,7.36705988932988,-4.9798674289126,26,28,-2,34,50,-16,50,82,-32,2,2,0,0
"12900","MTL","NYI",2017020991,17592,20172018,0,60,6,3,3,4.38319891458377,2.4494745728407,1.93372434174307,25,35,-10,37,49,-12,42,62,-20,3,4,0,0
"12901","MTL","BOS",2017021003,17593,20172018,0,62.1,1,2,-1,3.35984177531921,6.20381923381905,-2.84397745849983,28,50,-22,39,70,-31,45,88,-43,4,6,0,0
"12902","MTL","N.J",2017021021,17596,20172018,0,60,4,6,-2,5.97151998826303,5.50941944097061,0.462100547292413,33,33,0,48,40,8,64,51,13,3,5,0,0
"12903","MTL","FLA",2017021038,17598,20172018,0,60,0,5,-5,4.62985882856447,4.70353026692273,-0.0736714383582626,40,32,8,50,44,6,73,54,19,4,2,0,0
"12904","MTL","T.B",2017021050,17600,20172018,0,65,2,2,0,5.09367720386945,5.08239779734868,0.0112794065207709,29,34,-5,39,52,-13,53,66,-13,4,5,0,0
"12905","MTL","CBJ",2017021066,17602,20172018,0,60,2,5,-3,6.12143871454828,3.88712412982568,2.2343145847226,40,25,15,54,35,19,74,45,29,2,3,0,0
"12906","MTL","DAL",2017021072,17603,20172018,1,60,4,2,2,3.65313932867139,6.10358489945065,-2.45044557077927,26,38,-12,35,49,-14,53,68,-15,5,5,0,0
"12907","MTL","PIT",2017021086,17605,20172018,1,60,3,5,-2,1.98702410096303,6.96348258347996,-4.97645848251693,20,39,-19,32,52,-20,48,66,-18,1,2,0,0
"12908","MTL","TOR",2017021101,17607,20172018,0,60,0,4,-4,0,0,0,33,49,-16,40,71,-31,59,89,-30,1,4,0,0
"12909","MTL","FLA",2017021118,17609,20172018,1,60,0,2,-2,6.01632318260447,5.7705810238371,0.245742158767375,28,40,-12,36,58,-22,49,79,-30,6,3,0,0
"12910","MTL","PIT",2017021133,17611,20172018,0,60,3,5,-2,3.19320352631621,5.14936339407996,-1.95615986776374,30,39,-9,37,51,-14,55,66,-11,4,4,0,0
"12911","MTL","BUF",2017021146,17613,20172018,0,60,3,0,3,3.46654642875365,4.22215433428221,-0.755607905528563,24,35,-11,34,48,-14,40,56,-16,2,2,0,0
"12912","MTL","WSH",2017021154,17614,20172018,1,60,4,6,-2,3.02258528353741,2.51904377649316,0.503541507044247,21,30,-9,33,40,-7,47,53,-6,3,3,0,0
"12913","MTL","DET",2017021172,17616,20172018,1,60,4,2,2,5.88027078291634,3.23244435840752,2.64782642450882,31,28,3,44,38,6,64,53,11,5,3,0,0
"12914","MTL","PIT",2017021211,17621,20172018,0,60,2,5,-3,2.71311776664817,4.8789078786649,-2.16579011201673,26,33,-7,37,42,-5,53,54,-1,1,5,0,0
"12915","MTL","N.J",2017021220,17622,20172018,1,60,1,2,-1,3.83249307632445,3.32806640156195,0.504426674762499,26,32,-6,34,38,-4,51,53,-2,4,5,0,0
"12916","MTL","WPG",2017021232,17624,20172018,1,63,4,5,-1,5.36101633223007,3.74091376868873,1.62010256354134,40,32,8,54,40,14,73,49,24,7,4,0,0
"12917","MTL","DET",2017021246,17626,20172018,0,60,4,3,1,4.28700549752102,2.48330542305484,1.80370007446618,28,26,2,37,35,2,49,43,6,1,3,0,0
"12918","MTL","TOR",2017021259,17628,20172018,0,60,2,4,-2,6.73983625972505,3.47658440035019,3.26325185937486,33,30,3,46,46,0,59,67,-8,4,5,0,0
"12919","MTL","TOR",2018020001,17807,20182019,0,61.0166666666667,2,3,-1,4.82973710649821,2.97456685151155,1.85517025498666,36,26,10,52,44,8,76,60,16,4,3,0,0
"12920","MTL","PIT",2018020022,17810,20182019,0,60,5,1,4,3.94219554685696,3.36116193878115,0.581033608075813,29,22,7,35,34,1,42,56,-14,3,3,0,0
"12921","MTL","L.A",2018020051,17815,20182019,1,60,0,3,-3,4.54104574197683,2.09001526911217,2.45103047286466,40,29,11,51,30,21,73,41,32,4,3,0,0
"12922","MTL","PIT",2018020062,17817,20182019,1,65,3,3,0,4.86912687709891,3.30780023612231,1.5613266409766,40,28,12,53,38,15,78,48,30,6,2,0,0
"12923","MTL","DET",2018020075,17819,20182019,1,60,7,3,4,7.61766853230073,2.72072520980146,4.89694332249927,35,28,7,40,46,-6,60,66,-6,7,3,0,0
"12924","MTL","STL",2018020086,17821,20182019,1,60,3,2,1,3.71476026906053,4.03245806206152,-0.317697793000987,23,25,-2,33,36,-3,56,55,1,4,5,0,0
"12925","MTL","OTT",2018020107,17824,20182019,0,62.5,3,4,-1,3.79614251283774,3.31660772413521,0.479534788702535,27,34,-7,37,41,-4,57,52,5,3,4,0,0
"12926","MTL","CGY",2018020124,17827,20182019,1,60,3,2,1,4.90193987480262,3.22401251913794,1.67792735566468,40,23,17,49,34,15,63,54,9,5,5,0,0
"12927","MTL","BUF",2018020135,17829,20182019,0,60,3,4,-1,3.19648405880434,5.63679733805475,-2.4403132792504,22,42,-20,32,57,-25,45,66,-21,2,4,0,0
"12928","MTL","BOS",2018020152,17831,20182019,0,60,3,0,3,4.71460279838357,4.94410165734007,-0.229498858956504,23,33,-10,35,44,-9,43,56,-13,4,4,0,0
"12929","MTL","DAL",2018020171,17834,20182019,1,60,1,4,-3,3.32777548937388,4.0600023534389,-0.732226864065025,35,22,13,48,31,17,63,40,23,6,7,0,0
"12930","MTL","WSH",2018020182,17836,20182019,1,60,3,4,-1,3.78110186383128,1.62602027218909,2.15508159164219,35,28,7,43,35,8,62,49,13,3,1,0,0
"12931","MTL","T.B",2018020196,17838,20182019,1,60,1,4,-3,5.915297814121,3.5005019720993,2.4147958420217,35,36,-1,54,47,7,77,64,13,4,3,0,0
"12932","MTL","NYI",2018020211,17840,20182019,0,65,3,3,0,5.64827057626098,4.05445112939924,1.59381944686174,35,24,11,47,35,12,70,50,20,4,5,0,0
"12933","MTL","NYR",2018020216,17841,20182019,0,60,3,5,-2,4.40173690444317,3.55553497246807,0.846201931975097,34,32,2,46,41,5,60,57,3,9,8,0,0
"12934","MTL","BUF",2018020230,17843,20182019,1,61.6333333333333,5,6,-1,4.99600288202979,3.68915456484274,1.30684831718705,37,31,6,49,35,14,65,50,15,5,3,0,0
"12935","MTL","VGK",2018020246,17845,20182019,1,60,5,4,1,4.24583990644896,5.40877822400395,-1.16293831755499,27,38,-11,36,47,-11,59,58,1,2,3,0,0
"12936","MTL","EDM",2018020270,17848,20182019,0,60,2,6,-4,3.82252061056156,5.82733243422717,-2.00481182366561,29,43,-14,38,59,-21,52,77,-25,5,5,0,0
"12937","MTL","CGY",2018020283,17850,20182019,0,60,3,2,1,2.78157359909528,3.44290299161803,-0.661329392522745,22,45,-23,29,61,-32,49,76,-27,2,1,0,0
"12938","MTL","VAN",2018020298,17852,20182019,0,60,3,2,1,5.10652357366416,5.85791024512173,-0.751386671457567,31,38,-7,48,48,0,63,64,-1,3,4,0,0
"12939","MTL","WSH",2018020311,17854,20182019,1,63.5666666666667,4,5,-1,6.59111948728969,5.37956635720911,1.21155313008057,44,34,10,53,45,8,71,60,11,4,3,0,0
"12940","MTL","N.J",2018020319,17856,20182019,0,60,2,5,-3,5.63843620248372,2.96333638498868,2.67509981749504,26,28,-2,39,37,2,50,48,2,2,1,0,0
"12941","MTL","BUF",2018020333,17858,20182019,0,63.1,2,3,-1,5.80080634790978,7.92816605698317,-2.1273597090734,33,40,-7,48,50,-2,64,62,2,2,4,0,0
"12942","MTL","BOS",2018020349,17859,20182019,1,60,2,3,-1,3.0513285994889,4.33721807976082,-1.28588948027191,33,35,-2,50,48,2,78,65,13,7,7,0,0
"12943","MTL","CAR",2018020369,17862,20182019,1,60,1,2,-1,7.81268414234,4.91301460636896,2.89966953597104,49,22,27,67,32,35,93,47,46,3,1,0,0
"12944","MTL","NYR",2018020398,17866,20182019,1,60,5,2,3,6.47644574126856,3.71096211702024,2.76548362424832,41,22,19,52,38,14,62,53,9,3,3,0,0
"12945","MTL","S.J",2018020409,17867,20182019,1,60,1,3,-2,6.69311306333111,4.94260461830709,1.75050844502402,41,29,12,51,43,8,73,62,11,2,4,0,0
"12946","MTL","OTT",2018020421,17869,20182019,1,60,5,2,3,8.55737600848079,6.42608244890611,2.13129355957468,41,30,11,58,39,19,84,49,35,4,5,0,0
"12947","MTL","OTT",2018020433,17871,20182019,0,60,5,2,3,6.09965068509337,1.58866584381832,4.51098484127504,43,21,22,56,26,30,72,38,34,3,1,0,0
"12948","MTL","CHI",2018020457,17874,20182019,0,60,3,2,1,3.8741104435212,3.27214286390199,0.601967579619213,28,39,-11,39,48,-9,48,68,-20,4,7,0,0
"12949","MTL","MIN",2018020472,17876,20182019,0,60,1,7,-6,5.84907568645945,6.35440635103805,-0.505330664578604,30,32,-2,45,43,2,62,51,11,1,4,0,0
"12950","MTL","CAR",2018020481,17878,20182019,1,60,6,4,2,7.81014237926865,6.21376163257943,1.59638074668922,40,31,9,53,44,9,70,55,15,7,3,0,0
"12951","MTL","OTT",2018020496,17880,20182019,1,60,5,2,3,7.01555259980159,2.20648429589346,4.80906830390813,47,18,29,58,23,35,83,32,51,6,4,0,0
"12952","MTL","BOS",2018020514,17882,20182019,1,60,0,4,-4,2.69375051290262,4.04743793784041,-1.35368742493778,22,35,-13,34,45,-11,51,63,-12,4,4,0,0
"12953","MTL","COL",2018020529,17884,20182019,0,60,1,2,-1,4.9289699607465,2.57833089527048,2.35063906547602,36,26,10,55,33,22,81,40,41,4,4,0,0
"12954","MTL","ARI",2018020538,17885,20182019,0,60,2,1,1,3.42973396624438,3.90951141732373,-0.479777451079343,28,37,-9,33,52,-19,50,65,-15,3,4,0,0
"12955","MTL","VGK",2018020549,17887,20182019,0,61.9833333333333,4,3,1,7.69873612401716,4.64370352096739,3.05503260304977,47,26,21,71,41,30,93,58,35,2,2,0,0
"12956","MTL","FLA",2018020580,17893,20182019,0,60,5,3,2,5.32933061069343,4.57380572071088,0.755524889982553,28,26,2,41,36,5,52,47,5,3,3,0,0
"12957","MTL","T.B",2018020590,17894,20182019,0,60,5,6,-1,5.82102458556983,5.10038796261688,0.720636622952952,38,32,6,51,44,7,65,59,6,3,3,0,0
"12958","MTL","DAL",2018020608,17896,20182019,0,60.2333333333333,3,2,1,5.38536805848531,4.48111423212108,0.904253826364235,38,47,-9,47,54,-7,72,76,-4,2,2,0,0
"12959","MTL","VAN",2018020626,17899,20182019,1,60,2,0,2,4.44598528080678,2.7701634868572,1.67582179394958,27,33,-6,38,45,-7,56,67,-11,3,5,0,0
"12960","MTL","NSH",2018020640,17901,20182019,1,60,1,4,-3,6.10511724198841,7.25350344672916,-1.14838620474075,28,32,-4,46,41,5,64,53,11,1,2,0,0
"12961","MTL","MIN",2018020654,17903,20182019,1,60,0,1,-1,4.91352980060037,3.42702905548504,1.48650074511534,32,25,7,41,34,7,60,55,5,5,3,0,0
"12962","MTL","DET",2018020662,17904,20182019,0,60,3,2,1,3.18121827605864,5.2120903717182,-2.03087209565956,25,32,-7,33,44,-11,42,63,-21,2,5,0,0
"12963","MTL","STL",2018020677,17906,20182019,0,60,1,4,-3,3.35316687652039,5.8208932171774,-2.46772634065701,29,30,-1,45,45,0,62,52,10,7,6,0,0
"12964","MTL","COL",2018020691,17908,20182019,1,60,3,0,3,5.50590917374018,4.60861927833739,0.897289895402793,31,28,3,48,36,12,79,56,23,4,5,0,0
"12965","MTL","BOS",2018020705,17910,20182019,0,60.25,3,2,1,2.30169738481345,5.32751434430247,-3.02581695948902,22,43,-21,36,59,-23,50,70,-20,2,5,0,0
"12966","MTL","FLA",2018020714,17911,20182019,1,60,5,1,4,5.02036985785354,8.34073365367658,-3.32036379582304,28,53,-25,48,68,-20,60,84,-24,4,5,0,0
"12967","MTL","CBJ",2018020734,17914,20182019,0,60,4,1,3,5.91900803669341,2.33050278317203,3.58850525352138,26,35,-9,37,46,-9,48,53,-5,3,2,0,0
"12968","MTL","PHI",2018020743,17915,20182019,1,60,2,5,-3,2.64991684716826,4.11780781717971,-1.46789097001145,35,24,11,47,33,14,70,51,19,1,2,0,0
"12969","MTL","ARI",2018020766,17919,20182019,1,60,2,1,1,5.88464377999154,5.92068501355484,-0.0360412335633038,24,31,-7,35,42,-7,55,58,-3,2,3,0,0
"12970","MTL","N.J",2018020790,17929,20182019,1,61.9333333333333,2,3,-1,6.99013402529458,4.99256174110269,1.99757228419189,39,27,12,55,33,22,79,39,40,3,3,0,0
"12971","MTL","EDM",2018020803,17930,20182019,1,60.9666666666667,4,3,1,4.65922110673637,5.13349076290615,-0.474269656169781,27,24,3,40,35,5,63,51,12,5,5,0,0
"12972","MTL","ANA",2018020815,17932,20182019,1,60,4,1,3,3.81935157408589,2.20939037998832,1.60996119409756,32,25,7,46,29,17,65,48,17,3,1,0,0
"12973","MTL","WPG",2018020828,17934,20182019,1,60,5,2,3,6.30595423901275,4.68301368480024,1.62294055421251,53,34,19,60,39,21,83,56,27,4,4,0,0
"12974","MTL","TOR",2018020846,17936,20182019,1,62.2833333333333,3,4,-1,4.42946968760649,7.50457042364341,-3.07510073603692,38,32,6,45,45,0,72,59,13,4,3,0,0
"12975","MTL","NSH",2018020881,17941,20182019,0,60,1,3,-2,4.26867840387786,4.02631449458568,0.24236390929218,35,38,-3,44,44,0,59,58,1,3,3,0,0
"12976","MTL","T.B",2018020895,17943,20182019,0,60,0,3,-3,1.83412706613308,4.41119041610653,-2.57706334997345,20,37,-17,26,47,-21,39,61,-22,3,5,0,0
"12977","MTL","FLA",2018020908,17944,20182019,0,60,3,6,-3,3.65389695078193,9.30691390430718,-5.65301695352525,31,36,-5,43,50,-7,55,58,-3,3,3,0,0
"12978","MTL","CBJ",2018020920,17946,20182019,1,60,3,2,1,4.05550371285062,4.48825592549501,-0.432752212644388,32,33,-1,49,44,5,69,56,13,3,2,0,0
"12979","MTL","PHI",2018020934,17948,20182019,1,60,5,1,4,7.58233830815941,5.4999470042078,2.08239130395161,40,30,10,48,42,6,64,58,6,1,4,0,0
"12980","MTL","TOR",2018020952,17950,20182019,0,60,3,6,-3,3.26787215541368,5.71809000248777,-2.45021784707409,35,37,-2,49,51,-2,69,70,-1,4,2,0,0
"12981","MTL","N.J",2018020963,17952,20182019,0,60,1,2,-1,5.18447188086562,2.71872710224925,2.46574477861637,35,22,13,52,31,21,63,42,21,5,6,0,0
"12982","MTL","DET",2018020974,17953,20182019,0,60,8,1,7,7.43460893659441,4.11621636521886,3.31839257137555,34,29,5,46,45,1,57,62,-5,1,6,0,0
"12983","MTL","NYR",2018020994,17956,20182019,0,60,4,2,2,4.35136867017718,3.89315728496877,0.458211385208415,36,30,6,42,40,2,49,56,-7,3,3,0,0
"12984","MTL","PIT",2018021003,17957,20182019,1,60,1,5,-4,5.22049296181649,3.71560791434577,1.50488504747072,37,25,12,57,34,23,77,43,34,3,3,0,0
"12985","MTL","L.A",2018021028,17960,20182019,0,60,3,1,2,2.51615015965945,4.66325623478042,-2.14710607512097,24,27,-3,36,37,-1,47,53,-6,1,2,0,0
"12986","MTL","S.J",2018021043,17962,20182019,0,60,2,5,-3,6.91311988670714,5.39166389553975,1.52145599116739,39,25,14,54,33,21,67,46,21,1,0,0,0
"12987","MTL","ANA",2018021047,17963,20182019,0,60,2,8,-6,3.05131424343563,6.13225885114018,-3.08094460770455,37,29,8,53,43,10,69,53,16,6,3,0,0
"12988","MTL","DET",2018021075,17967,20182019,1,60,3,1,2,8.48291953100467,2.28646629711147,6.19645323389319,36,21,15,58,31,27,82,42,40,2,2,0,0
"12989","MTL","NYI",2018021084,17969,20182019,0,60,1,2,-1,4.65185634462978,6.19650692549658,-1.5446505808668,34,38,-4,48,53,-5,58,69,-11,2,2,0,0
"12990","MTL","CHI",2018021103,17971,20182019,1,60,0,2,-2,6.72489829163533,4.46487470404827,2.26002358758706,48,24,24,67,35,32,91,46,45,4,2,0,0
"12991","MTL","PHI",2018021125,17974,20182019,0,60,3,1,2,5.08156207208458,5.88076548858953,-0.799203416504952,36,33,3,42,51,-9,64,68,-4,2,2,0,0
"12992","MTL","NYI",2018021139,17976,20182019,1,60,4,0,4,2.95724402753709,5.67043119319715,-2.71318716566006,34,28,6,45,33,12,64,50,14,2,3,0,0
"12993","MTL","BUF",2018021155,17978,20182019,1,60,7,4,3,7.04157259544218,3.94903187995078,3.0925407154914,44,27,17,52,39,13,63,48,15,2,4,0,0
"12994","MTL","CAR",2018021166,17979,20182019,0,63.25,1,2,-1,3.68416467802217,5.86736604204634,-2.18320136402417,29,40,-11,41,72,-31,53,91,-38,1,3,0,0
"12995","MTL","FLA",2018021180,17981,20182019,1,60,6,1,5,5.96569971559063,5.0628512985988,0.90284841699183,27,34,-7,41,46,-5,64,59,5,2,3,0,0
"12996","MTL","CBJ",2018021191,17983,20182019,0,60,2,6,-4,5.74053298766376,6.11679389676442,-0.376260909100665,28,30,-2,40,41,-1,53,52,1,2,2,0,0
"12997","MTL","WPG",2018021209,17985,20182019,0,60,3,1,2,7.58855910783313,5.36219023691956,2.22636887091357,44,24,20,51,36,15,59,45,14,3,0,0,0
"12998","MTL","T.B",2018021232,17988,20182019,1,60,4,2,2,9.00834462173043,4.9157351606118,4.09260946111863,45,24,21,68,37,31,92,52,40,3,1,0,0
"12999","MTL","WSH",2018021246,17990,20182019,0,60,1,2,-1,4.26353700320396,5.80799787814249,-1.54446087493852,34,31,3,53,36,17,72,44,28,1,1,0,0
"13000","MTL","TOR",2018021259,17992,20182019,1,65,5,5,0,5.32493842466556,7.25123605571935,-1.92629763105379,49,49,0,61,64,-3,72,85,-13,1,1,0,0
"13001","N.J","NYI",2008020009,14162,20082009,1,60,2,1,1,0,0,0,29,26,3,42,33,9,58,41,17,6,8,0,0
"13002","N.J","PIT",2008020022,14163,20082009,0,64.3666666666667,2,1,1,0,0,0,49,15,34,61,27,34,88,38,50,5,5,0,0
"13003","N.J","NYR",2008020034,14165,20082009,0,60,1,4,-3,0,0,0,27,24,3,39,32,7,58,45,13,5,6,0,0
"13004","N.J","ATL",2008020049,14168,20082009,0,60,1,0,1,0,0,0,35,25,10,45,37,8,63,47,16,3,5,0,0
"13005","N.J","WSH",2008020067,14170,20082009,0,65,3,3,0,0,0,0,37,27,10,45,43,2,58,58,0,4,8,0,0
"13006","N.J","DAL",2008020088,14174,20082009,1,60,5,0,5,0,0,0,29,21,8,38,25,13,46,35,11,5,5,0,0
"13007","N.J","PHI",2008020100,14176,20082009,1,60,3,6,-3,0,0,0,26,28,-2,33,39,-6,42,41,1,3,2,0,0
"13008","N.J","PHI",2008020110,14177,20082009,0,63.7333333333333,2,3,-1,0,0,0,31,33,-2,35,50,-15,48,60,-12,6,5,0,0
"13009","N.J","TOR",2008020133,14181,20082009,1,65,5,5,0,0,0,0,31,48,-17,45,57,-12,59,71,-12,3,4,0,0
"13010","N.J","ATL",2008020154,14184,20082009,1,60,6,1,5,0,0,0,32,20,12,40,32,8,46,42,4,6,3,0,0
"13011","N.J","BUF",2008020168,14186,20082009,1,60,0,2,-2,0,0,0,24,30,-6,41,42,-1,54,61,-7,8,6,0,0
"13012","N.J","T.B",2008020178,14188,20082009,1,65,3,3,0,0,0,0,38,27,11,46,34,12,61,46,15,2,3,0,0
"13013","N.J","DET",2008020201,14191,20082009,0,60,1,3,-2,0,0,0,25,31,-6,33,43,-10,38,53,-15,3,4,0,0
"13014","N.J","EDM",2008020209,14192,20082009,1,60,1,2,-1,0,0,0,38,28,10,57,31,26,68,42,26,2,3,0,0
"13015","N.J","NYR",2008020222,14195,20082009,1,60,2,5,-3,0,0,0,32,42,-10,38,49,-11,45,66,-21,5,7,0,0
"13016","N.J","WSH",2008020236,14197,20082009,0,60,1,3,-2,0,0,0,33,27,6,47,42,5,67,61,6,2,1,0,0
"13017","N.J","WSH",2008020243,14198,20082009,1,65,5,5,0,0,0,0,33,30,3,57,44,13,77,63,14,4,2,0,0
"13018","N.J","FLA",2008020271,14203,20082009,1,60,3,1,2,0,0,0,19,24,-5,36,28,8,45,40,5,2,2,0,0
"13019","N.J","NYI",2008020280,14204,20082009,1,60,5,2,3,0,0,0,33,27,6,47,35,12,66,46,20,6,4,0,0
"13020","N.J","T.B",2008020298,14206,20082009,0,60,7,3,4,0,0,0,45,29,16,62,38,24,70,49,21,2,4,0,0
"13021","N.J","FLA",2008020315,14209,20082009,0,64.0666666666667,3,2,1,0,0,0,37,38,-1,49,46,3,58,56,2,4,5,0,0
"13022","N.J","PIT",2008020341,14212,20082009,0,60,1,4,-3,0,0,0,30,35,-5,46,49,-3,68,61,7,6,7,0,0
"13023","N.J","PHI",2008020367,14217,20082009,0,62.7666666666667,3,2,1,0,0,0,31,31,0,46,42,4,63,63,0,5,7,0,0
"13024","N.J","MTL",2008020381,14219,20082009,0,60.5166666666667,2,1,1,0,0,0,31,26,5,45,38,7,62,60,2,4,5,0,0
"13025","N.J","PIT",2008020406,14223,20082009,1,60,4,1,3,0,0,0,32,27,5,38,38,0,55,43,12,7,6,0,0
"13026","N.J","NYR",2008020422,14225,20082009,1,60,8,5,3,0,0,0,34,36,-2,38,55,-17,47,69,-22,6,11,0,0
"13027","N.J","BUF",2008020434,14226,20082009,1,60,2,4,-2,0,0,0,22,34,-12,32,40,-8,41,46,-5,1,3,0,0
"13028","N.J","TOR",2008020449,14229,20082009,0,65,2,2,0,0,0,0,27,27,0,48,41,7,69,59,10,3,2,0,0
"13029","N.J","BUF",2008020455,14230,20082009,0,60,5,3,2,0,0,0,30,26,4,36,41,-5,46,52,-6,5,5,0,0
"13030","N.J","OTT",2008020469,14232,20082009,1,60,5,1,4,0,0,0,26,25,1,34,34,0,44,40,4,4,3,0,0
"13031","N.J","PHI",2008020489,14234,20082009,1,65,2,2,0,0,0,0,26,29,-3,40,36,4,51,42,9,5,1,0,0
"13032","N.J","BOS",2008020494,14236,20082009,1,60,0,2,-2,0,0,0,25,24,1,34,33,1,42,39,3,3,4,0,0
"13033","N.J","PIT",2008020507,14239,20082009,1,60,0,1,-1,0,0,0,37,18,19,50,24,26,59,29,30,5,6,0,0
"13034","N.J","NYR",2008020520,14240,20082009,0,60,4,2,2,0,0,0,35,33,2,53,41,12,59,57,2,4,4,0,0
"13035","N.J","STL",2008020544,14243,20082009,0,60,4,3,1,0,0,0,26,31,-5,38,44,-6,55,53,2,3,1,0,0
"13036","N.J","DAL",2008020551,14244,20082009,0,60,2,4,-2,0,0,0,27,44,-17,37,62,-25,46,69,-23,4,4,0,0
"13037","N.J","MTL",2008020559,14246,20082009,1,60,4,1,3,0,0,0,29,34,-5,41,38,3,48,47,1,3,4,0,0
"13038","N.J","OTT",2008020578,14248,20082009,1,61.7166666666667,4,3,1,0,0,0,35,20,15,47,29,18,59,34,25,5,5,0,0
"13039","N.J","CAR",2008020588,14250,20082009,0,60,2,3,-1,0,0,0,28,28,0,46,36,10,62,51,11,2,3,0,0
"13040","N.J","ATL",2008020599,14252,20082009,1,60,0,4,-4,0,0,0,29,24,5,41,31,10,54,37,17,7,5,0,0
"13041","N.J","L.A",2008020625,14254,20082009,0,60,5,1,4,0,0,0,28,35,-7,36,49,-13,50,62,-12,7,4,0,0
"13042","N.J","ANA",2008020628,14255,20082009,0,60,3,4,-1,0,0,0,21,34,-13,27,44,-17,33,51,-18,2,4,0,0
"13043","N.J","VAN",2008020640,14257,20082009,0,60,5,3,2,0,0,0,28,29,-1,37,41,-4,44,54,-10,2,4,0,0
"13044","N.J","CBJ",2008020656,14260,20082009,0,60,2,1,1,0,0,0,28,27,1,34,35,-1,47,48,-1,1,3,0,0
"13045","N.J","NYI",2008020665,14261,20082009,0,60,3,1,2,0,0,0,36,33,3,50,52,-2,74,71,3,1,2,0,0
"13046","N.J","NSH",2008020683,14263,20082009,0,60,3,1,2,0,0,0,35,34,1,45,45,0,58,58,0,3,5,0,0
"13047","N.J","MTL",2008020692,14265,20082009,1,60,5,2,3,0,0,0,34,28,6,47,39,8,55,47,8,3,6,0,0
"13048","N.J","OTT",2008020704,14271,20082009,0,60,4,1,3,0,0,0,27,22,5,32,34,-2,44,51,-7,4,4,0,0
"13049","N.J","BOS",2008020716,14273,20082009,0,61.1833333333333,4,3,1,0,0,0,30,27,3,41,37,4,47,53,-6,1,4,0,0
"13050","N.J","PIT",2008020725,14274,20082009,1,64,4,3,1,0,0,0,43,16,27,54,19,35,65,22,43,6,3,0,0
"13051","N.J","WSH",2008020748,14278,20082009,1,60,2,5,-3,0,0,0,34,26,8,46,38,8,59,48,11,4,4,0,0
"13052","N.J","ATL",2008020774,14281,20082009,0,60,5,1,4,0,0,0,31,32,-1,37,39,-2,46,58,-12,7,8,0,0
"13053","N.J","L.A",2008020782,14282,20082009,1,60,1,3,-2,0,0,0,26,32,-6,37,44,-7,47,52,-5,6,7,0,0
"13054","N.J","NYR",2008020793,14284,20082009,1,60,3,0,3,0,0,0,31,27,4,43,35,8,46,48,-2,7,7,0,0
"13055","N.J","NYI",2008020802,14286,20082009,1,60,4,2,2,0,0,0,50,25,25,63,32,31,71,40,31,5,3,0,0
"13056","N.J","BOS",2008020818,14288,20082009,1,60,1,0,1,0,0,0,18,31,-13,27,37,-10,33,55,-22,2,2,0,0
"13057","N.J","S.J",2008020834,14290,20082009,1,60,6,5,1,0,0,0,29,32,-3,39,38,1,49,48,1,8,5,0,0
"13058","N.J","FLA",2008020850,14292,20082009,0,60,0,4,-4,0,0,0,36,28,8,44,37,7,65,50,15,5,4,0,0
"13059","N.J","T.B",2008020864,14294,20082009,0,65,2,2,0,0,0,0,40,41,-1,47,54,-7,70,70,0,4,4,0,0
"13060","N.J","NYI",2008020881,14296,20082009,0,60,0,4,-4,0,0,0,40,38,2,47,50,-3,60,73,-13,3,5,0,0
"13061","N.J","COL",2008020909,14301,20082009,1,60,4,0,4,0,0,0,32,24,8,47,32,15,61,36,25,4,3,0,0
"13062","N.J","FLA",2008020924,14303,20082009,1,60,7,2,5,0,0,0,46,17,29,58,19,39,63,23,40,3,3,0,0
"13063","N.J","PHI",2008020934,14304,20082009,1,60,3,0,3,0,0,0,42,27,15,48,30,18,60,45,15,5,3,0,0
"13064","N.J","TOR",2008020945,14306,20082009,0,64.8,3,2,1,0,0,0,52,32,20,70,47,23,100,61,39,4,4,0,0
"13065","N.J","NYI",2008020970,14310,20082009,0,60,3,7,-4,0,0,0,38,28,10,53,35,18,71,45,26,6,2,0,0
"13066","N.J","CGY",2008020989,14313,20082009,1,60,3,2,1,0,0,0,31,37,-6,39,46,-7,42,53,-11,4,7,0,0
"13067","N.J","ARI",2008021005,14315,20082009,1,60,5,2,3,0,0,0,36,28,8,42,37,5,56,48,8,3,4,0,0
"13068","N.J","MTL",2008021024,14317,20082009,0,60,3,1,2,0,0,0,48,23,25,62,29,33,90,45,45,6,2,0,0
"13069","N.J","CHI",2008021040,14320,20082009,1,60,3,2,1,0,0,0,30,32,-2,40,44,-4,48,48,0,4,5,0,0
"13070","N.J","CAR",2008021051,14321,20082009,0,60,2,4,-2,0,0,0,43,32,11,55,40,15,74,61,13,6,5,0,0
"13071","N.J","MIN",2008021063,14323,20082009,1,60,4,0,4,0,0,0,29,35,-6,41,46,-5,50,68,-18,3,7,0,0
"13072","N.J","BOS",2008021078,14325,20082009,0,60,1,4,-3,0,0,0,42,30,12,49,36,13,69,46,23,6,5,0,0
"13073","N.J","PHI",2008021085,14326,20082009,0,60,2,4,-2,0,0,0,34,25,9,54,35,19,80,49,31,10,6,0,0
"13074","N.J","CHI",2008021113,14330,20082009,0,63.6,2,3,-1,0,0,0,30,42,-12,36,52,-16,42,61,-19,2,6,0,0
"13075","N.J","CAR",2008021119,14331,20082009,1,60,1,2,-1,0,0,0,32,48,-16,44,56,-12,53,66,-13,2,5,0,0
"13076","N.J","NYR",2008021134,14333,20082009,0,60,0,3,-3,0,0,0,38,37,1,47,43,4,63,58,5,6,9,0,0
"13077","N.J","PIT",2008021147,14335,20082009,0,60,1,6,-5,0,0,0,25,37,-12,30,48,-18,42,60,-18,4,6,0,0
"13078","N.J","T.B",2008021158,14337,20082009,1,61.35,5,4,1,0,0,0,39,22,17,48,28,20,66,35,31,5,3,0,0
"13079","N.J","BUF",2008021165,14338,20082009,0,60,3,2,1,0,0,0,28,37,-9,32,50,-18,41,76,-35,3,5,0,0
"13080","N.J","TOR",2008021184,14341,20082009,1,60,1,4,-3,0,0,0,48,18,30,70,22,48,89,27,62,5,2,0,0
"13081","N.J","OTT",2008021203,14343,20082009,0,65,2,2,0,0,0,0,32,30,2,48,41,7,59,54,5,7,4,0,0
"13082","N.J","CAR",2008021214,14345,20082009,1,60,3,2,1,0,0,0,35,25,10,54,30,24,63,38,25,6,5,0,0
"13083","N.J","CAR",2008030131,14349,20082009,1,60,4,1,3,0,0,0,39,19,20,51,24,27,63,35,28,4,2,0,0
"13084","N.J","CAR",2008030132,14351,20082009,1,62.6666666666667,1,2,-1,0,0,0,34,32,2,43,39,4,51,42,9,7,4,0,0
"13085","N.J","CAR",2008030133,14353,20082009,0,64.9666666666667,3,2,1,0,0,0,35,30,5,52,48,4,71,59,12,4,6,0,0
"13086","N.J","CAR",2008030134,14355,20082009,0,60,3,4,-1,0,0,0,29,46,-17,38,59,-21,52,72,-20,4,5,0,0
"13087","N.J","CAR",2008030135,14357,20082009,1,60,1,0,1,0,0,0,42,44,-2,54,50,4,61,72,-11,4,5,0,0
"13088","N.J","CAR",2008030136,14360,20082009,0,60,0,4,-4,0,0,0,28,37,-9,40,50,-10,54,67,-13,2,6,0,0
"13089","N.J","CAR",2008030137,14362,20082009,1,60,3,4,-1,0,0,0,35,31,4,41,41,0,54,58,-4,4,5,0,0
"13090","N.J","PHI",2009020012,14520,20092010,1,60,2,5,-3,0,0,0,26,27,-1,32,32,0,38,41,-3,5,3,0,0
"13091","N.J","NYR",2009020024,14522,20092010,1,60,2,3,-1,0,0,0,27,26,1,41,37,4,50,44,6,9,9,0,0
"13092","N.J","T.B",2009020040,14525,20092010,0,65,3,3,0,0,0,0,34,44,-10,49,58,-9,63,72,-9,2,4,0,0
"13093","N.J","FLA",2009020053,14527,20092010,0,60,3,2,1,0,0,0,41,21,20,49,28,21,65,44,21,6,4,0,0
"13094","N.J","WSH",2009020067,14529,20092010,0,65,2,2,0,0,0,0,29,33,-4,42,39,3,50,57,-7,5,5,0,0
"13095","N.J","ATL",2009020087,14533,20092010,1,60,2,4,-2,0,0,0,30,19,11,47,24,23,61,33,28,7,4,0,0
"13096","N.J","CAR",2009020096,14534,20092010,1,60,2,0,2,0,0,0,29,26,3,38,33,5,46,38,8,4,2,0,0
"13097","N.J","NYR",2009020119,14539,20092010,0,60,4,2,2,0,0,0,25,31,-6,38,40,-2,50,55,-5,1,3,0,0
"13098","N.J","PIT",2009020136,14541,20092010,0,60,4,1,3,0,0,0,26,33,-7,35,42,-7,41,53,-12,2,5,0,0
"13099","N.J","BUF",2009020155,14545,20092010,1,60,1,4,-3,0,0,0,32,27,5,38,30,8,41,38,3,6,5,0,0
"13100","N.J","BOS",2009020165,14546,20092010,0,60,2,1,1,0,0,0,31,32,-1,37,49,-12,47,59,-12,1,2,0,0
"13101","N.J","T.B",2009020183,14548,20092010,0,65,1,1,0,0,0,0,38,19,19,48,30,18,59,43,16,4,3,0,0
"13102","N.J","WSH",2009020204,14552,20092010,1,60,3,2,1,0,0,0,32,28,4,35,33,2,40,39,1,5,1,0,0
"13103","N.J","NYI",2009020219,14554,20092010,1,60,2,1,1,0,0,0,31,24,7,37,27,10,40,30,10,5,3,0,0
"13104","N.J","OTT",2009020229,14555,20092010,0,60,3,2,1,0,0,0,25,21,4,35,24,11,54,37,17,7,3,0,0
"13105","N.J","ANA",2009020248,14559,20092010,1,60,3,1,2,0,0,0,25,32,-7,31,37,-6,34,44,-10,3,6,0,0
"13106","N.J","PIT",2009020256,14560,20092010,0,60,4,1,3,0,0,0,25,26,-1,39,36,3,52,59,-7,4,3,0,0
"13107","N.J","WSH",2009020270,14562,20092010,1,60,5,2,3,0,0,0,23,29,-6,28,35,-7,35,47,-12,3,1,0,0
"13108","N.J","PHI",2009020284,14564,20092010,0,60,2,3,-1,0,0,0,35,35,0,47,48,-1,73,62,11,6,3,0,0
"13109","N.J","NSH",2009020303,14567,20092010,0,65,2,2,0,0,0,0,28,28,0,36,46,-10,47,62,-15,3,3,0,0
"13110","N.J","DAL",2009020322,14569,20092010,0,60,3,5,-2,0,0,0,34,26,8,43,37,6,56,60,-4,5,4,0,0
"13111","N.J","OTT",2009020339,14573,20092010,1,60,3,1,2,0,0,0,21,25,-4,27,31,-4,38,36,2,5,2,0,0
"13112","N.J","BOS",2009020355,14575,20092010,0,65,1,1,0,0,0,0,37,33,4,45,41,4,52,58,-6,3,3,0,0
"13113","N.J","NYI",2009020367,14576,20092010,1,60,6,1,5,0,0,0,42,23,19,51,30,21,57,36,21,3,4,0,0
"13114","N.J","VAN",2009020395,14580,20092010,1,60,2,5,-3,0,0,0,29,26,3,36,33,3,45,39,6,4,3,0,0
"13115","N.J","T.B",2009020409,14582,20092010,1,60,3,2,1,0,0,0,19,24,-5,33,33,0,42,41,1,4,4,0,0
"13116","N.J","DET",2009020418,14583,20092010,1,65,3,3,0,0,0,0,26,31,-5,40,39,1,47,48,-1,2,3,0,0
"13117","N.J","BUF",2009020429,14585,20092010,0,60,3,0,3,0,0,0,37,22,15,46,31,15,58,51,7,5,5,0,0
"13118","N.J","CAR",2009020444,14587,20092010,1,60,4,2,2,0,0,0,31,23,8,36,28,8,43,41,2,5,4,0,0
"13119","N.J","FLA",2009020458,14589,20092010,1,60,2,4,-2,0,0,0,28,22,6,39,26,13,54,31,23,2,2,0,0
"13120","N.J","PHI",2009020468,14590,20092010,1,60,4,1,3,0,0,0,28,23,5,32,31,1,37,40,-3,6,2,0,0
"13121","N.J","MTL",2009020494,14594,20092010,1,60,2,1,1,0,0,0,27,18,9,32,20,12,43,32,11,5,1,0,0
"13122","N.J","OTT",2009020511,14596,20092010,1,60,4,2,2,0,0,0,22,29,-7,27,41,-14,34,51,-17,4,7,0,0
"13123","N.J","ATL",2009020525,14597,20092010,0,60,5,4,1,0,0,0,42,26,16,50,38,12,59,52,7,2,2,0,0
"13124","N.J","PIT",2009020537,14599,20092010,0,60,4,0,4,0,0,0,30,35,-5,40,52,-12,55,64,-9,4,6,0,0
"13125","N.J","WSH",2009020560,14604,20092010,0,60,1,4,-3,0,0,0,30,40,-10,40,51,-11,55,61,-6,4,2,0,0
"13126","N.J","PIT",2009020591,14608,20092010,1,60,2,0,2,0,0,0,33,32,1,41,36,5,58,48,10,5,2,0,0
"13127","N.J","CHI",2009020607,14609,20092010,0,60,1,5,-4,0,0,0,27,36,-9,37,48,-11,50,67,-17,3,3,0,0
"13128","N.J","MIN",2009020620,14611,20092010,0,60,5,3,2,0,0,0,26,32,-6,33,49,-16,45,59,-14,3,2,0,0
"13129","N.J","DAL",2009020630,14614,20092010,1,60,4,0,4,0,0,0,27,28,-1,40,38,2,48,49,-1,5,4,0,0
"13130","N.J","T.B",2009020655,14617,20092010,1,60,2,4,-2,0,0,0,35,14,21,41,21,20,54,28,26,4,5,0,0
"13131","N.J","MTL",2009020663,14618,20092010,0,62.6333333333333,2,1,1,0,0,0,28,30,-2,40,43,-3,61,64,-3,5,5,0,0
"13132","N.J","NYR",2009020682,14621,20092010,0,65,0,0,0,0,0,0,45,51,-6,55,68,-13,68,84,-16,2,2,0,0
"13133","N.J","ARI",2009020701,14623,20092010,0,60,3,4,-1,0,0,0,34,19,15,53,31,22,64,41,23,3,4,0,0
"13134","N.J","COL",2009020709,14625,20092010,0,60,1,3,-2,0,0,0,38,28,10,55,34,21,70,44,26,4,3,0,0
"13135","N.J","NYI",2009020724,14627,20092010,0,60,0,4,-4,0,0,0,20,46,-26,36,55,-19,65,77,-12,2,4,0,0
"13136","N.J","FLA",2009020741,14629,20092010,1,60,2,0,2,0,0,0,32,22,10,45,26,19,58,33,25,2,3,0,0
"13137","N.J","MTL",2009020757,14631,20092010,1,60,1,3,-2,0,0,0,32,24,8,46,29,17,57,40,17,3,3,0,0
"13138","N.J","NYI",2009020763,14632,20092010,0,60,4,2,2,0,0,0,28,22,6,35,38,-3,61,61,0,1,2,0,0
"13139","N.J","OTT",2009020782,14635,20092010,0,60,0,3,-3,0,0,0,24,18,6,31,32,-1,40,45,-5,1,2,0,0
"13140","N.J","BUF",2009020786,14636,20092010,0,65,1,1,0,0,0,0,40,31,9,50,37,13,62,48,14,1,1,0,0
"13141","N.J","TOR",2009020801,14638,20092010,1,64.2333333333333,5,4,1,0,0,0,31,29,2,37,39,-2,48,52,-4,2,2,0,0
"13142","N.J","L.A",2009020819,14640,20092010,1,60,2,3,-1,0,0,0,28,22,6,38,33,5,46,41,5,3,4,0,0
"13143","N.J","TOR",2009020828,14642,20092010,0,60,0,3,-3,0,0,0,30,26,4,41,40,1,58,55,3,2,4,0,0
"13144","N.J","TOR",2009020850,14645,20092010,1,60,4,3,1,0,0,0,28,20,8,35,25,10,42,28,14,3,4,0,0
"13145","N.J","NYR",2009020861,14646,20092010,0,60,1,3,-2,0,0,0,42,25,17,54,31,23,72,39,33,7,5,0,0
"13146","N.J","PHI",2009020872,14648,20092010,0,60,2,3,-1,0,0,0,30,37,-7,39,46,-7,53,57,-4,7,4,0,0
"13147","N.J","PHI",2009020883,14650,20092010,1,63.45,2,3,-1,0,0,0,23,15,8,37,24,13,50,40,10,3,4,0,0
"13148","N.J","NSH",2009020898,14652,20092010,1,60,5,2,3,0,0,0,28,21,7,37,31,6,40,36,4,5,4,0,0
"13149","N.J","CAR",2009020908,14653,20092010,0,60,2,5,-3,0,0,0,25,31,-6,35,47,-12,47,67,-20,4,5,0,0
"13150","N.J","S.J",2009020934,14670,20092010,0,60,4,3,1,0,0,0,25,20,5,40,34,6,56,47,9,3,1,0,0
"13151","N.J","CGY",2009020953,14673,20092010,0,60,3,5,-2,0,0,0,25,25,0,39,35,4,52,52,0,4,1,0,0
"13152","N.J","EDM",2009020972,14675,20092010,0,60,0,2,-2,0,0,0,22,35,-13,38,45,-7,56,56,0,2,4,0,0
"13153","N.J","NYR",2009020986,14678,20092010,1,60,6,3,3,0,0,0,27,19,8,35,27,8,41,34,7,2,3,0,0
"13154","N.J","PIT",2009021000,14680,20092010,1,60,3,1,2,0,0,0,32,35,-3,44,43,1,54,59,-5,7,8,0,0
"13155","N.J","NYI",2009021009,14681,20092010,0,60,2,4,-2,0,0,0,40,29,11,48,41,7,63,58,5,3,3,0,0
"13156","N.J","BOS",2009021025,14683,20092010,1,60,3,2,1,0,0,0,28,36,-8,35,41,-6,38,45,-7,1,2,0,0
"13157","N.J","PIT",2009021039,14685,20092010,1,60,5,2,3,0,0,0,19,26,-7,25,38,-13,31,53,-22,2,2,0,0
"13158","N.J","TOR",2009021046,14686,20092010,0,65,1,1,0,0,0,0,25,26,-1,37,47,-10,59,70,-11,4,3,0,0
"13159","N.J","STL",2009021060,14688,20092010,1,60,0,1,-1,0,0,0,29,20,9,46,23,23,55,33,22,4,3,0,0
"13160","N.J","CBJ",2009021081,14691,20092010,1,60,6,3,3,0,0,0,30,22,8,38,30,8,48,34,14,7,4,0,0
"13161","N.J","NYR",2009021097,14693,20092010,1,65,3,3,0,0,0,0,38,31,7,46,39,7,59,43,16,4,4,0,0
"13162","N.J","MTL",2009021114,14695,20092010,0,60,4,2,2,0,0,0,26,27,-1,37,37,0,49,48,1,3,5,0,0
"13163","N.J","PHI",2009021125,14696,20092010,0,60,1,5,-4,0,0,0,33,25,8,45,35,10,71,45,26,7,6,0,0
"13164","N.J","BOS",2009021134,14698,20092010,1,64.6833333333333,0,1,-1,0,0,0,21,34,-13,31,48,-17,41,60,-19,2,2,0,0
"13165","N.J","CHI",2009021157,14701,20092010,1,65,1,1,0,0,0,0,33,26,7,45,29,16,52,42,10,0,0,0,0
"13166","N.J","CAR",2009021169,14702,20092010,0,60,4,0,4,0,0,0,29,26,3,46,41,5,61,56,5,3,3,0,0
"13167","N.J","ATL",2009021185,14705,20092010,0,60,3,0,3,0,0,0,27,19,8,35,26,9,48,40,8,2,2,0,0
"13168","N.J","FLA",2009021202,14707,20092010,0,60,2,3,-1,0,0,0,44,18,26,48,27,21,62,40,22,2,1,0,0
"13169","N.J","NYI",2009021216,14709,20092010,1,60,7,1,6,0,0,0,37,19,18,52,30,22,61,39,22,7,5,0,0
"13170","N.J","BUF",2009021227,14710,20092010,1,60,2,1,1,0,0,0,34,23,11,43,26,17,49,32,17,5,2,0,0
"13171","N.J","PHI",2009030121,14713,20092010,1,60,1,2,-1,0,0,0,24,14,10,40,20,20,54,24,30,4,3,0,0
"13172","N.J","PHI",2009030122,14715,20092010,1,60,5,3,2,0,0,0,33,29,4,45,43,2,55,56,-1,5,9,0,0
"13173","N.J","PHI",2009030123,14717,20092010,0,63.5833333333333,2,3,-1,0,0,0,19,34,-15,39,44,-5,60,65,-5,9,6,0,0
"13174","N.J","PHI",2009030124,14719,20092010,0,60,1,4,-3,0,0,0,31,28,3,49,38,11,74,51,23,8,8,0,0
"13175","N.J","PHI",2009030125,14721,20092010,1,60,0,3,-3,0,0,0,28,21,7,40,28,12,55,33,22,11,9,0,0
"13176","N.J","DAL",2010020007,14890,20102011,1,61.6,3,4,-1,3.92179460213811,2.70482597217051,1.2169686299676,30,28,2,36,40,-4,44,48,-4,3,3,0,0
"13177","N.J","WSH",2010020017,14891,20102011,0,60,2,7,-5,3.74308588304189,6.20818623295054,-2.46510034990865,33,29,4,43,42,1,56,55,1,5,5,0,0
"13178","N.J","PIT",2010020027,14893,20102011,1,60,1,3,-2,2.67344368488148,5.1037925049628,-2.43034882008132,31,31,0,36,42,-6,40,48,-8,2,6,0,0
"13179","N.J","BUF",2010020036,14895,20102011,0,60.8833333333333,1,0,1,3.60331533812132,5.82009667134844,-2.21678133322712,35,24,11,47,36,11,58,54,4,3,2,0,0
"13180","N.J","COL",2010020048,14897,20102011,1,60,2,3,-1,2.97339739599387,2.83489532000385,0.138502075990016,43,22,21,50,30,20,61,35,26,3,4,0,0
"13181","N.J","BOS",2010020056,14898,20102011,1,60,1,4,-3,3.69593545331736,2.80802522109161,0.887910232225749,32,35,-3,46,44,2,58,49,9,4,3,0,0
"13182","N.J","MTL",2010020086,14903,20102011,0,60,3,0,3,3.24675283569377,4.25421049852829,-1.00745766283453,20,29,-9,28,42,-14,42,63,-21,4,3,0,0
"13183","N.J","BUF",2010020100,14905,20102011,1,60,1,6,-5,2.47587075515185,2.6397619069586,-0.163891151806752,27,29,-2,34,33,1,43,45,-2,3,3,0,0
"13184","N.J","NYR",2010020112,14906,20102011,0,60,1,3,-2,4.65804255459256,4.30138087412342,0.356661680469138,28,34,-6,44,44,0,65,56,9,4,7,0,0
"13185","N.J","S.J",2010020128,14909,20102011,0,60,2,5,-3,0,0,0,29,39,-10,39,50,-11,53,64,-11,6,4,0,0
"13186","N.J","ANA",2010020142,14911,20102011,0,60,2,1,1,1.98575816247467,5.62776492883131,-3.64200676635664,27,28,-1,35,39,-4,49,44,5,4,4,0,0
"13187","N.J","L.A",2010020155,14912,20102011,0,60,1,3,-2,6.2534198274011,4.9501100290363,1.30330979836481,40,23,17,50,31,19,62,40,22,2,3,0,0
"13188","N.J","VAN",2010020159,14914,20102011,0,60,0,3,-3,3.30451874487335,3.86894911227864,-0.564430367405294,30,23,7,40,36,4,58,51,7,3,5,0,0
"13189","N.J","CHI",2010020168,14916,20102011,0,60,5,3,2,5.64573769372745,6.6498816551757,-1.00414396144825,24,32,-8,29,43,-14,44,62,-18,3,4,0,0
"13190","N.J","NYR",2010020179,14918,20102011,1,60,0,3,-3,3.7848150108215,3.18932515697179,0.595489853849713,33,20,13,46,29,17,53,38,15,3,4,0,0
"13191","N.J","BUF",2010020211,14923,20102011,1,65,4,4,0,3.27866404079396,4.73169776395662,-1.45303372316266,32,42,-10,39,48,-9,45,59,-14,2,2,0,0
"13192","N.J","EDM",2010020227,14925,20102011,1,63.45,4,3,1,3.22101407455921,1.81895154427912,1.40206253028009,39,24,15,50,26,24,61,34,27,3,2,0,0
"13193","N.J","BOS",2010020248,14928,20102011,0,60,0,3,-3,4.82191649351171,4.12907859144616,0.692837902065548,28,24,4,40,31,9,54,44,10,3,6,0,0
"13194","N.J","TOR",2010020270,14931,20102011,0,60,1,3,-2,4.45891516999109,2.99057506723329,1.46834010275779,30,27,3,47,35,12,70,43,27,2,3,0,0
"13195","N.J","STL",2010020289,14933,20102011,0,60,2,3,-1,4.3956857605109,4.3201713753019,0.0755143852090043,37,27,10,51,39,12,63,47,16,3,4,0,0
"13196","N.J","WSH",2010020299,14935,20102011,1,60,5,0,5,1.0344323154095,4.07346297253389,-3.03903065712439,23,30,-7,25,36,-11,28,42,-14,4,4,0,0
"13197","N.J","CGY",2010020313,14937,20102011,1,65,1,1,0,1.56472160399426,2.38375568483744,-0.819034080843181,21,26,-5,28,37,-9,42,51,-9,3,3,0,0
"13198","N.J","NYI",2010020322,14939,20102011,0,60,0,2,-2,5.30227383380419,2.80410823361308,2.49816560019111,29,20,9,48,26,22,75,37,38,4,2,0,0
"13199","N.J","PHI",2010020334,14940,20102011,1,65,1,1,0,4.64701274796244,7.78073807121837,-3.13372532325593,25,41,-16,33,49,-16,44,58,-14,2,2,0,0
"13200","N.J","MTL",2010020367,14945,20102011,1,60,1,5,-4,3.76846084451245,4.71206272262498,-0.943601878112531,28,32,-4,32,43,-11,46,50,-4,3,3,0,0
"13201","N.J","PHI",2010020379,14947,20102011,0,60,3,5,-2,4.63889482314698,10.0440470996109,-5.40515227646392,26,34,-8,35,46,-11,49,64,-15,5,5,0,0
"13202","N.J","PIT",2010020396,14949,20102011,0,60,1,2,-1,2.59092229907401,6.35874563676771,-3.7678233376937,28,34,-6,35,44,-9,42,62,-20,5,7,0,0
"13203","N.J","OTT",2010020420,14953,20102011,0,60,2,3,-1,3.79245595022951,3.12871601448569,0.66373993574382,31,29,2,41,40,1,61,49,12,3,4,0,0
"13204","N.J","DET",2010020428,14954,20102011,1,60,1,4,-3,5.0834895251046,4.70748896268196,0.376000562422632,34,23,11,41,33,8,50,41,9,5,3,0,0
"13205","N.J","ARI",2010020450,14958,20102011,1,60,3,0,3,3.1103251646054,4.24705397054071,-1.13672880593531,29,29,0,41,35,6,49,41,8,4,3,0,0
"13206","N.J","NSH",2010020469,14960,20102011,1,60,1,3,-2,1.94272364504286,1.48938788189844,0.453335763144423,16,20,-4,29,26,3,42,32,10,3,5,0,0
"13207","N.J","ATL",2010020477,14961,20102011,0,60,1,7,-6,7.22309914242942,2.87126923556207,4.35182990686735,27,22,5,37,28,9,53,40,13,4,3,0,0
"13208","N.J","WSH",2010020496,14964,20102011,0,60,1,5,-4,4.65881128988821,3.67341256729361,0.985398722594594,36,28,8,44,43,1,59,59,0,4,5,0,0
"13209","N.J","NYI",2010020508,14966,20102011,1,60,1,5,-4,5.92002233660605,3.23659961821977,2.68342271838628,35,14,21,50,19,31,63,23,40,4,1,0,0
"13210","N.J","TOR",2010020520,14969,20102011,1,60,1,4,-3,5.5180750201107,3.64658844717633,1.87148657293437,30,22,8,44,31,13,52,47,5,5,5,0,0
"13211","N.J","NYR",2010020545,14972,20102011,1,60,1,3,-2,5.32525211343921,4.67064465011117,0.654607463328034,44,26,18,53,31,22,61,37,24,4,4,0,0
"13212","N.J","ATL",2010020557,14974,20102011,1,60,3,1,2,3.8668404935961,4.4307132238755,-0.5638727302794,28,29,-1,35,36,-1,48,43,5,2,2,0,0
"13213","N.J","CAR",2010020569,14975,20102011,0,60,3,6,-3,3.13254113942402,5.17367329541594,-2.04113215599192,28,25,3,40,30,10,55,43,12,2,7,0,0
"13214","N.J","MIN",2010020586,14978,20102011,1,60,1,2,-1,2.72413379678619,3.2909739051247,-0.566840108338511,22,18,4,29,24,5,46,33,13,5,2,0,0
"13215","N.J","PHI",2010020599,14980,20102011,1,60,2,4,-2,1.7954326488547,3.64233268014505,-1.84690003129035,20,20,0,32,34,-2,37,43,-6,1,4,0,0
"13216","N.J","PHI",2010020612,14982,20102011,0,60,1,2,-1,3.69866037439471,2.30930616753176,1.38935420686295,35,29,6,47,40,7,64,52,12,4,5,0,0
"13217","N.J","T.B",2010020624,14983,20102011,1,60,6,3,3,6.5183494302624,5.17548807591129,1.34286135435111,26,36,-10,41,41,0,45,48,-3,4,3,0,0
"13218","N.J","T.B",2010020658,14988,20102011,0,60,5,2,3,4.56413699680999,4.65898824330975,-0.094851246499756,25,32,-7,35,35,0,49,51,-2,1,3,0,0
"13219","N.J","FLA",2010020665,14989,20102011,0,63.6,2,3,-1,2.96714208977937,2.50676956985262,0.46037251992675,35,22,13,46,30,16,56,43,13,4,4,0,0
"13220","N.J","NYI",2010020678,14991,20102011,0,60,5,2,3,3.19186131079914,5.62881405939606,-2.43695274859692,27,29,-2,34,48,-14,44,59,-15,2,3,0,0
"13221","N.J","PIT",2010020698,14994,20102011,1,60,2,0,2,2.1653931948822,5.49199477529532,-3.32660158041313,20,23,-3,32,33,-1,34,41,-7,4,1,0,0
"13222","N.J","PHI",2010020712,14996,20102011,0,60,3,1,2,4.19966078756261,6.26602772926708,-2.06636694170447,22,27,-5,38,41,-3,53,61,-8,4,3,0,0
"13223","N.J","FLA",2010020723,14997,20102011,1,60,5,2,3,3.61919428769033,3.28930218380992,0.329892103880411,23,26,-3,32,38,-6,39,46,-7,3,1,0,0
"13224","N.J","DET",2010020745,15000,20102011,0,60,1,3,-2,3.98638510872115,3.11393371246648,0.872451396254671,24,29,-5,35,44,-9,50,52,-2,3,2,0,0
"13225","N.J","OTT",2010020752,15006,20102011,1,60,2,1,1,4.22361953908253,4.10974351218165,0.113876026900882,33,16,17,47,27,20,52,35,17,1,3,0,0
"13226","N.J","NYR",2010020772,15008,20102011,0,60,3,2,1,2.64980903148654,3.79271192836677,-1.14290289688023,18,27,-9,29,40,-11,41,47,-6,3,6,0,0
"13227","N.J","FLA",2010020776,15009,20102011,1,62,3,4,-1,4.38850071705856,5.95073134023903,-1.56223062318048,31,29,2,39,36,3,51,43,8,3,2,0,0
"13228","N.J","MTL",2010020794,15011,20102011,0,60,4,1,3,4.33484241273254,4.90703654411482,-0.572194131382275,30,26,4,39,38,1,54,56,-2,2,1,0,0
"13229","N.J","CAR",2010020802,15013,20102011,1,62.7,3,2,1,4.58578305493575,2.63115950688371,1.95462354805204,34,22,12,47,31,16,59,38,21,0,3,0,0
"13230","N.J","TOR",2010020816,15015,20102011,0,64.6,2,1,1,8.97626885927457,2.77812429097729,6.19814456829728,39,32,7,60,47,13,83,63,20,5,7,0,0
"13231","N.J","S.J",2010020822,15016,20102011,1,60,2,1,1,4.38086987752467,4.58940586901736,-0.208535991492681,23,32,-9,28,39,-11,37,46,-9,3,2,0,0
"13232","N.J","CAR",2010020856,15021,20102011,1,60,3,2,1,1.96395275100076,6.6433629673616,-4.67941021636084,22,27,-5,31,35,-4,40,48,-8,2,3,0,0
"13233","N.J","NYR",2010020870,15023,20102011,1,60,1,0,1,5.10065299275993,2.08761779390625,3.01303519885369,28,16,12,42,21,21,53,29,24,1,2,0,0
"13234","N.J","CAR",2010020880,15024,20102011,0,60,4,1,3,7.66576319094747,4.17474955800571,3.49101363294176,25,25,0,39,39,0,49,56,-7,5,5,0,0
"13235","N.J","DAL",2010020900,15027,20102011,0,60,1,0,1,3.10346335959229,2.69305052374561,0.41041283584668,23,19,4,32,32,0,43,47,-4,4,3,0,0
"13236","N.J","T.B",2010020920,15030,20102011,0,60,1,2,-1,3.08225511343335,3.03233529336285,0.0499198200704996,20,30,-10,29,39,-10,43,53,-10,1,2,0,0
"13237","N.J","FLA",2010020935,15032,20102011,0,60,2,1,1,3.31236436197651,4.21706032333896,-0.904695961362449,26,26,0,32,35,-3,41,49,-8,3,1,0,0
"13238","N.J","T.B",2010020953,15035,20102011,1,60,2,1,1,3.27674408658339,3.07472513748507,0.202018949098317,27,16,11,35,18,17,42,25,17,2,2,0,0
"13239","N.J","PIT",2010020968,15037,20102011,1,64.5833333333333,2,1,1,4.28812377544818,2.24398545239819,2.04413832304999,30,26,4,41,33,8,48,54,-6,1,2,0,0
"13240","N.J","NYI",2010020983,15039,20102011,0,65,2,2,0,4.48076034890255,2.41233995840776,2.06842039049479,29,22,7,38,32,6,54,44,10,2,4,0,0
"13241","N.J","OTT",2010020992,15041,20102011,1,60,1,2,-1,4.50758718190082,3.71296555255504,0.79462162934578,32,21,11,40,28,12,51,38,13,4,3,0,0
"13242","N.J","ATL",2010021019,15044,20102011,0,64.3,3,2,1,4.42203447065549,1.51073742974222,2.91129704091327,30,26,4,41,33,8,57,44,13,6,4,0,0
"13243","N.J","NYI",2010021025,15045,20102011,1,63.15,3,2,1,5.23555079121661,2.62784213619307,2.60770865502354,35,15,20,49,23,26,67,33,34,5,1,0,0
"13244","N.J","ATL",2010021042,15048,20102011,1,60,4,2,2,4.46128254077843,4.49652266170597,-0.0352401209275399,24,20,4,38,27,11,45,35,10,2,1,0,0
"13245","N.J","OTT",2010021058,15050,20102011,0,60,1,3,-2,4.33240068244814,6.37420816124705,-2.04180747879891,34,25,9,44,35,9,68,46,22,3,3,0,0
"13246","N.J","WSH",2010021066,15051,20102011,1,60,0,3,-3,5.56333371024812,1.83135913979589,3.73197457045222,33,12,21,42,15,27,50,21,29,3,0,0,0
"13247","N.J","CBJ",2010021082,15053,20102011,0,60,3,0,3,5.52539641677868,2.9837063485611,2.54169006821758,31,13,18,43,25,18,57,38,19,4,1,0,0
"13248","N.J","BOS",2010021088,15055,20102011,0,60,1,4,-3,4.43269569711295,3.72771554416977,0.704980152943184,31,30,1,36,38,-2,41,47,-6,2,5,0,0
"13249","N.J","PIT",2010021111,15058,20102011,0,65,0,0,0,4.59280890569789,4.61671584418036,-0.0239069384824688,21,26,-5,32,44,-12,47,61,-14,4,2,0,0
"13250","N.J","BUF",2010021118,15059,20102011,0,60,0,2,-2,4.20735742186662,3.39183132732842,0.8155260945382,30,28,2,40,35,5,53,46,7,2,2,0,0
"13251","N.J","NYI",2010021146,15063,20102011,1,60,3,2,1,1.63520532326902,3.13997602824384,-1.50477070497482,20,29,-9,28,33,-5,39,43,-4,5,3,0,0
"13252","N.J","PHI",2010021160,15065,20102011,1,60,4,2,2,2.14128063687531,2.95584538811818,-0.81456475124287,24,36,-12,38,44,-6,42,48,-6,1,1,0,0
"13253","N.J","MTL",2010021169,15066,20102011,1,60,1,3,-2,3.46617871918716,2.73559017041043,0.730588548776723,21,29,-8,26,33,-7,28,35,-7,3,3,0,0
"13254","N.J","PIT",2010021186,15069,20102011,0,60,2,4,-2,1.77470597578213,3.34114686141038,-1.56644088562825,24,27,-3,27,32,-5,37,49,-12,2,3,0,0
"13255","N.J","TOR",2010021194,15070,20102011,1,60,4,2,2,4.5587823530368,3.78623272359408,0.772549629442722,33,24,9,39,28,11,52,32,20,5,1,0,0
"13256","N.J","NYR",2010021215,15073,20102011,0,60,2,5,-3,2.72830423977575,6.39231394315721,-3.66400970338145,26,29,-3,43,36,7,57,42,15,1,1,0,0
"13257","N.J","BOS",2010021226,15074,20102011,1,60,3,2,1,3.57094683893956,4.16773407394066,-0.596787235001102,32,26,6,43,35,8,53,44,9,1,2,0,0
"13258","N.J","PHI",2011020012,15255,20112012,1,60,0,3,-3,1.48775807888286,3.51561046206803,-2.02785238318517,20,29,-9,25,36,-11,31,47,-16,5,8,0,0
"13259","N.J","CAR",2011020026,15257,20112012,1,60,4,2,2,1.86914765180981,3.10565750541641,-1.23650985360661,26,26,0,35,34,1,39,44,-5,7,7,0,0
"13260","N.J","L.A",2011020037,15260,20112012,1,65,1,1,0,3.67607702344321,3.24035489138623,0.435722132056981,37,27,10,50,33,17,64,49,15,2,1,0,0
"13261","N.J","NSH",2011020057,15262,20112012,0,65,2,2,0,5.95352529287811,5.21899507346097,0.734530219417138,41,31,10,51,38,13,67,48,19,8,3,0,0
"13262","N.J","S.J",2011020091,15268,20112012,1,65,3,3,0,4.21028833567834,5.49262419133936,-1.28233585566102,19,41,-22,27,50,-23,37,57,-20,5,5,0,0
"13263","N.J","PIT",2011020101,15269,20112012,0,60,1,4,-3,2.08760459057521,6.85491411566181,-4.7673095250866,24,29,-5,27,50,-23,41,71,-30,2,5,0,0
"13264","N.J","L.A",2011020121,15272,20112012,0,60,3,0,3,5.41904529200313,6.36512206523912,-0.946076773235987,23,31,-8,40,47,-7,50,60,-10,2,1,0,0
"13265","N.J","ARI",2011020135,15274,20112012,0,60,3,5,-2,2.45033345914005,3.40582561833435,-0.955492159194293,34,42,-8,45,54,-9,57,68,-11,1,4,0,0
"13266","N.J","DAL",2011020149,15276,20112012,0,60,1,3,-2,3.15791991274455,3.81770613228967,-0.659786219545126,32,23,9,42,36,6,60,51,9,4,3,0,0
"13267","N.J","TOR",2011020166,15280,20112012,1,60,3,5,-2,2.6698385241325,3.59266480139922,-0.922826277266722,22,23,-1,28,34,-6,38,40,-2,2,2,0,0
"13268","N.J","PHI",2011020170,15281,20112012,0,65,3,3,0,4.622918048266,3.87379670021481,0.749121348051187,39,23,16,49,32,17,77,51,26,4,7,0,0
"13269","N.J","WPG",2011020186,15283,20112012,1,61.4666666666667,3,2,1,2.55836164770588,4.49014405451877,-1.93178240681289,28,23,5,33,31,2,37,38,-1,2,3,0,0
"13270","N.J","CAR",2011020204,15286,20112012,1,60,3,2,1,7.24071444652509,2.28454904683058,4.95616539969451,36,27,9,53,29,24,57,34,23,4,2,0,0
"13271","N.J","WSH",2011020222,15289,20112012,1,60,1,3,-2,3.59023273524767,3.00378884840757,0.586443886840108,33,20,13,37,25,12,48,30,18,5,4,0,0
"13272","N.J","WSH",2011020231,15290,20112012,0,65,2,2,0,3.27941736605165,2.86477464972995,0.414642716321699,19,17,2,36,28,8,50,50,0,5,5,0,0
"13273","N.J","BOS",2011020247,15293,20112012,0,60,3,4,-1,3.63630432308128,8.52449389332787,-4.8881895702466,30,37,-7,40,46,-6,50,59,-9,5,2,0,0
"13274","N.J","BUF",2011020257,15294,20112012,0,60,5,3,2,3.34197796217632,5.68831708730431,-2.346339125128,21,32,-11,31,45,-14,38,58,-20,4,4,0,0
"13275","N.J","T.B",2011020280,15297,20112012,0,60,4,2,2,2.92589672144669,4.41273216620903,-1.48683544476233,24,23,1,26,29,-3,36,45,-9,8,6,0,0
"13276","N.J","FLA",2011020295,15299,20112012,0,60,3,4,-1,2.75480877660448,5.63377730951083,-2.87896853290636,25,36,-11,37,44,-7,46,57,-11,3,5,0,0
"13277","N.J","CBJ",2011020301,15301,20112012,1,65,1,1,0,3.36493281364345,3.69427171568555,-0.329338902042096,24,36,-12,30,45,-15,38,50,-12,3,6,0,0
"13278","N.J","NYI",2011020314,15303,20112012,0,60,1,0,1,3.64866317869858,3.10149660165189,0.547166577046691,23,23,0,33,28,5,50,49,1,2,4,0,0
"13279","N.J","NYI",2011020326,15304,20112012,1,60,2,3,-1,2.78491560951807,2.39144347333803,0.393472136180034,26,26,0,31,31,0,39,44,-5,3,2,0,0
"13280","N.J","COL",2011020355,15308,20112012,0,60,1,6,-5,2.89467984757453,2.10702975341701,0.787650094157519,19,25,-6,32,34,-2,47,44,3,4,3,0,0
"13281","N.J","MIN",2011020367,15310,20112012,0,60,2,4,-2,4.5273847111763,1.32985810265479,3.19752660852151,31,16,15,40,22,18,64,31,33,5,3,0,0
"13282","N.J","WPG",2011020376,15311,20112012,0,60,2,4,-2,4.60855701202672,4.32535721489694,0.283199797129782,25,20,5,43,28,15,62,40,22,5,3,0,0
"13283","N.J","TOR",2011020392,15314,20112012,0,62.6666666666667,3,2,1,3.99560947611462,4.69604638417155,-0.700436908056929,26,31,-5,38,43,-5,54,55,-1,4,2,0,0
"13284","N.J","OTT",2011020406,15316,20112012,1,65,4,4,0,0,0,0,31,29,2,39,33,6,45,39,6,6,6,0,0
"13285","N.J","MTL",2011020421,15318,20112012,1,60,1,2,-1,1.95797686807806,2.85154650107143,-0.893569632993362,29,24,5,38,28,10,46,37,9,4,5,0,0
"13286","N.J","T.B",2011020435,15320,20112012,0,60,5,4,1,0,0,0,22,36,-14,31,53,-22,42,64,-22,3,5,0,0
"13287","N.J","FLA",2011020444,15321,20112012,0,65,2,2,0,5.18933674221626,1.48000691310153,3.70932982911472,34,26,8,54,34,20,65,42,23,6,3,0,0
"13288","N.J","DAL",2011020461,15324,20112012,1,60,6,3,3,4.72459518071514,4.74155848739611,-0.0169633066809638,31,36,-5,33,41,-8,37,44,-7,2,4,0,0
"13289","N.J","MTL",2011020468,15325,20112012,0,60,5,3,2,4.3898504749009,2.61531345184406,1.77453702305683,35,26,9,42,35,7,65,48,17,5,4,0,0
"13290","N.J","NYR",2011020487,15328,20112012,1,60,1,4,-3,1.89084998477483,4.90822566760471,-3.01737568282988,31,21,10,38,33,5,52,39,13,4,2,0,0
"13291","N.J","WSH",2011020509,15331,20112012,1,65,3,3,0,1.39486155255634,6.00302867707796,-4.60816712452163,28,25,3,35,38,-3,45,50,-5,4,3,0,0
"13292","N.J","CAR",2011020522,15334,20112012,0,60,2,4,-2,0,0,0,25,34,-9,34,45,-11,50,61,-11,2,3,0,0
"13293","N.J","BUF",2011020536,15336,20112012,1,60,3,1,2,3.47410249677,2.92928723641671,0.544815260353289,23,23,0,33,35,-2,41,42,-1,3,5,0,0
"13294","N.J","OTT",2011020570,15341,20112012,0,64,2,3,-1,3.0806840985997,8.45172348927008,-5.37103939067038,29,32,-3,39,55,-16,47,78,-31,2,4,0,0
"13295","N.J","BOS",2011020581,15343,20112012,1,60,1,6,-5,3.06545618925884,4.7909266156571,-1.72547042639826,31,27,4,35,37,-2,46,53,-7,3,3,0,0
"13296","N.J","FLA",2011020593,15345,20112012,1,60,5,2,3,5.44164868647931,3.22156575568169,2.22008293079762,29,24,5,36,28,8,41,35,6,3,2,0,0
"13297","N.J","CGY",2011020627,15349,20112012,0,60,3,6,-3,8.04564661826214,1.93588784720632,6.10975877105582,38,14,24,54,17,37,67,26,41,4,5,0,0
"13298","N.J","EDM",2011020630,15350,20112012,0,61.1,2,1,1,2.8636018480247,1.43014681353816,1.43345503448654,25,23,2,34,38,-4,45,64,-19,2,5,0,0
"13299","N.J","WPG",2011020653,15353,20112012,0,60,2,1,1,2.19155779089488,6.1392212624778,-3.94766347158293,25,23,2,33,35,-2,46,53,-7,3,2,0,0
"13300","N.J","WPG",2011020671,15356,20112012,1,60,5,1,4,3.79298507950807,3.89897966425633,-0.10599458474826,20,21,-1,25,26,-1,29,32,-3,4,1,0,0
"13301","N.J","BOS",2011020686,15358,20112012,1,60,1,4,-3,3.1854788470082,4.07119128046907,-0.885712433460867,31,25,6,37,34,3,42,38,4,1,1,0,0
"13302","N.J","PHI",2011020700,15360,20112012,1,60,1,4,-3,5.53353004144652,3.2894721469311,2.24405789451541,31,20,11,38,28,10,47,32,15,7,6,0,0
"13303","N.J","BUF",2011020722,15363,20112012,1,65,1,1,0,3.15407918675191,1.38709697301965,1.76698221373226,28,14,14,42,21,21,53,27,26,2,1,0,0
"13304","N.J","NYR",2011020737,15370,20112012,1,65,3,3,0,3.75695797407278,4.47108421951998,-0.714126245447201,29,26,3,37,34,3,55,48,7,3,3,0,0
"13305","N.J","MTL",2011020755,15372,20112012,1,60,5,3,2,3.80623665414804,3.32430473821504,0.481931915933,22,30,-8,24,30,-6,29,36,-7,4,3,0,0
"13306","N.J","PHI",2011020768,15374,20112012,0,60,6,4,2,3.62750232903454,6.41903314199089,-2.79153081295635,31,41,-10,39,58,-19,43,82,-39,10,10,0,0
"13307","N.J","NYR",2011020786,15377,20112012,0,60,1,0,1,2.72887288182392,6.39653168832615,-3.66765880650223,22,30,-8,32,44,-12,47,61,-14,4,3,0,0
"13308","N.J","STL",2011020801,15379,20112012,1,65,3,3,0,3.87100209291935,3.29505900503136,0.575943087887985,27,26,1,40,35,5,43,41,2,3,0,0,0
"13309","N.J","FLA",2011020817,15381,20112012,1,60,1,3,-2,2.77343823765841,2.80785000050673,-0.0344117628483218,28,20,8,33,20,13,42,31,11,1,3,0,0
"13310","N.J","BUF",2011020838,15384,20112012,0,60,4,1,3,6.28558518725913,4.14193316141169,2.14365202584744,31,30,1,41,35,6,60,47,13,7,2,0,0
"13311","N.J","ANA",2011020858,15387,20112012,1,65,2,2,0,2.40906348601584,4.26654770728783,-1.85748422127199,27,38,-11,35,44,-9,42,50,-8,1,3,0,0
"13312","N.J","MTL",2011020877,15389,20112012,0,60,3,1,2,5.49090055244938,5.17976022879884,0.311140323650534,25,22,3,36,34,2,51,67,-16,0,3,0,0
"13313","N.J","TOR",2011020886,15391,20112012,0,61.3,4,3,1,3.01114311908422,5.02130373200634,-2.01016061292213,32,32,0,49,49,0,53,62,-9,3,2,0,0
"13314","N.J","VAN",2011020908,15394,20112012,1,60,1,2,-1,3.66495953215781,1.99827907642285,1.66668045573496,31,16,15,39,23,16,54,32,22,2,1,0,0
"13315","N.J","T.B",2011020925,15396,20112012,1,60,3,4,-1,3.12915512000473,1.45329490059521,1.67586021940951,22,16,6,29,19,10,44,25,19,4,3,0,0
"13316","N.J","NYR",2011020932,15397,20112012,0,60,0,2,-2,2.16812134688371,3.64864170050714,-1.48052035362343,13,15,-2,27,27,0,45,29,16,3,4,0,0
"13317","N.J","BOS",2011020950,15400,20112012,0,62.9833333333333,3,4,-1,3.13240852914168,2.43372128734219,0.698687241799495,31,25,6,34,33,1,53,51,2,3,3,0,0
"13318","N.J","WSH",2011020959,15401,20112012,0,60,5,0,5,2.16741629449803,2.60494557043421,-0.437529275936186,20,23,-3,31,28,3,38,45,-7,2,2,0,0
"13319","N.J","NYI",2011020974,15403,20112012,0,60,0,1,-1,1.37594382053794,4.33176697941963,-2.95582315888169,24,25,-1,30,38,-8,57,56,1,2,6,0,0
"13320","N.J","NYR",2011020985,15405,20112012,1,60,4,1,3,5.35153762891986,3.0786100985299,2.27292753038996,29,26,3,41,32,9,51,38,13,4,2,0,0
"13321","N.J","NYI",2011020999,15407,20112012,1,60,5,1,4,1.57170673948713,4.39539388322737,-2.82368714374024,20,30,-10,29,39,-10,34,47,-13,3,3,0,0
"13322","N.J","NYI",2011021018,15409,20112012,0,60,2,1,1,4.37599340111774,2.9428863893412,1.43310701177654,35,24,11,45,31,14,65,44,21,4,3,0,0
"13323","N.J","PHI",2011021029,15410,20112012,1,60,4,1,3,3.27547055279138,1.55931773313029,1.71615281966109,31,19,12,43,24,19,46,27,19,5,3,0,0
"13324","N.J","PHI",2011021039,15412,20112012,0,60,0,3,-3,1.22677993093483,3.46740246517584,-2.24062253424101,17,29,-12,26,39,-13,41,48,-7,6,7,0,0
"13325","N.J","COL",2011021052,15414,20112012,1,65,0,0,0,5.62917542428477,3.34955432679044,2.27962109749433,33,28,5,46,31,15,59,40,19,1,1,0,0
"13326","N.J","NYR",2011021083,15418,20112012,0,60,2,4,-2,2.71228400833138,2.68329656900539,0.0289874393259879,22,27,-5,31,36,-5,44,45,-1,4,4,0,0
"13327","N.J","OTT",2011021092,15419,20112012,0,60,1,0,1,3.4545178269544,5.06693506084796,-1.61241723389356,34,34,0,46,41,5,56,57,-1,4,4,0,0
"13328","N.J","TOR",2011021110,15422,20112012,1,65,3,3,0,8.19282883585765,2.22884891775902,5.96397991809863,46,17,29,56,20,36,64,24,40,2,0,0,0
"13329","N.J","CHI",2011021142,15426,20112012,1,65,1,1,0,2.69568015367258,5.0070935566317,-2.31141340295912,22,38,-16,30,47,-17,46,62,-16,3,4,0,0
"13330","N.J","T.B",2011021156,15428,20112012,1,60,6,4,2,5.69875496203895,1.00990270643706,4.68885225560189,38,20,18,55,20,35,69,23,46,4,3,0,0
"13331","N.J","CAR",2011021173,15430,20112012,0,60,5,0,5,3.23183806541596,5.85346275151824,-2.62162468610228,31,22,9,40,37,3,50,48,2,4,4,0,0
"13332","N.J","NYI",2011021191,15433,20112012,1,60,3,1,2,4.75074619016959,2.34089712288176,2.40984906728784,20,20,0,26,29,-3,38,40,-2,4,0,0,0
"13333","N.J","DET",2011021208,15435,20112012,0,60,2,1,1,3.01865213605925,3.0362808290738,-0.0176286930145579,21,24,-3,25,34,-9,34,46,-12,2,1,0,0
"13334","N.J","OTT",2011021217,15437,20112012,1,60,4,2,2,4.95636440860471,4.11154013383202,0.844824274772691,35,33,2,41,35,6,45,45,0,3,2,0,0
"13335","N.J","FLA",2011030131,15443,20112012,0,60,3,2,1,4.57997314657405,2.83401314353409,1.74596000303995,38,26,12,45,34,11,51,40,11,6,4,0,0
"13336","N.J","FLA",2011030132,15445,20112012,0,60,2,4,-2,2.95950932666892,7.33334048353646,-4.37383115686754,25,24,1,38,35,3,56,47,9,2,4,0,0
"13337","N.J","FLA",2011030133,15447,20112012,1,60,3,4,-1,2.79141030422761,2.72848689911189,0.0629234051157255,25,26,-1,33,34,-1,48,40,8,4,4,0,0
"13338","N.J","FLA",2011030134,15449,20112012,1,60,4,0,4,4.49902453545025,3.99227435369312,0.506750181757127,27,26,1,37,33,4,48,40,8,6,8,0,0
"13339","N.J","FLA",2011030135,15451,20112012,0,60,0,3,-3,5.46324354922569,6.23946029755468,-0.776216748328981,30,33,-3,40,48,-8,53,60,-7,4,6,0,0
"13340","N.J","FLA",2011030136,15454,20112012,1,65.65,3,2,1,3.81625348145462,3.84594390664637,-0.0296904251917454,42,16,26,57,24,33,61,30,31,4,1,0,0
"13341","N.J","FLA",2011030137,15456,20112012,0,80,2,2,0,3.14787505187996,3.80320177490103,-0.655326723021062,35,45,-10,50,55,-5,68,72,-4,6,6,0,0
"13342","N.J","PHI",2011030221,15459,20112012,0,64.6,3,4,-1,1.35739091500707,7.25539358978858,-5.89800267478152,26,36,-10,34,54,-20,47,71,-24,3,6,0,0
"13343","N.J","PHI",2011030222,15461,20112012,0,60,4,1,3,4.80351292203475,3.02010527207312,1.78340764996162,35,20,15,47,25,22,70,37,33,6,6,0,0
"13344","N.J","PHI",2011030223,15463,20112012,1,77.35,4,3,1,3.42098549544805,3.49411510606296,-0.0731296106149131,31,28,3,44,34,10,59,46,13,2,5,0,0
"13345","N.J","PHI",2011030224,15466,20112012,1,60,4,2,2,4.37443804611394,4.16321670093207,0.211221345181864,43,22,21,54,27,27,64,33,31,5,2,0,0
"13346","N.J","PHI",2011030225,15468,20112012,0,60,3,1,2,5.02897305048224,2.27576763297947,2.75320541750277,30,28,2,44,37,7,60,55,5,4,1,0,0
"13347","N.J","NYR",2011030311,15474,20112012,0,60,0,3,-3,2.81414763196687,2.80897763469053,0.0051699972763366,21,28,-7,36,41,-5,62,56,6,4,4,0,0
"13348","N.J","NYR",2011030312,15476,20112012,0,60,3,2,1,3.27917695109096,3.35668083769269,-0.0775038866017326,27,25,2,43,32,11,59,39,20,3,4,0,0
"13349","N.J","NYR",2011030313,15479,20112012,1,60,0,3,-3,3.34508989946335,2.72088104658225,0.624208852881099,36,22,14,46,26,20,65,32,33,6,2,0,0
"13350","N.J","NYR",2011030314,15481,20112012,1,60,4,1,3,5.20953192291199,3.9847152193488,1.22481670356319,30,29,1,40,37,3,52,50,2,9,4,0,0
"13351","N.J","NYR",2011030315,15483,20112012,0,60,5,3,2,3.20509715361613,5.04431391444412,-1.83921676082799,17,28,-11,30,42,-12,47,58,-11,4,4,0,0
"13352","N.J","NYR",2011030316,15485,20112012,1,61.05,3,2,1,2.64153457933571,3.84760098802485,-1.20606640868914,29,35,-6,37,43,-6,45,58,-13,3,3,0,0
"13353","N.J","L.A",2011030411,15490,20112012,1,68.2166666666667,1,2,-1,4.66039753044697,4.17683845903457,0.483559071412401,17,25,-8,28,39,-11,34,54,-20,2,1,0,0
"13354","N.J","L.A",2011030412,15493,20112012,1,73.7,1,2,-1,6.97372424738978,3.81651704792239,3.15720719946739,33,32,1,48,40,8,67,53,14,4,2,0,0
"13355","N.J","L.A",2011030413,15495,20112012,0,60,0,4,-4,7.35854728348204,3.48704539852966,3.87150188495238,22,21,1,43,31,12,60,42,18,5,3,0,0
"13356","N.J","L.A",2011030414,15497,20112012,0,60,3,1,2,2.77451528242091,3.10413739632349,-0.329622113902587,24,22,2,34,45,-11,45,58,-13,3,4,0,0
"13357","N.J","L.A",2011030415,15500,20112012,1,60,2,1,1,2.97681292926205,2.96564984202269,0.0111630872393604,19,26,-7,25,40,-15,38,60,-22,3,3,0,0
"13358","N.J","L.A",2011030416,15502,20112012,0,60,1,6,-5,4.65786792301803,6.32742497826359,-1.66955705524556,18,25,-7,29,41,-12,38,57,-19,3,5,0,0
"13359","N.J","NYI",2012020006,15724,20122013,0,60,2,1,1,2.25363999124966,4.13678787730169,-1.88314788605203,28,19,9,34,31,3,50,40,10,2,4,0,0
"13360","N.J","PHI",2012020030,15727,20122013,1,60,3,0,3,4.42626415609081,2.46280969875113,1.96345445733968,26,24,2,33,30,3,41,46,-5,14,12,0,0
"13361","N.J","WSH",2012020052,15730,20122013,1,64.65,3,2,1,4.71261828321713,3.24020708267926,1.47241120053786,35,28,7,44,34,10,60,43,17,6,8,0,0
"13362","N.J","MTL",2012020067,15732,20122013,0,64.3666666666667,3,4,-1,3.7158473539817,3.60998756746267,0.105859786519034,25,32,-7,38,47,-9,45,61,-16,4,5,0,0
"13363","N.J","BOS",2012020078,15734,20122013,0,65,1,1,0,4.27082623098613,3.54222496836155,0.728601262624579,26,28,-2,35,39,-4,49,58,-9,5,3,0,0
"13364","N.J","NYI",2012020094,15736,20122013,1,62.0166666666667,4,5,-1,4.91991431071074,5.09509890417576,-0.175184593465019,32,35,-3,43,38,5,57,47,10,5,4,0,0
"13365","N.J","NYI",2012020122,15739,20122013,0,60,3,0,3,4.35490693059344,1.87109695983236,2.48380997076108,27,22,5,40,29,11,53,51,2,5,7,0,0
"13366","N.J","NYR",2012020128,15741,20122013,1,60,3,1,2,3.21940447240027,3.05581240247193,0.163592069928345,22,25,-3,31,33,-2,39,47,-8,4,4,0,0
"13367","N.J","T.B",2012020142,15743,20122013,1,60,4,2,2,5.37318044270069,1.74839346983936,3.62478697286133,27,19,8,42,22,20,47,30,17,5,5,0,0
"13368","N.J","CAR",2012020178,15748,20122013,1,60,2,4,-2,4.68108257338167,2.9878845946223,1.69319797875937,28,25,3,41,27,14,49,38,11,4,5,0,0
"13369","N.J","PHI",2012020198,15751,20122013,1,60,5,3,2,3.50101368414471,4.5132333424699,-1.01221965832519,19,28,-9,31,38,-7,41,46,-5,1,1,0,0
"13370","N.J","NYI",2012020207,15752,20122013,0,60,1,5,-4,2.47574238528244,4.50481183108039,-2.02906944579795,31,33,-2,43,43,0,60,55,5,5,6,0,0
"13371","N.J","OTT",2012020219,15754,20122013,1,65,1,1,0,4.02284787578547,4.38218970883967,-0.359341833054195,31,30,1,41,39,2,49,43,6,7,6,0,0
"13372","N.J","WSH",2012020239,15757,20122013,0,60,3,2,1,5.84982054459397,2.92022853808885,2.92959200650512,37,19,18,48,30,18,66,41,25,7,5,0,0
"13373","N.J","WSH",2012020250,15759,20122013,0,60,1,5,-4,1.86993296720902,4.09207728074398,-2.22214431353495,22,26,-4,33,36,-3,46,44,2,4,3,0,0
"13374","N.J","WPG",2012020263,15760,20122013,1,60,2,4,-2,3.93462826957693,5.61086225404188,-1.67623398446494,26,27,-1,36,36,0,47,45,2,2,2,0,0
"13375","N.J","WPG",2012020293,15764,20122013,0,60,1,3,-2,2.87951822408947,3.48010634762775,-0.600588123538286,23,21,2,36,29,7,58,46,12,4,4,0,0
"13376","N.J","BUF",2012020304,15766,20122013,0,65,3,3,0,4.56828916815721,1.87970920385347,2.68857996430374,31,23,8,43,33,10,61,47,14,7,7,0,0
"13377","N.J","TOR",2012020320,15768,20122013,0,60,2,4,-2,5.78248231553897,1.93538988077773,3.84709243476124,30,23,7,51,32,19,71,48,23,4,4,0,0
"13378","N.J","T.B",2012020324,15769,20122013,1,60,2,5,-3,0,0,0,27,25,2,41,26,15,49,31,18,3,3,0,0
"13379","N.J","BUF",2012020340,15771,20122013,1,65,2,2,0,4.53532454415108,5.30936165886878,-0.774037114717702,33,25,8,47,38,9,61,47,14,4,4,0,0
"13380","N.J","CAR",2012020360,15773,20122013,0,60,3,6,-3,4.14036274136743,3.26746604697109,0.872896694396331,34,22,12,45,34,11,61,43,18,2,3,0,0
"13381","N.J","WPG",2012020368,15774,20122013,1,65,2,2,0,5.10795696649438,4.31628593360074,0.791671032893646,27,25,2,41,33,8,57,44,13,1,1,0,0
"13382","N.J","PHI",2012020389,15777,20122013,1,60,5,2,3,3.51212940090045,2.9124277574104,0.599701643490044,32,25,7,42,27,15,57,35,22,7,5,0,0
"13383","N.J","PHI",2012020402,15779,20122013,0,65,1,1,0,3.69249129664995,4.16911196243018,-0.476620665780224,28,22,6,44,32,12,60,42,18,5,4,0,0
"13384","N.J","MTL",2012020410,15780,20122013,1,60,1,2,-1,2.98113294858032,2.87365548335947,0.107477465220853,33,22,11,41,29,12,56,36,20,3,3,0,0
"13385","N.J","NYR",2012020429,15783,20122013,1,60,2,3,-1,4.08145395776955,4.87085122067947,-0.789397262909915,31,22,9,45,31,14,60,37,23,4,2,0,0
"13386","N.J","CAR",2012020446,15785,20122013,0,60,4,1,3,3.32146184832709,4.20944967996184,-0.887987831634746,23,18,5,31,41,-10,49,55,-6,6,5,0,0
"13387","N.J","FLA",2012020461,15787,20122013,1,60,2,1,1,3.20673238216692,3.58018675073833,-0.373454368571416,25,18,7,40,31,9,48,47,1,1,2,0,0
"13388","N.J","OTT",2012020473,15789,20122013,0,65,2,2,0,5.88703367277049,2.87211500182093,3.01491867094956,34,14,20,52,21,31,67,34,33,1,1,0,0
"13389","N.J","T.B",2012020502,15793,20122013,0,65,4,4,0,3.29082781943725,4.24689437170116,-0.956066552263906,25,25,0,40,35,5,52,44,8,6,3,0,0
"13390","N.J","FLA",2012020514,15794,20122013,0,61.7166666666667,2,3,-1,3.99395108528087,4.38036403603746,-0.386412950756593,26,30,-4,31,36,-5,37,51,-14,5,4,0,0
"13391","N.J","NYI",2012020522,15796,20122013,1,60,1,3,-2,2.21656931750476,2.23918727040291,-0.0226179528981447,25,21,4,36,24,12,57,31,26,2,3,0,0
"13392","N.J","BOS",2012020543,15799,20122013,0,60,0,1,-1,3.48434326488655,2.97174175464917,0.512601510237374,40,26,14,51,32,19,64,46,18,1,1,0,0
"13393","N.J","TOR",2012020563,15801,20122013,1,60,1,2,-1,2.09930474726826,1.97136905851403,0.127935688754235,28,18,10,35,26,9,51,36,15,6,6,0,0
"13394","N.J","BUF",2012020575,15802,20122013,0,65,2,2,0,4.04605408868156,3.159378672093,0.88667541658856,39,26,13,47,29,18,65,42,23,5,3,0,0
"13395","N.J","BOS",2012020591,15805,20122013,1,60,4,5,-1,4.98983567511095,2.25397825931542,2.73585741579553,28,18,10,46,26,20,56,34,22,8,3,0,0
"13396","N.J","OTT",2012020605,15807,20122013,1,60,0,2,-2,4.5508097095917,3.00962720911048,1.54118250048123,33,11,22,48,16,32,58,25,33,4,2,0,0
"13397","N.J","TOR",2012020625,15810,20122013,0,60,0,2,-2,4.28169355379259,2.85107507591601,1.43061847787658,32,13,19,51,20,31,73,33,40,5,4,0,0
"13398","N.J","PHI",2012020648,15813,20122013,0,60,3,0,3,5.32877077563717,4.64769690769026,0.681073867946907,31,23,8,44,29,15,61,42,19,5,3,0,0
"13399","N.J","FLA",2012020660,15815,20122013,1,60,6,2,4,3.82735125499111,0.91622809600085,2.91112315899026,33,13,20,41,15,26,49,22,27,3,3,0,0
"13400","N.J","NYR",2012020671,15816,20122013,0,60,1,4,-3,4.89877422875634,3.40898576260952,1.48978846614682,27,22,5,41,30,11,55,41,14,3,8,0,0
"13401","N.J","MTL",2012020681,15818,20122013,1,60,3,2,1,3.47832771646324,1.84140857905004,1.6369191374132,24,21,3,29,25,4,38,29,9,4,4,0,0
"13402","N.J","NYR",2012020714,15822,20122013,0,60,0,4,-4,4.37204832218788,3.93489758567216,0.437150736515719,20,21,-1,30,31,-1,51,37,14,4,6,0,0
"13403","N.J","NYI",2013020016,15982,20132014,1,65,3,3,0,3.88542650542144,5.06006936414633,-1.17464285872489,29,26,3,41,30,11,55,39,16,2,2,0,0
"13404","N.J","EDM",2013020035,15985,20132014,0,65,4,4,0,4.1505608199077,4.23947868123651,-0.0889178613288095,25,27,-2,36,38,-2,49,55,-6,3,4,0,0
"13405","N.J","VAN",2013020043,15986,20132014,0,62.3,2,3,-1,1.95786547439639,4.20325330892229,-2.2453878345259,23,32,-9,31,42,-11,36,58,-22,1,2,0,0
"13406","N.J","CGY",2013020063,15989,20132014,0,60,2,3,-1,4.73649498153827,7.01517196395071,-2.27867698241243,21,29,-8,32,44,-12,49,55,-6,2,4,0,0
"13407","N.J","WPG",2013020077,15991,20132014,0,60,0,3,-3,0,0,0,24,35,-11,36,47,-11,55,56,-1,6,4,0,0
"13408","N.J","OTT",2013020101,15995,20132014,0,60,2,5,-3,4.12596286868211,6.30121148948691,-2.1752486208048,42,23,19,52,31,21,62,37,25,7,5,0,0
"13409","N.J","NYR",2013020116,15997,20132014,1,60,4,0,4,1.91385625270709,3.90682954900933,-1.99297329630224,19,22,-3,23,28,-5,27,37,-10,4,3,0,0
"13410","N.J","CBJ",2013020131,16000,20132014,0,60,1,4,-3,3.24760472035268,3.51645974392886,-0.26885502357618,25,24,1,37,33,4,51,46,5,4,3,0,0
"13411","N.J","VAN",2013020140,16002,20132014,1,65,2,2,0,0,0,0,30,21,9,41,29,12,47,33,14,3,2,0,0
"13412","N.J","BOS",2013020155,16004,20132014,0,60,4,3,1,5.0574656794779,2.75760856610594,2.29985711337196,32,28,4,40,36,4,51,43,8,6,2,0,0
"13413","N.J","T.B",2013020179,16007,20132014,1,60,2,1,1,2.92236949395738,3.42699723510304,-0.504627741145669,22,17,5,28,22,6,34,27,7,3,5,0,0
"13414","N.J","PHI",2013020203,16011,20132014,1,60,0,1,-1,1.23291151336161,1.76509138918482,-0.532179875823203,14,21,-7,20,28,-8,27,34,-7,5,5,0,0
"13415","N.J","MIN",2013020214,16012,20132014,0,60,0,4,-4,3.54297034932461,2.87289815628901,0.670072193035594,19,20,-1,33,27,6,52,37,15,4,4,0,0
"13416","N.J","PHI",2013020232,16016,20132014,0,60,3,0,3,4.98463954069302,3.56167182422781,1.42296771646522,25,22,3,32,31,1,40,46,-6,3,3,0,0
"13417","N.J","TOR",2013020241,16017,20132014,0,65,1,1,0,5.44747896363901,4.18017985154938,1.26729911208963,35,28,7,47,42,5,60,52,8,3,5,0,0
"13418","N.J","NSH",2013020256,16019,20132014,1,60,5,0,5,1.83354210798461,1.47732196480501,0.356220143179598,23,15,8,27,19,8,36,22,14,4,6,0,0
"13419","N.J","NYR",2013020265,16021,20132014,0,60,3,2,1,2.06920322701332,5.07737594065838,-3.00817271364506,28,35,-7,35,45,-10,51,63,-12,4,6,0,0
"13420","N.J","L.A",2013020285,16024,20132014,1,60,0,2,-2,4.84083422250241,2.70535516095861,2.1354790615438,26,21,5,35,27,8,44,40,4,3,2,0,0
"13421","N.J","ANA",2013020325,16029,20132014,0,61.9666666666667,4,3,1,4.95682049139396,3.50226538078949,1.45455511060447,26,25,1,39,33,6,53,47,6,3,5,0,0
"13422","N.J","L.A",2013020334,16030,20132014,0,62.5,2,1,1,3.7843604433001,4.22522215081608,-0.440861707515978,15,35,-20,29,56,-27,38,76,-38,3,5,0,0
"13423","N.J","S.J",2013020352,16032,20132014,0,60,1,2,-1,2.30319522318314,4.81414875090604,-2.5109535277229,19,30,-11,27,41,-14,45,57,-12,1,3,0,0
"13424","N.J","WPG",2013020357,16034,20132014,1,60,1,3,-2,3.52775600827953,2.98771306034178,0.540042947937758,26,22,4,35,24,11,49,30,19,2,2,0,0
"13425","N.J","CAR",2013020366,16036,20132014,1,60,3,4,-1,3.8309475829592,2.9731833012338,0.857764281725395,22,22,0,34,27,7,45,33,12,1,1,0,0
"13426","N.J","CAR",2013020389,16038,20132014,0,60,5,2,3,3.85486533611977,2.6764582201431,1.17840711597666,31,18,13,48,24,24,68,38,30,4,4,0,0
"13427","N.J","BUF",2013020396,16039,20132014,1,64.3166666666667,1,0,1,4.12581697035521,1.87582523601076,2.24999173434445,24,15,9,38,27,11,52,35,17,3,4,0,0
"13428","N.J","MTL",2013020407,16041,20132014,0,60,2,3,-1,4.01146421532214,2.27008708584909,1.74137712947305,30,17,13,41,26,15,63,39,24,3,2,0,0
"13429","N.J","MTL",2013020419,16043,20132014,1,65,3,3,0,4.0435050978686,4.68477425585185,-0.641269157983245,34,30,4,50,38,12,64,44,20,2,3,0,0
"13430","N.J","DET",2013020432,16045,20132014,1,60,1,3,-2,0,0,0,11,21,-10,19,28,-9,26,31,-5,4,5,0,0
"13431","N.J","NYR",2013020444,16046,20132014,0,61.25,4,3,1,2.12241879576322,3.6131467751984,-1.49072797943518,24,24,0,36,38,-2,48,61,-13,2,4,0,0
"13432","N.J","CBJ",2013020460,16049,20132014,0,60,4,5,-1,6.51933613058645,1.4478123546578,5.07152377592865,34,23,11,42,25,17,53,27,26,2,1,0,0
"13433","N.J","T.B",2013020492,16053,20132014,1,60,3,0,3,1.97756789674168,5.93386866449146,-3.95630076774978,19,33,-14,29,45,-16,38,53,-15,2,3,0,0
"13434","N.J","OTT",2013020521,16057,20132014,1,60,5,2,3,3.51816863498675,2.51698713171253,1.00118150327422,33,25,8,38,32,6,43,38,5,5,4,0,0
"13435","N.J","ANA",2013020534,16059,20132014,1,62.6166666666667,2,3,-1,4.07356372767583,4.45700123105325,-0.383437503377422,21,24,-3,29,28,1,36,35,1,3,4,0,0
"13436","N.J","WSH",2013020546,16060,20132014,0,60.7166666666667,5,4,1,4.88068027087138,5.67504624393769,-0.794365973066306,37,22,15,51,29,22,72,37,35,2,1,0,0
"13437","N.J","CHI",2013020561,16062,20132014,0,60,2,5,-3,3.6046814980634,7.71142266379588,-4.10674116573248,12,37,-25,21,53,-32,32,65,-33,1,4,0,0
"13438","N.J","CBJ",2013020569,16066,20132014,1,65,1,1,0,2.53411029109213,4.46148146844826,-1.92737117735612,17,30,-13,27,40,-13,34,44,-10,4,6,0,0
"13439","N.J","NYI",2013020580,16067,20132014,0,60,2,1,1,2.89114024119044,2.72948268451728,0.161657556673163,25,31,-6,33,40,-7,48,60,-12,1,3,0,0
"13440","N.J","CHI",2013020622,16073,20132014,1,60,3,5,-2,2.56680429575499,1.30660442868248,1.26019986707252,27,24,3,36,29,7,47,36,11,4,3,0,0
"13441","N.J","BUF",2013020628,16074,20132014,0,60,1,2,-1,2.61515094306031,2.99983096960932,-0.384680026549006,22,22,0,32,26,6,52,34,18,4,5,0,0
"13442","N.J","PHI",2013020649,16077,20132014,1,61.8333333333333,2,3,-1,3.75220050978533,5.46271287628412,-1.71051236649879,33,28,5,43,40,3,47,48,-1,3,5,0,0
"13443","N.J","DAL",2013020661,16079,20132014,1,60,1,0,1,3.69682842520372,2.28965093709864,1.40717748810508,34,26,8,42,33,9,47,51,-4,2,2,0,0
"13444","N.J","FLA",2013020677,16081,20132014,1,64.95,2,1,1,5.04260523401535,3.80343529728998,1.23916993672538,36,30,6,48,38,10,57,46,11,2,2,0,0
"13445","N.J","TOR",2013020687,16082,20132014,0,65,2,2,0,7.44263981820428,3.36620210902765,4.07643770917663,38,25,13,61,34,27,83,48,35,4,4,0,0
"13446","N.J","MTL",2013020700,16084,20132014,0,60,4,1,3,2.83460478872121,4.04280454553811,-1.2081997568169,19,30,-11,35,44,-9,50,57,-7,3,3,0,0
"13447","N.J","COL",2013020718,16086,20132014,0,65,1,1,0,3.43059314148195,4.47973283371539,-1.04913969223344,34,38,-4,40,50,-10,53,63,-10,2,3,0,0
"13448","N.J","ARI",2013020733,16088,20132014,0,60,2,3,-1,4.54621071006113,2.958262385946,1.58794832411513,35,27,8,47,41,6,73,51,22,2,3,0,0
"13449","N.J","STL",2013020747,16091,20132014,1,60,7,1,6,3.56925725447945,3.33949441667726,0.229762837802191,23,27,-4,29,31,-2,33,45,-12,4,3,0,0
"13450","N.J","WSH",2013020769,16094,20132014,1,60,2,1,1,4.6169579430134,2.9726076642437,1.64435027876971,30,31,-1,38,40,-2,42,47,-5,5,3,0,0
"13451","N.J","NYR",2013020784,16096,20132014,1,60,3,7,-4,3.99225860549505,4.70542951279367,-0.713170907298625,22,26,-4,33,33,0,45,44,1,2,4,0,0
"13452","N.J","STL",2013020801,16098,20132014,0,60,0,3,-3,3.66631916731876,4.40306355147868,-0.73674438415992,23,25,-2,36,35,1,55,53,2,5,5,0,0
"13453","N.J","DAL",2013020813,16100,20132014,0,60.6666666666667,3,2,1,1.99793193663675,0.877340031618587,1.12059190501816,24,16,8,36,25,11,46,43,3,5,5,0,0
"13454","N.J","NSH",2013020822,16101,20132014,0,61.4833333333333,2,3,-1,2.29107774104341,5.15763931000129,-2.86656156895788,26,33,-7,31,43,-12,45,52,-7,3,3,0,0
"13455","N.J","COL",2013020840,16104,20132014,1,60.4666666666667,1,2,-1,3.52681879390081,4.2040563890585,-0.677237595157696,28,25,3,40,35,5,47,40,7,4,5,0,0
"13456","N.J","EDM",2013020867,16108,20132014,1,62.5666666666667,2,1,1,4.41414170503413,2.80536262266105,1.60877908237308,24,20,4,33,29,4,47,36,11,3,3,0,0
"13457","N.J","WSH",2013020879,16109,20132014,0,60,0,3,-3,4.4182048813125,5.10208261013031,-0.683877728817805,25,26,-1,42,37,5,63,53,10,4,4,0,0
"13458","N.J","CBJ",2013020886,16128,20132014,1,60,5,2,3,5.43903568344189,2.93014253673027,2.50889314671162,35,19,16,49,31,18,53,45,8,6,5,0,0
"13459","N.J","NYI",2013020903,16130,20132014,0,60,6,1,5,0,0,0,35,19,16,44,25,19,60,40,20,8,3,0,0
"13460","N.J","S.J",2013020913,16131,20132014,1,60,2,4,-2,3.83253353102373,0.960509247845039,2.87202428317869,23,22,1,34,23,11,36,29,7,4,1,0,0
"13461","N.J","DET",2013020925,16133,20132014,1,60,4,3,1,3.48394361266401,2.41121477517481,1.07272883748919,29,23,6,35,29,6,41,35,6,4,5,0,0
"13462","N.J","DET",2013020949,16136,20132014,0,60,4,7,-3,1.66639807185857,4.42632593980664,-2.75992786794808,25,33,-8,30,41,-11,44,47,-3,3,3,0,0
"13463","N.J","CAR",2013020957,16137,20132014,1,60,5,4,1,4.00842026316322,7.19977241482798,-3.19135215166476,31,33,-2,38,42,-4,51,52,-1,2,2,0,0
"13464","N.J","PHI",2013020977,16140,20132014,0,60,2,1,1,1.73001110475523,4.74974215926844,-3.0197310545132,26,31,-5,32,49,-17,46,67,-21,3,6,0,0
"13465","N.J","FLA",2013020999,16143,20132014,0,60,3,5,-2,3.93048772508337,2.08988433645573,1.84060338862764,31,22,9,41,31,10,61,38,23,2,4,0,0
"13466","N.J","T.B",2013021007,16144,20132014,0,60,0,3,-3,3.3101116680773,3.93419359926943,-0.624081931192137,23,32,-9,33,39,-6,41,47,-6,4,4,0,0
"13467","N.J","BOS",2013021026,16147,20132014,1,60,2,4,-2,2.16253099445021,2.20926927911933,-0.046738284669118,24,31,-7,31,35,-4,45,44,1,4,2,0,0
"13468","N.J","MIN",2013021042,16149,20132014,1,62,4,3,1,3.65393001686971,4.41709535350674,-0.76316533663703,29,23,6,38,28,10,43,32,11,3,6,0,0
"13469","N.J","NYR",2013021061,16151,20132014,1,60,0,2,-2,2.78704873750591,5.84554608784674,-3.05849735034083,21,27,-6,34,33,1,48,40,8,2,4,0,0
"13470","N.J","TOR",2013021068,16152,20132014,1,60,3,2,1,2.92772156087449,2.72567907511257,0.202042485761922,24,23,1,35,33,2,40,42,-2,2,4,0,0
"13471","N.J","ARI",2013021093,16156,20132014,1,65,2,2,0,4.29565939900931,2.87300710362615,1.42265229538316,28,27,1,41,34,7,50,40,10,4,3,0,0
"13472","N.J","NYI",2013021113,16158,20132014,0,65,1,1,0,4.33391666974057,2.92993784897152,1.40397882076905,24,20,4,38,36,2,59,50,9,3,2,0,0
"13473","N.J","FLA",2013021126,16160,20132014,1,60,6,3,3,3.99916380508284,1.95984388807288,2.03931991700997,32,22,10,43,29,14,48,43,5,4,5,0,0
"13474","N.J","BUF",2013021129,16161,20132014,0,65,2,2,0,5.00272504164604,4.24525602045469,0.757469021191355,35,27,8,45,31,14,71,43,28,2,3,0,0
"13475","N.J","WSH",2013021157,16164,20132014,1,60,2,1,1,6.46570636052638,4.68107053604035,1.78463582448603,31,25,6,39,36,3,54,46,8,5,4,0,0
"13476","N.J","CAR",2013021167,16165,20132014,0,60,3,1,2,3.52588491782066,5.45042886664299,-1.92454394882233,23,27,-4,41,37,4,54,58,-4,1,4,0,0
"13477","N.J","CGY",2013021177,16167,20132014,1,60,0,1,-1,3.29994830036355,3.62542443719576,-0.325476136832208,31,22,9,39,30,9,52,35,17,3,4,0,0
"13478","N.J","OTT",2013021197,16170,20132014,0,65,1,1,0,6.38933151913746,2.72195292903291,3.66737859010455,39,32,7,46,46,0,60,62,-2,2,4,0,0
"13479","N.J","NYI",2013021208,16171,20132014,1,65,2,2,0,1.3131320446555,3.73469799460145,-2.42156594994594,27,30,-3,34,39,-5,41,46,-5,1,3,0,0
"13480","N.J","BOS",2013021221,16173,20132014,1,60,3,2,1,2.64639387701573,2.68714408395198,-0.0407502069362522,31,18,13,36,24,12,45,28,17,3,3,0,0
"13481","N.J","PHI",2014020006,16352,20142015,0,60,6,4,2,3.29089820355875,6.54974558906213,-3.25884738550337,26,39,-13,39,54,-15,53,68,-15,3,5,0,0
"13482","N.J","FLA",2014020022,16354,20142015,0,60,5,1,4,3.31707212945912,4.5836635484231,-1.26659141896398,24,29,-5,31,41,-10,36,51,-15,6,9,0,0
"13483","N.J","T.B",2014020044,16357,20142015,0,60,2,1,1,2.74991068255622,3.08092133502865,-0.331010652472429,25,27,-2,35,37,-2,43,51,-8,4,4,0,0
"13484","N.J","WSH",2014020052,16359,20142015,0,60,2,6,-4,3.66716714706854,3.86694866257858,-0.19978151551004,28,33,-5,38,43,-5,56,56,0,3,5,0,0
"13485","N.J","S.J",2014020067,16361,20142015,1,60,2,4,-2,3.99707561786779,4.53296959685423,-0.535893978986437,37,32,5,42,40,2,50,48,2,3,4,0,0
"13486","N.J","NYR",2014020080,16364,20142015,1,62.7,3,4,-1,3.97147899217089,4.55093515381304,-0.579456161642156,31,25,6,38,32,6,49,40,9,5,3,0,0
"13487","N.J","DAL",2014020101,16367,20142015,1,65,2,2,0,2.782462180957,4.97969982496579,-2.19723764400879,27,37,-10,36,44,-8,44,50,-6,0,2,0,0
"13488","N.J","OTT",2014020109,16368,20142015,0,63.65,3,2,1,6.2843874651735,3.82958301377948,2.45480445139401,29,35,-6,41,42,-1,53,63,-10,6,5,0,0
"13489","N.J","WPG",2014020139,16373,20142015,1,65,1,1,0,3.58478556026239,2.20286442735232,1.38192113291007,28,25,3,36,33,3,50,40,10,1,2,0,0
"13490","N.J","CBJ",2014020157,16375,20142015,1,60,3,2,1,3.36641878087539,3.4185386847239,-0.0521199038485065,29,34,-5,33,37,-4,46,40,6,8,5,0,0
"13491","N.J","STL",2014020173,16378,20142015,1,60,0,1,-1,2.40033406409202,4.40881646224238,-2.00848239815036,26,23,3,32,30,2,47,38,9,3,3,0,0
"13492","N.J","STL",2014020191,16380,20142015,0,60,3,4,-1,5.30530258059116,3.61937327933265,1.68592930125851,27,29,-2,40,39,1,51,49,2,3,3,0,0
"13493","N.J","DET",2014020199,16381,20142015,0,60,2,4,-2,3.03865129838406,5.86862211399421,-2.82997081561015,17,31,-14,25,37,-12,45,41,4,4,5,0,0
"13494","N.J","BOS",2014020218,16384,20142015,0,60,2,4,-2,3.88598613115028,5.44808795728022,-1.56210182612995,28,23,5,38,35,3,53,48,5,2,3,0,0
"13495","N.J","MIN",2014020220,16385,20142015,1,60,3,1,2,3.49869088096875,3.34716546925483,0.151525411713919,23,24,-1,29,31,-2,35,37,-2,6,4,0,0
"13496","N.J","WSH",2014020243,16388,20142015,0,60,1,0,1,1.97605118104324,3.55795260082834,-1.5819014197851,28,30,-2,37,43,-6,51,62,-11,4,5,0,0
"13497","N.J","COL",2014020254,16389,20142015,1,60,2,3,-1,3.47462246858777,3.718228910584,-0.243606441996235,25,29,-4,35,34,1,43,37,6,2,2,0,0
"13498","N.J","WPG",2014020273,16392,20142015,0,60,1,3,-2,4.24627260956814,6.16953642142471,-1.92326381185656,22,34,-12,33,43,-10,45,63,-18,2,5,0,0
"13499","N.J","EDM",2014020294,16395,20142015,0,60,2,0,2,3.37177971119672,7.04593050076161,-3.67415078956489,26,29,-3,33,46,-13,39,69,-30,2,3,0,0
"13500","N.J","CGY",2014020305,16396,20142015,0,65,4,4,0,3.71048152336152,3.58298082283,0.127500700531527,29,37,-8,40,49,-9,58,60,-2,3,7,0,0
"13501","N.J","VAN",2014020321,16399,20142015,0,60,0,2,-2,4.43412177603204,4.18397182741319,0.250149948618855,20,36,-16,32,47,-15,46,60,-14,0,2,0,0
"13502","N.J","DET",2014020338,16402,20142015,1,65,4,4,0,4.77211780348443,4.73098190090968,0.0411359025747515,25,32,-7,36,42,-6,43,54,-11,6,6,0,0
"13503","N.J","NYI",2014020347,16403,20142015,0,60,1,3,-2,4.62996132075386,6.0473540360108,-1.41739271525694,35,28,7,49,40,9,75,55,20,5,5,0,0
"13504","N.J","TOR",2014020378,16408,20142015,0,60,5,3,2,1.80600619519828,5.65876228813025,-3.85275609293197,26,32,-6,37,48,-11,44,60,-16,3,2,0,0
"13505","N.J","WSH",2014020396,16410,20142015,1,60,1,4,-3,3.95067695042962,3.25088561908342,0.699791331346205,34,29,5,49,39,10,66,42,24,4,4,0,0
"13506","N.J","CAR",2014020407,16412,20142015,0,60,2,1,1,2.84958312341769,5.05621542946938,-2.20663230605169,16,40,-24,29,61,-32,42,94,-52,2,4,0,0
"13507","N.J","CHI",2014020410,16413,20142015,1,65,2,2,0,2.34070531157158,6.91033860425523,-4.56963329268365,24,39,-15,33,56,-23,41,73,-32,1,2,0,0
"13508","N.J","PHI",2014020423,16415,20142015,0,60,1,4,-3,5.43234155897323,6.50897848908789,-1.07663693011466,18,36,-18,25,44,-19,46,55,-9,2,5,0,0
"13509","N.J","DAL",2014020443,16417,20142015,0,60,3,4,-1,5.3159904149652,5.82628432213096,-0.51029390716576,31,36,-5,51,55,-4,65,74,-9,2,2,0,0
"13510","N.J","NYI",2014020451,16419,20142015,0,65,2,2,0,2.15037122485228,4.18754905511742,-2.03717783026514,28,33,-5,30,41,-11,43,57,-14,3,4,0,0
"13511","N.J","OTT",2014020464,16421,20142015,1,60,0,2,-2,3.3468883332971,3.76539628510363,-0.418507951806532,34,16,18,44,20,24,58,25,33,5,2,0,0
"13512","N.J","T.B",2014020474,16423,20142015,1,65,2,2,0,2.42704025609419,3.83191295087454,-1.40487269478035,18,28,-10,20,38,-18,24,57,-33,4,5,0,0
"13513","N.J","WSH",2014020483,16424,20142015,1,60,0,4,-4,1.88453132550772,4.96814352711658,-3.08361220160887,21,21,0,32,29,3,36,37,-1,3,4,0,0
"13514","N.J","CAR",2014020504,16427,20142015,1,65,1,1,0,4.81252646193025,2.54898309597775,2.2635433659525,19,33,-14,27,42,-15,41,53,-12,3,2,0,0
"13515","N.J","NYR",2014020517,16431,20142015,0,60,1,3,-2,4.25266116519924,6.30031220627143,-2.04765104107219,20,28,-8,32,36,-4,41,52,-11,4,3,0,0
"13516","N.J","DET",2014020550,16435,20142015,0,60,1,3,-2,1.92576013866346,3.3312003293513,-1.40544019068784,13,28,-15,20,39,-19,31,50,-19,3,4,0,0
"13517","N.J","MTL",2014020559,16437,20142015,1,60,2,4,-2,2.74604545371403,2.9440801279926,-0.198034674278571,24,26,-2,33,34,-1,41,43,-2,3,4,0,0
"13518","N.J","PHI",2014020568,16438,20142015,1,60,5,2,3,1.93181888830441,4.54890458920272,-2.61708570089831,18,20,-2,26,26,0,38,39,-1,3,2,0,0
"13519","N.J","BUF",2014020584,16441,20142015,1,60,4,1,3,3.79479387199535,3.32291184272617,0.471882029269182,28,21,7,39,27,12,54,38,16,2,2,0,0
"13520","N.J","BOS",2014020598,16443,20142015,0,60,0,3,-3,4.43645786400884,7.3543669694991,-2.91790910549025,14,43,-29,27,48,-21,36,68,-32,1,3,0,0
"13521","N.J","NYI",2014020608,16444,20142015,1,63.0833333333333,2,3,-1,3.14105616816889,2.80375777054596,0.337298397622927,23,31,-8,31,40,-9,37,52,-15,2,4,0,0
"13522","N.J","L.A",2014020643,16449,20142015,0,60,5,3,2,3.20725517597748,6.47431548423422,-3.26706030825674,20,26,-6,31,35,-4,39,50,-11,4,4,0,0
"13523","N.J","ANA",2014020659,16451,20142015,0,60,1,5,-4,4.25686055156302,4.30870026252876,-0.0518397109657371,15,40,-25,23,51,-28,38,69,-31,2,3,0,0
"13524","N.J","S.J",2014020682,16454,20142015,0,60,5,2,3,3.18672340910416,5.63900833570663,-2.45228492660247,34,36,-2,40,51,-11,56,69,-13,3,4,0,0
"13525","N.J","TOR",2014020708,16463,20142015,1,65,1,1,0,2.73933605202811,3.66471311854571,-0.925377066517598,23,30,-7,30,36,-6,35,46,-11,4,6,0,0
"13526","N.J","FLA",2014020731,16466,20142015,1,60,3,1,2,2.99373989895685,3.3223036370473,-0.328563738090452,14,27,-13,23,37,-14,33,51,-18,4,3,0,0
"13527","N.J","OTT",2014020745,16469,20142015,1,60,2,1,1,2.13074558367884,2.42794154177034,-0.297195958091502,19,20,-1,27,27,0,28,39,-11,3,1,0,0
"13528","N.J","TOR",2014020768,16472,20142015,1,60,4,1,3,2.92331195884617,4.79145196109312,-1.86814000224695,17,34,-17,24,42,-18,26,50,-24,2,3,0,0
"13529","N.J","MTL",2014020778,16473,20142015,0,60,2,6,-4,2.46809632243037,6.41356554994127,-3.9454692275109,23,44,-21,31,56,-25,43,77,-34,2,3,0,0
"13530","N.J","EDM",2014020792,16475,20142015,1,60,1,2,-1,1.34436522307806,4.2713898960501,-2.92702467297204,14,24,-10,24,37,-13,34,47,-13,2,4,0,0
"13531","N.J","CHI",2014020819,16479,20142015,0,60,1,3,-2,4.63980227031905,7.39252026252507,-2.75271799220602,26,35,-9,31,48,-17,48,65,-17,2,4,0,0
"13532","N.J","NSH",2014020827,16480,20142015,0,60,1,3,-2,5.12502930359915,4.67470593484177,0.450323368757381,22,38,-16,32,51,-19,43,70,-27,3,3,0,0
"13533","N.J","BUF",2014020846,16483,20142015,1,65,1,1,0,5.01186932426936,2.15315787169675,2.85871145257261,35,25,10,47,37,10,60,46,14,5,3,0,0
"13534","N.J","VAN",2014020867,16486,20142015,1,60,4,2,2,4.83389016568253,3.83966170801068,0.994228457671852,27,23,4,37,35,2,45,43,2,4,3,0,0
"13535","N.J","CAR",2014020878,16487,20142015,1,60,3,1,2,1.85983560566092,2.84913967429497,-0.989304068634056,19,32,-13,26,41,-15,30,51,-21,4,3,0,0
"13536","N.J","ARI",2014020892,16489,20142015,1,60,3,0,3,4.66887722949837,2.61508701206185,2.05379021743652,28,38,-10,34,48,-14,42,59,-17,2,4,0,0
"13537","N.J","CGY",2014020905,16491,20142015,1,60,1,3,-2,2.34427851824148,5.95717915872228,-3.6129006404808,27,26,1,34,37,-3,44,47,-3,3,2,0,0
"13538","N.J","BOS",2014020917,16493,20142015,1,62.7666666666667,2,3,-1,5.7975644954422,6.19105385662988,-0.393489361187676,31,34,-3,39,42,-3,46,55,-9,2,2,0,0
"13539","N.J","CBJ",2014020926,16494,20142015,0,60,2,0,2,1.98381443563267,2.53380707431143,-0.549992638678759,19,33,-14,28,45,-17,44,60,-16,4,3,0,0
"13540","N.J","NSH",2014020942,16497,20142015,1,60,3,1,2,5.38457514653783,3.66128452244448,1.72329062409335,24,34,-10,35,45,-10,43,61,-18,2,3,0,0
"13541","N.J","CBJ",2014020964,16500,20142015,1,60,2,3,-1,5.43100471893558,5.2436807849125,0.187323934023087,23,24,-1,42,36,6,59,45,14,5,2,0,0
"13542","N.J","PHI",2014020981,16502,20142015,1,60,5,2,3,3.88059542791359,4.17727199778892,-0.296676569875331,21,27,-6,31,33,-2,42,47,-5,5,4,0,0
"13543","N.J","MIN",2014020997,16504,20142015,0,60,2,6,-4,5.23452383123185,4.95371786832402,0.280805962907834,32,38,-6,41,57,-16,45,70,-25,0,4,0,0
"13544","N.J","COL",2014021009,16506,20142015,0,65,1,1,0,4.02410680366938,2.73165066281217,1.29245614085721,24,29,-5,37,41,-4,60,60,0,2,3,0,0
"13545","N.J","ARI",2014021027,16508,20142015,0,60,4,1,3,6.08406816893694,4.52745049163466,1.55661767730228,29,31,-2,40,46,-6,52,66,-14,4,2,0,0
"13546","N.J","BUF",2014021063,16514,20142015,0,60,3,1,2,3.64921790236258,6.15237189885556,-2.50315399649298,27,29,-2,37,41,-4,53,55,-2,2,4,0,0
"13547","N.J","NYI",2014021072,16515,20142015,1,60,0,3,-3,2.40488732955419,3.98929327188853,-1.58440594233434,26,30,-4,37,40,-3,49,47,2,1,1,0,0
"13548","N.J","L.A",2014021083,16517,20142015,1,60,1,3,-2,4.08270766306669,3.18503375409637,0.897673908970319,20,33,-13,33,47,-14,44,59,-15,2,4,0,0
"13549","N.J","WSH",2014021104,16520,20142015,0,61.2166666666667,2,3,-1,5.38450157914657,2.93119212580132,2.45330945334525,31,24,7,44,34,10,50,47,3,4,4,0,0
"13550","N.J","CAR",2014021123,16522,20142015,0,60,1,3,-2,4.44838269763352,5.53416327515151,-1.08578057751799,22,32,-10,37,47,-10,53,64,-11,1,3,0,0
"13551","N.J","ANA",2014021133,16523,20142015,1,60,1,2,-1,3.85085366779822,2.17892178761824,1.67193188017998,27,25,2,37,31,6,44,41,3,2,1,0,0
"13552","N.J","CBJ",2014021144,16525,20142015,0,60.9333333333333,2,3,-1,3.35068278562835,4.79894438358908,-1.44826159796073,26,31,-5,33,41,-8,37,52,-15,2,5,0,0
"13553","N.J","MTL",2014021163,16528,20142015,1,65,2,2,0,2.2590139914271,3.76578782292199,-1.5067738314949,18,33,-15,23,40,-17,35,46,-11,2,6,0,0
"13554","N.J","NYR",2014021174,16529,20142015,0,60,1,6,-5,4.87931518611731,7.73121890141419,-2.85190371529688,36,32,4,47,42,5,68,52,16,5,2,0,0
"13555","N.J","NYR",2014021190,16532,20142015,1,60,2,4,-2,2.65191784431008,4.9607417892048,-2.30882394489472,21,40,-19,30,48,-18,37,57,-20,2,7,0,0
"13556","N.J","T.B",2014021206,16534,20142015,0,61.3666666666667,3,4,-1,1.49510739071944,3.32448372250656,-1.82937633178712,24,31,-7,31,42,-11,48,64,-16,3,8,0,0
"13557","N.J","FLA",2014021222,16536,20142015,0,60,2,3,-1,6.54906080237051,4.07058643960045,2.47847436277006,33,27,6,46,38,8,56,55,1,2,2,0,0
"13558","N.J","WPG",2015020012,16717,20152016,1,60,1,3,-2,3.55169704783475,4.21059004950318,-0.658893001668432,21,30,-9,28,38,-10,32,44,-12,4,4,0,0
"13559","N.J","WSH",2015020022,16718,20152016,0,60,3,5,-2,3.442017953245,3.37850045737287,0.0635174958721336,25,27,-2,35,37,-2,51,54,-3,4,6,0,0
"13560","N.J","NSH",2015020037,16721,20152016,1,60,1,3,-2,1.78015813819366,4.49206206237432,-2.71190392418066,23,20,3,28,30,-2,33,38,-5,2,2,0,0
"13561","N.J","S.J",2015020058,16724,20152016,1,65,1,1,0,3.65558843540222,2.84726845395989,0.808319981442331,32,34,-2,42,39,3,47,46,1,7,3,0,0
"13562","N.J","NYR",2015020075,16726,20152016,0,63.1166666666667,2,1,1,3.42869826141396,2.43958460539579,0.989113656018162,24,27,-3,36,40,-4,42,58,-16,3,2,0,0
"13563","N.J","ARI",2015020081,16728,20152016,1,60.7166666666667,3,2,1,2.6268291141605,3.21873432658685,-0.591905212426354,25,20,5,33,31,2,37,41,-4,3,5,0,0
"13564","N.J","OTT",2015020094,16730,20152016,0,65,4,4,0,5.44255952111784,5.45245429047282,-0.00989476935497535,32,39,-7,42,53,-11,53,70,-17,5,4,0,0
"13565","N.J","BUF",2015020107,16732,20152016,0,60,4,3,1,5.91626558957159,3.92657791148224,1.98968767808935,28,29,-1,45,36,9,61,47,14,2,5,0,0
"13566","N.J","CBJ",2015020125,16735,20152016,1,60,1,3,-2,0,0,0,24,14,10,35,20,15,40,25,15,5,4,0,0
"13567","N.J","PHI",2015020138,16737,20152016,0,60,4,1,3,3.80882845170072,4.09130798394569,-0.282479532244972,33,28,5,48,47,1,59,68,-9,5,2,0,0
"13568","N.J","NYI",2015020154,16739,20152016,1,65,2,2,0,1.19470543281932,3.3317953332371,-2.13708990041778,17,26,-9,22,40,-18,33,49,-16,4,3,0,0
"13569","N.J","NYI",2015020173,16742,20152016,0,60,1,2,-1,3.10689760322566,3.02030601307578,0.0865915901498795,24,34,-10,32,43,-11,57,58,-1,6,2,0,0
"13570","N.J","CHI",2015020195,16745,20152016,1,60,4,2,2,3.63263401901607,4.10476751800161,-0.472133498985542,26,29,-3,33,36,-3,38,53,-15,2,3,0,0
"13571","N.J","VAN",2015020212,16747,20152016,1,63.55,4,3,1,3.27714829168326,3.8562799191568,-0.579131627473544,28,31,-3,38,47,-9,42,58,-16,7,7,0,0
"13572","N.J","STL",2015020216,16749,20152016,1,60,0,2,-2,3.68208167318164,2.91388314163487,0.768198531546773,24,28,-4,29,35,-6,39,45,-6,2,3,0,0
"13573","N.J","CHI",2015020238,16751,20152016,0,60,3,2,1,2.9765186609593,4.82552342610503,-1.84900476514573,22,29,-7,25,38,-13,33,60,-27,3,5,0,0
"13574","N.J","CGY",2015020274,16756,20152016,0,60,2,3,-1,2.51916604442522,4.24310625509679,-1.72394021067157,20,30,-10,33,38,-5,47,50,-3,3,4,0,0
"13575","N.J","EDM",2015020292,16759,20152016,0,60,1,5,-4,2.22881627071183,3.75246664976487,-1.52365037905304,20,27,-7,34,35,-1,47,54,-7,4,6,0,0
"13576","N.J","VAN",2015020307,16761,20152016,0,60,3,2,1,2.7165040175023,9.26796309280326,-6.55145907530095,22,38,-16,31,50,-19,43,64,-21,5,8,0,0
"13577","N.J","CBJ",2015020318,16764,20152016,1,60,1,2,-1,2.7213173485361,3.17581492571662,-0.454497577180518,28,25,3,38,27,11,41,32,9,5,3,0,0
"13578","N.J","MTL",2015020336,16766,20152016,1,65,2,2,0,3.55554754938767,2.76683119569134,0.78871635369633,27,27,0,32,36,-4,37,51,-14,4,4,0,0
"13579","N.J","MTL",2015020344,16767,20152016,0,62.5166666666667,3,2,1,3.71990466327406,6.68860834665429,-2.96870368338023,31,32,-1,41,42,-1,55,60,-5,2,2,0,0
"13580","N.J","COL",2015020359,16770,20152016,1,60,1,2,-1,3.03018397017513,3.0390213628998,-0.0088373927246721,28,25,3,33,27,6,49,34,15,3,4,0,0
"13581","N.J","CAR",2015020374,16772,20152016,0,60,5,1,4,3.75848410848994,5.00056528283886,-1.24208117434893,27,31,-4,34,46,-12,50,62,-12,5,4,0,0
"13582","N.J","PHI",2015020382,16773,20152016,1,63.4,3,4,-1,2.94144996331306,3.94806079278966,-1.0066108294766,18,25,-7,24,36,-12,32,44,-12,6,5,0,0
"13583","N.J","FLA",2015020400,16775,20152016,1,60,4,2,2,2.05568049673457,4.64349781692727,-2.5878173201927,18,36,-18,24,41,-17,30,52,-22,5,6,0,0
"13584","N.J","TOR",2015020411,16777,20152016,0,65,2,2,0,4.62604617484612,5.94641186156543,-1.32036568671931,27,37,-10,39,56,-17,47,73,-26,5,5,0,0
"13585","N.J","DET",2015020428,16780,20152016,1,64.3333333333333,3,2,1,5.73385889451311,3.238523565582,2.49533532893111,38,29,9,47,37,10,56,41,15,4,3,0,0
"13586","N.J","NYI",2015020445,16782,20152016,0,60,0,4,-4,3.43149605209353,4.10146705040825,-0.669970998314714,27,30,-3,35,37,-2,48,51,-3,4,4,0,0
"13587","N.J","BUF",2015020453,16784,20152016,0,60,2,0,2,3.05364377536995,4.44423163158353,-1.39058785621359,21,25,-4,32,37,-5,42,55,-13,1,3,0,0
"13588","N.J","FLA",2015020467,16786,20152016,1,60,1,5,-4,1.91331960182288,3.04523939614228,-1.1319197943194,16,26,-10,21,31,-10,26,33,-7,3,3,0,0
"13589","N.J","ANA",2015020486,16788,20152016,1,60,1,2,-1,2.72547176165972,3.53816022493993,-0.81268846328021,22,18,4,31,28,3,40,35,5,2,0,0,0
"13590","N.J","BOS",2015020494,16789,20152016,0,65,1,1,0,3.3938592917666,5.64276205486842,-2.24890276310182,30,39,-9,39,51,-12,58,66,-8,4,3,0,0
"13591","N.J","DET",2015020509,16791,20152016,0,60,4,3,1,3.84830920553122,3.5876470180113,0.260662187519927,17,28,-11,24,38,-14,27,48,-21,8,8,0,0
"13592","N.J","CAR",2015020520,16795,20152016,0,60,1,3,-2,0.840536815056112,4.36446228485147,-3.52392546979536,20,25,-5,30,39,-9,39,50,-11,1,1,0,0
"13593","N.J","CAR",2015020543,16798,20152016,1,60,3,2,1,3.14977423403376,5.68789707610267,-2.53812284206891,24,28,-4,34,44,-10,40,57,-17,2,1,0,0
"13594","N.J","OTT",2015020553,16799,20152016,0,60,3,0,3,3.11649392625276,4.90308387217295,-1.78658994592019,21,36,-15,28,52,-24,32,76,-44,4,4,0,0
"13595","N.J","DAL",2015020573,16802,20152016,1,61.7833333333333,3,2,1,3.15995839540847,5.1529942326769,-1.99303583726843,30,31,-1,43,37,6,48,43,5,4,3,0,0
"13596","N.J","DET",2015020583,16804,20152016,1,60,0,1,-1,2.43180329374445,1.26671553877532,1.16508775496914,22,21,1,33,25,8,48,35,13,2,1,0,0
"13597","N.J","MTL",2015020596,16806,20152016,0,60,1,2,-1,5.89457216892376,4.66094587683392,1.23362629208984,20,25,-5,30,39,-9,48,57,-9,3,4,0,0
"13598","N.J","BOS",2015020608,16808,20152016,1,60,1,4,-3,4.1116709256271,3.72405562183121,0.387615303795883,20,31,-11,30,39,-9,39,48,-9,3,4,0,0
"13599","N.J","MIN",2015020627,16810,20152016,0,60,2,1,1,3.7467954766762,3.73662108415738,0.0101743925188202,17,18,-1,33,26,7,49,37,12,3,2,0,0
"13600","N.J","STL",2015020636,16812,20152016,0,60,2,5,-3,3.29424701590324,4.13911586335598,-0.844868847452744,24,37,-13,31,45,-14,48,57,-9,4,5,0,0
"13601","N.J","COL",2015020651,16814,20152016,0,60,0,3,-3,3.28533421912296,5.8701972300734,-2.58486301095044,27,26,1,37,36,1,47,46,1,3,2,0,0
"13602","N.J","ARI",2015020667,16816,20152016,0,60,2,0,2,2.2319063544701,7.19424250924749,-4.96233615477739,16,38,-22,25,69,-44,31,96,-65,3,6,0,0
"13603","N.J","CGY",2015020682,16819,20152016,1,60,4,2,2,6.41129141053213,5.42072069104051,0.990570719491615,26,28,-2,39,38,1,50,45,5,2,4,0,0
"13604","N.J","OTT",2015020694,16821,20152016,1,60,6,3,3,4.92607892720343,7.82914602970413,-2.9030671025007,20,32,-12,29,40,-11,35,48,-13,2,4,0,0
"13605","N.J","WPG",2015020715,16823,20152016,0,60,3,1,2,4.8810677761212,4.05286844109651,0.828199335024692,16,23,-7,29,33,-4,41,46,-5,2,1,0,0
"13606","N.J","PIT",2015020732,16826,20152016,0,60,0,2,-2,2.32255382389917,2.76792128567234,-0.445367461773174,25,31,-6,38,38,0,49,48,1,4,2,0,0
"13607","N.J","NYR",2015020745,16833,20152016,1,60,3,2,1,4.38556254615105,2.290758391704,2.09480415444705,25,33,-8,33,42,-9,41,50,-9,2,4,0,0
"13608","N.J","TOR",2015020762,16835,20152016,0,65,2,2,0,5.2529634393743,6.91962692519171,-1.66666348581741,34,39,-5,49,63,-14,61,92,-31,6,4,0,0
"13609","N.J","WSH",2015020775,16837,20152016,1,65,2,2,0,2.30909381633637,4.62844482436776,-2.31935100803139,24,29,-5,29,39,-10,39,53,-14,2,3,0,0
"13610","N.J","NYR",2015020790,16839,20152016,0,60,1,2,-1,5.42756409427167,4.13902344240341,1.28854065186826,28,37,-9,36,47,-11,49,74,-25,0,5,0,0
"13611","N.J","EDM",2015020796,16840,20152016,1,60,2,1,1,1.65960167892424,2.0916411753511,-0.432039496426861,26,20,6,33,25,8,39,32,7,5,3,0,0
"13612","N.J","PHI",2015020825,16844,20152016,0,62.9666666666667,2,1,1,5.84921216023213,5.30110500229057,0.548107157941558,24,32,-8,39,41,-2,55,54,1,4,4,0,0
"13613","N.J","L.A",2015020836,16845,20152016,1,60,1,0,1,3.64834325354411,4.18664043355966,-0.538297180015547,18,28,-10,25,39,-14,34,52,-18,3,1,0,0
"13614","N.J","PHI",2015020847,16847,20152016,1,60,3,6,-3,3.33204122846061,4.84661607243083,-1.51457484397023,24,26,-2,37,32,5,44,38,6,7,6,0,0
"13615","N.J","NYI",2015020869,16850,20152016,1,60,0,1,-1,3.28759973707929,3.14057563594542,0.147024101133866,27,24,3,33,32,1,45,46,-1,1,3,0,0
"13616","N.J","WSH",2015020878,16851,20152016,0,60,3,4,-1,4.35161238027126,4.15453029383207,0.197082086439195,24,32,-8,33,41,-8,48,64,-16,1,3,0,0
"13617","N.J","NYR",2015020893,16854,20152016,1,60,5,2,3,4.2583369021886,1.36479517038173,2.89354173180688,36,19,17,46,25,21,52,39,13,4,2,0,0
"13618","N.J","CBJ",2015020907,16856,20152016,0,60,1,6,-5,5.54804042922569,1.94461680069799,3.60342362852771,26,24,2,34,34,0,52,42,10,4,2,0,0
"13619","N.J","T.B",2015020916,16857,20152016,1,60,0,4,-4,3.45584217942087,6.65829646547627,-3.2024542860554,21,36,-15,29,44,-15,35,55,-20,2,7,0,0
"13620","N.J","CAR",2015020945,16861,20152016,1,60,1,3,-2,5.23241000947869,2.37490019004326,2.85750981943543,30,19,11,43,20,23,46,29,17,3,3,0,0
"13621","N.J","NSH",2015020960,16863,20152016,0,61.9,5,4,1,4.71171851345571,3.13876340998104,1.57295510347467,33,34,-1,40,42,-2,50,60,-10,3,2,0,0
"13622","N.J","DAL",2015020968,16864,20152016,0,60,2,4,-2,4.37099582905648,4.85417633858742,-0.483180509530939,20,25,-5,36,43,-7,53,60,-7,3,3,0,0
"13623","N.J","PIT",2015020981,16866,20152016,1,60,1,6,-5,2.10122784068517,2.58009500666564,-0.478867165980468,18,30,-12,28,34,-6,35,36,-1,5,6,0,0
"13624","N.J","S.J",2015021012,16870,20152016,0,60,3,0,3,2.94973934363225,3.25067177403253,-0.30093243040028,16,30,-14,22,41,-19,37,67,-30,1,3,0,0
"13625","N.J","L.A",2015021028,16872,20152016,0,64.7333333333333,2,1,1,4.50584863700522,3.18234223057516,1.32350640643006,24,23,1,40,39,1,51,68,-17,1,4,0,0
"13626","N.J","ANA",2015021038,16874,20152016,0,60,1,7,-6,3.17776622076781,3.54269932972966,-0.36493310896185,25,27,-2,36,39,-3,47,48,-1,4,3,0,0
"13627","N.J","MIN",2015021053,16877,20152016,1,60,7,4,3,3.65064190288613,7.33209782183985,-3.68145591895372,25,32,-7,31,42,-11,39,50,-11,1,3,0,0
"13628","N.J","CBJ",2015021073,16879,20152016,0,60,3,6,-3,3.71951728823478,6.66256148060347,-2.94304419236869,30,34,-4,39,52,-13,53,68,-15,4,3,0,0
"13629","N.J","CBJ",2015021079,16880,20152016,1,60,2,1,1,2.25037653117418,5.31472818469202,-3.06435165351784,22,28,-6,34,38,-4,45,47,-2,3,3,0,0
"13630","N.J","PIT",2015021102,16884,20152016,0,60,3,0,3,4.02633189657354,5.71626961654692,-1.68993771997339,24,39,-15,29,55,-26,37,73,-36,3,3,0,0
"13631","N.J","WSH",2015021112,16885,20152016,1,62.2833333333333,0,1,-1,3.0056028659892,4.69484576949617,-1.68924290350697,22,26,-4,30,36,-6,38,48,-10,4,3,0,0
"13632","N.J","CAR",2015021129,16887,20152016,0,60,2,3,-1,4.01260239819283,2.85847399767954,1.15412840051329,25,23,2,36,31,5,50,39,11,2,5,0,0
"13633","N.J","BOS",2015021140,16889,20152016,1,60,2,1,1,2.31085478416935,6.55706232238117,-4.24620753821182,15,40,-25,19,53,-34,29,64,-35,6,3,0,0
"13634","N.J","FLA",2015021157,16891,20152016,0,60,2,3,-1,4.5646997706499,5.71094047533552,-1.14624070468562,25,40,-15,33,50,-17,38,66,-28,6,4,0,0
"13635","N.J","T.B",2015021171,16893,20152016,0,60,1,3,-2,2.69316597046486,4.25172691208547,-1.55856094162061,26,36,-10,38,48,-10,49,68,-19,7,8,0,0
"13636","N.J","BUF",2015021189,16896,20152016,1,60,1,3,-2,3.04738101681005,2.36430086255533,0.683080154254725,19,18,1,35,26,9,42,32,10,6,4,0,0
"13637","N.J","T.B",2015021203,16898,20152016,1,60,2,4,-2,5.68773917739122,3.217054245295,2.47068493209622,22,22,0,32,30,2,39,41,-2,3,4,0,0
"13638","N.J","TOR",2015021222,16900,20152016,1,60,5,1,4,6.25443606360204,2.5879670599345,3.66646900366754,36,20,16,42,26,16,47,38,9,6,3,0,0
"13639","N.J","FLA",2016020010,17087,20162017,0,62.8,1,2,-1,2.51542510901345,3.74073040722215,-1.2253052982087,24,34,-10,33,51,-18,37,67,-30,7,8,0,0
"13640","N.J","T.B",2016020019,17089,20162017,0,60,2,3,-1,3.25054511860071,4.42460019034684,-1.17405507174612,34,34,0,42,47,-5,53,59,-6,5,4,0,0
"13641","N.J","ANA",2016020037,17092,20162017,1,60,2,1,1,3.65516817284515,4.55783759528504,-0.902669422439885,28,24,4,35,33,2,45,45,0,7,5,0,0
"13642","N.J","BOS",2016020051,17094,20162017,0,60,1,2,-1,4.63331758657796,5.21401900110327,-0.580701414525308,29,36,-7,40,56,-16,58,71,-13,3,4,0,0
"13643","N.J","MIN",2016020069,17096,20162017,1,60.4833333333333,2,1,1,3.38689145909491,2.81044952222146,0.576441936873449,32,29,3,37,34,3,41,41,0,3,3,0,0
"13644","N.J","ARI",2016020084,17099,20162017,1,60,5,3,2,6.49419329443481,4.52222408651141,1.97196920792339,35,31,4,41,37,4,50,46,4,3,3,0,0
"13645","N.J","CHI",2016020107,17102,20162017,1,61.25,2,3,-1,4.39215735159814,5.1693198736757,-0.77716252207756,32,29,3,38,41,-3,44,57,-13,4,4,0,0
"13646","N.J","T.B",2016020116,17103,20162017,1,60,3,1,2,4.2635041832109,3.87305033934535,0.390453843865544,23,33,-10,30,47,-17,32,55,-23,1,4,0,0
"13647","N.J","FLA",2016020152,17108,20162017,0,64.2666666666667,3,4,-1,5.31177214474883,3.99122144113062,1.32055070361821,34,31,3,49,43,6,57,54,3,5,4,0,0
"13648","N.J","T.B",2016020166,17110,20162017,0,60,1,4,-3,5.18928807909833,6.3814278690711,-1.19213978997277,38,35,3,51,43,8,64,60,4,5,5,0,0
"13649","N.J","CAR",2016020176,17111,20162017,0,60,4,1,3,5.06650683982298,5.43718196550981,-0.37067512568683,21,34,-13,32,52,-20,46,72,-26,3,4,0,0
"13650","N.J","CAR",2016020183,17113,20162017,1,65,2,2,0,4.41714525089628,3.75940735332773,0.657737897568552,41,33,8,53,43,10,65,47,18,3,1,0,0
"13651","N.J","BUF",2016020206,17116,20162017,0,60.4833333333333,2,1,1,6.37697602272237,2.46122384372168,3.91575217900069,43,26,17,54,35,19,69,44,25,5,2,0,0
"13652","N.J","BUF",2016020215,17117,20162017,1,60,4,2,2,3.5941806938572,2.81234667454959,0.78183401930761,27,23,4,36,27,9,49,38,11,6,3,0,0
"13653","N.J","DAL",2016020239,17120,20162017,0,60.7333333333333,2,1,1,4.09965456434293,4.14096001951111,-0.0413054551681853,33,24,9,45,40,5,72,57,15,1,2,0,0
"13654","N.J","ANA",2016020253,17122,20162017,0,60,2,3,-1,3.82035918813199,3.92859784015806,-0.108238652026074,29,23,6,49,35,14,66,49,17,3,2,0,0
"13655","N.J","L.A",2016020261,17124,20162017,0,60,2,4,-2,3.62871474027634,4.77313793302164,-1.14442319274531,23,28,-5,31,38,-7,44,45,-1,2,1,0,0
"13656","N.J","S.J",2016020282,17126,20162017,0,60,0,4,-4,2.81751429266296,8.134949583446,-5.31743529078303,26,42,-16,38,57,-19,55,84,-29,3,5,0,0
"13657","N.J","TOR",2016020289,17128,20162017,1,65,4,4,0,3.74892205315268,5.0651280170855,-1.31620596393282,30,31,-1,40,40,0,50,49,1,4,4,0,0
"13658","N.J","DET",2016020310,17130,20162017,1,63.3,4,5,-1,2.38385509874206,1.99757819275874,0.386276905983323,19,33,-14,32,39,-7,41,49,-8,4,3,0,0
"13659","N.J","PIT",2016020317,17131,20162017,0,65,3,3,0,3.05348930780019,9.3040625015916,-6.25057319379141,30,49,-19,38,63,-25,57,83,-26,3,6,0,0
"13660","N.J","WPG",2016020335,17134,20162017,0,60,2,3,-1,6.74323458041231,3.70108824985186,3.04214633056045,25,29,-4,45,48,-3,60,57,3,5,5,0,0
"13661","N.J","CHI",2016020353,17136,20162017,0,61.5166666666667,3,4,-1,4.37141759577707,4.53748842974892,-0.166070833971844,33,33,0,49,46,3,65,65,0,2,4,0,0
"13662","N.J","NSH",2016020362,17138,20162017,0,64.7,5,4,1,4.24647129210643,4.56033936817221,-0.313868076065773,22,42,-20,29,59,-30,38,77,-39,4,3,0,0
"13663","N.J","VAN",2016020383,17141,20162017,1,60,3,2,1,3.07157465489581,4.17707828181636,-1.10550362692054,22,24,-2,33,32,1,40,38,2,3,4,0,0
"13664","N.J","MTL",2016020398,17143,20162017,0,60,2,5,-3,2.55683632247383,7.57907006275866,-5.02223374028484,21,49,-28,27,66,-39,44,83,-39,4,3,0,0
"13665","N.J","STL",2016020407,17144,20162017,1,60,1,4,-3,4.00432145304512,2.33809094925527,1.66623050378985,21,32,-11,33,40,-7,40,46,-6,3,3,0,0
"13666","N.J","NYR",2016020426,17146,20162017,0,60,0,5,-5,3.99252716638148,5.29760428297368,-1.3050771165922,19,31,-12,27,44,-17,41,60,-19,5,6,0,0
"13667","N.J","STL",2016020449,17150,20162017,0,60,2,5,-3,3.42240400795708,5.08588411394157,-1.66348010598449,26,31,-5,36,45,-9,48,59,-11,3,5,0,0
"13668","N.J","OTT",2016020463,17152,20162017,0,60,1,3,-2,2.75043357082177,5.5369281986641,-2.78649462784233,30,31,-1,37,42,-5,55,53,2,2,2,0,0
"13669","N.J","NYR",2016020475,17153,20162017,0,65,2,2,0,6.23369681334589,5.67867706720483,0.555019746141056,31,27,4,48,41,7,64,58,6,4,2,0,0
"13670","N.J","NSH",2016020482,17155,20162017,1,60,1,5,-4,4.69295807994786,2.44160435209051,2.25135372785735,28,32,-4,37,36,1,43,44,-1,2,1,0,0
"13671","N.J","PHI",2016020496,17157,20162017,1,60,4,0,4,3.91169088840252,1.95027913611375,1.96141175228877,22,16,6,29,23,6,32,35,-3,10,6,0,0
"13672","N.J","PIT",2016020507,17158,20162017,0,60,1,4,-3,2.95013809168063,4.68333462333934,-1.73319653165871,24,39,-15,31,55,-24,43,73,-30,2,2,0,0
"13673","N.J","PIT",2016020517,17162,20162017,1,60,2,5,-3,4.94503865204751,2.38727188814573,2.55776676390178,23,29,-6,33,38,-5,39,47,-8,7,4,0,0
"13674","N.J","WSH",2016020533,17164,20162017,0,65,1,1,0,3.18085654717402,6.05075037757388,-2.86989383039986,27,44,-17,37,62,-25,50,78,-28,4,4,0,0
"13675","N.J","WSH",2016020549,17166,20162017,1,60,2,6,-4,3.32435174140846,2.22093032699487,1.10342141441359,23,26,-3,36,31,5,49,41,8,10,5,0,0
"13676","N.J","BOS",2016020563,17168,20162017,1,60,3,0,3,4.53324159461772,3.20930882846005,1.32393276615767,26,22,4,36,36,0,44,41,3,6,3,0,0
"13677","N.J","CAR",2016020567,17169,20162017,0,60,3,1,2,5.63668259984115,5.23970241654752,0.396980183293635,18,30,-12,24,41,-17,37,65,-28,2,4,0,0
"13678","N.J","TOR",2016020586,17172,20162017,1,60,2,4,-2,5.4308720830013,3.02752812299877,2.40334396000253,32,14,18,44,19,25,48,32,16,4,3,0,0
"13679","N.J","EDM",2016020597,17173,20162017,1,63.9833333333333,1,2,-1,2.88964856115513,9.27543658566719,-6.38578802451207,20,43,-23,27,64,-37,34,77,-43,2,3,0,0
"13680","N.J","FLA",2016020609,17175,20162017,1,60,0,3,-3,3.4827575304555,5.46522113577521,-1.98246360531971,28,29,-1,36,35,1,39,44,-5,3,4,0,0
"13681","N.J","EDM",2016020631,17178,20162017,0,61.8333333333333,2,3,-1,2.74827702337188,4.75875705820363,-2.01048003483174,19,34,-15,24,54,-30,41,70,-29,4,3,0,0
"13682","N.J","CGY",2016020638,17179,20162017,0,60,2,1,1,3.18896985659376,3.74155687626973,-0.552587019675975,36,32,4,47,37,10,61,52,9,4,2,0,0
"13683","N.J","VAN",2016020654,17181,20162017,0,61.4666666666667,2,1,1,2.09869018680183,2.91901930829039,-0.820329121488555,22,22,0,29,31,-2,36,40,-4,2,4,0,0
"13684","N.J","MIN",2016020667,17183,20162017,0,60,4,3,1,4.25457769402419,5.70419816626236,-1.44962047223817,26,35,-9,40,45,-5,51,59,-8,1,3,0,0
"13685","N.J","MTL",2016020688,17186,20162017,1,60,1,3,-2,1.56303271838169,3.65650816287962,-2.09347544449793,17,26,-9,21,38,-17,30,50,-20,3,4,0,0
"13686","N.J","PHI",2016020696,17187,20162017,0,60,4,1,3,2.24232603943701,5.76500324485824,-3.52267720542122,29,36,-7,37,53,-16,48,85,-37,7,6,0,0
"13687","N.J","L.A",2016020715,17190,20162017,1,60,1,3,-2,3.02445569090196,2.21836606875877,0.80608962214319,25,25,0,30,32,-2,34,35,-1,4,2,0,0
"13688","N.J","WSH",2016020729,17192,20162017,1,60,2,5,-3,5.78032999957213,6.2828826615781,-0.502552662005964,29,36,-7,43,47,-4,48,54,-6,4,5,0,0
"13689","N.J","DET",2016020746,17197,20162017,0,60,4,3,1,2.21218826752152,4.72148416195705,-2.50929589443553,24,30,-6,31,43,-12,38,59,-21,1,5,0,0
"13690","N.J","CGY",2016020769,17200,20162017,1,61.2166666666667,3,4,-1,4.66806362580974,6.89941428555176,-2.23135065974202,29,38,-9,40,49,-9,53,60,-7,4,3,0,0
"13691","N.J","CBJ",2016020778,17201,20162017,0,60,5,1,4,6.13055624079976,2.69650229311083,3.43405394768894,30,32,-2,39,45,-6,45,60,-15,3,3,0,0
"13692","N.J","BUF",2016020787,17203,20162017,1,60,2,1,1,8.48557588041876,3.15233417655717,5.33324170386159,39,23,16,64,38,26,76,58,18,5,2,0,0
"13693","N.J","S.J",2016020828,17209,20162017,1,60,1,4,-3,2.7200748984193,6.20509421563474,-3.48501931721545,22,38,-16,31,50,-19,43,59,-16,2,6,0,0
"13694","N.J","COL",2016020836,17211,20162017,1,60,3,2,1,3.55731632083189,2.60798209893983,0.949334221892059,40,30,10,45,39,6,55,51,4,3,3,0,0
"13695","N.J","OTT",2016020848,17213,20162017,1,60,0,3,-3,3.90521477693983,4.09172506094441,-0.186510284004584,21,35,-14,32,46,-14,40,62,-22,1,2,0,0
"13696","N.J","NYI",2016020862,17215,20162017,1,60,3,2,1,3.87928508743369,5.39689273449767,-1.51760764706398,21,42,-21,36,54,-18,45,72,-27,2,4,0,0
"13697","N.J","NYI",2016020873,17216,20162017,0,60,4,6,-2,7.34538609138144,4.79296495212475,2.55242113925669,30,32,-2,36,43,-7,50,68,-18,3,2,0,0
"13698","N.J","OTT",2016020882,17218,20162017,1,60,1,2,-1,3.6693594030221,3.37089183195167,0.298467571070432,30,23,7,46,34,12,68,40,28,1,2,0,0
"13699","N.J","NYR",2016020905,17222,20162017,1,61.2666666666667,3,4,-1,3.85504849084828,7.47975650115404,-3.62470801030577,38,40,-2,51,47,4,57,60,-3,2,1,0,0
"13700","N.J","MTL",2016020919,17224,20162017,1,62.9,3,4,-1,2.79745540622389,6.189910585701,-3.39245517947711,37,33,4,45,44,1,57,56,1,3,3,0,0
"13701","N.J","WSH",2016020939,17227,20162017,0,60,0,1,-1,1.32562786334862,4.18893322756319,-2.86330536421457,15,24,-9,26,40,-14,50,59,-9,4,5,0,0
"13702","N.J","BOS",2016020952,17229,20162017,0,60,2,3,-1,2.71860392880916,6.19548263230691,-3.47687870349775,17,40,-23,27,58,-31,31,68,-37,1,5,0,0
"13703","N.J","CBJ",2016020963,17230,20162017,1,60,0,3,-3,2.69608132646681,4.43542521464406,-1.73934388817725,20,22,-2,35,31,4,42,35,7,3,1,0,0
"13704","N.J","CBJ",2016020974,17232,20162017,0,60,0,2,-2,4.64519086945802,4.65285655419575,-0.00766568473773077,33,25,8,42,38,4,53,53,0,1,2,0,0
"13705","N.J","COL",2016020989,17234,20162017,0,60,2,3,-1,5.45497346908087,5.69996552008524,-0.244992051004374,27,22,5,42,39,3,54,53,1,1,3,0,0
"13706","N.J","ARI",2016021008,17236,20162017,0,60,4,5,-1,4.68732511904091,3.63213012670167,1.05519499233924,30,31,-1,40,40,0,57,48,9,5,5,0,0
"13707","N.J","WPG",2016021024,17253,20162017,1,65,3,3,0,2.69090060930851,5.72842044908271,-3.03751983977419,23,36,-13,34,54,-20,42,63,-21,5,3,0,0
"13708","N.J","PHI",2016021037,17241,20162017,1,60,6,2,4,3.01110195426736,1.94928712944966,1.0618148248177,29,19,10,40,24,16,51,30,21,4,4,0,0
"13709","N.J","PIT",2016021050,17242,20162017,0,60,4,6,-2,4.43384509367201,5.39663956855657,-0.962794474884561,36,43,-7,42,54,-12,57,68,-11,6,7,0,0
"13710","N.J","CBJ",2016021063,17244,20162017,1,60,1,4,-3,8.32945646267035,3.39667329450822,4.93278316816213,36,27,9,48,40,8,64,46,18,3,3,0,0
"13711","N.J","NYR",2016021077,17246,20162017,1,64.0833333333333,3,2,1,4.70757880131714,6.9039228373731,-2.19634403605596,29,40,-11,35,57,-22,41,68,-27,3,2,0,0
"13712","N.J","TOR",2016021091,17248,20162017,0,60,2,4,-2,3.78712076542433,4.32546125689752,-0.538340491473186,32,30,2,44,44,0,51,57,-6,6,4,0,0
"13713","N.J","CAR",2016021110,17250,20162017,1,60,1,3,-2,5.8589976040239,3.4715188533155,2.3874787507084,27,28,-1,44,33,11,51,44,7,3,3,0,0
"13714","N.J","DAL",2016021118,17251,20162017,1,60.3333333333333,1,2,-1,2.68060958356364,3.78304349184327,-1.10243390827964,21,32,-11,27,43,-16,33,58,-25,0,4,0,0
"13715","N.J","NYI",2016021151,17256,20162017,0,60,1,2,-1,4.77560847615848,3.61741795228586,1.15819052387262,27,38,-11,39,48,-9,56,58,-2,3,10,0,0
"13716","N.J","PHI",2016021161,17257,20162017,0,60,0,3,-3,3.40667046900489,3.43018001773248,-0.0235095487275885,32,41,-9,44,54,-10,59,64,-5,5,6,0,0
"13717","N.J","PHI",2016021180,17260,20162017,1,60.9833333333333,1,0,1,3.24405840830877,3.9202096833904,-0.67615127508163,27,35,-8,32,44,-12,40,54,-14,5,4,0,0
"13718","N.J","PIT",2016021195,17262,20162017,1,60,4,7,-3,5.74618273432134,3.9957823510631,1.75040038325824,38,28,10,56,36,20,69,41,28,3,3,0,0
"13719","N.J","NYI",2016021210,17264,20162017,1,60,2,4,-2,7.60766545800945,3.71967838529963,3.88798707270982,39,20,19,50,28,22,67,38,29,3,4,0,0
"13720","N.J","DET",2016021221,17265,20162017,0,60,1,4,-3,5.48106279096828,3.57146329055627,1.90959950041201,25,35,-10,37,38,-1,50,46,4,3,3,0,0
"13721","N.J","COL",2017020019,17446,20172018,1,60,4,1,3,4.99183146729411,5.25581369904103,-0.263982231746922,39,41,-2,53,53,0,62,62,0,4,5,0,0
"13722","N.J","BUF",2017020034,17448,20172018,0,60,6,2,4,0,0,0,31,25,6,41,34,7,51,47,4,4,4,0,0
"13723","N.J","TOR",2017020046,17450,20172018,0,60,6,3,3,4.40602134659395,5.43412349158933,-1.02810214499537,31,50,-19,42,61,-19,50,79,-29,5,8,0,0
"13724","N.J","WSH",2017020058,17452,20172018,1,60,2,5,-3,5.14818535721861,3.84029945981456,1.30788589740405,23,28,-5,37,43,-6,46,52,-6,5,5,0,0
"13725","N.J","NYR",2017020065,17453,20172018,0,60,3,2,1,4.48161703131575,2.96255969116328,1.51905734015247,19,31,-12,36,44,-8,47,64,-17,6,4,0,0
"13726","N.J","T.B",2017020081,17456,20172018,1,65,4,4,0,5.38693975756655,5.18728307395349,0.199656683613057,34,37,-3,51,60,-9,65,73,-8,4,5,0,0
"13727","N.J","OTT",2017020099,17458,20172018,0,61.3333333333333,5,4,1,6.15134955654048,4.7724485227758,1.37890103376468,46,33,13,61,40,21,70,51,19,5,7,0,0
"13728","N.J","S.J",2017020105,17459,20172018,1,60,0,3,-3,3.8354622423426,2.48052758831679,1.35493465402581,28,33,-5,37,44,-7,47,58,-11,5,4,0,0
"13729","N.J","OTT",2017020150,17466,20172018,1,65,4,4,0,6.10562030563641,4.11198720390621,1.9936331017302,25,27,-2,40,40,0,53,54,-1,3,2,0,0
"13730","N.J","ARI",2017020161,17467,20172018,1,60,4,3,1,1.39537305392589,5.170942584984,-3.77556953105811,25,37,-12,33,48,-15,42,63,-21,3,5,0,0
"13731","N.J","VAN",2017020183,17471,20172018,0,60,2,0,2,4.98603705527603,6.56482529891218,-1.57878824363615,26,37,-11,33,59,-26,42,80,-38,1,4,0,0
"13732","N.J","EDM",2017020198,17473,20172018,0,60,3,6,-3,3.39325137693959,7.2407797195774,-3.84752834263782,34,42,-8,42,62,-20,66,76,-10,0,1,0,0
"13733","N.J","CGY",2017020216,17475,20172018,0,65,4,4,0,7.05358248119667,4.43566788928001,2.61791459191666,30,34,-4,43,48,-5,57,64,-7,3,4,0,0
"13734","N.J","STL",2017020224,17477,20172018,1,60,1,3,-2,2.35303438530112,6.71867506731201,-4.36564068201089,22,40,-18,33,54,-21,40,65,-25,4,5,0,0
"13735","N.J","EDM",2017020235,17479,20172018,1,64.7166666666667,2,3,-1,5.13053342525382,3.56056781656724,1.56996560868658,34,32,2,46,42,4,60,56,4,4,2,0,0
"13736","N.J","FLA",2017020254,17481,20172018,1,60,2,1,1,1.64958756800479,4.24619279161539,-2.5966052236106,21,33,-12,24,46,-22,33,58,-25,4,5,0,0
"13737","N.J","CHI",2017020262,17482,20172018,0,60,7,5,2,0,0,0,38,44,-6,47,58,-11,60,87,-27,4,4,0,0
"13738","N.J","TOR",2017020278,17486,20172018,0,64.95,0,1,-1,6.09290706234606,5.3370028588688,0.755904203477257,42,25,17,58,42,16,73,61,12,3,2,0,0
"13739","N.J","WPG",2017020295,17488,20172018,0,60,2,5,-3,4.77571498265024,4.17328844938311,0.602426533267135,36,34,2,49,44,5,64,57,7,2,0,0,0
"13740","N.J","MIN",2017020314,17490,20172018,0,60.8666666666667,4,3,1,4.7684443523672,5.18295603078011,-0.414511678412911,25,36,-11,37,52,-15,52,73,-21,4,6,0,0
"13741","N.J","BOS",2017020322,17492,20172018,1,65,2,2,0,6.52569752797399,3.18915990024107,3.33653762773292,42,29,13,54,40,14,68,55,13,4,5,0,0
"13742","N.J","VAN",2017020340,17494,20172018,1,60,3,2,1,2.18868979613762,3.29383771322058,-1.10514791708296,26,25,1,36,37,-1,43,48,-5,3,3,0,0
"13743","N.J","DET",2017020351,17495,20172018,0,62.5333333333333,4,3,1,3.59209928204655,5.06880182184182,-1.47670253979527,32,34,-2,38,39,-1,47,49,-2,3,2,0,0
"13744","N.J","FLA",2017020362,17497,20172018,1,60,2,3,-1,3.66185214649704,3.57002392249342,0.0918282240036206,25,38,-13,36,52,-16,43,64,-21,4,5,0,0
"13745","N.J","COL",2017020395,17501,20172018,0,60,2,1,1,3.58379684701868,2.63444537238684,0.94935147463184,21,23,-2,28,36,-8,45,60,-15,6,5,0,0
"13746","N.J","ARI",2017020405,17502,20172018,0,60,0,5,-5,2.78443204320502,3.22278084105346,-0.438348797848448,27,27,0,44,37,7,70,52,18,3,2,0,0
"13747","N.J","CBJ",2017020417,17505,20172018,0,60,4,1,3,4.7204131112403,4.19251134089427,0.527901770346034,36,42,-6,46,54,-8,60,70,-10,1,6,0,0
"13748","N.J","CBJ",2017020439,17508,20172018,1,60,3,5,-2,3.87608897480823,2.96802465481935,0.908064319988881,24,28,-4,34,38,-4,44,47,-3,3,2,0,0
"13749","N.J","NYR",2017020449,17509,20172018,0,60,2,5,-3,5.81460207968419,3.06778799598876,2.74681408369544,28,39,-11,40,43,-3,58,59,-1,4,4,0,0
"13750","N.J","L.A",2017020467,17512,20172018,1,60,5,1,4,3.1860342208056,1.95824392410113,1.22779029670447,26,17,9,35,24,11,45,34,11,3,4,0,0
"13751","N.J","MTL",2017020482,17514,20172018,0,61.8666666666667,1,2,-1,8.20523143542224,6.36861719384774,1.8366142415745,32,36,-4,47,51,-4,69,76,-7,3,3,0,0
"13752","N.J","DAL",2017020492,17515,20172018,1,60,5,2,3,4.28516737735481,5.96652866108343,-1.68136128372862,26,30,-4,33,44,-11,41,57,-16,5,4,0,0
"13753","N.J","ANA",2017020512,17518,20172018,1,60,5,3,2,6.59735318234876,2.26846962704846,4.3288835553003,34,24,10,46,35,11,51,50,1,2,2,0,0
"13754","N.J","NYR",2017020530,17521,20172018,1,65,3,3,0,4.53842901393728,3.09036619787512,1.44806281606216,48,28,20,58,40,18,72,49,23,4,3,0,0
"13755","N.J","CHI",2017020547,17523,20172018,1,60,4,1,3,3.92008806461618,3.76348387666076,0.156604187955421,29,40,-11,38,49,-11,45,77,-32,3,3,0,0
"13756","N.J","DET",2017020559,17527,20172018,1,60,3,1,2,4.79076311194446,3.55569329884987,1.2350698130946,32,32,0,40,48,-8,53,57,-4,2,5,0,0
"13757","N.J","BUF",2017020576,17529,20172018,1,62.6166666666667,3,4,-1,4.73285465729714,3.83099653501995,0.90185812227719,38,29,9,45,43,2,54,52,2,2,3,0,0
"13758","N.J","WSH",2017020589,17530,20172018,0,60,2,5,-3,5.53929665840406,4.88758820343074,0.651708454973317,27,35,-8,41,45,-4,60,67,-7,2,2,0,0
"13759","N.J","STL",2017020607,17533,20172018,0,65,2,2,0,4.43337041480299,3.79309429598652,0.640276118816473,26,29,-3,40,47,-7,53,60,-7,2,4,0,0
"13760","N.J","DAL",2017020623,17535,20172018,0,60,3,4,-1,6.69478715690639,4.20995352886545,2.48483362804094,42,33,9,48,38,10,65,58,7,5,4,0,0
"13761","N.J","NYI",2017020642,17538,20172018,0,65,4,4,0,4.15467697495336,3.81694620627968,0.33773076867368,46,38,8,55,43,12,69,65,4,5,3,0,0
"13762","N.J","PHI",2017020673,17544,20172018,1,60,3,5,-2,3.6398375670542,2.32595438847539,1.31388317857881,29,25,4,44,30,14,51,37,14,7,2,0,0
"13763","N.J","NYI",2017020688,17547,20172018,0,60,4,1,3,5.94347840182621,4.6210073800286,1.3224710217976,42,26,16,59,38,21,69,51,18,3,2,0,0
"13764","N.J","WSH",2017020695,17549,20172018,1,60.5666666666667,4,3,1,4.49459292201573,1.91066187848816,2.58393104352757,32,19,13,49,32,17,56,44,12,3,5,0,0
"13765","N.J","PHI",2017020709,17551,20172018,0,60,1,3,-2,3.27210738551841,3.77009041571312,-0.497983030194705,29,31,-2,38,44,-6,55,61,-6,5,4,0,0
"13766","N.J","DET",2017020727,17553,20172018,1,60,0,3,-3,3.93865884339448,6.06131506734528,-2.1226562239508,37,30,7,51,42,9,64,49,15,5,2,0,0
"13767","N.J","BOS",2017020732,17554,20172018,0,60,2,3,-1,4.99027894871244,3.69445016770978,1.29582878100266,39,24,15,46,32,14,57,41,16,4,4,0,0
"13768","N.J","NSH",2017020746,17556,20172018,1,60,0,3,-3,4.86542764713522,3.3403517062834,1.52507594085182,27,27,0,39,38,1,53,45,8,2,2,0,0
"13769","N.J","BUF",2017020762,17561,20172018,0,60,3,1,2,5.18102745262513,6.14454395824578,-0.963516505620646,28,28,0,37,38,-1,47,56,-9,0,4,0,0
"13770","N.J","PHI",2017020778,17563,20172018,1,60,4,3,1,4.15673686380615,3.33509137776677,0.821645486039373,22,25,-3,33,38,-5,43,47,-4,5,4,0,0
"13771","N.J","PIT",2017020797,17565,20172018,1,60,3,1,2,8.15560221052743,3.14314431099774,5.01245789952969,38,16,22,58,26,32,75,41,34,3,1,0,0
"13772","N.J","OTT",2017020816,17568,20172018,0,60,3,5,-2,5.4067579748662,6.64284283061236,-1.23608485574616,33,32,1,57,55,2,77,67,10,5,4,0,0
"13773","N.J","CGY",2017020827,17570,20172018,1,60,2,3,-1,4.04681248109046,1.66230522953265,2.38450725155781,32,25,7,47,38,9,58,46,12,2,0,0,0
"13774","N.J","CBJ",2017020848,17572,20172018,0,60,1,6,-5,7.94657617650228,7.86394636466333,0.0826298118389417,36,50,-14,57,62,-5,75,84,-9,2,6,0,0
"13775","N.J","BOS",2017020857,17573,20172018,1,60,3,5,-2,4.36359038205644,5.3933445208417,-1.02975413878526,38,27,11,50,36,14,66,44,22,9,4,0,0
"13776","N.J","PHI",2017020867,17575,20172018,0,65,4,4,0,8.4838640486653,7.96167285574106,0.522191192924244,36,35,1,54,52,2,68,65,3,4,6,0,0
"13777","N.J","CAR",2017020879,17577,20172018,1,60,5,2,3,4.84331627305073,7.21107718417446,-2.36776091112372,22,29,-7,31,36,-5,37,53,-16,2,3,0,0
"13778","N.J","T.B",2017020898,17579,20172018,0,60,4,3,1,2.01927885599752,3.86543514927452,-1.84615629327701,28,51,-23,36,64,-28,39,80,-41,4,7,0,0
"13779","N.J","CAR",2017020907,17580,20172018,0,64.6166666666667,3,2,1,4.70934720871264,5.11030501947019,-0.400957810757552,21,42,-21,31,61,-30,41,79,-38,4,4,0,0
"13780","N.J","CBJ",2017020919,17582,20172018,1,60,1,2,-1,3.55678200808325,2.42534133760739,1.13144067047585,31,19,12,43,29,14,54,39,15,2,3,0,0
"13781","N.J","MIN",2017020931,17584,20172018,1,60,2,4,-2,6.44302925208643,3.6807883787551,2.76224087333134,40,25,15,60,35,25,73,45,28,3,2,0,0
"13782","N.J","NYI",2017020952,17586,20172018,1,60,2,1,1,2.80981378130673,4.41584075900028,-1.60602697769355,33,31,2,37,42,-5,52,51,1,1,2,0,0
"13783","N.J","PIT",2017020970,17589,20172018,0,60,3,2,1,6.01798496745424,4.27399045743005,1.74399451002419,38,38,0,48,48,0,61,68,-7,2,3,0,0
"13784","N.J","FLA",2017020985,17591,20172018,0,60,2,3,-1,6.80105891553103,5.55464885670591,1.24641005882512,31,29,2,44,43,1,62,56,6,2,2,0,0
"13785","N.J","CAR",2017020993,17592,20172018,0,60,1,3,-2,4.21662279323209,4.99299344077008,-0.776370647537988,26,30,-4,34,42,-8,46,54,-8,3,1,0,0
"13786","N.J","VGK",2017021011,17594,20172018,1,60,2,3,-1,5.04743505231454,3.52181698905122,1.52561806326332,35,27,8,48,43,5,57,51,6,3,2,0,0
"13787","N.J","MTL",2017021021,17596,20172018,1,60,6,4,2,5.50941944097061,5.97151998826303,-0.462100547292413,33,33,0,40,48,-8,51,64,-13,5,3,0,0
"13788","N.J","WPG",2017021033,17598,20172018,1,60,2,3,-1,7.72482768600639,3.92267169669503,3.80215598931136,43,24,19,60,31,29,82,42,40,3,1,0,0
"13789","N.J","NSH",2017021057,17600,20172018,0,65,2,2,0,4.65388310426244,8.21127867387258,-3.55739556961014,27,36,-9,39,61,-22,56,78,-22,3,3,0,0
"13790","N.J","VGK",2017021081,17604,20172018,0,60,8,3,5,7.27588235846756,7.06480136088157,0.211080997585981,28,42,-14,42,58,-16,51,84,-33,2,5,0,0
"13791","N.J","L.A",2017021100,17607,20172018,0,60,3,0,3,8.08545455091495,6.58968139056458,1.49577316035037,28,38,-10,43,64,-21,56,86,-30,4,6,0,0
"13792","N.J","ANA",2017021115,17608,20172018,0,60,2,4,-2,2.79268907897495,6.56280494141902,-3.77011586244407,17,36,-19,26,53,-27,39,67,-28,5,3,0,0
"13793","N.J","S.J",2017021131,17610,20172018,0,60,2,6,-4,5.49523982591904,3.50337704914466,1.99186277677438,28,25,3,45,42,3,62,64,-2,4,2,0,0
"13794","N.J","PIT",2017021147,17613,20172018,0,60.45,4,3,1,5.38917132855568,7.85468809099075,-2.46551676243507,34,43,-9,47,61,-14,55,76,-21,3,3,0,0
"13795","N.J","T.B",2017021157,17614,20172018,1,60,2,1,1,5.41482762072701,3.62628072448751,1.7885468962395,31,36,-5,41,52,-11,49,70,-21,2,3,0,0
"13796","N.J","CAR",2017021177,17617,20172018,1,60,4,3,1,6.15009612877412,3.91713982564397,2.23295630313015,45,34,11,57,43,14,63,51,12,4,3,0,0
"13797","N.J","PIT",2017021192,17619,20172018,1,60.3166666666667,3,4,-1,6.60762733395677,4.85365144917884,1.75397588477793,31,35,-4,39,53,-14,49,60,-11,4,3,0,0
"13798","N.J","NYI",2017021210,17621,20172018,1,60,4,3,1,3.52522752324148,4.41124256816693,-0.886015044925443,35,30,5,45,38,7,51,50,1,2,2,0,0
"13799","N.J","MTL",2017021220,17622,20172018,0,60,2,1,1,3.32806640156195,3.83249307632445,-0.504426674762499,32,26,6,38,34,4,53,51,2,5,4,0,0
"13800","N.J","NYR",2017021229,17624,20172018,1,60,5,2,3,7.53750681759534,4.54126644874478,2.99624036885056,44,24,20,55,40,15,67,49,18,6,3,0,0
"13801","N.J","TOR",2017021241,17626,20172018,1,60,2,1,1,7.66006801468779,4.17779119469924,3.48227681998856,39,32,7,54,46,8,63,58,5,2,2,0,0
"13802","N.J","WSH",2017021262,17628,20172018,0,60,3,5,-2,2.86629477715729,8.14067317650188,-5.27437839934459,26,26,0,35,46,-11,48,57,-9,3,4,0,0
"13803","N.J","T.B",2017030111,17633,20172018,0,60,2,5,-3,4.32607751415344,5.88276260573912,-1.55668509158568,31,32,-1,43,49,-6,58,65,-7,2,1,0,0
"13804","N.J","T.B",2017030112,17635,20172018,0,60,3,5,-2,5.70873862237204,6.3737705957974,-0.665031973425357,44,26,18,54,44,10,64,55,9,5,5,0,0
"13805","N.J","T.B",2017030113,17637,20172018,1,60,5,2,3,6.56164815524991,3.95467205349504,2.60697610175487,41,36,5,50,44,6,58,53,5,9,7,0,0
"13806","N.J","T.B",2017030114,17639,20172018,1,60,1,3,-2,3.47951156343333,6.1243331183469,-2.64482155491357,28,37,-9,39,52,-13,49,62,-13,7,6,0,0
"13807","N.J","T.B",2017030115,17642,20172018,0,60,1,3,-2,4.13463223103645,5.91458162449999,-1.77994939346354,27,38,-11,34,51,-17,47,59,-12,1,5,0,0
"13808","N.J","EDM",2018020020,17810,20182019,1,60,5,2,3,3.97758116945624,3.55453479342395,0.423046376032289,27,19,8,40,30,10,48,38,10,2,4,0,0
"13809","N.J","WSH",2018020048,17815,20182019,1,60,6,0,6,5.35756818480968,2.31129408247944,3.04627410233024,36,21,15,54,33,21,62,53,9,5,5,0,0
"13810","N.J","S.J",2018020071,17818,20182019,1,60,3,2,1,4.9742286126058,5.69824741597034,-0.724018803364546,36,39,-3,44,52,-8,57,64,-7,7,3,0,0
"13811","N.J","DAL",2018020078,17820,20182019,1,60,3,0,3,6.29887907166267,1.60325134077279,4.69562773088987,34,24,10,51,34,17,58,41,17,7,4,0,0
"13812","N.J","COL",2018020091,17822,20182019,1,60,3,5,-2,3.72818635128155,4.45367399853421,-0.725487647252669,30,34,-4,42,40,2,47,51,-4,5,7,0,0
"13813","N.J","PHI",2018020102,17824,20182019,0,60,2,5,-3,2.20514669647407,5.08385566835932,-2.87870897188525,21,21,0,34,42,-8,45,69,-24,4,6,0,0
"13814","N.J","NSH",2018020136,17829,20182019,1,63.5833333333333,3,4,-1,5.26242320000893,5.30831907806684,-0.045895878057916,36,36,0,43,53,-10,54,66,-12,3,4,0,0
"13815","N.J","FLA",2018020148,17831,20182019,1,60,3,2,1,2.42680914129107,6.9768366859816,-4.55002754469052,26,37,-11,40,51,-11,48,81,-33,6,6,0,0
"13816","N.J","T.B",2018020172,17834,20182019,0,60,3,8,-5,5.57050056682783,4.53741626012197,1.03308430670586,30,44,-14,42,51,-9,55,65,-10,3,3,0,0
"13817","N.J","DET",2018020184,17836,20182019,0,60,3,4,-1,4.58353779884055,5.29304825076099,-0.709510451920437,28,31,-3,45,41,4,56,58,-2,5,5,0,0
"13818","N.J","NYI",2018020198,17838,20182019,0,60,0,3,-3,5.10383408620205,6.21901699021691,-1.11518290401487,35,33,2,51,45,6,71,58,13,4,4,0,0
"13819","N.J","PIT",2018020212,17840,20182019,0,60,5,1,4,5.06229226365622,4.50721611763942,0.555076146016802,39,36,3,50,46,4,65,68,-3,5,4,0,0
"13820","N.J","OTT",2018020218,17841,20182019,0,60,3,7,-4,5.42975187653842,7.05792085357825,-1.62816897703983,39,42,-3,48,62,-14,63,76,-13,2,4,0,0
"13821","N.J","TOR",2018020236,17844,20182019,0,60,1,6,-5,6.29379779848801,3.47853606624994,2.81526173223807,39,32,7,53,42,11,69,58,11,3,4,0,0
"13822","N.J","WPG",2018020257,17846,20182019,0,60,2,5,-3,5.22376550897025,7.35174235969635,-2.1279768507261,36,28,8,46,42,4,71,53,18,5,3,0,0
"13823","N.J","PIT",2018020265,17848,20182019,1,60,4,2,2,5.24831284694868,3.62305583784109,1.62525700910758,35,31,4,46,41,5,54,55,-1,3,4,0,0
"13824","N.J","PHI",2018020278,17850,20182019,0,60,3,0,3,6.21597711697359,4.99023153992289,1.2257455770507,27,29,-2,33,54,-21,47,68,-21,3,5,0,0
"13825","N.J","DET",2018020292,17852,20182019,1,64.15,2,3,-1,5.46320035954705,6.75070297264028,-1.28750261309324,40,30,10,57,42,15,73,55,18,2,4,0,0
"13826","N.J","CAR",2018020304,17853,20182019,0,60,1,2,-1,6.3734715991086,4.64559759755525,1.72787400155335,34,25,9,48,41,7,62,61,1,3,3,0,0
"13827","N.J","MTL",2018020319,17856,20182019,1,60,5,2,3,2.96333638498868,5.63843620248372,-2.67509981749504,28,26,2,37,39,-2,48,50,-2,1,2,0,0
"13828","N.J","NYI",2018020334,17858,20182019,1,63.6666666666667,3,4,-1,4.54271327165043,2.9590735602745,1.58363971137592,42,35,7,56,45,11,69,55,14,3,3,0,0
"13829","N.J","T.B",2018020359,17860,20182019,0,60,2,5,-3,4.20885445340537,2.13223818791693,2.07661626548844,35,36,-1,49,44,5,59,55,4,2,3,0,0
"13830","N.J","FLA",2018020363,17861,20182019,0,61.4666666666667,3,4,-1,4.58805275290678,4.10654985259433,0.481502900312449,32,34,-2,44,47,-3,58,59,-1,2,4,0,0
"13831","N.J","WSH",2018020391,17865,20182019,0,60,3,6,-3,6.22534692939507,6.77965078560192,-0.554303856206843,36,31,5,48,39,9,62,50,12,4,3,0,0
"13832","N.J","WPG",2018020400,17866,20182019,1,64.7166666666667,3,4,-1,5.23945219484449,6.75207890498954,-1.51262671014505,39,38,1,47,51,-4,61,62,-1,4,2,0,0
"13833","N.J","T.B",2018020413,17868,20182019,1,60,1,5,-4,4.0679600332478,3.77369398117918,0.294266052068622,27,26,1,36,40,-4,43,48,-5,5,4,0,0
"13834","N.J","L.A",2018020439,17871,20182019,0,60,6,3,3,6.62160207079796,3.89688604228309,2.72471602851488,35,32,3,45,45,0,62,57,5,4,3,0,0
"13835","N.J","ANA",2018020458,17874,20182019,0,65,5,5,0,3.71440460802832,7.82906370552519,-4.11465909749687,35,38,-3,50,52,-2,63,67,-4,3,1,0,0
"13836","N.J","S.J",2018020464,17875,20182019,0,60,2,5,-3,4.19524624856422,4.60295744774339,-0.407711199179175,24,34,-10,36,50,-14,46,64,-18,2,2,0,0
"13837","N.J","VGK",2018020487,17879,20182019,1,60.6833333333333,5,4,1,6.35448712819561,1.64540313264092,4.70908399555469,42,22,20,58,31,27,69,39,30,5,3,0,0
"13838","N.J","NSH",2018020502,17880,20182019,0,65,1,1,0,5.35735842891972,5.71767784947075,-0.360319420551027,34,28,6,47,45,2,62,55,7,4,2,0,0
"13839","N.J","TOR",2018020518,17883,20182019,1,60,2,7,-5,3.80684453375579,4.14994594438804,-0.343101410632244,29,31,-2,41,50,-9,50,56,-6,3,3,0,0
"13840","N.J","CBJ",2018020535,17885,20182019,0,60,1,2,-1,3.0117601341598,2.72762652941017,0.284133604749631,30,38,-8,36,48,-12,45,63,-18,2,5,0,0
"13841","N.J","OTT",2018020542,17886,20182019,1,60,5,2,3,4.44870633598669,2.88830189587316,1.56040444011354,32,27,5,42,40,2,46,50,-4,4,6,0,0
"13842","N.J","CBJ",2018020559,17888,20182019,1,60,0,3,-3,5.35387727220268,3.19116630761891,2.16271096458377,39,20,19,55,35,20,68,42,26,4,5,0,0
"13843","N.J","BOS",2018020567,17892,20182019,0,60,5,2,3,5.73222217935216,4.03581870889232,1.69640347045985,33,42,-9,46,53,-7,50,72,-22,4,2,0,0
"13844","N.J","CAR",2018020583,17894,20182019,1,60,2,0,2,5.49137927084496,2.58131033776027,2.91006893308468,30,37,-7,44,46,-2,60,59,1,4,6,0,0
"13845","N.J","VAN",2018020600,17896,20182019,1,60,4,0,4,3.17397683373498,5.26639247662388,-2.09241564288889,23,25,-2,32,38,-6,40,56,-16,3,4,0,0
"13846","N.J","DAL",2018020618,17898,20182019,0,60,4,5,-1,4.24754349706927,3.75068844374461,0.496855053324662,34,40,-6,40,43,-3,54,60,-6,6,2,0,0
"13847","N.J","ARI",2018020634,17900,20182019,0,65,2,2,0,3.95780584944665,5.78733368384422,-1.82952783439757,35,25,10,45,34,11,56,51,5,4,5,0,0
"13848","N.J","VGK",2018020646,17902,20182019,0,60,2,3,-1,5.88330359451356,2.15269634188735,3.73060725262621,38,28,10,45,39,6,62,56,6,2,2,0,0
"13849","N.J","BUF",2018020658,17904,20182019,0,60,1,5,-4,5.46632056843411,5.8300636212688,-0.363743052834685,21,33,-12,34,46,-12,45,65,-20,5,2,0,0
"13850","N.J","TOR",2018020672,17906,20182019,1,60,2,4,-2,3.75156194303418,7.19152216899822,-3.43996022596404,29,43,-14,44,60,-16,52,69,-17,4,3,0,0
"13851","N.J","PHI",2018020687,17908,20182019,1,60,3,2,1,2.51348195704208,4.93994379503373,-2.42646183799165,26,34,-8,37,54,-17,51,68,-17,7,5,0,0
"13852","N.J","CHI",2018020707,17910,20182019,1,60,8,5,3,4.24449037344696,3.69690829524188,0.547582078205075,41,32,9,47,43,4,54,58,-4,4,6,0,0
"13853","N.J","CBJ",2018020713,17911,20182019,0,60,1,4,-3,3.80679666726154,5.10959186954523,-1.30279520228369,30,34,-4,37,43,-6,56,52,4,2,3,0,0
"13854","N.J","NYI",2018020727,17913,20182019,0,60,1,4,-3,2.23652433165444,4.57694590516621,-2.34042157351178,17,26,-9,26,41,-15,39,60,-21,2,3,0,0
"13855","N.J","ANA",2018020740,17915,20182019,1,60,2,3,-1,3.46817985998618,2.21473797831716,1.25344188166902,31,14,17,43,21,22,54,30,24,4,2,0,0
"13856","N.J","PIT",2018020772,17924,20182019,0,60,6,3,3,3.79315648448348,8.20023299889522,-4.40707651441174,32,40,-8,40,54,-14,49,76,-27,2,5,0,0
"13857","N.J","NYR",2018020779,17927,20182019,1,60,3,4,-1,4.88140655960888,4.82300644481517,0.0584001147937041,22,25,-3,35,43,-8,44,54,-10,4,4,0,0
"13858","N.J","MTL",2018020790,17929,20182019,0,61.9333333333333,3,2,1,4.99256174110269,6.99013402529458,-1.99757228419189,27,39,-12,33,55,-22,39,79,-40,3,3,0,0
"13859","N.J","L.A",2018020812,17932,20182019,1,60,1,5,-4,3.19834822067432,3.27248383636788,-0.0741356156935638,30,25,5,42,35,7,58,47,11,7,4,0,0
"13860","N.J","NYI",2018020825,17934,20182019,1,65,1,1,0,3.59279796348892,3.56947886469425,0.0233190987946728,31,28,3,41,40,1,51,53,-2,4,5,0,0
"13861","N.J","MIN",2018020840,17936,20182019,1,60,2,4,-2,4.30848173378035,4.68198951701424,-0.37350778323389,18,33,-15,28,45,-17,43,59,-16,2,3,0,0
"13862","N.J","CAR",2018020855,17937,20182019,1,60,3,2,1,3.09521714023262,6.47853396252322,-3.3833168222906,21,35,-14,27,54,-27,36,69,-33,5,6,0,0
"13863","N.J","STL",2018020869,17939,20182019,0,60,3,8,-5,2.58609087398145,4.46039654084598,-1.87430566686453,23,39,-16,26,50,-24,35,70,-35,3,3,0,0
"13864","N.J","CHI",2018020883,17941,20182019,0,60,2,5,-3,4.83075992535932,4.05054607976924,0.780213845590074,43,36,7,51,42,9,64,63,1,3,3,0,0
"13865","N.J","MIN",2018020890,17942,20182019,0,63.3166666666667,5,4,1,3.56290701206308,5.20586594147608,-1.642958929413,28,32,-4,40,45,-5,57,59,-2,4,2,0,0
"13866","N.J","BUF",2018020906,17944,20182019,1,60,4,1,3,3.26686888345284,2.95620983225209,0.31065905120075,24,35,-11,30,44,-14,40,61,-21,2,3,0,0
"13867","N.J","PIT",2018020917,17946,20182019,1,60,3,4,-1,8.46601858121483,4.5963428802981,3.86967570091673,36,28,8,46,40,6,54,51,3,2,2,0,0
"13868","N.J","OTT",2018020931,17948,20182019,1,60,4,0,4,3.39094275733937,4.2974824688572,-0.906539711517825,31,30,1,47,42,5,55,60,-5,2,4,0,0
"13869","N.J","NYR",2018020946,17950,20182019,0,60,2,5,-3,2.525475180856,5.68651970475003,-3.16104452389402,21,34,-13,34,44,-10,44,62,-18,4,5,0,0
"13870","N.J","MTL",2018020963,17952,20182019,1,60,2,1,1,2.71872710224925,5.18447188086562,-2.46574477861637,22,35,-13,31,52,-21,42,63,-21,6,5,0,0
"13871","N.J","CGY",2018020980,17954,20182019,1,60,1,2,-1,2.8697457096132,5.14237072272226,-2.27262501310906,20,35,-15,30,47,-17,40,58,-18,3,5,0,0
"13872","N.J","PHI",2018020992,17956,20182019,1,60,3,6,-3,3.41929680030741,3.36881656941,0.0504802308974046,33,24,9,47,29,18,58,37,21,3,4,0,0
"13873","N.J","BOS",2018021001,17957,20182019,0,60,0,1,-1,2.63968665210996,3.21604700946409,-0.576360357354133,20,30,-10,29,40,-11,41,54,-13,2,2,0,0
"13874","N.J","CBJ",2018021020,17960,20182019,1,65,1,1,0,4.4762667089235,6.75555942405481,-2.27929271513131,30,18,12,47,35,12,59,49,10,2,2,0,0
"13875","N.J","WSH",2018021045,17963,20182019,0,60,0,3,-3,3.71727196810672,6.69871501982237,-2.98144305171564,25,36,-11,35,53,-18,55,69,-14,6,5,0,0
"13876","N.J","NYR",2018021053,17964,20182019,0,60,2,4,-2,2.84611667290011,6.27841488478589,-3.43229821188578,24,41,-17,30,60,-30,39,72,-33,3,6,0,0
"13877","N.J","CGY",2018021078,17967,20182019,0,60,4,9,-5,2.17941153232667,7.48000416719151,-5.30059263486484,26,39,-13,36,53,-17,43,72,-29,2,2,0,0
"13878","N.J","EDM",2018021081,17968,20182019,0,60,6,3,3,4.81127381979116,5.78139015298802,-0.970116333196868,35,39,-4,41,51,-10,50,74,-24,5,6,0,0
"13879","N.J","VAN",2018021098,17970,20182019,0,65,2,2,0,3.84744038109784,4.59269117156509,-0.745250790467253,33,27,6,41,42,-1,58,55,3,1,5,0,0
"13880","N.J","COL",2018021111,17972,20182019,0,60,0,3,-3,3.52305099963814,6.01366096219135,-2.49060996255321,22,34,-12,35,48,-13,52,63,-11,4,3,0,0
"13881","N.J","WSH",2018021122,17974,20182019,1,60,1,4,-3,3.49285565217724,2.29255507141352,1.20030058076372,21,22,-1,29,32,-3,37,38,-1,2,1,0,0
"13882","N.J","BOS",2018021137,17976,20182019,1,60,1,5,-4,2.88937193672957,5.17963977967156,-2.29026784294199,22,27,-5,29,43,-14,36,58,-22,1,3,0,0
"13883","N.J","ARI",2018021150,17978,20182019,1,65,1,1,0,4.66570052057944,5.31621893314878,-0.650518412569332,32,24,8,51,41,10,62,55,7,5,3,0,0
"13884","N.J","BUF",2018021170,17980,20182019,1,60,3,1,2,3.16391033330001,4.70334636041571,-1.5394360271157,21,46,-25,30,52,-22,34,62,-28,3,3,0,0
"13885","N.J","DET",2018021199,17984,20182019,0,60,0,4,-4,4.07596485397439,5.20355014789675,-1.12758529392236,28,33,-5,40,42,-2,49,55,-6,1,1,0,0
"13886","N.J","STL",2018021207,17985,20182019,1,64.95,2,3,-1,4.99247546808328,3.59406834891291,1.39840711917037,27,27,0,45,42,3,61,66,-5,3,1,0,0
"13887","N.J","NYR",2018021222,17987,20182019,1,60,4,2,2,5.24629077473684,3.44024631571854,1.8060444590183,41,32,9,52,46,6,63,51,12,5,3,0,0
"13888","N.J","CAR",2018021247,17990,20182019,0,60,1,3,-2,6.70882649549914,4.73095169694716,1.97787479855198,37,25,12,46,41,5,63,49,14,3,2,0,0
"13889","NSH","STL",2008020014,14162,20082009,0,60,2,5,-3,0,0,0,22,22,0,39,36,3,49,43,6,4,6,0,0
"13890","NSH","DAL",2008020024,14163,20082009,1,60,3,1,2,0,0,0,32,20,12,47,32,15,64,41,23,9,7,0,0
"13891","NSH","CHI",2008020038,14165,20082009,0,65,2,2,0,0,0,0,27,25,2,41,34,7,50,45,5,3,5,0,0
"13892","NSH","DAL",2008020047,14167,20082009,0,60,4,6,-2,0,0,0,19,28,-9,32,44,-12,44,60,-16,6,6,0,0
"13893","NSH","CBJ",2008020058,14169,20082009,0,60,3,5,-2,0,0,0,30,28,2,42,33,9,57,44,13,6,5,0,0
"13894","NSH","CBJ",2008020072,14170,20082009,1,60,6,3,3,0,0,0,30,26,4,38,35,3,47,51,-4,5,5,0,0
"13895","NSH","CGY",2008020095,14175,20082009,1,60,3,5,-2,0,0,0,38,27,11,50,39,11,59,57,2,8,5,0,0
"13896","NSH","L.A",2008020112,14177,20082009,1,60,5,4,1,0,0,0,27,30,-3,36,44,-8,42,56,-14,3,5,0,0
"13897","NSH","WSH",2008020126,14180,20082009,0,65,3,3,0,0,0,0,26,32,-6,33,43,-10,47,61,-14,7,5,0,0
"13898","NSH","EDM",2008020140,14182,20082009,1,60,3,1,2,0,0,0,25,28,-3,35,44,-9,44,57,-13,3,4,0,0
"13899","NSH","FLA",2008020158,14184,20082009,1,65,2,2,0,0,0,0,32,26,6,46,39,7,68,53,15,4,3,0,0
"13900","NSH","VAN",2008020175,14187,20082009,0,60,0,4,-4,0,0,0,24,39,-15,35,44,-9,45,52,-7,6,7,0,0
"13901","NSH","CGY",2008020188,14189,20082009,0,60,6,7,-1,0,0,0,29,29,0,42,38,4,47,52,-5,9,7,0,0
"13902","NSH","COL",2008020203,14191,20082009,0,60,0,1,-1,0,0,0,26,20,6,39,30,9,48,43,5,7,9,0,0
"13903","NSH","S.J",2008020220,14194,20082009,0,62.4666666666667,4,3,1,0,0,0,29,57,-28,37,65,-28,51,87,-36,3,8,0,0
"13904","NSH","ANA",2008020241,14197,20082009,0,62.2833333333333,4,3,1,0,0,0,35,35,0,48,54,-6,56,63,-7,5,4,0,0
"13905","NSH","L.A",2008020251,14198,20082009,0,60,3,1,2,0,0,0,22,34,-12,31,53,-22,40,68,-28,3,3,0,0
"13906","NSH","S.J",2008020261,14200,20082009,1,60,1,4,-3,0,0,0,33,32,1,38,43,-5,44,56,-12,7,8,0,0
"13907","NSH","T.B",2008020283,14204,20082009,0,60,1,4,-3,0,0,0,35,24,11,42,33,9,55,44,11,7,6,0,0
"13908","NSH","CAR",2008020297,14206,20082009,0,60,5,2,3,0,0,0,30,26,4,39,43,-4,55,54,1,6,9,0,0
"13909","NSH","STL",2008020306,14208,20082009,1,65,0,0,0,0,0,0,47,17,30,59,28,31,75,42,33,6,5,0,0
"13910","NSH","ATL",2008020330,14211,20082009,0,61.7333333333333,4,3,1,0,0,0,26,25,1,38,33,5,49,42,7,3,4,0,0
"13911","NSH","MIN",2008020342,14212,20082009,1,60,2,6,-4,0,0,0,27,29,-2,44,37,7,54,46,8,5,12,0,0
"13912","NSH","BUF",2008020350,14214,20082009,0,60,2,0,2,0,0,0,27,30,-3,36,36,0,47,53,-6,2,2,0,0
"13913","NSH","COL",2008020373,14217,20082009,1,60,3,2,1,0,0,0,24,21,3,34,28,6,50,37,13,6,4,0,0
"13914","NSH","MIN",2008020388,14219,20082009,1,60,1,0,1,0,0,0,43,32,11,53,43,10,65,55,10,3,3,0,0
"13915","NSH","STL",2008020401,14221,20082009,0,60,3,6,-3,0,0,0,21,26,-5,28,47,-19,37,58,-21,2,5,0,0
"13916","NSH","VAN",2008020404,14222,20082009,1,60,1,3,-2,0,0,0,21,28,-7,31,42,-11,44,53,-9,7,8,0,0
"13917","NSH","CBJ",2008020415,14224,20082009,0,65,1,1,0,0,0,0,26,36,-10,36,48,-12,45,63,-18,4,5,0,0
"13918","NSH","DAL",2008020437,14226,20082009,1,60,3,0,3,0,0,0,38,27,11,44,36,8,53,52,1,3,5,0,0
"13919","NSH","ARI",2008020468,14231,20082009,0,60,1,2,-1,0,0,0,31,27,4,42,39,3,53,48,5,3,2,0,0
"13920","NSH","NYI",2008020481,14233,20082009,1,60,1,0,1,0,0,0,28,23,5,42,27,15,61,38,23,2,2,0,0
"13921","NSH","FLA",2008020501,14236,20082009,0,60,0,3,-3,0,0,0,27,43,-16,46,48,-2,57,56,1,2,5,0,0
"13922","NSH","DET",2008020512,14239,20082009,1,60,3,2,1,0,0,0,31,40,-9,41,53,-12,50,72,-22,3,3,0,0
"13923","NSH","EDM",2008020531,14241,20082009,0,60,2,5,-3,0,0,0,30,33,-3,44,47,-3,56,55,1,1,4,0,0
"13924","NSH","COL",2008020536,14242,20082009,0,60,1,5,-4,0,0,0,26,21,5,37,29,8,56,40,16,6,5,0,0
"13925","NSH","VAN",2008020558,14245,20082009,1,60,1,2,-1,0,0,0,32,32,0,38,44,-6,43,56,-13,3,4,0,0
"13926","NSH","CGY",2008020567,14247,20082009,1,60,2,3,-1,0,0,0,26,26,0,42,42,0,54,55,-1,4,5,0,0
"13927","NSH","COL",2008020592,14250,20082009,1,60,1,2,-1,0,0,0,23,21,2,47,27,20,70,38,32,3,2,0,0
"13928","NSH","PIT",2008020604,14252,20082009,1,60,5,3,2,0,0,0,35,25,10,48,30,18,66,37,29,3,3,0,0
"13929","NSH","CHI",2008020622,14254,20082009,1,60,4,1,3,0,0,0,38,35,3,48,56,-8,56,70,-14,5,6,0,0
"13930","NSH","CHI",2008020626,14255,20082009,0,60,1,3,-2,0,0,0,27,33,-6,32,39,-7,40,49,-9,2,5,0,0
"13931","NSH","TOR",2008020636,14257,20082009,0,60,2,0,2,0,0,0,23,17,6,39,36,3,50,49,1,4,5,0,0
"13932","NSH","MTL",2008020648,14259,20082009,0,60,2,3,-1,0,0,0,25,20,5,37,34,3,63,48,15,2,3,0,0
"13933","NSH","ATL",2008020668,14261,20082009,1,60,2,7,-5,0,0,0,33,32,1,49,37,12,73,42,31,6,2,0,0
"13934","NSH","N.J",2008020683,14263,20082009,1,60,1,3,-2,0,0,0,34,35,-1,45,45,0,58,58,0,5,3,0,0
"13935","NSH","VAN",2008020715,14272,20082009,0,60,5,3,2,0,0,0,38,27,11,44,41,3,55,55,0,8,6,0,0
"13936","NSH","CGY",2008020728,14274,20082009,0,60,1,3,-2,0,0,0,29,32,-3,37,43,-6,48,54,-6,5,8,0,0
"13937","NSH","EDM",2008020744,14276,20082009,0,60,2,1,1,0,0,0,29,33,-4,38,47,-9,48,61,-13,2,3,0,0
"13938","NSH","ARI",2008020755,14278,20082009,1,60,2,1,1,0,0,0,24,30,-6,40,42,-2,51,63,-12,6,7,0,0
"13939","NSH","ANA",2008020767,14280,20082009,1,60,4,2,2,0,0,0,34,30,4,42,35,7,56,51,5,2,2,0,0
"13940","NSH","MIN",2008020775,14281,20082009,0,60,2,0,2,0,0,0,26,22,4,34,34,0,42,56,-14,5,7,0,0
"13941","NSH","DAL",2008020792,14283,20082009,0,60,1,4,-3,0,0,0,26,22,4,40,31,9,55,37,18,3,3,0,0
"13942","NSH","DET",2008020800,14285,20082009,1,60,3,5,-2,0,0,0,21,51,-30,32,62,-30,40,77,-37,3,7,0,0
"13943","NSH","STL",2008020815,14287,20082009,1,65,3,3,0,0,0,0,34,27,7,45,34,11,67,49,18,5,4,0,0
"13944","NSH","BOS",2008020830,14289,20082009,1,65,2,2,0,0,0,0,31,25,6,51,41,10,68,52,16,6,4,0,0
"13945","NSH","OTT",2008020844,14291,20082009,1,60,0,2,-2,0,0,0,24,24,0,32,30,2,46,41,5,4,4,0,0
"13946","NSH","DET",2008020857,14293,20082009,0,60,2,6,-4,0,0,0,25,41,-16,37,51,-14,49,60,-11,6,7,0,0
"13947","NSH","STL",2008020866,14294,20082009,1,62.8666666666667,1,2,-1,0,0,0,29,36,-7,39,47,-8,54,57,-3,4,4,0,0
"13948","NSH","STL",2008020885,14296,20082009,0,62.6,1,0,1,0,0,0,22,30,-8,40,38,2,47,48,-1,1,3,0,0
"13949","NSH","CHI",2008020899,14299,20082009,1,60,5,3,2,0,0,0,29,32,-3,39,43,-4,51,57,-6,6,2,0,0
"13950","NSH","ARI",2008020915,14301,20082009,1,60,4,1,3,0,0,0,47,26,21,60,37,23,75,47,28,4,3,0,0
"13951","NSH","DET",2008020931,14303,20082009,1,60,8,0,8,0,0,0,23,30,-7,29,48,-19,36,67,-31,3,2,0,0
"13952","NSH","EDM",2008020948,14306,20082009,1,62.5166666666667,6,5,1,0,0,0,43,28,15,55,38,17,64,51,13,4,3,0,0
"13953","NSH","CBJ",2008020961,14308,20082009,1,60,4,2,2,0,0,0,23,33,-10,40,38,2,53,47,6,2,3,0,0
"13954","NSH","PHI",2008020974,14310,20082009,0,60,1,4,-3,0,0,0,32,26,6,46,41,5,57,60,-3,5,6,0,0
"13955","NSH","NYR",2008021011,14315,20082009,1,60,2,4,-2,0,0,0,21,32,-11,31,46,-15,47,59,-12,6,4,0,0
"13956","NSH","ARI",2008021029,14317,20082009,0,60,2,0,2,0,0,0,33,18,15,42,25,17,53,38,15,3,3,0,0
"13957","NSH","L.A",2008021039,14319,20082009,0,60,4,3,1,0,0,0,30,29,1,48,40,8,59,52,7,4,4,0,0
"13958","NSH","ANA",2008021054,14321,20082009,0,60.5666666666667,3,4,-1,0,0,0,24,31,-7,26,44,-18,31,54,-23,3,5,0,0
"13959","NSH","S.J",2008021062,14322,20082009,0,65,2,2,0,0,0,0,26,38,-12,37,46,-9,45,65,-20,2,4,0,0
"13960","NSH","ANA",2008021092,14327,20082009,1,65,1,1,0,0,0,0,32,19,13,44,28,16,61,42,19,3,1,0,0
"13961","NSH","S.J",2008021106,14329,20082009,1,60,3,2,1,0,0,0,33,31,2,48,38,10,61,48,13,4,4,0,0
"13962","NSH","L.A",2008021122,14331,20082009,1,63.6833333333333,4,3,1,0,0,0,28,27,1,39,39,0,57,46,11,6,4,0,0
"13963","NSH","DET",2008021127,14332,20082009,0,60,4,3,1,0,0,0,26,36,-10,34,52,-18,38,67,-29,3,4,0,0
"13964","NSH","CHI",2008021163,14337,20082009,0,60,1,3,-2,0,0,0,26,32,-6,28,34,-6,30,39,-9,1,2,0,0
"13965","NSH","CHI",2008021191,14341,20082009,1,60,2,4,-2,0,0,0,24,28,-4,34,36,-2,0,0,0,3,2,0,0
"13966","NSH","DET",2008021206,14343,20082009,0,65,3,3,0,0,0,0,25,26,-1,37,38,-1,50,57,-7,6,4,0,0
"13967","NSH","MIN",2008021210,14344,20082009,0,60,4,8,-4,0,0,0,35,37,-2,45,49,-4,57,55,2,5,6,0,0
"13968","NSH","DAL",2009020019,14520,20092010,0,65,2,2,0,0,0,0,26,40,-14,32,64,-32,45,79,-34,4,6,0,0
"13969","NSH","COL",2009020043,14525,20092010,1,60,3,2,1,0,0,0,37,24,13,42,29,13,55,36,19,2,3,0,0
"13970","NSH","EDM",2009020070,14529,20092010,1,60,1,6,-5,0,0,0,41,20,21,53,24,29,61,36,25,7,3,0,0
"13971","NSH","DAL",2009020078,14531,20092010,0,60,0,6,-6,0,0,0,29,26,3,48,35,13,59,45,14,4,4,0,0
"13972","NSH","CHI",2009020085,14532,20092010,1,60,1,3,-2,0,0,0,13,30,-17,26,40,-14,42,49,-7,3,2,0,0
"13973","NSH","BOS",2009020112,14538,20092010,0,60,2,3,-1,0,0,0,30,27,3,36,31,5,43,42,1,3,2,0,0
"13974","NSH","OTT",2009020122,14539,20092010,0,62.1833333333333,6,5,1,0,0,0,37,32,5,48,39,9,58,48,10,7,7,0,0
"13975","NSH","CHI",2009020140,14541,20092010,0,60,0,2,-2,0,0,0,27,34,-7,40,42,-2,47,55,-8,4,3,0,0
"13976","NSH","MIN",2009020161,14545,20092010,0,60,4,3,1,0,0,0,22,22,0,38,31,7,53,44,9,4,3,0,0
"13977","NSH","CHI",2009020169,14546,20092010,1,60,2,0,2,0,0,0,28,22,6,41,32,9,53,49,4,7,5,0,0
"13978","NSH","DAL",2009020188,14548,20092010,1,60,4,2,2,0,0,0,33,29,4,46,32,14,60,49,11,5,7,0,0
"13979","NSH","ANA",2009020217,14553,20092010,0,60,0,4,-4,0,0,0,40,31,9,58,36,22,69,42,27,6,6,0,0
"13980","NSH","L.A",2009020225,14555,20092010,0,60,3,1,2,0,0,0,25,28,-3,46,43,3,59,52,7,5,5,0,0
"13981","NSH","S.J",2009020246,14558,20092010,0,60,3,4,-1,0,0,0,26,29,-3,42,43,-1,52,55,-3,2,1,0,0
"13982","NSH","STL",2009020259,14560,20092010,0,60,3,1,2,0,0,0,37,22,15,50,29,21,66,38,28,3,5,0,0
"13983","NSH","MTL",2009020277,14562,20092010,1,60,2,0,2,0,0,0,55,20,35,68,27,41,78,37,41,6,2,0,0
"13984","NSH","S.J",2009020292,14565,20092010,1,60,4,3,1,0,0,0,31,32,-1,42,47,-5,56,64,-8,4,2,0,0
"13985","NSH","N.J",2009020303,14567,20092010,1,65,2,2,0,0,0,0,28,28,0,46,36,10,62,47,15,3,3,0,0
"13986","NSH","DET",2009020328,14571,20092010,1,60,3,1,2,0,0,0,25,31,-6,33,49,-16,43,71,-28,4,2,0,0
"13987","NSH","COL",2009020348,14573,20092010,0,63.1166666666667,4,3,1,0,0,0,27,22,5,39,35,4,56,42,14,3,3,0,0
"13988","NSH","STL",2009020364,14575,20092010,1,60,1,3,-2,0,0,0,38,38,0,52,48,4,70,53,17,5,3,0,0
"13989","NSH","FLA",2009020375,14576,20092010,1,60,4,1,3,0,0,0,29,24,5,43,36,7,66,49,17,4,5,0,0
"13990","NSH","CGY",2009020389,14578,20092010,1,60,0,5,-5,0,0,0,22,30,-8,41,40,1,57,53,4,3,2,0,0
"13991","NSH","MIN",2009020397,14580,20092010,0,61.4333333333333,4,5,-1,0,0,0,35,27,8,45,41,4,54,52,2,2,2,0,0
"13992","NSH","CHI",2009020412,14582,20092010,0,60,4,1,3,0,0,0,23,35,-12,29,44,-15,37,56,-19,3,2,0,0
"13993","NSH","MIN",2009020424,14583,20092010,1,60,3,5,-2,0,0,0,29,39,-10,38,47,-9,54,61,-7,5,4,0,0
"13994","NSH","VAN",2009020440,14586,20092010,1,60,4,2,2,0,0,0,26,36,-10,44,50,-6,62,65,-3,7,3,0,0
"13995","NSH","DET",2009020474,14590,20092010,1,60.4,2,3,-1,0,0,0,35,29,6,42,40,2,51,56,-5,4,4,0,0
"13996","NSH","T.B",2009020490,14593,20092010,1,60,7,4,3,0,0,0,27,34,-7,38,47,-9,54,57,-3,3,4,0,0
"13997","NSH","EDM",2009020509,14595,20092010,0,60,6,3,3,0,0,0,27,26,1,39,41,-2,51,52,-1,3,5,0,0
"13998","NSH","CGY",2009020526,14597,20092010,0,60,5,3,2,0,0,0,20,32,-12,30,40,-10,39,50,-11,4,3,0,0
"13999","NSH","VAN",2009020544,14600,20092010,0,60,1,4,-3,0,0,0,21,36,-15,33,46,-13,46,60,-14,2,3,0,0
"14000","NSH","CHI",2009020564,14604,20092010,1,60,1,4,-3,0,0,0,26,40,-14,37,50,-13,54,61,-7,4,4,0,0
"14001","NSH","CHI",2009020574,14605,20092010,0,60,4,5,-1,0,0,0,20,29,-9,27,41,-14,33,52,-19,4,6,0,0
"14002","NSH","STL",2009020586,14607,20092010,0,60,4,3,1,0,0,0,30,27,3,45,38,7,60,50,10,7,4,0,0
"14003","NSH","ANA",2009020619,14611,20092010,1,60,3,1,2,0,0,0,36,26,10,49,33,16,64,43,21,2,2,0,0
"14004","NSH","CGY",2009020634,14614,20092010,1,60,1,3,-2,0,0,0,28,34,-6,42,48,-6,59,64,-5,3,2,0,0
"14005","NSH","CAR",2009020650,14616,20092010,1,60,4,2,2,0,0,0,34,27,7,45,37,8,64,48,16,7,4,0,0
"14006","NSH","ANA",2009020667,14618,20092010,1,60,2,3,-1,0,0,0,27,21,6,37,32,5,55,44,11,1,1,0,0
"14007","NSH","VAN",2009020678,14620,20092010,0,60,3,2,1,0,0,0,25,32,-7,35,47,-12,45,60,-15,8,4,0,0
"14008","NSH","EDM",2009020687,14621,20092010,0,60,5,3,2,0,0,0,28,41,-13,38,56,-18,53,81,-28,1,3,0,0
"14009","NSH","CGY",2009020706,14624,20092010,0,60,1,0,1,0,0,0,21,22,-1,36,32,4,48,42,6,3,3,0,0
"14010","NSH","TOR",2009020729,14627,20092010,1,60,3,4,-1,0,0,0,30,22,8,45,31,14,62,36,26,2,3,0,0
"14011","NSH","COL",2009020758,14631,20092010,0,60,1,2,-1,0,0,0,30,23,7,43,31,12,56,38,18,6,8,0,0
"14012","NSH","DET",2009020805,14638,20092010,0,60,2,4,-2,0,0,0,48,29,19,64,40,24,81,51,30,4,4,0,0
"14013","NSH","ATL",2009020813,14639,20092010,1,60,4,3,1,0,0,0,31,26,5,41,32,9,52,44,8,5,5,0,0
"14014","NSH","COL",2009020847,14644,20092010,1,60,5,3,2,0,0,0,36,26,10,43,35,8,53,48,5,6,4,0,0
"14015","NSH","S.J",2009020866,14646,20092010,1,60,3,4,-1,0,0,0,38,29,9,52,38,14,65,50,15,4,5,0,0
"14016","NSH","NYI",2009020877,14649,20092010,0,65,3,3,0,0,0,0,27,32,-5,36,53,-17,53,73,-20,6,7,0,0
"14017","NSH","NYR",2009020884,14650,20092010,0,60,2,1,1,0,0,0,36,38,-2,46,46,0,59,61,-2,5,6,0,0
"14018","NSH","N.J",2009020898,14652,20092010,0,60,2,5,-3,0,0,0,21,28,-7,31,37,-6,36,40,-4,4,5,0,0
"14019","NSH","PIT",2009020917,14654,20092010,0,65,3,3,0,0,0,0,26,33,-7,40,49,-9,52,61,-9,8,5,0,0
"14020","NSH","EDM",2009020931,14670,20092010,1,60,4,3,1,0,0,0,28,25,3,42,31,11,55,42,13,2,2,0,0
"14021","NSH","L.A",2009020946,14672,20092010,1,60,4,2,2,0,0,0,32,22,10,48,29,19,59,35,24,7,5,0,0
"14022","NSH","DET",2009020951,14673,20092010,0,60,2,5,-3,0,0,0,22,32,-10,34,45,-11,50,57,-7,4,3,0,0
"14023","NSH","VAN",2009020966,14675,20092010,1,60,2,4,-2,0,0,0,35,28,7,47,39,8,61,52,9,2,1,0,0
"14024","NSH","ATL",2009020978,14677,20092010,0,60,2,1,1,0,0,0,32,31,1,43,42,1,55,56,-1,2,2,0,0
"14025","NSH","S.J",2009020999,14679,20092010,0,60,5,8,-3,0,0,0,45,26,19,57,38,19,75,59,16,4,3,0,0
"14026","NSH","ANA",2009021005,14680,20092010,0,60,1,0,1,0,0,0,28,31,-3,36,43,-7,41,50,-9,6,4,0,0
"14027","NSH","L.A",2009021017,14682,20092010,0,60,3,2,1,0,0,0,31,20,11,45,33,12,55,41,14,1,1,0,0
"14028","NSH","PHI",2009021035,14684,20092010,1,65,3,3,0,0,0,0,30,45,-15,43,55,-12,52,75,-23,0,2,0,0
"14029","NSH","MIN",2009021049,14686,20092010,1,60,5,0,5,0,0,0,37,17,20,51,21,30,63,39,24,3,2,0,0
"14030","NSH","STL",2009021072,14689,20092010,0,60,3,2,1,0,0,0,39,25,14,50,35,15,63,45,18,4,3,0,0
"14031","NSH","DAL",2009021085,14691,20092010,1,60,1,3,-2,0,0,0,35,14,21,46,22,24,70,32,38,6,4,0,0
"14032","NSH","DET",2009021118,14695,20092010,1,65,0,0,0,0,0,0,33,38,-5,45,51,-6,56,67,-11,3,2,0,0
"14033","NSH","FLA",2009021130,14697,20092010,0,61,3,2,1,0,0,0,25,29,-4,41,38,3,54,47,7,1,3,0,0
"14034","NSH","L.A",2009021140,14698,20092010,1,60,0,2,-2,0,0,0,34,31,3,45,42,3,64,58,6,3,2,0,0
"14035","NSH","STL",2009021155,14700,20092010,1,60,3,2,1,0,0,0,32,33,-1,42,39,3,60,53,7,5,5,0,0
"14036","NSH","DET",2009021166,14702,20092010,0,60.2666666666667,4,3,1,0,0,0,24,31,-7,38,38,0,50,49,1,2,3,0,0
"14037","NSH","STL",2009021219,14709,20092010,1,65,1,1,0,0,0,0,36,34,2,46,41,5,62,62,0,3,2,0,0
"14038","NSH","CHI",2009030161,14715,20092010,0,60,4,1,3,0,0,0,26,26,0,43,44,-1,57,63,-6,3,2,0,0
"14039","NSH","CHI",2009030162,14717,20092010,0,60,0,2,-2,0,0,0,23,33,-10,33,44,-11,46,54,-8,7,7,0,0
"14040","NSH","CHI",2009030163,14719,20092010,1,60,4,1,3,0,0,0,35,27,8,49,38,11,66,52,14,6,4,0,0
"14041","NSH","CHI",2009030164,14721,20092010,1,60,0,3,-3,0,0,0,33,30,3,48,37,11,66,51,15,6,3,0,0
"14042","NSH","CHI",2009030165,14723,20092010,0,64.1166666666667,4,5,-1,0,0,0,21,32,-11,27,46,-19,41,59,-18,4,4,0,0
"14043","NSH","CHI",2009030166,14725,20092010,1,60,3,5,-2,0,0,0,28,32,-4,39,45,-6,57,52,5,5,5,0,0
"14044","NSH","ANA",2010020020,14891,20102011,1,60,4,1,3,3.81164818812977,6.07015120323922,-2.25850301510945,49,37,12,63,43,20,74,57,17,8,4,0,0
"14045","NSH","CHI",2010020040,14895,20102011,0,60,3,2,1,3.41184638763661,3.65988936522626,-0.248042977589648,27,25,2,37,35,2,51,46,5,4,2,0,0
"14046","NSH","STL",2010020044,14896,20102011,1,60,4,3,1,2.46301326597859,3.59836531537439,-1.13535204939581,22,35,-13,33,46,-13,42,58,-16,4,6,0,0
"14047","NSH","CGY",2010020075,14901,20102011,1,62.1666666666667,0,1,-1,4.17994136400177,5.04094354630797,-0.861002182306207,34,35,-1,46,47,-1,57,61,-4,5,2,0,0
"14048","NSH","PIT",2010020089,14903,20102011,1,63.8166666666667,3,4,-1,2.12769952835515,7.51456891628914,-5.38686938793398,24,38,-14,26,49,-23,36,62,-26,5,6,0,0
"14049","NSH","DAL",2010020106,14905,20102011,0,60,1,0,1,2.00235356795599,4.26663057434604,-2.26427700639005,24,30,-6,32,43,-11,44,58,-14,2,3,0,0
"14050","NSH","T.B",2010020111,14906,20102011,0,60,4,3,1,3.95414725023471,5.76898461846577,-1.81483736823105,26,45,-19,30,60,-30,41,73,-32,2,5,0,0
"14051","NSH","STL",2010020133,14910,20102011,1,60,0,3,-3,3.73386679310352,4.35623855804442,-0.622371764940908,24,34,-10,37,46,-9,54,59,-5,4,4,0,0
"14052","NSH","DET",2010020148,14912,20102011,0,60,2,5,-3,3.03593184080546,2.9953562004157,0.0405756403897612,25,28,-3,36,37,-1,51,50,1,5,5,0,0
"14053","NSH","L.A",2010020187,14919,20102011,0,60,1,4,-3,3.78764369108831,6.02771107658918,-2.24006738550088,26,31,-5,41,41,0,62,48,14,3,3,0,0
"14054","NSH","ANA",2010020202,14920,20102011,0,60,4,5,-1,3.80431104976089,7.68575879279012,-3.88144774302924,24,37,-13,43,53,-10,53,60,-7,4,4,0,0
"14055","NSH","STL",2010020224,14924,20102011,0,65,2,2,0,3.53030451270752,3.40694746059307,0.123357052114443,26,23,3,37,37,0,49,44,5,6,6,0,0
"14056","NSH","CHI",2010020240,14926,20102011,1,65,3,3,0,4.50124512049873,4.59920292592869,-0.0979578054299672,33,32,1,44,43,1,66,58,8,6,7,0,0
"14057","NSH","TOR",2010020254,14929,20102011,0,60,4,5,-1,4.68862947937481,4.88979558745632,-0.201166108081509,34,33,1,44,45,-1,62,67,-5,2,8,0,0
"14058","NSH","MTL",2010020272,14931,20102011,0,60,3,0,3,2.30381047960377,4.31186626898125,-2.00805578937748,30,30,0,38,41,-3,51,59,-8,3,4,0,0
"14059","NSH","CAR",2010020288,14933,20102011,0,65,1,1,0,4.4880544293407,4.58261148398742,-0.0945570546467227,27,22,5,50,34,16,60,41,19,3,3,0,0
"14060","NSH","STL",2010020316,14937,20102011,1,65,1,1,0,1.78652355546046,4.67071905836929,-2.88419550290882,30,15,15,43,30,13,61,40,21,3,3,0,0
"14061","NSH","MIN",2010020325,14939,20102011,0,60,2,5,-3,5.43128362037668,3.03809972308227,2.39318389729441,34,23,11,51,31,20,59,40,19,5,2,0,0
"14062","NSH","NYR",2010020340,14940,20102011,1,65,1,1,0,3.44208303403622,2.79684897892002,0.645234055116191,30,24,6,43,34,9,66,45,21,4,5,0,0
"14063","NSH","CAR",2010020386,14947,20102011,1,60,5,2,3,5.16847767920081,3.1707406406058,1.99773703859501,39,30,9,48,45,3,58,60,-2,1,4,0,0
"14064","NSH","ATL",2010020398,14949,20102011,0,62.1833333333333,2,3,-1,3.84246267313938,4.3927134215046,-0.550250748365215,29,37,-8,36,48,-12,47,63,-16,1,4,0,0
"14065","NSH","DET",2010020408,14951,20102011,0,60,3,2,1,2.17419983398293,3.41218908315568,-1.23798924917276,24,37,-13,30,48,-18,36,61,-25,3,4,0,0
"14066","NSH","FLA",2010020433,14954,20102011,1,60,3,0,3,1.63780160006718,3.51021875742299,-1.87241715735581,27,22,5,37,37,0,54,45,9,6,3,0,0
"14067","NSH","NYI",2010020443,14956,20102011,1,60,5,0,5,5.00493153385469,2.51863842041058,2.48629311344411,26,28,-2,39,41,-2,52,53,-1,4,3,0,0
"14068","NSH","S.J",2010020457,14958,20102011,1,60,3,2,1,5.32138479463174,3.14899259813119,2.17239219650055,35,27,8,44,41,3,59,52,7,4,4,0,0
"14069","NSH","N.J",2010020469,14960,20102011,0,60,3,1,2,1.48938788189844,1.94272364504286,-0.453335763144423,20,16,4,26,29,-3,32,42,-10,5,3,0,0
"14070","NSH","L.A",2010020481,14961,20102011,1,60,1,6,-5,3.84135118062574,4.00660398293985,-0.165252802314113,30,34,-4,38,38,0,47,50,-3,3,3,0,0
"14071","NSH","CHI",2010020505,14965,20102011,0,60,1,4,-3,0,0,0,25,35,-10,31,45,-14,50,51,-1,3,3,0,0
"14072","NSH","OTT",2010020514,14966,20102011,1,60,1,2,-1,3.09006217366418,2.94110554290673,0.148956630757455,26,30,-4,36,37,-1,49,44,5,4,5,0,0
"14073","NSH","STL",2010020525,14969,20102011,0,60,0,2,-2,3.7584012883899,4.9457866132143,-1.18738532482439,32,26,6,42,35,7,49,46,3,0,1,0,0
"14074","NSH","DAL",2010020541,14971,20102011,1,60,2,4,-2,4.94688735099044,4.33197512704646,0.614912223943975,46,25,21,52,28,24,77,36,41,7,5,0,0
"14075","NSH","MIN",2010020559,14974,20102011,0,60,4,1,3,4.49602655267608,2.07431755126163,2.42170900141446,32,23,9,47,29,18,63,45,18,1,4,0,0
"14076","NSH","ANA",2010020596,14979,20102011,0,60,4,1,3,7.00636979844421,5.60861095158566,1.39775884685855,24,41,-17,33,50,-17,41,64,-23,2,4,0,0
"14077","NSH","L.A",2010020603,14980,20102011,0,60,5,2,3,3.2790548040939,4.62365098443115,-1.34459618033725,28,26,2,42,41,1,51,51,0,3,2,0,0
"14078","NSH","S.J",2010020620,14982,20102011,0,60,2,1,1,3.77756194477843,5.65411137588671,-1.87654943110829,26,43,-17,33,59,-26,44,81,-37,0,2,0,0
"14079","NSH","MIN",2010020639,14985,20102011,1,60,5,1,4,5.44598744943505,4.56189317836706,0.884094271067994,30,26,4,37,36,1,47,47,0,2,3,0,0
"14080","NSH","FLA",2010020650,14987,20102011,0,60,2,3,-1,4.94600155521766,3.60821399548615,1.33778755973151,29,34,-5,41,42,-1,52,48,4,3,3,0,0
"14081","NSH","CHI",2010020667,14989,20102011,1,65,2,2,0,1.59738937784818,6.11505834514896,-4.51766896730078,26,33,-7,39,41,-2,52,50,2,2,2,0,0
"14082","NSH","CHI",2010020675,14990,20102011,0,60,3,6,-3,3.7389724033419,4.15034029978095,-0.411367896439046,23,34,-11,31,45,-14,49,61,-12,6,4,0,0
"14083","NSH","COL",2010020704,14994,20102011,0,60,5,1,4,0,0,0,28,33,-5,36,43,-7,50,51,-1,5,2,0,0
"14084","NSH","EDM",2010020727,14997,20102011,0,65,2,2,0,4.4812727038443,4.74920019938145,-0.267927495537151,28,24,4,43,38,5,64,51,13,5,4,0,0
"14085","NSH","CGY",2010020730,14998,20102011,0,60,1,3,-2,4.42924804541981,4.30323771201074,0.12601033340907,24,27,-3,33,42,-9,45,57,-12,5,6,0,0
"14086","NSH","VAN",2010020749,15000,20102011,0,60,1,2,-1,3.32873594936555,4.44344656422618,-1.11471061486063,27,35,-8,37,43,-6,47,62,-15,5,4,0,0
"14087","NSH","CGY",2010020760,15006,20102011,1,65,2,2,0,4.00668624997832,5.9646173218498,-1.95793107187149,27,28,-1,39,36,3,55,47,8,4,5,0,0
"14088","NSH","PHI",2010020773,15008,20102011,0,60,2,3,-1,4.38697342549676,5.50276547759557,-1.11579205209881,28,29,-1,38,38,0,49,53,-4,2,2,0,0
"14089","NSH","DET",2010020790,15010,20102011,1,60,3,0,3,2.69333767478625,7.34285525982,-4.64951758503375,29,35,-6,40,51,-11,53,61,-8,5,6,0,0
"14090","NSH","EDM",2010020798,15012,20102011,1,60,0,4,-4,4.49044486795901,3.80936169188533,0.681083176073685,37,22,15,53,30,23,70,39,31,5,2,0,0
"14091","NSH","DET",2010020809,15014,20102011,0,60,4,1,3,2.67081469116965,6.22109102677496,-3.5502763356053,30,35,-5,40,57,-17,50,77,-27,2,3,0,0
"14092","NSH","COL",2010020833,15017,20102011,1,60,5,3,2,6.86343980692243,1.87518404417422,4.98825576274821,39,18,21,57,23,34,74,35,39,3,2,0,0
"14093","NSH","S.J",2010020852,15020,20102011,1,63.8833333333333,1,2,-1,2.91143209391982,8.36863926556543,-5.45720717164562,31,50,-19,40,58,-18,51,70,-19,2,4,0,0
"14094","NSH","VAN",2010020866,15022,20102011,1,60,3,1,2,3.43028042733204,5.06236524706765,-1.63208481973561,26,36,-10,32,45,-13,45,64,-19,2,5,0,0
"14095","NSH","CHI",2010020912,15029,20102011,1,60,0,3,-3,3.22781346313423,5.50569756014738,-2.27788409701316,31,25,6,46,36,10,67,42,25,1,1,0,0
"14096","NSH","DAL",2010020924,15031,20102011,0,60,2,3,-1,1.65622914935238,2.84732858822467,-1.19109943887228,27,25,2,40,40,0,64,54,10,3,5,0,0
"14097","NSH","EDM",2010020948,15034,20102011,0,65,1,1,0,4.29935860100886,1.7870174445808,2.51234115642806,35,26,9,45,32,13,61,48,13,3,3,0,0
"14098","NSH","VAN",2010020965,15036,20102011,0,60,3,0,3,4.5795306332293,5.025957116915,-0.4464264836857,29,29,0,43,49,-6,54,61,-7,2,2,0,0
"14099","NSH","CGY",2010020987,15039,20102011,0,60,2,3,-1,3.09448985027848,5.89425776485587,-2.79976791457739,23,36,-13,31,46,-15,52,53,-1,3,3,0,0
"14100","NSH","S.J",2010021000,15041,20102011,0,63.4,2,3,-1,2.60513213415106,5.03262285611709,-2.42749072196602,25,33,-8,36,51,-15,56,71,-15,4,2,0,0
"14101","NSH","MIN",2010021012,15043,20102011,1,60,4,0,4,5.3858063466032,4.11209014654919,1.27371620005402,31,19,12,38,26,12,44,35,9,4,2,0,0
"14102","NSH","COL",2010021030,15045,20102011,1,60,4,2,2,4.77266698801031,2.90645237412245,1.86621461388787,29,38,-9,34,52,-18,47,66,-19,6,5,0,0
"14103","NSH","L.A",2010021048,15048,20102011,1,60,2,4,-2,3.11140065369885,3.78176733874716,-0.670366685048307,32,18,14,41,29,12,53,39,14,2,1,0,0
"14104","NSH","BOS",2010021060,15050,20102011,1,63.6166666666667,4,3,1,5.36702157997934,3.99132489322801,1.37569668675133,31,38,-7,39,46,-7,53,62,-9,4,2,0,0
"14105","NSH","DET",2010021075,15052,20102011,1,60,3,1,2,8.26663819476139,6.87588740168394,1.39075079307745,39,40,-1,48,62,-14,57,78,-21,2,3,0,0
"14106","NSH","EDM",2010021094,15055,20102011,1,60,3,1,2,4.80674690424061,4.29188302366799,0.514863880572619,30,20,10,36,30,6,44,42,2,3,3,0,0
"14107","NSH","ANA",2010021107,15057,20102011,1,60,5,4,1,3.48781727151263,3.89665169198997,-0.408834420477348,28,38,-10,36,43,-7,45,59,-14,3,6,0,0
"14108","NSH","DAL",2010021123,15059,20102011,1,60,4,2,2,4.86991661092907,4.55543624039274,0.31448037053633,32,30,2,42,44,-2,54,56,-2,2,4,0,0
"14109","NSH","VAN",2010021142,15062,20102011,1,60,1,3,-2,2.62923731061164,5.11979112026965,-2.49055380965801,17,32,-15,24,42,-18,31,56,-25,5,5,0,0
"14110","NSH","COL",2010021157,15064,20102011,0,60,3,2,1,4.79789446445648,4.02742918744182,0.770465277014652,34,29,5,43,43,0,55,59,-4,4,1,0,0
"14111","NSH","DET",2010021166,15066,20102011,1,62.9666666666667,3,4,-1,3.79661179834511,7.0781997199233,-3.28158792157819,34,41,-7,42,49,-7,56,58,-2,9,4,0,0
"14112","NSH","ATL",2010021190,15069,20102011,1,60,6,3,3,3.80195442768309,4.94501046975569,-1.1430560420726,24,36,-12,29,44,-15,37,62,-25,5,3,0,0
"14113","NSH","STL",2010021222,15073,20102011,0,60,0,2,-2,2.56185573661294,2.5091630188399,0.0526927177730432,24,25,-1,33,36,-3,48,46,2,1,1,0,0
"14114","NSH","ANA",2010030181,15077,20102011,0,60,4,1,3,2.67266835339507,3.01756259548711,-0.344894242092039,30,28,2,38,41,-3,55,61,-6,8,7,0,0
"14115","NSH","ANA",2010030182,15079,20102011,0,60,3,5,-2,4.62409308832139,5.90319080688641,-1.27909771856503,34,28,6,51,33,18,65,40,25,7,6,0,0
"14116","NSH","ANA",2010030183,15081,20102011,1,60,4,3,1,6.16143932813429,2.65011751980444,3.51132180832985,37,16,21,52,28,24,70,42,28,6,3,0,0
"14117","NSH","ANA",2010030184,15084,20102011,1,60,3,6,-3,2.86837577201711,4.7670366717648,-1.89866089974769,22,38,-16,32,46,-14,52,57,-5,5,5,0,0
"14118","NSH","ANA",2010030185,15086,20102011,0,61.95,4,3,1,4.95800620387308,4.94728716765083,0.0107190362222482,37,26,11,51,35,16,70,42,28,2,2,0,0
"14119","NSH","ANA",2010030186,15088,20102011,1,60,4,2,2,5.23959432651645,4.74630186179638,0.493292464720071,30,27,3,41,42,-1,56,59,-3,4,2,0,0
"14120","NSH","VAN",2010030231,15092,20102011,0,60,0,1,-1,1.96548640366018,4.06687687837672,-2.10139047471654,20,30,-10,29,38,-9,41,53,-12,5,5,0,0
"14121","NSH","VAN",2010030232,15094,20102011,0,80,1,1,0,9.60282072325936,7.59475685648795,2.00806386677141,43,26,17,57,45,12,73,64,9,3,1,0,0
"14122","NSH","VAN",2010030233,15097,20102011,1,70.75,2,3,-1,4.39922603996695,9.37734735581029,-4.97812131584333,30,47,-17,43,59,-16,56,74,-18,3,4,0,0
"14123","NSH","VAN",2010030234,15099,20102011,1,60,2,4,-2,4.00876095857529,6.28358066431247,-2.27481970573717,21,28,-7,28,35,-7,44,50,-6,4,4,0,0
"14124","NSH","VAN",2010030235,15101,20102011,0,60,4,3,1,4.68363443865383,4.25313763853046,0.430496800123365,23,34,-11,28,43,-15,45,73,-28,3,4,0,0
"14125","NSH","VAN",2010030236,15103,20102011,1,60,1,2,-1,3.99104420874898,3.27659155443525,0.714452654313729,24,19,5,32,29,3,45,39,6,6,4,0,0
"14126","NSH","STL",2011020015,15255,20112012,0,60,4,2,2,4.80953982149367,3.91443097992217,0.895108841571499,16,33,-17,22,47,-25,35,68,-33,4,5,0,0
"14127","NSH","N.J",2011020057,15262,20112012,1,65,2,2,0,5.21899507346097,5.95352529287811,-0.734530219417138,31,41,-10,38,51,-13,48,67,-19,3,8,0,0
"14128","NSH","EDM",2011020067,15264,20112012,0,60,1,3,-2,1.16769058574573,5.50774803815875,-4.34005745241302,12,25,-13,19,38,-19,27,54,-27,5,5,0,0
"14129","NSH","VAN",2011020089,15267,20112012,0,60,1,5,-4,4.88049810642951,7.02438202789585,-2.14388392146634,26,40,-14,38,57,-19,56,69,-13,4,9,0,0
"14130","NSH","CGY",2011020095,15269,20112012,0,60,2,0,2,3.84144701319747,5.63177782432467,-1.79033081112721,14,33,-19,26,50,-24,36,69,-33,3,4,0,0
"14131","NSH","S.J",2011020117,15272,20112012,1,60,1,3,-2,1.23340058790964,5.87229631576287,-4.63889572785323,20,36,-16,28,43,-15,45,57,-12,4,2,0,0
"14132","NSH","T.B",2011020131,15274,20112012,1,60,5,3,2,1.90717789103655,7.00043892976828,-5.09326103873173,27,32,-5,36,44,-8,46,62,-16,4,3,0,0
"14133","NSH","ANA",2011020147,15276,20112012,1,60,3,0,3,4.48165696975775,3.50483819062356,0.976818779134192,29,20,9,39,31,8,55,45,10,6,3,0,0
"14134","NSH","CHI",2011020159,15278,20112012,0,62.3,4,5,-1,2.21140247528187,7.29615351994289,-5.08475104466102,28,35,-7,33,56,-23,38,74,-36,4,8,0,0
"14135","NSH","S.J",2011020194,15283,20112012,0,62.8833333333333,4,3,1,6.02499287724813,6.61248511241865,-0.58749223517052,35,38,-3,44,50,-6,55,69,-14,3,4,0,0
"14136","NSH","L.A",2011020210,15286,20112012,0,60,3,4,-1,2.47167951814944,4.66680709112552,-2.19512757297608,30,30,0,40,45,-5,55,54,1,7,7,0,0
"14137","NSH","ANA",2011020213,15287,20112012,0,60,4,2,2,1.25474548559083,3.08527661378935,-1.83053112819852,32,33,-1,40,51,-11,46,71,-25,4,5,0,0
"14138","NSH","MTL",2011020235,15290,20112012,1,62.5166666666667,1,2,-1,3.15809101412957,4.76014657935593,-1.60205556522636,26,25,1,34,36,-2,50,46,4,5,4,0,0
"14139","NSH","TOR",2011020265,15295,20112012,1,60,4,1,3,5.31634554523043,3.32179083501773,1.99455471021271,22,39,-17,33,50,-17,41,68,-27,3,2,0,0
"14140","NSH","EDM",2011020299,15300,20112012,1,60,2,6,-4,2.9138727906975,4.12099170664442,-1.20711891594692,32,32,0,49,37,12,54,43,11,6,4,0,0
"14141","NSH","MIN",2011020308,15301,20112012,0,60,2,3,-1,2.89121318748221,2.82001361696257,0.0711995705196387,25,30,-5,37,44,-7,48,60,-12,7,6,0,0
"14142","NSH","DET",2011020333,15304,20112012,0,60,1,4,-3,3.43478846963262,6.8276939651696,-3.39290549553698,19,37,-18,26,50,-24,33,60,-27,3,2,0,0
"14143","NSH","EDM",2011020343,15306,20112012,0,60,2,1,1,4.07259398986935,1.64111573953414,2.4314782503352,31,18,13,45,25,20,66,41,25,2,5,0,0
"14144","NSH","CGY",2011020351,15307,20112012,0,60,0,1,-1,2.70693107723491,1.86147861368954,0.845452463545371,26,29,-3,39,37,2,51,53,-2,3,2,0,0
"14145","NSH","VAN",2011020363,15309,20112012,0,60,6,5,1,4.63295330747496,4.60655474977102,0.0263985577039421,20,37,-17,25,60,-35,37,81,-44,3,4,0,0
"14146","NSH","ANA",2011020429,15318,20112012,1,60,3,2,1,3.29300756014709,2.73318934446434,0.559818215682753,28,17,11,42,23,19,54,35,19,4,2,0,0
"14147","NSH","CGY",2011020445,15321,20112012,1,60,2,1,1,5.25237490822474,5.83466259785928,-0.582287689634541,45,36,9,51,46,5,63,60,3,3,1,0,0
"14148","NSH","DET",2011020457,15323,20112012,1,60,4,3,1,2.42334311141167,7.03535039253711,-4.61200728112544,21,40,-19,31,50,-19,40,67,-27,1,2,0,0
"14149","NSH","STL",2011020473,15325,20112012,1,65,1,1,0,3.85459798457975,9.07598913370748,-5.22139114912773,20,40,-20,30,54,-24,40,77,-37,1,6,0,0
"14150","NSH","CBJ",2011020503,15330,20112012,1,60,6,5,1,5.79950176319107,5.81957975763362,-0.0200779944425449,38,31,7,46,43,3,54,54,0,4,3,0,0
"14151","NSH","DAL",2011020514,15331,20112012,0,60,3,6,-3,4.55151636343208,3.60657707151404,0.944939291918041,37,29,8,48,43,5,61,62,-1,5,3,0,0
"14152","NSH","DET",2011020524,15334,20112012,1,60,1,4,-3,4.96445582769229,2.38747628224307,2.57697954544922,32,22,10,44,30,14,57,39,18,5,2,0,0
"14153","NSH","MIN",2011020538,15336,20112012,1,65,1,1,0,3.72719857377433,6.61423793990616,-2.88703936613183,25,35,-10,37,53,-16,54,65,-11,3,2,0,0
"14154","NSH","STL",2011020554,15338,20112012,0,65,1,1,0,5.76580212400586,4.40650768180058,1.35929444220528,34,36,-2,43,50,-7,55,65,-10,2,4,0,0
"14155","NSH","CGY",2011020568,15340,20112012,1,60,5,3,2,4.68374746956397,3.46216831612401,1.22157915343996,27,20,7,34,30,4,43,41,2,3,2,0,0
"14156","NSH","DAL",2011020590,15344,20112012,1,60,1,4,-3,3.57917735905409,5.43847715412267,-1.85929979506858,25,30,-5,37,43,-6,50,57,-7,4,5,0,0
"14157","NSH","CAR",2011020607,15346,20112012,1,60,5,2,3,4.72807879408538,1.85695497506829,2.87112381901709,36,29,7,42,34,8,53,47,6,5,2,0,0
"14158","NSH","COL",2011020626,15349,20112012,0,60,4,1,3,0,0,0,26,33,-7,38,42,-4,50,60,-10,3,3,0,0
"14159","NSH","COL",2011020637,15351,20112012,1,60.5666666666667,3,2,1,6.32334500433353,2.83571413757545,3.48763086675808,35,29,6,50,33,17,68,46,22,6,2,0,0
"14160","NSH","PHI",2011020656,15353,20112012,1,60,4,2,2,2.78340989269782,3.44715128957523,-0.663741396877413,25,38,-13,34,48,-14,42,66,-24,3,2,0,0
"14161","NSH","NYI",2011020664,15355,20112012,0,60,3,1,2,4.46216039397405,4.64376124930482,-0.181600855330771,32,37,-5,42,46,-4,51,65,-14,1,3,0,0
"14162","NSH","NYR",2011020672,15356,20112012,0,60,0,3,-3,4.67554458853556,4.71177870736392,-0.0362341188283608,27,29,-2,38,42,-4,56,49,7,2,2,0,0
"14163","NSH","CBJ",2011020689,15358,20112012,0,60,3,0,3,5.20876889699139,6.9495301230927,-1.74076122610131,25,38,-13,29,51,-22,38,64,-26,2,3,0,0
"14164","NSH","CHI",2011020708,15360,20112012,1,60,5,2,3,3.2034828569158,5.40186340361834,-2.19838054670254,23,22,1,36,41,-5,48,55,-7,2,1,0,0
"14165","NSH","CBJ",2011020719,15362,20112012,1,60,4,1,3,2.43098788143834,5.57242594003765,-3.14143805859931,29,26,3,36,36,0,48,51,-3,5,2,0,0
"14166","NSH","CHI",2011020729,15363,20112012,0,60,3,1,2,2.56810882900066,3.74684553670522,-1.17873670770456,26,25,1,35,39,-4,42,63,-21,3,4,0,0
"14167","NSH","MIN",2011020743,15370,20112012,0,60,5,4,1,5.74338616192108,4.86509350361302,0.878292658308055,30,25,5,42,38,4,58,50,8,2,2,0,0
"14168","NSH","PHI",2011020756,15372,20112012,0,60,1,4,-3,4.0900912584366,4.95858639001381,-0.868495131577204,27,28,-1,40,45,-5,55,57,-2,6,5,0,0
"14169","NSH","STL",2011020775,15374,20112012,1,60,3,1,2,5.18103821054683,5.54657527586096,-0.365537065314129,37,43,-6,47,55,-8,58,74,-16,2,2,0,0
"14170","NSH","VAN",2011020793,15377,20112012,1,65,3,3,0,4.98028856088058,5.48153171781451,-0.501243156933924,40,31,9,52,44,8,63,57,6,4,1,0,0
"14171","NSH","OTT",2011020807,15379,20112012,0,60,3,4,-1,3.72474694333312,4.38058623081105,-0.655839287477927,27,29,-2,36,44,-8,55,67,-12,5,6,0,0
"14172","NSH","BOS",2011020816,15381,20112012,0,65,3,3,0,2.61458736492904,4.6073891511478,-1.99280178621876,22,41,-19,29,54,-25,38,83,-45,3,4,0,0
"14173","NSH","CHI",2011020842,15384,20112012,1,60,3,2,1,3.10378663346637,5.20559550234049,-2.10180886887412,19,32,-13,33,43,-10,45,59,-14,3,3,0,0
"14174","NSH","DET",2011020862,15387,20112012,0,60,1,2,-1,1.82372623444826,1.89481498580426,-0.071088751356001,21,31,-10,29,36,-7,36,45,-9,2,1,0,0
"14175","NSH","DAL",2011020880,15389,20112012,0,60,3,2,1,4.21646439174401,5.82069277790288,-1.60422838615887,21,24,-3,29,41,-12,41,63,-22,2,1,0,0
"14176","NSH","VAN",2011020891,15391,20112012,1,60,3,1,2,2.92300768254063,3.6436054870901,-0.72059780454947,28,33,-5,32,42,-10,41,58,-17,4,3,0,0
"14177","NSH","STL",2011020903,15393,20112012,1,65,2,2,0,6.20175381971058,3.42255748502794,2.77919633468264,27,24,3,40,29,11,61,43,18,1,1,0,0
"14178","NSH","S.J",2011020923,15395,20112012,1,60,6,2,4,5.453219121031,3.3490951963322,2.1041239246988,21,34,-13,29,45,-16,40,56,-16,4,3,0,0
"14179","NSH","L.A",2011020933,15397,20112012,1,60,2,1,1,5.52796302567003,7.9960854633191,-2.46812243764907,28,31,-3,34,52,-18,43,69,-26,1,1,0,0
"14180","NSH","CAR",2011020940,15398,20112012,0,60,3,4,-1,3.5789316106675,6.16575461528555,-2.58682300461805,29,33,-4,39,48,-9,51,60,-9,1,6,0,0
"14181","NSH","FLA",2011020968,15402,20112012,0,60,3,1,2,2.74357365227971,5.39175464672735,-2.64818099444764,23,40,-17,32,49,-17,43,58,-15,1,3,0,0
"14182","NSH","L.A",2011020991,15405,20112012,1,60,4,5,-1,2.93391951115336,5.75313722087502,-2.81921770972166,26,28,-2,36,39,-3,46,48,-2,4,2,0,0
"14183","NSH","COL",2011021005,15407,20112012,1,60,4,2,2,3.79827577807009,2.18245417789149,1.61582160017861,31,17,14,38,28,10,54,40,14,3,1,0,0
"14184","NSH","DET",2011021021,15409,20112012,1,60,3,2,1,1.89741858629156,7.30063858124322,-5.40321999495166,20,37,-17,27,47,-20,38,63,-25,4,4,0,0
"14185","NSH","ARI",2011021036,15411,20112012,0,65,4,4,0,4.12464363785693,5.09785981148087,-0.973216173623939,35,35,0,45,52,-7,58,66,-8,3,1,0,0
"14186","NSH","S.J",2011021059,15414,20112012,0,65,1,1,0,5.31089020304103,6.81291929193821,-1.50202908889719,33,35,-2,44,52,-8,57,78,-21,3,5,0,0
"14187","NSH","L.A",2011021074,15416,20112012,0,60,2,4,-2,3.61095764732454,2.42831497310544,1.1826426742191,21,27,-6,30,37,-7,38,48,-10,3,3,0,0
"14188","NSH","ANA",2011021080,15417,20112012,0,60,3,1,2,3.89045366036589,4.55615864241181,-0.665704982045921,27,31,-4,41,42,-1,50,54,-4,4,1,0,0
"14189","NSH","EDM",2011021093,15419,20112012,1,60,3,6,-3,5.08062765980577,3.08984508023225,1.99078257957352,44,20,24,55,25,30,71,28,43,5,2,0,0
"14190","NSH","WPG",2011021124,15423,20112012,1,60,3,1,2,4.47633627749747,3.23941811668919,1.23691816080827,28,25,3,47,37,10,59,54,5,4,1,0,0
"14191","NSH","CHI",2011021131,15424,20112012,0,60,6,1,5,4.80155507331801,3.1111527635984,1.69040230971962,24,25,-1,30,36,-6,41,61,-20,2,4,0,0
"14192","NSH","STL",2011021146,15426,20112012,0,60,0,3,-3,2.95913049281808,2.26441093666654,0.69471955615154,24,24,0,30,37,-7,48,55,-7,1,1,0,0
"14193","NSH","DET",2011021165,15429,20112012,0,60,4,1,3,4.78364812479765,4.32877768011531,0.454870444682342,27,32,-5,38,47,-9,47,61,-14,2,3,0,0
"14194","NSH","CHI",2011021176,15430,20112012,1,60,4,5,-1,3.26903566162036,4.23890889089671,-0.969873229276345,33,37,-4,37,42,-5,51,50,1,4,6,0,0
"14195","NSH","MIN",2011021195,15433,20112012,1,65,1,1,0,2.2813802073797,4.8983680876263,-2.6169878802466,24,26,-2,37,39,-2,45,52,-7,3,6,0,0
"14196","NSH","DAL",2011021209,15435,20112012,1,60,2,0,2,3.62406142638065,3.48335051828053,0.140710908100118,31,28,3,38,36,2,48,59,-11,2,4,0,0
"14197","NSH","COL",2011021228,15437,20112012,0,60,6,1,5,4.16001216755831,5.98278185920961,-1.8227696916513,29,45,-16,40,59,-19,48,71,-23,2,2,0,0
"14198","NSH","DET",2011030181,15441,20112012,1,60,3,2,1,3.35740348135346,5.5301871207588,-2.17278363940535,26,37,-11,35,45,-10,45,61,-16,7,10,0,0
"14199","NSH","DET",2011030182,15443,20112012,1,60,2,3,-1,5.28887961208238,1.09769769327249,4.19118191880989,26,17,9,40,26,14,56,36,20,6,2,0,0
"14200","NSH","DET",2011030183,15445,20112012,0,60,3,2,1,3.32255643705139,6.08259546640329,-2.7600390293519,22,43,-21,32,58,-26,41,77,-36,6,6,0,0
"14201","NSH","DET",2011030184,15447,20112012,0,60,3,1,2,0.952909150425597,5.7990997107845,-4.84619056035891,17,41,-24,21,58,-37,29,74,-45,3,7,0,0
"14202","NSH","DET",2011030185,15450,20112012,1,60,2,1,1,3.40020255069248,5.27866835979512,-1.87846580910264,25,22,3,35,36,-1,52,48,4,3,2,0,0
"14203","NSH","ARI",2011030241,15457,20112012,0,74.0666666666667,3,4,-1,6.7151508947054,4.76569171634037,1.94945917836503,42,24,18,67,37,30,82,52,30,5,3,0,0
"14204","NSH","ARI",2011030242,15459,20112012,0,60,3,5,-2,4.61826420575993,5.81006407178938,-1.19179986602946,33,39,-6,50,50,0,57,70,-13,4,4,0,0
"14205","NSH","ARI",2011030243,15462,20112012,1,60,2,0,2,4.3273730649337,7.96947080827393,-3.64209774334023,26,32,-6,36,45,-9,45,60,-15,5,4,0,0
"14206","NSH","ARI",2011030244,15464,20112012,1,60,0,1,-1,5.51426213033847,4.31654245965819,1.19771967068027,25,24,1,39,37,2,55,52,3,3,2,0,0
"14207","NSH","ARI",2011030245,15467,20112012,0,60,1,2,-1,4.85061804112047,2.61618655550064,2.23443148561983,33,17,16,56,26,30,73,40,33,4,1,0,0
"14208","NSH","CBJ",2012020010,15724,20122013,1,65,2,2,0,5.28930123167811,5.76422181216185,-0.47492058048374,34,28,6,46,39,7,58,48,10,2,4,0,0
"14209","NSH","STL",2012020022,15726,20122013,1,65,3,3,0,3.88821421826651,5.63951741065179,-1.75130319238528,24,39,-15,35,55,-20,42,71,-29,8,4,0,0
"14210","NSH","MIN",2012020032,15727,20122013,0,60,3,1,2,2.95668439994915,4.27484673855361,-1.31816233860445,26,30,-4,35,37,-2,43,52,-9,5,5,0,0
"14211","NSH","STL",2012020045,15729,20122013,0,60,0,3,-3,1.33672274873334,1.76839094317984,-0.431668194446502,13,24,-11,21,28,-7,34,41,-7,4,5,0,0
"14212","NSH","ANA",2012020064,15731,20122013,0,65,2,2,0,3.9927824519109,3.12746730668005,0.865315145230852,21,22,-1,35,37,-2,47,54,-7,3,4,0,0
"14213","NSH","ARI",2012020075,15733,20122013,0,60,0,4,-4,4.66880574979587,4.38366244017379,0.285143309622072,21,25,-4,37,39,-2,47,52,-5,3,5,0,0
"14214","NSH","L.A",2012020099,15736,20122013,0,65,1,1,0,2.9320808032644,4.50125162419863,-1.56917082093423,14,24,-10,23,43,-20,31,67,-36,3,6,0,0
"14215","NSH","S.J",2012020118,15738,20122013,0,65,1,1,0,3.3344493131608,4.3128862711601,-0.978436957999293,24,27,-3,35,37,-2,53,54,-1,5,5,0,0
"14216","NSH","STL",2012020136,15741,20122013,0,60,6,1,5,3.9950651958352,4.21791157594998,-0.222846380114788,19,32,-13,30,40,-10,36,58,-22,4,7,0,0
"14217","NSH","L.A",2012020150,15743,20122013,1,60,3,0,3,1.64197251130827,6.5387399099709,-4.89676739866263,14,32,-18,18,43,-25,23,62,-39,3,3,0,0
"14218","NSH","MIN",2012020164,15745,20122013,0,64.35,1,2,-1,0,0,0,26,32,-6,32,44,-12,39,60,-21,7,6,0,0
"14219","NSH","CHI",2012020171,15746,20122013,1,60,0,3,-3,1.71848042774945,2.97505859819648,-1.25657817044703,17,27,-10,27,36,-9,41,50,-9,1,2,0,0
"14220","NSH","S.J",2012020184,15748,20122013,1,62.1333333333333,1,0,1,3.04381799615484,4.83136184554314,-1.7875438493883,25,25,0,34,37,-3,48,55,-7,3,5,0,0
"14221","NSH","ARI",2012020195,15750,20122013,1,60,3,0,3,6.01197579348809,4.85764259626512,1.15433319722298,29,19,10,36,29,7,52,48,4,2,4,0,0
"14222","NSH","ANA",2012020209,15752,20122013,1,65,2,2,0,4.17786876825267,2.36854840986324,1.80932035838942,34,22,12,46,34,12,62,51,11,5,2,0,0
"14223","NSH","COL",2012020221,15754,20122013,0,60,5,6,-1,7.64018891676096,2.55570779420668,5.08448112255428,38,28,10,56,32,24,83,41,42,5,2,0,0
"14224","NSH","DET",2012020231,15755,20122013,1,60.7333333333333,4,3,1,5.91815931913607,4.45617282453895,1.46198649459711,25,29,-4,38,46,-8,47,61,-14,6,2,0,0
"14225","NSH","VAN",2012020248,15758,20122013,1,60,0,1,-1,2.67270524552441,5.92312096047681,-3.2504157149524,23,24,-1,28,40,-12,40,58,-18,2,2,0,0
"14226","NSH","DET",2012020258,15759,20122013,0,60,0,4,-4,4.09474215416049,3.84858580020955,0.246156353950937,33,27,6,45,34,11,57,42,15,2,2,0,0
"14227","NSH","DAL",2012020272,15761,20122013,1,60.4666666666667,5,4,1,4.80145320785232,2.40158023004551,2.39987297780681,31,24,7,36,33,3,46,53,-7,5,4,0,0
"14228","NSH","ANA",2012020286,15763,20122013,0,60,1,5,-4,5.08455081015767,4.19831164773859,0.886239162419077,21,28,-7,27,44,-17,38,57,-19,3,4,0,0
"14229","NSH","S.J",2012020310,15766,20122013,0,60,1,2,-1,3.24737164381077,4.99644700373756,-1.74907535992679,19,39,-20,26,50,-24,52,68,-16,1,4,0,0
"14230","NSH","L.A",2012020323,15768,20122013,0,60,1,5,-4,3.0819978652471,2.66768381285169,0.414314052395412,19,16,3,28,33,-5,35,47,-12,3,4,0,0
"14231","NSH","EDM",2012020352,15772,20122013,1,60,6,0,6,4.94065827078884,4.80524290437825,0.135415366410598,34,24,10,49,31,18,62,38,24,5,1,0,0
"14232","NSH","MIN",2012020362,15773,20122013,1,65,1,1,0,4.9689457131899,5.29754645875073,-0.328600745560834,25,29,-4,35,44,-9,45,56,-11,3,6,0,0
"14233","NSH","DAL",2012020385,15776,20122013,0,60,4,0,4,2.05571952310856,3.55800067956778,-1.50228115645922,21,32,-11,28,50,-22,42,72,-30,6,5,0,0
"14234","NSH","VAN",2012020400,15778,20122013,0,60,4,7,-3,4.40413652693678,5.17383252368745,-0.76969599675067,33,22,11,42,36,6,50,46,4,4,3,0,0
"14235","NSH","CGY",2012020403,15779,20122013,0,60,3,6,-3,3.5630258298479,3.49547463061754,0.0675511992303655,20,22,-2,31,36,-5,44,52,-8,2,3,0,0
"14236","NSH","EDM",2012020421,15781,20122013,0,60,2,3,-1,3.91019249064947,1.84055147925392,2.06964101139555,31,21,10,48,26,22,63,39,24,4,2,0,0
"14237","NSH","CBJ",2012020432,15783,20122013,0,60,3,4,-1,4.70221927927923,2.85959048895165,1.84262879032758,35,31,4,43,33,10,50,46,4,1,3,0,0
"14238","NSH","CGY",2012020449,15785,20122013,1,60,5,3,2,4.17504635191062,3.5640790415855,0.610967310325123,23,22,1,35,34,1,49,54,-5,4,4,0,0
"14239","NSH","CBJ",2012020462,15787,20122013,1,60,5,2,3,3.78550795831688,3.44786624638073,0.337641711936158,24,23,1,31,30,1,42,44,-2,2,2,0,0
"14240","NSH","EDM",2012020475,15789,20122013,1,60,3,2,1,2.10817454050266,7.11155446921475,-5.00337992871209,26,26,0,30,33,-3,43,48,-5,2,4,0,0
"14241","NSH","ARI",2012020498,15792,20122013,1,60,4,7,-3,5.67112850252306,7.93772204092238,-2.26659353839932,38,29,9,51,37,14,59,43,16,5,3,0,0
"14242","NSH","COL",2012020509,15794,20122013,0,60.8333333333333,0,1,-1,6.44599114364246,5.68718870470184,0.75880243894062,34,24,10,50,39,11,68,56,12,5,1,0,0
"14243","NSH","CHI",2012020527,15796,20122013,0,65,2,2,0,3.20678107421554,4.0139800308616,-0.807198956646062,27,40,-13,31,51,-20,44,68,-24,2,3,0,0
"14244","NSH","COL",2012020536,15797,20122013,1,60,3,1,2,7.62296313807019,5.03642671022681,2.58653642784338,38,26,12,50,36,14,64,52,12,4,3,0,0
"14245","NSH","CBJ",2012020548,15799,20122013,1,60,1,3,-2,4.06232281589473,4.19388369788601,-0.131560881991277,39,38,1,45,50,-5,58,68,-10,3,3,0,0
"14246","NSH","CHI",2012020560,15801,20122013,1,60,0,1,-1,3.39834657055326,4.89665206199288,-1.49830549143962,20,30,-10,31,41,-10,44,58,-14,2,1,0,0
"14247","NSH","CHI",2012020574,15802,20122013,0,60,3,5,-2,1.49510737578385,5.54008015527506,-4.04497277949122,22,40,-18,26,47,-21,37,65,-28,1,1,0,0
"14248","NSH","STL",2012020588,15804,20122013,1,60,0,1,-1,3.53041061857948,5.34882307014777,-1.81841245156829,15,26,-11,21,37,-16,30,53,-23,0,1,0,0
"14249","NSH","DAL",2012020607,15807,20122013,1,60,2,5,-3,3.56998087879037,2.76203791542503,0.807942963365349,28,18,10,37,26,11,55,31,24,3,2,0,0
"14250","NSH","DET",2012020623,15809,20122013,1,60,0,3,-3,3.95589778451399,5.20321059493123,-1.24731281041724,22,32,-10,30,48,-18,41,70,-29,2,2,0,0
"14251","NSH","VAN",2012020628,15810,20122013,1,60,2,5,-3,4.28149925562168,3.68623913942417,0.595260116197511,38,24,14,48,33,15,59,38,21,4,6,0,0
"14252","NSH","CHI",2012020657,15814,20122013,0,60.8666666666667,4,5,-1,2.43136173475068,2.52696664972553,-0.0956049149748486,27,30,-3,32,46,-14,40,59,-19,3,2,0,0
"14253","NSH","CGY",2012020687,15818,20122013,1,60,4,3,1,3.87877329144249,2.43128055028501,1.44749274115748,32,18,14,51,29,22,69,35,34,4,2,0,0
"14254","NSH","DET",2012020699,15820,20122013,0,60,2,5,-3,5.70336810988374,4.28437328433633,1.41899482554741,22,38,-16,30,52,-22,34,65,-31,5,4,0,0
"14255","NSH","CBJ",2012020713,15822,20122013,0,60,1,3,-2,3.87124017995666,8.1798214110313,-4.30858123107464,20,47,-27,29,61,-32,38,73,-35,1,3,0,0
"14256","NSH","STL",2013020010,15981,20132014,0,60,2,4,-2,2.28155290423956,4.06920539485873,-1.78765249061917,30,28,2,41,37,4,56,44,12,5,4,0,0
"14257","NSH","COL",2013020020,15982,20132014,0,60,1,3,-2,4.37805755734361,4.67782778330138,-0.299770225957767,27,36,-9,37,45,-8,48,59,-11,6,8,0,0
"14258","NSH","MIN",2013020042,15986,20132014,1,60,3,2,1,4.72995654195159,5.9558455053193,-1.22588896336771,25,34,-9,36,45,-9,42,57,-15,6,6,0,0
"14259","NSH","TOR",2013020053,15988,20132014,1,60,0,4,-4,4.22146761999102,3.71971027713153,0.501757342859491,36,26,10,44,34,10,56,47,9,3,1,0,0
"14260","NSH","NYI",2013020071,15990,20132014,1,60,3,2,1,4.33884467293592,2.02058658888564,2.31825808405029,31,16,15,43,23,20,60,40,20,2,2,0,0
"14261","NSH","FLA",2013020090,15993,20132014,1,60,4,3,1,3.34451011742931,3.96682615492318,-0.622316037493874,30,25,5,39,40,-1,50,52,-2,2,1,0,0
"14262","NSH","L.A",2013020105,15995,20132014,1,65,1,1,0,2.72036570264027,5.55295375032105,-2.83258804768079,35,30,5,45,39,6,61,56,5,4,4,0,0
"14263","NSH","MTL",2013020113,15997,20132014,0,60,2,1,1,6.17541814331548,3.80121195179913,2.37420619151635,37,29,8,49,36,13,59,54,5,7,6,0,0
"14264","NSH","WPG",2013020124,15998,20132014,0,60,3,1,2,2.50558603559585,7.24820455600275,-4.7426185204069,26,39,-13,34,50,-16,38,68,-30,3,3,0,0
"14265","NSH","MIN",2013020134,16000,20132014,0,60,0,2,-2,4.09432717059826,5.55702074593864,-1.46269357534038,16,29,-13,27,49,-22,46,70,-24,2,2,0,0
"14266","NSH","WPG",2013020144,16002,20132014,1,64.7166666666667,3,2,1,4.21399608990259,5.89871698641218,-1.68472089650959,33,36,-3,41,48,-7,51,69,-18,2,4,0,0
"14267","NSH","STL",2013020163,16004,20132014,1,60,1,6,-5,2.82351219241536,3.54427743023723,-0.720765237821865,23,30,-7,34,47,-13,45,56,-11,5,7,0,0
"14268","NSH","ARI",2013020190,16009,20132014,0,65,4,4,0,6.54866675671656,5.29848069203078,1.25018606468578,40,25,15,57,40,17,70,58,12,2,2,0,0
"14269","NSH","L.A",2013020200,16011,20132014,0,60,4,3,1,3.40025699371472,7.95475142737268,-4.55449443365796,17,38,-21,27,56,-29,35,78,-43,4,4,0,0
"14270","NSH","COL",2013020228,16015,20132014,0,60,6,4,2,2.92522322630975,4.98904797923387,-2.06382475292412,28,31,-3,39,45,-6,55,59,-4,3,3,0,0
"14271","NSH","WPG",2013020242,16017,20132014,0,60,0,5,-5,6.51192465815984,5.01237659927256,1.49954805888729,41,32,9,54,49,5,71,62,9,6,5,0,0
"14272","NSH","N.J",2013020256,16019,20132014,0,60,0,5,-5,1.47732196480501,1.83354210798461,-0.356220143179598,15,23,-8,19,27,-8,22,36,-14,6,4,0,0
"14273","NSH","NYI",2013020264,16021,20132014,0,60,1,3,-2,3.1598381195023,6.66626607247025,-3.50642795296795,33,33,0,41,50,-9,57,77,-20,2,5,0,0
"14274","NSH","CHI",2013020299,16025,20132014,1,60,7,2,5,2.86841936000565,6.22923409019131,-3.36081473018567,30,41,-11,37,60,-23,44,76,-32,5,4,0,0
"14275","NSH","DET",2013020316,16028,20132014,0,60,2,0,2,4.22850034335943,2.61014134934279,1.61835899401664,25,27,-2,36,34,2,46,49,-3,6,3,0,0
"14276","NSH","TOR",2013020327,16030,20132014,0,60,4,2,2,3.77487330528675,5.43974439322483,-1.66487108793808,28,26,2,41,44,-3,53,54,-1,3,2,0,0
"14277","NSH","NYR",2013020348,16032,20132014,1,60,0,2,-2,2.89732966237803,3.7465651697421,-0.849235507364071,17,34,-17,30,47,-17,35,56,-21,2,3,0,0
"14278","NSH","ARI",2013020361,16034,20132014,1,60,4,2,2,4.98885575972963,6.51199737389106,-1.52314161416143,29,31,-2,36,42,-6,45,56,-11,0,1,0,0
"14279","NSH","CBJ",2013020369,16036,20132014,0,60,4,0,4,2.07061567764049,1.42204208404291,0.648573593597575,29,19,10,33,26,7,43,40,3,3,2,0,0
"14280","NSH","EDM",2013020379,16037,20132014,1,60,0,3,-3,8.19870552855355,4.70396875096594,3.4947367775876,33,28,5,46,40,6,54,58,-4,4,5,0,0
"14281","NSH","PHI",2013020398,16039,20132014,1,65,2,2,0,4.50209488722612,3.40798088978806,1.09411399743806,36,24,12,46,38,8,59,49,10,5,3,0,0
"14282","NSH","VAN",2013020416,16042,20132014,1,60,1,3,-2,5.01549790974241,5.18740501895081,-0.171907109208405,31,33,-2,36,43,-7,44,61,-17,3,5,0,0
"14283","NSH","CAR",2013020429,16044,20132014,1,60,2,5,-3,3.47319165658996,6.09520075356022,-2.62200909697026,22,23,-1,31,40,-9,39,65,-26,5,6,0,0
"14284","NSH","NYR",2013020463,16049,20132014,0,60,4,1,3,5.89397619030206,4.0516041281353,1.84237206216676,26,29,-3,36,38,-2,56,62,-6,2,2,0,0
"14285","NSH","DAL",2013020478,16051,20132014,1,60,3,1,2,3.35771631685202,4.45759917574469,-1.09988285889267,30,34,-4,34,46,-12,42,69,-27,3,3,0,0
"14286","NSH","S.J",2013020495,16053,20132014,1,60,3,2,1,3.92659467831254,5.51660785195418,-1.59001317364164,23,38,-15,28,47,-19,38,59,-21,2,2,0,0
"14287","NSH","CHI",2013020517,16056,20132014,1,60,1,3,-2,2.80085935836541,3.09348804805643,-0.292628689691014,28,27,1,33,33,0,52,46,6,6,5,0,0
"14288","NSH","T.B",2013020529,16058,20132014,0,60,2,4,-2,3.55074407435899,4.68823401336704,-1.13748993900805,30,33,-3,43,44,-1,51,61,-10,5,4,0,0
"14289","NSH","MTL",2013020548,16060,20132014,1,61.7166666666667,3,4,-1,7.38033707617433,3.12277081444336,4.25756626173097,34,23,11,47,34,13,61,42,19,2,2,0,0
"14290","NSH","BOS",2013020562,16062,20132014,1,60,2,6,-4,5.77664365933742,5.44317022687756,0.333473432459868,34,33,1,43,43,0,62,50,12,2,3,0,0
"14291","NSH","DAL",2013020574,16066,20132014,0,60,1,4,-3,5.0065857999426,3.57257633961854,1.43400946032407,34,34,0,53,51,2,70,65,5,6,7,0,0
"14292","NSH","L.A",2013020582,16067,20132014,1,60,3,2,1,5.34446298889816,2.31831001353692,3.02615297536124,31,28,3,42,41,1,51,60,-9,5,2,0,0
"14293","NSH","DET",2013020597,16069,20132014,1,60,6,4,2,3.47932206920814,3.39311587907423,0.0862061901339075,29,25,4,41,39,2,51,55,-4,4,2,0,0
"14294","NSH","BOS",2013020612,16072,20132014,0,60.9,2,3,-1,3.93713695307068,4.07794202373004,-0.140805070659354,35,25,10,39,41,-2,50,64,-14,1,2,0,0
"14295","NSH","FLA",2013020631,16074,20132014,0,65,4,4,0,5.92534083360806,3.64441103869467,2.28092979491339,42,29,13,48,47,1,53,55,-2,2,2,0,0
"14296","NSH","CAR",2013020639,16075,20132014,0,60,1,2,-1,0,0,0,32,25,7,55,36,19,68,55,13,2,2,0,0
"14297","NSH","S.J",2013020650,16077,20132014,1,60,3,2,1,3.74613002274446,4.32094942973345,-0.574819406988986,28,28,0,41,40,1,48,60,-12,2,5,0,0
"14298","NSH","ANA",2013020664,16079,20132014,1,60,3,4,-1,5.41785501892446,3.45481389865745,1.96304112026701,26,28,-2,36,41,-5,47,57,-10,3,4,0,0
"14299","NSH","OTT",2013020678,16081,20132014,1,65,1,1,0,5.32892797962815,5.33298356566229,-0.00405558603414136,33,21,12,49,38,11,61,55,6,3,2,0,0
"14300","NSH","MIN",2013020690,16082,20132014,1,60,0,4,-4,6.32177684609633,6.35787073144456,-0.0360938853482367,23,23,0,37,33,4,58,39,19,2,1,0,0
"14301","NSH","CGY",2013020704,16084,20132014,1,60,4,2,2,4.18377635584329,1.85629617681224,2.32748017903106,34,24,10,45,36,9,60,50,10,5,3,0,0
"14302","NSH","PHI",2013020711,16086,20132014,0,65,3,3,0,5.76689409831777,3.44887075662336,2.31802334169441,37,30,7,45,39,6,60,59,1,4,4,0,0
"14303","NSH","COL",2013020732,16088,20132014,1,60,4,5,-1,5.83841216246947,6.65210923594125,-0.813697073471786,31,29,2,44,35,9,61,42,19,4,1,0,0
"14304","NSH","DAL",2013020743,16090,20132014,1,60,4,1,3,3.09643077524015,8.12326984629181,-5.02683907105165,23,36,-13,30,50,-20,44,63,-19,2,2,0,0
"14305","NSH","VAN",2013020766,16093,20132014,0,60,2,1,1,3.37428059032932,2.18539843552753,1.18888215480179,26,34,-8,34,45,-11,45,64,-19,3,4,0,0
"14306","NSH","CGY",2013020773,16094,20132014,0,65,4,4,0,4.35507904531005,3.77977987704799,0.575299168262063,25,31,-6,40,41,-1,50,56,-6,2,5,0,0
"14307","NSH","EDM",2013020787,16096,20132014,0,60,1,5,-4,7.52938517893199,5.38451584760332,2.14486933132866,35,27,8,47,43,4,67,58,9,3,3,0,0
"14308","NSH","WPG",2013020802,16098,20132014,0,60,4,3,1,7.41518529682071,3.15969224274158,4.25549305407912,25,27,-2,39,40,-1,47,54,-7,3,2,0,0
"14309","NSH","N.J",2013020822,16101,20132014,1,61.4833333333333,3,2,1,5.15763931000129,2.29107774104341,2.86656156895788,33,26,7,43,31,12,52,45,7,3,3,0,0
"14310","NSH","STL",2013020830,16102,20132014,0,65,3,3,0,5.32418324645732,3.47703000176261,1.84715324469471,31,34,-3,48,46,2,62,62,0,1,3,0,0
"14311","NSH","MIN",2013020865,16107,20132014,0,62.2666666666667,2,3,-1,5.68009216467908,6.96443244266266,-1.28434027798357,18,36,-18,35,47,-12,44,66,-22,2,5,0,0
"14312","NSH","ANA",2013020880,16109,20132014,1,60,2,5,-3,6.50857805714176,5.97329544593231,0.535282611209453,38,24,14,49,33,16,63,52,11,4,4,0,0
"14313","NSH","T.B",2013020893,16128,20132014,1,60,3,2,1,4.19634296471866,2.32310628279811,1.87323668192055,29,16,13,40,24,16,55,36,19,5,4,0,0
"14314","NSH","WPG",2013020906,16130,20132014,1,60,1,3,-2,5.28831200729473,2.24656965535485,3.04174235193989,40,20,20,55,27,28,75,40,35,7,2,0,0
"14315","NSH","STL",2013020943,16135,20132014,1,60,1,2,-1,1.74104707475635,1.42662373876919,0.314423335987158,21,22,-1,29,30,-1,40,33,7,5,3,0,0
"14316","NSH","CBJ",2013020959,16137,20132014,1,60,0,1,-1,5.13503018894698,4.13184443654609,1.0031857524009,28,36,-8,38,48,-10,56,59,-3,1,4,0,0
"14317","NSH","OTT",2013020969,16139,20132014,0,63.8166666666667,4,3,1,6.02837259991202,11.3315407255432,-5.30316812563115,42,37,5,58,48,10,70,65,5,3,1,0,0
"14318","NSH","CHI",2013021000,16143,20132014,0,60,3,2,1,4.09424932151887,4.87279810686596,-0.778548785347084,29,33,-4,34,44,-10,49,63,-14,3,2,0,0
"14319","NSH","STL",2013021009,16144,20132014,1,60,1,4,-3,5.03796381209395,3.90155577075348,1.13640804134047,31,26,5,39,34,5,52,47,5,5,3,0,0
"14320","NSH","EDM",2013021035,16147,20132014,0,60,1,5,-4,7.16827129778202,5.57975807068374,1.58851322709829,29,30,-1,44,41,3,58,54,4,6,5,0,0
"14321","NSH","VAN",2013021041,16148,20132014,0,60,0,2,-2,3.86977372627007,2.73771964311595,1.13205408315412,30,22,8,37,33,4,48,43,5,4,1,0,0
"14322","NSH","CGY",2013021054,16150,20132014,0,60,6,5,1,1.66529929969518,4.12348760220493,-2.45818830250975,22,29,-7,27,45,-18,38,55,-17,2,2,0,0
"14323","NSH","CHI",2013021069,16152,20132014,0,60,2,0,2,2.7801212195897,4.30598849576185,-1.52586727617215,17,29,-12,19,41,-22,24,58,-34,4,5,0,0
"14324","NSH","COL",2013021087,16154,20132014,1,65,4,4,0,6.36268437984836,4.21805963636143,2.14462474348693,33,28,5,47,42,5,61,52,9,2,0,0,0
"14325","NSH","DAL",2013021105,16157,20132014,0,60,3,7,-4,5.10792625353497,3.19568925746717,1.9122369960678,28,29,-1,48,35,13,67,51,16,1,1,0,0
"14326","NSH","ANA",2013021159,16164,20132014,0,60,5,2,3,2.26033725269372,4.18296642618043,-1.92262917348671,24,29,-5,32,38,-6,43,52,-9,4,3,0,0
"14327","NSH","S.J",2013021170,16165,20132014,0,60,3,0,3,5.12557358906562,5.57661771209392,-0.451044123028304,24,35,-11,34,53,-19,44,74,-30,2,3,0,0
"14328","NSH","DAL",2013021188,16168,20132014,0,65,2,2,0,4.40907477756264,5.9610263038694,-1.55195152630677,29,30,-1,43,44,-1,62,63,-1,1,2,0,0
"14329","NSH","ARI",2013021200,16170,20132014,1,60,2,0,2,3.19145925345947,6.0626636591478,-2.87120440568833,23,29,-6,34,45,-11,38,61,-23,2,2,0,0
"14330","NSH","CHI",2013021217,16172,20132014,1,60,7,5,2,5.52652460902127,4.78500735503621,0.741517253985052,33,25,8,41,33,8,50,48,2,3,2,0,0
"14331","NSH","MIN",2013021227,16173,20132014,0,60,7,3,4,4.90056774916593,4.60159631949729,0.29897142966864,33,29,4,42,40,2,52,55,-3,7,5,0,0
"14332","NSH","OTT",2014020012,16352,20142015,1,60,3,2,1,5.75664662952886,4.84562897478463,0.911017654744228,37,20,17,52,31,21,62,43,19,4,5,0,0
"14333","NSH","DAL",2014020027,16354,20142015,1,60,4,1,3,5.78888736892259,3.81519423809368,1.97369313082891,33,18,15,45,30,15,62,44,18,4,2,0,0
"14334","NSH","CGY",2014020045,16357,20142015,1,65,2,2,0,2.50556885735671,4.73384661038195,-2.22827775302524,21,28,-7,32,39,-7,46,61,-15,3,4,0,0
"14335","NSH","WPG",2014020060,16360,20142015,0,60,2,0,2,4.0352729902952,2.7707590823361,1.2645139079591,27,31,-4,40,39,1,54,53,1,6,5,0,0
"14336","NSH","CHI",2014020071,16361,20142015,0,63.4333333333333,1,2,-1,5.62799363011825,6.54435983197608,-0.916366201857826,20,37,-17,30,43,-13,47,60,-13,4,5,0,0
"14337","NSH","ARI",2014020083,16364,20142015,1,65,3,3,0,5.318042403047,5.90003309142776,-0.581990688380756,26,36,-10,43,42,1,59,59,0,5,5,0,0
"14338","NSH","CHI",2014020096,16366,20142015,1,60,3,2,1,4.09567157534184,5.25497660771666,-1.15930503237482,27,32,-5,40,41,-1,52,57,-5,2,1,0,0
"14339","NSH","EDM",2014020137,16372,20142015,0,60,4,1,3,4.51746140432078,4.19041806890164,0.327043335419148,35,27,8,41,41,0,55,65,-10,1,2,0,0
"14340","NSH","CGY",2014020151,16374,20142015,0,60,3,4,-1,6.20260783786944,4.43383957665355,1.76876826121588,31,30,1,54,38,16,90,51,39,1,2,0,0
"14341","NSH","VAN",2014020170,16376,20142015,0,60,3,1,2,3.20345856499625,3.32150299687396,-0.118044431877706,33,27,6,40,41,-1,56,55,1,5,4,0,0
"14342","NSH","WPG",2014020180,16378,20142015,0,60,1,3,-2,4.30382439449394,5.10738345334146,-0.803559058847512,24,26,-2,40,37,3,58,51,7,6,5,0,0
"14343","NSH","DAL",2014020193,16380,20142015,0,60,3,2,1,7.16105309376871,5.97706101788883,1.18399207587989,33,35,-2,56,61,-5,76,73,3,3,1,0,0
"14344","NSH","STL",2014020210,16382,20142015,0,60,2,1,1,5.53289969754405,4.37265770426893,1.16024199327512,35,29,6,44,41,3,54,54,0,2,1,0,0
"14345","NSH","EDM",2014020227,16385,20142015,1,60,3,2,1,3.84217099997477,2.42546986661773,1.41670113335704,35,23,12,42,28,14,56,36,20,2,2,0,0
"14346","NSH","STL",2014020237,16387,20142015,0,60,3,4,-1,4.06800878338981,2.28235589025105,1.78565289313877,25,27,-2,36,32,4,57,40,17,6,4,0,0
"14347","NSH","WPG",2014020257,16389,20142015,1,60,2,1,1,4.47736339372932,5.59044736369106,-1.11308396996174,29,22,7,39,33,6,50,48,2,4,0,0,0
"14348","NSH","TOR",2014020271,16392,20142015,0,60,9,2,7,4.78083915444114,3.30359692713318,1.47724222730796,37,31,6,52,40,12,66,56,10,4,3,0,0
"14349","NSH","OTT",2014020283,16394,20142015,0,60,2,3,-1,5.89179604898527,2.80298474943265,3.08881129955262,35,19,16,50,34,16,59,47,12,3,4,0,0
"14350","NSH","FLA",2014020302,16396,20142015,1,65,2,2,0,5.14350724109927,5.68844678573078,-0.544939544631507,50,30,20,65,38,27,76,48,28,4,2,0,0
"14351","NSH","EDM",2014020332,16401,20142015,1,63.9166666666667,1,0,1,4.52123778463283,5.0557363535094,-0.534498568876572,25,37,-12,45,46,-1,62,60,2,6,5,0,0
"14352","NSH","CBJ",2014020350,16403,20142015,1,60,2,1,1,4.78241909820645,3.45969849731773,1.32272060088872,42,22,20,52,31,21,73,41,32,4,4,0,0
"14353","NSH","STL",2014020383,16408,20142015,1,60,4,3,1,1.52364319894696,3.65123342912891,-2.12759023018195,24,32,-8,32,42,-10,52,55,-3,2,3,0,0
"14354","NSH","CHI",2014020398,16410,20142015,1,60,1,3,-2,6.35457841359312,4.93415885861032,1.4204195549828,33,31,2,41,39,2,53,52,1,1,3,0,0
"14355","NSH","COL",2014020417,16413,20142015,0,60,3,0,3,0,0,0,36,26,10,44,38,6,55,58,-3,6,3,0,0
"14356","NSH","ARI",2014020429,16415,20142015,0,60,5,1,4,4.5677810034249,8.27141782793478,-3.70363682450989,38,32,6,47,45,2,63,61,2,5,3,0,0
"14357","NSH","MIN",2014020488,16424,20142015,0,61.75,6,5,1,8.83276427706096,8.32030815177131,0.512456125289646,44,27,17,57,42,15,78,56,22,4,4,0,0
"14358","NSH","CBJ",2014020498,16426,20142015,0,60,5,1,4,3.53735764100108,3.89423664246715,-0.356879001466069,35,31,4,43,38,5,55,49,6,4,2,0,0
"14359","NSH","PHI",2014020522,16431,20142015,1,60,4,1,3,6.37406267447656,2.49734793684911,3.87671473762745,38,27,11,46,32,14,57,45,12,6,5,0,0
"14360","NSH","CHI",2014020537,16433,20142015,0,65,4,4,0,5.61956874136224,6.82947800721212,-1.20990926584988,40,42,-2,53,56,-3,67,80,-13,6,6,0,0
"14361","NSH","STL",2014020542,16434,20142015,1,60,3,2,1,4.81048217558964,4.98244244486041,-0.171960269270768,47,28,19,64,38,26,80,56,24,4,4,0,0
"14362","NSH","ANA",2014020581,16439,20142015,0,65,3,3,0,4.44220011046855,7.31957516931288,-2.87737505884434,30,33,-3,41,50,-9,55,67,-12,4,3,0,0
"14363","NSH","DAL",2014020602,16443,20142015,1,60.2833333333333,3,2,1,5.34094549692236,3.44534677634363,1.89559872057873,24,20,4,35,27,8,56,42,14,2,3,0,0
"14364","NSH","MIN",2014020614,16445,20142015,0,60,3,1,2,3.93330461112782,4.19122517600245,-0.257920564874624,27,37,-10,37,50,-13,50,64,-14,3,6,0,0
"14365","NSH","MTL",2014020686,16455,20142015,0,64.1333333333333,1,2,-1,8.46318211638906,5.54279129976103,2.92039081662803,37,27,10,48,42,6,61,61,0,2,4,0,0
"14366","NSH","COL",2014020704,16462,20142015,1,62.7666666666667,4,3,1,7.19915972814488,5.89332974310673,1.30582998503814,39,24,15,60,37,23,80,46,34,2,2,0,0
"14367","NSH","COL",2014020724,16465,20142015,0,60,0,3,-3,4.32863914046902,4.64675736916251,-0.318118228693493,23,28,-5,37,37,0,61,47,14,2,4,0,0
"14368","NSH","TOR",2014020751,16469,20142015,1,60,4,3,1,5.85702325816965,4.44060196494996,1.41642129321968,32,28,4,40,34,6,56,51,5,3,4,0,0
"14369","NSH","ANA",2014020763,16471,20142015,1,60,2,5,-3,7.27203252400795,4.16770037978495,3.10433214422301,46,26,20,57,32,25,72,41,31,4,4,0,0
"14370","NSH","NYR",2014020773,16473,20142015,1,60,3,2,1,4.26397136470769,5.31394213969179,-1.0499707749841,23,32,-9,38,47,-9,49,60,-11,1,2,0,0
"14371","NSH","T.B",2014020804,16476,20142015,1,64.45,3,2,1,7.0152588958008,6.14059729684232,0.874661598958483,29,32,-3,40,46,-6,52,68,-16,3,3,0,0
"14372","NSH","WPG",2014020814,16478,20142015,1,60,3,1,2,3.98543183202855,5.87878768809605,-1.8933558560675,26,33,-7,38,42,-4,49,65,-16,6,5,0,0
"14373","NSH","N.J",2014020827,16480,20142015,1,60,3,1,2,4.67470593484177,5.12502930359915,-0.450323368757381,38,22,16,51,32,19,70,43,27,3,3,0,0
"14374","NSH","NYI",2014020859,16485,20142015,0,60,2,5,-3,2.36232841448873,3.70180709921351,-1.33947868472478,32,40,-8,39,50,-11,63,68,-5,3,5,0,0
"14375","NSH","PHI",2014020874,16487,20142015,0,65,2,2,0,3.21105384916882,3.28648935182719,-0.0754355026583653,22,33,-11,30,43,-13,45,58,-13,2,2,0,0
"14376","NSH","COL",2014020900,16490,20142015,1,60,5,2,3,6.16953541409211,4.65652903789305,1.51300637619905,41,20,21,56,28,28,67,40,27,2,4,0,0
"14377","NSH","MIN",2014020913,16492,20142015,1,60,2,4,-2,3.91994219824846,5.42466313525074,-1.50472093700228,29,30,-1,37,37,0,53,42,11,2,2,0,0
"14378","NSH","NYR",2014020939,16496,20142015,0,60,1,4,-3,4.16585589628085,6.42898530871909,-2.26312941243824,26,40,-14,42,57,-15,53,63,-10,3,1,0,0
"14379","NSH","N.J",2014020942,16497,20142015,0,60,1,3,-2,3.66128452244448,5.38457514653783,-1.72329062409335,34,24,10,45,35,10,61,43,18,3,2,0,0
"14380","NSH","NYI",2014020961,16499,20142015,1,60,3,4,-1,5.27595585676318,5.3348559680162,-0.0589001112530241,31,26,5,51,37,14,67,51,16,1,2,0,0
"14381","NSH","WPG",2014020976,16501,20142015,1,60,1,3,-2,2.9991820238065,6.26755874371156,-3.26837671990506,21,26,-5,31,32,-1,45,44,1,3,3,0,0
"14382","NSH","ARI",2014020989,16503,20142015,0,62.75,2,1,1,5.39033587724043,5.53496957694733,-0.144633699706901,40,28,12,64,48,16,80,68,12,6,4,0,0
"14383","NSH","ANA",2014021036,16509,20142015,0,60,2,4,-2,4.2821246040985,4.43648555169057,-0.154360947592068,27,28,-1,34,43,-9,48,58,-10,3,3,0,0
"14384","NSH","MIN",2014021045,16511,20142015,1,60.3666666666667,2,3,-1,4.49141056431108,2.36727670067921,2.12413386363187,27,21,6,35,26,9,55,37,18,4,0,0,0
"14385","NSH","MTL",2014021096,16518,20142015,1,61.9,3,2,1,4.69670970461448,4.74327376496512,-0.0465640603506472,31,29,2,41,37,4,55,59,-4,4,1,0,0
"14386","NSH","T.B",2014021109,16520,20142015,0,60,3,2,1,3.51520713263959,4.12646188662893,-0.611254753989343,19,30,-11,27,39,-12,36,55,-19,6,5,0,0
"14387","NSH","DAL",2014021176,16529,20142015,1,64.0666666666667,3,4,-1,6.11744508688935,3.59033879554318,2.52710629134617,36,24,12,52,34,18,71,48,23,2,2,0,0
"14388","NSH","COL",2014021197,16532,20142015,0,60,2,3,-1,5.12553540612134,3.73262048186734,1.392914924254,42,23,19,57,28,29,82,39,43,4,3,0,0
"14389","NSH","MIN",2014021209,16534,20142015,1,60,2,4,-2,4.69905129242034,3.78581847250462,0.91323281991572,34,27,7,42,31,11,54,47,7,3,2,0,0
"14390","NSH","DAL",2014021227,16536,20142015,0,60,1,4,-3,2.53789534161115,6.0667340009386,-3.52883865932745,25,25,0,37,41,-4,60,59,1,2,3,0,0
"14391","NSH","EDM",2015020024,16718,20152016,1,60,2,0,2,3.78532148183481,4.23685859080979,-0.451537108974975,26,31,-5,29,41,-12,42,57,-15,2,5,0,0
"14392","NSH","N.J",2015020037,16721,20152016,0,60,3,1,2,4.49206206237432,1.78015813819366,2.71190392418066,20,23,-3,30,28,2,38,33,5,2,2,0,0
"14393","NSH","NYI",2015020050,16723,20152016,0,60,3,4,-1,5.56096925690678,3.21460787129844,2.34636138560834,47,28,19,64,35,29,76,48,28,3,3,0,0
"14394","NSH","OTT",2015020066,16725,20152016,0,65,3,3,0,2.30285998112231,4.55659100520496,-2.25373102408265,25,41,-16,35,53,-18,50,74,-24,9,5,0,0
"14395","NSH","T.B",2015020086,16728,20152016,1,65,4,4,0,6.38786876616541,5.46102035895456,0.926848407210855,33,29,4,47,41,6,61,58,3,3,2,0,0
"14396","NSH","ANA",2015020095,16730,20152016,1,60,5,1,4,5.20121214776009,2.49175687167477,2.70945527608532,29,28,1,34,38,-4,46,55,-9,5,5,0,0
"14397","NSH","ANA",2015020168,16740,20152016,0,60,2,4,-2,5.27410781418439,1.49809057501754,3.77601723916685,42,28,14,62,35,27,79,49,30,7,4,0,0
"14398","NSH","MIN",2015020189,16744,20152016,0,60,3,2,1,4.33304443590168,2.6049687092891,1.72807572661259,24,29,-5,37,44,-7,51,67,-16,2,7,0,0
"14399","NSH","OTT",2015020223,16749,20152016,1,60,7,5,2,5.29036570199276,3.58457687993359,1.70578882205916,38,26,12,55,32,23,69,49,20,3,3,0,0
"14400","NSH","TOR",2015020237,16751,20152016,1,65,1,1,0,5.36260113975732,1.94738196695107,3.41521917280625,22,23,-1,42,32,10,66,48,18,4,3,0,0
"14401","NSH","WPG",2015020255,16753,20152016,1,60,7,0,7,2.84037272014018,4.49398940819083,-1.65361668805065,34,20,14,41,28,13,44,41,3,11,11,0,0
"14402","NSH","ANA",2015020273,16756,20152016,1,60,3,2,1,2.93203503487473,3.58019052393219,-0.64815548905746,21,40,-19,26,55,-29,34,78,-44,7,6,0,0
"14403","NSH","CBJ",2015020288,16759,20152016,0,60,0,4,-4,6.07795726468612,3.84449149173201,2.2334657729541,39,18,21,58,24,34,84,32,52,3,1,0,0
"14404","NSH","MIN",2015020302,16760,20152016,0,60,0,4,-4,5.78553195827408,5.20807553705163,0.57745642122245,23,27,-4,32,36,-4,44,50,-6,3,5,0,0
"14405","NSH","NYR",2015020309,16762,20152016,0,60,0,3,-3,3.45013184796881,2.49714200301356,0.952989844955241,31,19,12,49,27,22,75,41,34,5,5,0,0
"14406","NSH","PHI",2015020331,16766,20152016,0,64.1333333333333,2,3,-1,5.59826547585705,4.40544263039192,1.19282284546513,35,36,-1,46,43,3,60,59,1,2,2,0,0
"14407","NSH","ARI",2015020364,16770,20152016,1,60,5,2,3,7.41069496667478,3.26779987453483,4.14289509213995,41,15,26,55,20,35,66,38,28,2,2,0,0
"14408","NSH","CHI",2015020414,16777,20152016,0,60,1,4,-3,4.61393635017731,4.37453414967335,0.239402200503954,37,24,13,41,35,6,60,54,6,2,3,0,0
"14409","NSH","CHI",2015020425,16779,20152016,1,60,5,1,4,4.5178565797396,4.45528627626481,0.0625703034747858,34,36,-2,37,44,-7,52,59,-7,1,3,0,0
"14410","NSH","COL",2015020441,16781,20152016,1,60,2,3,-1,0,0,0,36,25,11,51,33,18,68,39,29,6,6,0,0
"14411","NSH","MIN",2015020490,16788,20152016,1,60,3,2,1,6.45414897536102,3.41166050912943,3.04248846623159,39,22,17,53,30,23,66,42,24,5,2,0,0
"14412","NSH","MTL",2015020503,16790,20152016,1,60,5,1,4,2.35447038616985,7.9904212798865,-5.63595089371665,19,36,-17,27,50,-23,32,63,-31,4,5,0,0
"14413","NSH","NYR",2015020537,16797,20152016,1,60,5,3,2,5.61817061780084,3.37409558077411,2.24407503702673,35,29,6,46,42,4,65,52,13,2,1,0,0
"14414","NSH","DAL",2015020561,16800,20152016,0,60,1,5,-4,0,0,0,34,32,2,44,44,0,56,61,-5,1,1,0,0
"14415","NSH","WPG",2015020594,16805,20152016,1,60,1,4,-3,5.52106963227243,5.09717890234606,0.42389072992637,44,19,25,60,27,33,76,36,40,4,3,0,0
"14416","NSH","COL",2015020611,16808,20152016,0,60,3,5,-2,6.42736555624288,3.26262577268062,3.16473978356225,22,27,-5,35,34,1,50,54,-4,3,6,0,0
"14417","NSH","ARI",2015020621,16809,20152016,0,60,0,4,-4,4.71419049380347,4.42435089292849,0.289839600874984,26,29,-3,50,37,13,67,43,24,4,3,0,0
"14418","NSH","CHI",2015020639,16812,20152016,0,60,2,3,-1,4.41383610874129,2.25479316907604,2.15904293966526,43,23,20,55,35,20,70,49,21,6,5,0,0
"14419","NSH","WPG",2015020650,16814,20152016,0,60.85,4,5,-1,4.54544696930729,4.22696770093171,0.318479268375583,35,24,11,52,34,18,76,54,22,5,8,0,0
"14420","NSH","MIN",2015020666,16816,20152016,1,60,3,0,3,3.45679526139259,4.2576382955326,-0.800843034140016,25,29,-4,33,41,-8,48,59,-11,2,3,0,0
"14421","NSH","CHI",2015020688,16819,20152016,1,60,1,4,-3,3.54062031267677,4.66707894443607,-1.12645863175931,39,27,12,52,35,17,61,48,13,3,2,0,0
"14422","NSH","WPG",2015020699,16821,20152016,0,60,4,1,3,6.48901780759709,3.85476221995032,2.63425558764678,28,27,1,36,34,2,48,49,-1,3,4,0,0
"14423","NSH","EDM",2015020719,16823,20152016,0,60,4,1,3,2.83085392895009,2.72838418657193,0.102469742378162,25,24,1,29,35,-6,37,49,-12,3,4,0,0
"14424","NSH","PHI",2015020766,16835,20152016,1,60,3,6,-3,4.57482836849522,2.70928345365974,1.86554491483548,40,19,21,46,24,22,60,30,30,6,2,0,0
"14425","NSH","T.B",2015020822,16843,20152016,0,61.0666666666667,3,4,-1,3.66364012773583,4.37557793816086,-0.711937810425027,30,28,2,35,40,-5,40,51,-11,2,3,0,0
"14426","NSH","DAL",2015020843,16846,20152016,1,63.8166666666667,2,3,-1,4.82213239616249,6.61102266752278,-1.78889027136029,26,32,-6,39,45,-6,48,62,-14,2,2,0,0
"14427","NSH","MTL",2015020891,16853,20152016,0,65,1,1,0,5.16848881894839,3.04789255245851,2.12059626648988,30,29,1,43,35,8,51,52,-1,1,1,0,0
"14428","NSH","TOR",2015020895,16854,20152016,0,60,3,2,1,1.51896395696791,4.11352501817964,-2.59456106121173,26,27,-1,31,47,-16,39,73,-34,2,4,0,0
"14429","NSH","CHI",2015020911,16856,20152016,0,60,3,1,2,5.72500427468913,6.5890863077724,-0.864082033083275,32,39,-7,39,48,-9,51,67,-16,2,2,0,0
"14430","NSH","DAL",2015020947,16861,20152016,1,60,5,3,2,6.79534421246557,7.32778626459185,-0.532442052126285,34,38,-4,48,46,2,60,65,-5,5,4,0,0
"14431","NSH","N.J",2015020960,16863,20152016,1,61.9,4,5,-1,3.13876340998104,4.71171851345571,-1.57295510347467,34,33,1,42,40,2,60,50,10,2,3,0,0
"14432","NSH","COL",2015020971,16865,20152016,0,60,5,2,3,6.15356001821453,5.44284046402313,0.7107195541914,40,36,4,47,45,2,69,67,2,4,3,0,0
"14433","NSH","WPG",2015020999,16868,20152016,0,60,4,2,2,3.28805047938386,3.50593091841438,-0.217880439030523,31,23,8,41,36,5,53,59,-6,5,3,0,0
"14434","NSH","EDM",2015021036,16874,20152016,0,60,3,2,1,4.29603541395045,3.72404109955028,0.571994314400172,25,30,-5,35,40,-5,47,55,-8,4,4,0,0
"14435","NSH","NYI",2015021057,16877,20152016,1,60,4,2,2,6.5965260748053,3.57579927443294,3.02072680037236,32,22,10,50,33,17,63,43,20,1,0,0,0
"14436","NSH","CBJ",2015021125,16886,20152016,1,60,5,1,4,5.75200931751169,4.41119976568734,1.34080955182435,48,19,29,62,27,35,75,35,40,4,2,0,0
"14437","NSH","COL",2015021136,16888,20152016,1,60,3,4,-1,4.46899050669344,2.98766445656474,1.4813260501287,35,27,8,44,38,6,63,47,16,3,2,0,0
"14438","NSH","DAL",2015021147,16889,20152016,0,60,2,5,-3,5.04259440027818,5.64870338790934,-0.60610898763116,30,25,5,51,34,17,68,50,18,4,5,0,0
"14439","NSH","PIT",2015021154,16891,20152016,0,60,2,5,-3,1.73229096760042,4.58046238316547,-2.84817141556505,24,41,-17,31,46,-15,51,56,-5,5,5,0,0
"14440","NSH","COL",2015021194,16896,20152016,1,60,4,3,1,6.80318617478224,6.21346497966442,0.589721195117818,28,28,0,44,41,3,59,62,-3,2,3,0,0
"14441","NSH","ARI",2015021209,16898,20152016,1,60.3333333333333,3,2,1,4.62230791160255,1.85156535031274,2.77074256128981,31,18,13,51,19,32,59,31,28,6,3,0,0
"14442","NSH","DAL",2015021227,16900,20152016,0,60,2,3,-1,6.53322379804422,4.07916505825597,2.45405873978825,30,24,6,47,40,7,63,68,-5,4,4,0,0
"14443","NSH","ANA",2015030171,16906,20152016,0,60,3,2,1,5.15541181533536,5.12030318669463,0.0351086286407281,33,29,4,45,46,-1,62,66,-4,3,4,0,0
"14444","NSH","ANA",2015030172,16908,20152016,0,60,3,2,1,6.35549554777161,3.29471140638918,3.06078414138243,27,29,-2,37,45,-8,49,56,-7,6,2,0,0
"14445","NSH","ANA",2015030173,16910,20152016,1,60,0,3,-3,3.90837075874265,3.54151780175744,0.366852956985213,27,21,6,42,28,14,57,39,18,5,2,0,0
"14446","NSH","ANA",2015030174,16912,20152016,1,60,1,4,-3,5.53653247854078,4.00438212323934,1.53215035530144,31,25,6,38,33,5,63,45,18,7,7,0,0
"14447","NSH","ANA",2015030175,16914,20152016,0,60,2,5,-3,5.67630203199566,5.56129133046488,0.115010701530775,29,32,-3,49,46,3,63,57,6,3,7,0,0
"14448","NSH","ANA",2015030176,16916,20152016,1,60,3,1,2,5.57874715520302,7.8713589629042,-2.29261180770118,26,27,-1,38,41,-3,49,62,-13,1,2,0,0
"14449","NSH","ANA",2015030177,16918,20152016,0,60,2,1,1,3.72497765988101,4.60527730698232,-0.88029964710131,20,37,-17,35,53,-18,45,77,-32,4,5,0,0
"14450","NSH","CHI",2016020014,17088,20162017,1,60,3,2,1,4.46119986352278,5.04118518839823,-0.579985324875452,27,24,3,37,36,1,45,55,-10,7,5,0,0
"14451","NSH","CHI",2016020026,17089,20162017,0,60,3,5,-2,6.79381609569828,4.07126742159016,2.72254867410811,36,27,9,45,39,6,62,50,12,2,3,0,0
"14452","NSH","DAL",2016020043,17092,20162017,1,60,1,2,-1,2.37238075515623,7.39487019123044,-5.02248943607421,28,37,-9,36,52,-16,56,70,-14,4,3,0,0
"14453","NSH","PIT",2016020073,17096,20162017,1,60,5,1,4,2.99036148811865,4.26543975185961,-1.27507826374096,30,35,-5,36,54,-18,52,72,-20,4,2,0,0
"14454","NSH","ANA",2016020097,17100,20162017,0,60,1,6,-5,3.78849518782079,3.92602685819234,-0.137531670371555,29,26,3,50,44,6,66,53,13,5,4,0,0
"14455","NSH","COL",2016020140,17106,20162017,0,60,5,1,4,4.25350743631139,3.42439737697848,0.829110059332916,36,29,7,43,36,7,63,53,10,5,4,0,0
"14456","NSH","ARI",2016020155,17108,20162017,0,65,2,2,0,4.14387371088378,3.46002599797794,0.683847712905845,37,28,9,49,38,11,69,48,21,7,3,0,0
"14457","NSH","ANA",2016020220,17117,20162017,1,60,5,0,5,6.19106550123729,3.18043202126864,3.01063347996865,27,27,0,39,40,-1,44,55,-11,4,5,0,0
"14458","NSH","TOR",2016020233,17120,20162017,0,60,2,6,-4,4.46131389023611,4.25240377850423,0.208910111731882,34,32,2,56,47,9,68,57,11,1,1,0,0
"14459","NSH","T.B",2016020279,17126,20162017,1,60,3,1,2,4.20233389710484,3.15363935905043,1.04869453805441,30,25,5,40,36,4,47,43,4,6,3,0,0
"14460","NSH","DAL",2016020295,17128,20162017,1,60,5,2,3,3.625688834627,3.88747597092879,-0.261787136301791,21,35,-14,32,39,-7,52,50,2,4,2,0,0
"14461","NSH","WPG",2016020307,17130,20162017,1,60,5,1,4,6.88280426558346,4.28978610948354,2.59301815609992,30,23,7,42,27,15,61,35,26,3,1,0,0
"14462","NSH","WPG",2016020325,17132,20162017,0,60,0,3,-3,5.82623990277304,4.51097627119452,1.31526363157852,42,24,18,52,37,15,79,47,32,4,4,0,0
"14463","NSH","COL",2016020337,17134,20162017,0,60,5,3,2,6.76363778129235,4.60727766641446,2.15636011487788,33,40,-7,44,47,-3,61,63,-2,2,1,0,0
"14464","NSH","N.J",2016020362,17138,20162017,1,64.7,4,5,-1,4.56033936817221,4.24647129210643,0.313868076065773,42,22,20,59,29,30,77,38,39,3,4,0,0
"14465","NSH","PHI",2016020373,17139,20162017,1,60,2,4,-2,4.99305372685194,5.11236248171303,-0.119308754861095,32,28,4,43,45,-2,58,55,3,2,4,0,0
"14466","NSH","COL",2016020387,17141,20162017,1,60,4,3,1,4.61790982077946,5.59968533751089,-0.981775516731432,32,28,4,44,41,3,61,56,5,5,4,0,0
"14467","NSH","DAL",2016020402,17143,20162017,0,60,2,5,-3,5.4410815499723,4.22452463441386,1.21655691555844,36,37,-1,50,52,-2,69,68,1,5,6,0,0
"14468","NSH","ARI",2016020418,17145,20162017,0,60,1,4,-3,7.44995940370427,3.40698275127121,4.04297665243306,45,34,11,69,43,26,86,51,35,5,3,0,0
"14469","NSH","MIN",2016020450,17150,20162017,1,60,2,5,-3,6.46612291234487,5.05900460993871,1.40711830240616,36,19,17,54,31,23,67,41,26,3,2,0,0
"14470","NSH","NYR",2016020468,17152,20162017,1,65,1,1,0,7.62096444884082,4.1758970891533,3.44506735968753,32,27,5,48,43,5,65,56,9,3,2,0,0
"14471","NSH","PHI",2016020476,17154,20162017,0,65,1,1,0,3.93255173470243,5.66116055192759,-1.72860881722517,31,32,-1,41,46,-5,64,60,4,1,3,0,0
"14472","NSH","N.J",2016020482,17155,20162017,0,60,5,1,4,2.44160435209051,4.69295807994786,-2.25135372785735,32,28,4,36,37,-1,44,43,1,1,2,0,0
"14473","NSH","MIN",2016020522,17162,20162017,1,62.7666666666667,2,3,-1,6.3876515867305,6.6611476088874,-0.273496022156905,30,39,-9,39,54,-15,53,68,-15,1,4,0,0
"14474","NSH","CHI",2016020537,17164,20162017,1,60,2,3,-1,3.92410934170655,5.11498497373128,-1.19087563202473,38,23,15,49,33,16,72,43,29,5,5,0,0
"14475","NSH","MTL",2016020570,17169,20162017,1,64.5,1,2,-1,3.48473737854511,5.5370627479133,-2.05232536936819,23,43,-20,35,55,-20,49,76,-27,3,4,0,0
"14476","NSH","T.B",2016020580,17171,20162017,0,60,6,1,5,3.10374411684259,4.9795613326828,-1.87581721584021,19,28,-9,29,45,-16,35,69,-34,5,6,0,0
"14477","NSH","CHI",2016020607,17174,20162017,0,60,2,5,-3,5.76674776195432,6.88951761834323,-1.12276985638891,27,31,-4,41,38,3,64,57,7,3,1,0,0
"14478","NSH","COL",2016020641,17180,20162017,0,60,3,2,1,2.93517016270198,3.94451927021146,-1.00934910750948,32,30,2,37,39,-2,43,53,-10,3,4,0,0
"14479","NSH","EDM",2016020689,17186,20162017,0,65,2,2,0,5.27187104949553,4.25141992911709,1.02045112037844,44,32,12,58,43,15,78,56,22,7,6,0,0
"14480","NSH","MIN",2016020707,17188,20162017,0,60,4,2,2,7.32844194557401,2.12503788567847,5.20340405989555,32,23,9,45,34,11,59,46,13,3,2,0,0
"14481","NSH","CBJ",2016020735,17192,20162017,1,60,4,3,1,5.33674741519644,4.7328662807995,0.603881134396943,32,33,-1,44,42,2,59,53,6,4,3,0,0
"14482","NSH","PIT",2016020743,17197,20162017,0,60,2,4,-2,6.87801568706345,6.22052216643351,0.657493520629941,39,38,1,52,45,7,72,61,11,3,4,0,0
"14483","NSH","EDM",2016020762,17199,20162017,1,60,2,0,2,3.31261075317317,3.77564614139897,-0.463035388225791,27,31,-4,35,47,-12,52,54,-2,3,3,0,0
"14484","NSH","NYR",2016020804,17206,20162017,0,60,3,4,-1,5.99276980303694,4.91325873178721,1.07951107124973,37,30,7,52,37,15,62,46,16,3,1,0,0
"14485","NSH","DAL",2016020831,17209,20162017,1,60,5,3,2,6.62257069138286,4.91138475027401,1.71118594110885,36,21,15,55,35,20,77,47,30,6,9,0,0
"14486","NSH","MIN",2016020865,17215,20162017,0,60,2,5,-3,3.99241101622416,5.02621069938846,-1.0337996831643,39,33,6,52,42,10,68,57,11,3,5,0,0
"14487","NSH","CBJ",2016020874,17216,20162017,0,60,4,3,1,4.19439871050417,5.15756067784969,-0.963161967345513,32,38,-6,42,53,-11,55,72,-17,0,2,0,0
"14488","NSH","COL",2016020897,17220,20162017,1,60,4,2,2,5.98815412860131,2.62594908268511,3.3622050459162,29,22,7,40,32,8,51,55,-4,2,0,0,0
"14489","NSH","EDM",2016020915,17223,20162017,1,60,5,4,1,2.275972972624,3.81571608531522,-1.53974311269121,28,32,-4,34,38,-4,42,52,-10,5,4,0,0
"14490","NSH","MTL",2016020941,17227,20162017,0,60,1,2,-1,4.53859501058469,4.48137109632808,0.0572239142566104,25,26,-1,40,34,6,58,53,5,2,3,0,0
"14491","NSH","CHI",2016020959,17229,20162017,1,60,3,5,-2,3.8015488612582,5.12150097463746,-1.31995211337926,35,33,2,48,42,6,64,52,12,1,2,0,0
"14492","NSH","ANA",2016020981,17232,20162017,0,65,3,3,0,4.87203055879218,6.72314954659061,-1.85111898779843,27,42,-15,42,65,-23,50,90,-40,5,3,0,0
"14493","NSH","WPG",2016021019,17238,20162017,1,62.1833333333333,5,4,1,6.65939836081816,3.25523319435888,3.40416516645928,42,34,8,55,46,9,72,51,21,3,1,0,0
"14494","NSH","ARI",2016021072,17245,20162017,1,60,3,1,2,4.43571587698534,5.09726083877467,-0.661544961789332,31,26,5,48,39,9,63,47,16,1,2,0,0
"14495","NSH","NYI",2016021123,17252,20162017,0,60,3,1,2,3.53152568489531,3.87433454371057,-0.34280885881526,31,25,6,44,37,7,53,50,3,4,3,0,0
"14496","NSH","TOR",2016021146,17255,20162017,1,60,1,3,-2,4.58971013713017,2.24895717611071,2.34075296101946,30,17,13,49,24,25,62,35,27,5,3,0,0
"14497","NSH","MIN",2016021158,17257,20162017,1,60,3,0,3,4.53451901660446,6.10994583398497,-1.5754268173805,36,31,5,44,43,1,61,53,8,2,1,0,0
"14498","NSH","NYI",2016021185,17260,20162017,1,61.4166666666667,1,2,-1,3.15458884614054,3.9511937599184,-0.796604913777855,23,32,-9,36,54,-18,49,72,-23,1,2,0,0
"14499","NSH","DAL",2016021200,17262,20162017,0,60,7,3,4,4.14955726531116,5.32136210560043,-1.17180484028927,34,33,1,47,51,-4,66,66,0,5,2,0,0
"14500","NSH","WPG",2016021215,17264,20162017,0,60,1,2,-1,4.79648190876469,5.318565625872,-0.522083717107307,34,36,-2,46,45,1,65,52,13,6,2,0,0
"14501","NSH","ANA",2016030321,17298,20162017,0,69.4,3,2,1,6.49366051506857,6.83642260847008,-0.342762093401511,46,29,17,58,47,11,77,61,16,5,4,0,0
"14502","NSH","ANA",2016030322,17300,20162017,0,60,3,5,-2,3.83212680165889,7.86047394030174,-4.02834713864286,33,27,6,49,38,11,59,50,9,3,2,0,0
"14503","NSH","ANA",2016030323,17302,20162017,1,60,2,1,1,0,0,0,40,20,20,53,31,22,75,38,37,4,2,0,0
"14504","NSH","ANA",2016030324,17304,20162017,1,70.4166666666667,2,3,-1,7.86260119569488,7.27126919227885,0.591332003416028,34,37,-3,54,43,11,74,62,12,5,2,0,0
"14505","NSH","ANA",2016030325,17306,20162017,0,60,3,1,2,7.0372133447868,6.83837141378899,0.198841930997809,29,33,-4,48,51,-3,66,66,0,6,7,0,0
"14506","NSH","ANA",2016030326,17308,20162017,1,60,6,3,3,4.98730422125664,3.8711289208386,1.11617530041804,18,41,-23,26,51,-25,35,73,-38,2,4,0,0
"14507","NSH","PIT",2016030411,17315,20162017,0,60,3,5,-2,5.15137227111074,2.4006868719589,2.75068539915185,26,12,14,37,14,23,46,28,18,3,3,0,0
"14508","NSH","PIT",2016030412,17317,20162017,0,60,1,4,-3,4.88173758172867,3.99998427351602,0.881753308212652,38,27,11,51,33,18,71,41,30,5,7,0,0
"14509","NSH","PIT",2016030413,17320,20162017,1,60,5,1,4,3.29081671277533,4.06955206147074,-0.778735348695413,33,28,5,40,39,1,60,51,9,7,7,0,0
"14510","NSH","PIT",2016030414,17322,20162017,1,60,4,1,3,5.9081285594948,5.55922879602473,0.348899763470065,26,24,2,32,42,-10,50,57,-7,3,4,0,0
"14511","NSH","PIT",2016030415,17325,20162017,0,60,0,6,-6,4.28751377508084,2.88767756780726,1.39983620727358,24,24,0,34,30,4,50,37,13,6,9,0,0
"14512","NSH","PIT",2016030416,17328,20162017,1,60,0,2,-2,4.57743495001341,3.48573313901058,1.09170181100283,27,29,-2,44,31,13,56,41,15,4,0,0,0
"14513","NSH","PIT",2017020021,17446,20172018,0,60,0,4,-4,3.19943902098748,3.87981530151851,-0.680376280531028,26,34,-8,41,41,0,55,49,6,8,8,0,0
"14514","NSH","PHI",2017020042,17449,20172018,1,60,6,5,1,4.81208350444285,2.75227739487309,2.05980610956976,31,30,1,48,35,13,62,48,14,5,6,0,0
"14515","NSH","DAL",2017020053,17451,20172018,1,60,4,1,3,4.59592255475582,4.62613268006341,-0.0302101253075904,31,31,0,44,45,-1,53,59,-6,2,1,0,0
"14516","NSH","CHI",2017020071,17453,20172018,0,63.0833333333333,1,2,-1,4.65248253266714,3.93383004018214,0.718652492484997,38,35,3,56,45,11,68,67,1,6,8,0,0
"14517","NSH","COL",2017020086,17456,20172018,1,60,4,1,3,8.55918817281622,2.30627490026109,6.25291327255513,34,21,13,49,32,17,59,43,16,6,6,0,0
"14518","NSH","PHI",2017020097,17458,20172018,0,60,1,0,1,6.00664043048164,2.28562791259901,3.72101251788263,24,28,-4,37,41,-4,54,58,-4,2,5,0,0
"14519","NSH","NYR",2017020110,17460,20172018,0,60,2,4,-2,2.83871416098947,4.82101407786831,-1.98229991687885,25,15,10,44,22,22,62,38,24,6,6,0,0
"14520","NSH","CHI",2017020153,17466,20172018,0,60,2,1,1,4.03557196775773,4.78540300221357,-0.749831034455838,30,44,-14,36,56,-20,50,74,-24,6,6,0,0
"14521","NSH","NYI",2017020163,17467,20172018,1,60,2,6,-4,3.51186887459062,2.64211732437252,0.869751550218098,30,23,7,41,35,6,55,43,12,7,8,0,0
"14522","NSH","ANA",2017020199,17473,20172018,0,60,5,3,2,0,0,0,30,38,-8,50,53,-3,63,74,-11,4,4,0,0
"14523","NSH","CBJ",2017020228,17477,20172018,0,60,3,1,2,4.01272303470633,3.10623407336585,0.906488961340482,29,36,-7,39,52,-13,56,63,-7,4,4,0,0
"14524","NSH","PIT",2017020258,17481,20172018,1,65,4,4,0,3.97903578550517,4.90772907740029,-0.928693291895123,28,30,-2,44,45,-1,62,68,-6,7,5,0,0
"14525","NSH","MIN",2017020283,17486,20172018,0,60,4,6,-2,3.37155969299041,5.84523793686472,-2.4736782438743,30,36,-6,42,49,-7,51,63,-12,3,5,0,0
"14526","NSH","COL",2017020302,17488,20172018,1,60,5,2,3,4.28620241091235,2.90573023741308,1.38047217349926,24,31,-7,32,38,-6,43,56,-13,4,6,0,0
"14527","NSH","WPG",2017020313,17490,20172018,1,60,5,3,2,4.31965561611287,4.51292499819018,-0.193269382077313,29,35,-6,39,45,-6,52,57,-5,3,2,0,0
"14528","NSH","MTL",2017020329,17492,20172018,1,65,2,2,0,3.73786859575193,3.10079213387507,0.637076461876859,33,29,4,46,38,8,59,50,9,6,6,0,0
"14529","NSH","CHI",2017020373,17498,20172018,1,60,3,2,1,5.33046380986652,5.46718262479408,-0.136718814927561,31,39,-8,46,59,-13,62,74,-12,4,3,0,0
"14530","NSH","ANA",2017020404,17502,20172018,1,65,2,2,0,5.16902928368654,4.34034874043886,0.828680543247685,35,35,0,44,43,1,56,50,6,6,4,0,0
"14531","NSH","DAL",2017020421,17505,20172018,0,60,5,2,3,4.40083915881252,6.81362886322313,-2.41278970441061,32,45,-13,38,57,-19,44,75,-31,4,3,0,0
"14532","NSH","VGK",2017020441,17508,20172018,1,65,3,3,0,3.99941456015222,4.29488634358859,-0.295471783436369,44,39,5,53,51,2,67,66,1,5,5,0,0
"14533","NSH","EDM",2017020488,17514,20172018,0,60,4,0,4,2.17844590377024,6.57203945976516,-4.39359355599492,23,46,-23,36,59,-23,52,88,-36,4,4,0,0
"14534","NSH","WPG",2017020521,17519,20172018,1,60,4,6,-2,4.37731377357503,6.39136031176977,-2.01404653819475,34,36,-2,45,48,-3,59,58,1,4,6,0,0
"14535","NSH","DAL",2017020553,17523,20172018,0,65,3,3,0,4.01727425822264,4.21243508416228,-0.195160825939638,32,28,4,49,48,1,67,65,2,4,4,0,0
"14536","NSH","MIN",2017020581,17529,20172018,0,60,2,4,-2,7.4444998896605,5.24161723861471,2.20288265104579,43,38,5,64,48,16,81,59,22,3,5,0,0
"14537","NSH","MIN",2017020591,17530,20172018,1,60,3,0,3,5.22374573885463,2.69335307309939,2.53039266575524,29,29,0,45,36,9,63,48,15,5,3,0,0
"14538","NSH","VGK",2017020613,17533,20172018,0,60,0,3,-3,2.70361484633759,3.87882334433925,-1.17520849800167,29,31,-2,44,42,2,60,55,5,2,1,0,0
"14539","NSH","ARI",2017020627,17535,20172018,0,62.3166666666667,2,3,-1,10.0962493568368,5.14382241736166,4.95242693947512,39,25,14,55,37,18,80,53,27,2,2,0,0
"14540","NSH","EDM",2017020658,17540,20172018,1,60,2,1,1,2.78873753853259,2.82913045797613,-0.0403929194435477,24,26,-2,32,39,-7,42,53,-11,3,1,0,0
"14541","NSH","VGK",2017020691,17547,20172018,1,60,1,0,1,5.70126640100735,5.13657099672128,0.564695404286073,27,43,-16,39,58,-19,56,81,-25,2,4,0,0
"14542","NSH","ARI",2017020702,17549,20172018,1,65,2,2,0,4.5089599974026,3.17040087562054,1.33855912178205,39,29,10,57,37,20,69,49,20,2,2,0,0
"14543","NSH","T.B",2017020737,17554,20172018,1,61.75,3,4,-1,5.47788927721223,4.35275578603,1.12513349118223,33,31,2,40,37,3,59,54,5,3,2,0,0
"14544","NSH","N.J",2017020746,17556,20172018,0,60,3,0,3,3.3403517062834,4.86542764713522,-1.52507594085182,27,27,0,38,39,-1,45,53,-8,2,2,0,0
"14545","NSH","CHI",2017020768,17561,20172018,1,60,1,2,-1,7.10712408543986,3.72843665255277,3.37868743288709,43,31,12,54,40,14,73,56,17,1,2,0,0
"14546","NSH","NYR",2017020800,17565,20172018,1,60,5,2,3,4.22729865039582,2.69692513647385,1.53037351392197,28,22,6,44,24,20,54,38,16,6,4,0,0
"14547","NSH","NYI",2017020809,17567,20172018,0,63.7,5,4,1,5.81685448495685,4.36875555833103,1.44809892662582,47,28,19,60,36,24,73,48,25,4,5,0,0
"14548","NSH","TOR",2017020823,17569,20172018,0,65,2,2,0,5.04149747440533,4.77635768131586,0.265139793089475,46,32,14,66,43,23,79,54,25,2,2,0,0
"14549","NSH","MTL",2017020845,17572,20172018,0,65,2,2,0,5.21564495603565,5.96005333596736,-0.744408379931705,32,49,-17,43,63,-20,66,85,-19,4,4,0,0
"14550","NSH","WPG",2017020974,17589,20172018,0,60,6,5,1,5.57832535832131,6.38521496007161,-0.806889601750299,32,39,-7,49,53,-4,73,64,9,3,3,0,0
"14551","NSH","EDM",2017020987,17591,20172018,0,60,4,2,2,5.01666122587631,4.73391270416043,0.28274852171587,42,36,6,57,39,18,78,56,22,3,1,0,0
"14552","NSH","COL",2017021009,17594,20172018,0,61.1166666666667,4,3,1,5.75778941804002,3.73182478887611,2.02596462916391,31,26,5,47,39,8,68,57,11,4,5,0,0
"14553","NSH","DAL",2017021025,17596,20172018,1,60,2,0,2,7.47410685701939,3.83443919216643,3.63966766485296,34,26,8,51,37,14,64,48,16,6,5,0,0
"14554","NSH","ANA",2017021039,17598,20172018,1,60,4,2,2,8.99996482848655,3.60026292238018,5.39970190610637,28,33,-5,42,43,-1,49,61,-12,1,2,0,0
"14555","NSH","N.J",2017021057,17600,20172018,1,65,2,2,0,8.21127867387258,4.65388310426244,3.55739556961014,36,27,9,61,39,22,78,56,22,3,3,0,0
"14556","NSH","WPG",2017021074,17603,20172018,1,60,3,1,2,5.27918910386357,6.00150644010864,-0.722317336245069,45,33,12,56,45,11,67,69,-2,7,9,0,0
"14557","NSH","ARI",2017021090,17605,20172018,0,60,3,2,1,4.86036828350916,7.08969686945967,-2.22932858595051,29,34,-5,41,50,-9,56,70,-14,4,6,0,0
"14558","NSH","COL",2017021094,17606,20172018,0,60,4,2,2,5.05012041152804,3.59797621866899,1.45214419285906,28,35,-7,37,46,-9,52,53,-1,4,4,0,0
"14559","NSH","TOR",2017021142,17612,20172018,1,60,2,5,-3,5.21483945165528,2.77552869485226,2.43931075680302,25,28,-3,42,31,11,55,45,10,6,3,0,0
"14560","NSH","MIN",2017021161,17614,20172018,0,60,1,4,-3,1.40656181614545,2.97287039395237,-1.56630857780691,20,30,-10,33,36,-3,51,48,3,3,6,0,0
"14561","NSH","WPG",2017021165,17615,20172018,0,65,4,4,0,7.52888113971858,5.27843999635661,2.25044114336197,36,47,-11,50,68,-18,64,82,-18,7,7,0,0
"14562","NSH","MIN",2017021181,17617,20172018,1,65,1,1,0,5.94145345076686,3.01656026572442,2.92489318504244,29,23,6,39,29,10,54,40,14,5,3,0,0
"14563","NSH","T.B",2017021219,17622,20172018,0,60,4,1,3,2.94225778442342,1.80017581515131,1.14208196927211,25,30,-5,34,39,-5,46,59,-13,2,5,0,0
"14564","NSH","CBJ",2017021265,17628,20172018,1,60,4,2,2,6.44788449544467,6.63434577233798,-0.186461276893311,27,31,-4,41,41,0,56,51,5,6,2,0,0
"14565","NSH","COL",2017030151,17633,20172018,1,60,5,2,3,8.43717674634098,2.06583887161355,6.37133787472743,31,27,4,41,36,5,58,54,4,3,3,0,0
"14566","NSH","COL",2017030152,17635,20172018,1,60,5,4,1,4.80745231949186,3.35229549020005,1.45515682929181,33,30,3,43,35,8,66,50,16,7,7,0,0
"14567","NSH","COL",2017030153,17637,20172018,0,60,3,5,-2,7.73500947198595,5.59931887389394,2.13569059809201,32,34,-2,49,42,7,74,58,16,6,8,0,0
"14568","NSH","COL",2017030154,17639,20172018,0,60,3,2,1,5.93142707162788,4.05118338251486,1.88024368911302,34,33,1,48,45,3,62,63,-1,5,7,0,0
"14569","NSH","COL",2017030155,17641,20172018,1,60,1,2,-1,5.97416398943045,2.95076317924168,3.02340081018878,45,27,18,54,35,19,68,53,15,3,2,0,0
"14570","NSH","COL",2017030156,17643,20172018,0,60,5,0,5,5.13729093012807,4.15116592221511,0.98612500791296,37,22,15,54,29,25,67,42,25,5,2,0,0
"14571","NSH","WPG",2017030231,17648,20172018,1,60,1,4,-3,6.21487250580685,5.70984045194928,0.505032053857576,48,19,29,61,32,29,87,39,48,3,0,0,0
"14572","NSH","WPG",2017030232,17650,20172018,1,80,4,4,0,8.22558099798603,8.72238711520913,-0.496806117223096,38,48,-10,60,65,-5,88,91,-3,5,5,0,0
"14573","NSH","WPG",2017030233,17652,20172018,0,60,4,7,-3,2.40009898614937,8.20269241722508,-5.80259343107571,30,45,-15,38,58,-20,49,70,-21,5,6,0,0
"14574","NSH","WPG",2017030234,17654,20172018,0,60,2,1,1,4.67451954007265,4.29532473295694,0.379194807115709,29,33,-4,49,49,0,55,58,-3,3,3,0,0
"14575","NSH","WPG",2017030235,17656,20172018,1,60,2,6,-4,5.42784029075951,4.06166426110576,1.36617602965374,40,32,8,52,42,10,68,62,6,1,3,0,0
"14576","NSH","WPG",2017030236,17658,20172018,0,60,4,0,4,5.68769383547415,4.05219055420326,1.63550328127089,29,34,-5,40,49,-9,48,72,-24,1,4,0,0
"14577","NSH","WPG",2017030237,17661,20172018,1,60,1,5,-4,7.37382178916596,4.75008095531666,2.6237408338493,37,24,13,50,34,16,70,51,19,3,1,0,0
"14578","NSH","NYR",2018020006,17808,20182019,0,60,3,2,1,5.25826280668844,7.23326832949533,-1.9750055228069,33,36,-3,41,47,-6,61,58,3,3,3,0,0
"14579","NSH","NYI",2018020021,17810,20182019,0,60,4,3,1,3.09197115736606,3.70217689444183,-0.610205737075773,23,29,-6,30,37,-7,37,53,-16,2,5,0,0
"14580","NSH","WPG",2018020055,17815,20182019,1,60,3,0,3,4.87631594062532,1.86278191381962,3.0135340268057,30,29,1,45,37,8,51,43,8,9,3,0,0
"14581","NSH","NYI",2018020066,17817,20182019,1,60,5,2,3,2.82046961697051,3.31141261332823,-0.490942996357717,29,22,7,41,35,6,52,46,6,2,1,0,0
"14582","NSH","MIN",2018020077,17819,20182019,1,60,4,2,2,4.44117751321755,2.87551575100314,1.56566176221442,28,31,-3,41,40,1,58,52,6,3,4,0,0
"14583","NSH","EDM",2018020111,17824,20182019,0,60,3,0,3,4.06840243454735,3.72126209619455,0.347140338352801,28,31,-3,36,41,-5,54,53,1,4,4,0,0
"14584","NSH","N.J",2018020136,17829,20182019,0,63.5833333333333,4,3,1,5.30831907806684,5.26242320000893,0.045895878057916,36,36,0,53,43,10,66,54,12,4,3,0,0
"14585","NSH","EDM",2018020150,17831,20182019,1,60,3,5,-2,3.12460205276875,4.65856444618839,-1.53396239341964,27,35,-8,43,46,-3,63,56,7,6,6,0,0
"14586","NSH","VGK",2018020173,17834,20182019,1,60,4,1,3,3.7992059854276,3.37932045420797,0.419885531219627,29,24,5,42,34,8,52,46,6,4,4,0,0
"14587","NSH","T.B",2018020185,17836,20182019,0,60,4,1,3,3.83352571279102,7.55245306587312,-3.71892735308211,24,43,-19,32,53,-21,41,66,-25,1,2,0,0
"14588","NSH","COL",2018020225,17842,20182019,0,60,4,1,3,4.5261270175306,2.6039426685266,1.922184349004,34,25,9,45,31,14,62,49,13,3,3,0,0
"14589","NSH","DAL",2018020244,17845,20182019,0,62.45,5,4,1,7.45003676735723,1.6874330452265,5.76260372213073,34,24,10,50,31,19,61,40,21,5,3,0,0
"14590","NSH","ANA",2018020263,17847,20182019,0,65,1,1,0,5.38071186514155,3.45965653070084,1.92105533444071,35,30,5,45,46,-1,63,56,7,7,2,0,0
"14591","NSH","ARI",2018020284,17850,20182019,0,60,1,2,-1,7.59860362626205,5.46896913582896,2.12963449043309,46,23,23,63,37,26,82,46,36,5,2,0,0
"14592","NSH","T.B",2018020314,17854,20182019,1,60,3,2,1,2.77819492125127,6.64673040028696,-3.86853547903569,34,31,3,47,42,5,63,50,13,3,2,0,0
"14593","NSH","ANA",2018020360,17860,20182019,1,60,5,2,3,7.09863264416401,2.57408133830722,4.52455130585679,33,19,14,48,24,24,51,34,17,8,8,0,0
"14594","NSH","COL",2018020371,17862,20182019,1,60,2,3,-1,7.17502553439915,1.09265982124816,6.08236571315099,38,25,13,55,30,25,74,41,33,3,2,0,0
"14595","NSH","ARI",2018020386,17864,20182019,1,60,0,3,-3,4.04658005324718,3.17192805600644,0.87465199724074,29,25,4,43,34,9,61,56,5,4,7,0,0
"14596","NSH","CHI",2018020404,17866,20182019,1,60,5,2,3,5.3305014305497,2.67410012741311,2.65640130313659,30,21,9,48,28,20,57,44,13,3,2,0,0
"14597","NSH","N.J",2018020502,17880,20182019,1,65,1,1,0,5.71767784947075,5.35735842891972,0.360319420551027,28,34,-6,45,47,-2,55,62,-7,2,4,0,0
"14598","NSH","CHI",2018020522,17883,20182019,0,60,1,2,-1,3.79459605726879,2.4932380378068,1.30135801946199,31,36,-5,41,42,-1,56,56,0,2,3,0,0
"14599","NSH","PHI",2018020532,17885,20182019,0,60,1,2,-1,3.87162953880761,2.99340351481214,0.878226023995467,32,31,1,41,41,0,65,47,18,6,4,0,0
"14600","NSH","DAL",2018020573,17892,20182019,1,60,0,2,-2,9.63985738470172,4.5058805593435,5.13397682535822,49,30,19,71,41,30,89,57,32,3,3,0,0
"14601","NSH","NYR",2018020593,17894,20182019,1,60,3,4,-1,7.0141023073229,5.56574944537967,1.44835286194323,37,22,15,55,34,21,74,41,33,5,2,0,0
"14602","NSH","PHI",2018020613,17897,20182019,1,60,4,0,4,5.35026145982556,5.6804288677522,-0.330167407926638,30,32,-2,42,44,-2,58,62,-4,2,2,0,0
"14603","NSH","MTL",2018020640,17901,20182019,0,60,4,1,3,7.25350344672916,6.10511724198841,1.14838620474075,32,28,4,41,46,-5,53,64,-11,2,1,0,0
"14604","NSH","TOR",2018020652,17903,20182019,0,60,4,0,4,3.69796132381452,2.09685296447424,1.60110835934029,32,18,14,44,38,6,59,61,-2,2,3,0,0
"14605","NSH","CHI",2018020668,17905,20182019,0,61,4,3,1,3.34869946818662,2.54642632990726,0.802273138279361,37,31,6,47,34,13,65,52,13,3,2,0,0
"14606","NSH","CBJ",2018020675,17906,20182019,0,61.3666666666667,3,4,-1,3.28692551818676,4.6840262174519,-1.39710069926514,35,33,2,46,44,2,67,56,11,2,2,0,0
"14607","NSH","WPG",2018020730,17913,20182019,1,60,1,5,-4,6.29181814744948,7.68788387134336,-1.39606572389388,38,34,4,46,42,4,64,50,14,4,3,0,0
"14608","NSH","COL",2018020756,17917,20182019,0,60,4,1,3,6.15397348216911,3.33043395359982,2.82353952856929,27,36,-9,32,51,-19,40,72,-32,4,6,0,0
"14609","NSH","VGK",2018020768,17919,20182019,0,60,2,1,1,2.24311052077449,4.61493127438456,-2.37182075361008,27,48,-21,36,64,-28,53,84,-31,4,6,0,0
"14610","NSH","DAL",2018020798,17929,20182019,1,60,1,3,-2,4.02882215737964,2.67506445608888,1.35375770129076,39,26,13,54,34,20,70,45,25,4,2,0,0
"14611","NSH","ARI",2018020817,17932,20182019,1,60,5,2,3,7.5537007731109,2.5381539926425,5.0155467804684,47,26,21,61,35,26,82,44,38,5,3,0,0
"14612","NSH","DAL",2018020832,17934,20182019,1,60.7166666666667,3,2,1,4.5922977725507,7.32492802079651,-2.7326302482458,24,29,-5,36,44,-8,45,51,-6,2,3,0,0
"14613","NSH","MTL",2018020881,17941,20182019,1,60,3,1,2,4.02631449458568,4.26867840387786,-0.24236390929218,38,35,3,44,44,0,58,59,-1,3,3,0,0
"14614","NSH","VGK",2018020901,17943,20182019,0,60,1,5,-4,1.82119089033222,6.86005913300197,-5.03886824266975,30,50,-20,39,64,-25,52,78,-26,3,3,0,0
"14615","NSH","DAL",2018020923,17946,20182019,0,60,5,3,2,8.25820954252413,3.55191186688173,4.7062976756424,47,39,8,55,48,7,75,62,13,3,3,0,0
"14616","NSH","COL",2018020951,17950,20182019,1,60,0,5,-5,6.27411429496351,3.87722612149082,2.39688817347269,38,21,17,55,29,26,74,34,40,7,7,0,0
"14617","NSH","EDM",2018020965,17952,20182019,1,65,2,2,0,6.67428572796052,5.57216936824261,1.10211635971791,38,27,11,61,35,26,74,46,28,5,3,0,0
"14618","NSH","WPG",2018020996,17956,20182019,0,60,3,5,-2,5.92665354158817,6.96761130762752,-1.04095776603936,38,32,6,50,43,7,63,55,8,3,4,0,0
"14619","NSH","MIN",2018021015,17958,20182019,0,65,2,2,0,7.11183566847467,4.00198802366504,3.10984764480963,43,26,17,57,47,10,72,64,8,2,2,0,0
"14620","NSH","MIN",2018021024,17960,20182019,1,65,4,4,0,3.63833778254048,4.90406155008532,-1.26572376754484,25,33,-8,39,44,-5,53,60,-7,1,4,0,0
"14621","NSH","ANA",2018021079,17967,20182019,0,60,2,3,-1,8.0483025585516,4.92435498091808,3.12394757763352,34,18,16,53,33,20,71,45,26,7,4,0,0
"14622","NSH","TOR",2018021128,17974,20182019,1,60,3,0,3,4.35390114110101,3.07537785945846,1.27852328164255,20,22,-2,29,33,-4,40,51,-11,1,3,0,0
"14623","NSH","PIT",2018021141,17976,20182019,1,65,1,1,0,4.57964595412977,4.1995521824546,0.38009377167517,29,33,-4,38,54,-16,54,69,-15,3,2,0,0
"14624","NSH","WPG",2018021158,17978,20182019,0,60,0,5,-5,2.92825033503955,8.95078025507974,-6.02252992004018,33,43,-10,44,56,-12,66,67,-1,0,2,0,0
"14625","NSH","MIN",2018021174,17980,20182019,0,60,1,0,1,2.82577131711938,5.11576242592308,-2.2899911088037,19,29,-10,28,52,-24,43,69,-26,5,5,0,0
"14626","NSH","PIT",2018021198,17984,20182019,0,60,3,1,2,3.75177356575957,3.35328691637769,0.39848664938188,26,43,-17,42,46,-4,52,56,-4,2,4,0,0
"14627","NSH","CBJ",2018021210,17985,20182019,1,60,2,5,-3,2.96129773889697,5.29678604646324,-2.33548830756627,25,32,-7,32,47,-15,42,58,-16,2,6,0,0
"14628","NSH","CHI",2018021266,17992,20182019,1,60,5,2,3,6.5778361030425,3.24772012742628,3.33011597561622,50,33,17,61,40,21,72,55,17,3,2,0,0
"14629","NSH","DAL",2018030151,17996,20182019,1,60,2,3,-1,5.24951989687747,3.26174440025352,1.98777549662395,32,29,3,45,38,7,64,56,8,5,4,0,0
"14630","NSH","DAL",2018030152,17999,20182019,1,65,2,1,1,6.8469505785326,3.65995707231662,3.18699350621599,42,23,19,55,38,17,76,51,25,4,7,0,0
"14631","NSH","DAL",2018030153,18001,20182019,0,60,3,2,1,2.78810279881873,7.15540215079091,-4.36729935197218,28,42,-14,34,61,-27,47,89,-42,1,4,0,0
"14632","NSH","DAL",2018030154,18003,20182019,0,60,1,5,-4,3.31152069075802,4.61668541516394,-1.30516472440592,35,29,6,40,34,6,71,49,22,3,7,0,0
"14633","NSH","DAL",2018030155,18006,20182019,1,60,3,5,-2,7.95441051363741,4.1431024333906,3.81130808024682,33,26,7,50,35,15,65,44,21,2,3,0,0
"14634","NSH","DAL",2018030156,18008,20182019,0,77.0333333333333,1,2,-1,8.26104356954716,8.43907462628026,-0.178031056733097,48,51,-3,64,64,0,89,100,-11,4,1,0,0
"14635","NYI","N.J",2008020009,14162,20082009,0,60,1,2,-1,0,0,0,26,29,-3,33,42,-9,41,58,-17,8,6,0,0
"14636","NYI","STL",2008020018,14163,20082009,1,60,5,2,3,0,0,0,34,26,8,49,36,13,61,56,5,4,3,0,0
"14637","NYI","BUF",2008020033,14165,20082009,1,60,1,7,-6,0,0,0,24,35,-11,35,42,-7,48,61,-13,7,13,0,0
"14638","NYI","T.B",2008020051,14168,20082009,0,60.85,4,3,1,0,0,0,36,36,0,44,48,-4,58,58,0,10,7,0,0
"14639","NYI","FLA",2008020069,14170,20082009,0,60,0,2,-2,0,0,0,31,36,-5,39,53,-14,49,65,-16,2,6,0,0
"14640","NYI","DAL",2008020093,14175,20082009,1,60,3,5,-2,0,0,0,27,29,-2,42,43,-1,60,51,9,6,7,0,0
"14641","NYI","CAR",2008020108,14177,20082009,1,60,3,4,-1,0,0,0,60,28,32,73,40,33,95,58,37,8,3,0,0
"14642","NYI","NYR",2008020121,14179,20082009,1,60,2,4,-2,0,0,0,30,39,-9,40,48,-8,50,68,-18,6,10,0,0
"14643","NYI","PHI",2008020138,14182,20082009,0,64.6166666666667,2,3,-1,0,0,0,36,28,8,49,40,9,66,50,16,5,6,0,0
"14644","NYI","MTL",2008020155,14184,20082009,1,60,4,5,-1,0,0,0,31,32,-1,41,45,-4,59,66,-7,4,3,0,0
"14645","NYI","CBJ",2008020169,14186,20082009,1,63.2166666666667,4,3,1,0,0,0,29,34,-5,41,48,-7,59,66,-7,2,7,0,0
"14646","NYI","NYR",2008020171,14187,20082009,0,60,2,1,1,0,0,0,19,36,-17,25,55,-30,37,87,-50,5,7,0,0
"14647","NYI","ATL",2008020184,14189,20082009,0,60,3,4,-1,0,0,0,27,27,0,39,40,-1,52,50,2,5,4,0,0
"14648","NYI","PIT",2008020198,14191,20082009,1,65,3,3,0,0,0,0,22,32,-10,28,45,-17,42,74,-32,3,4,0,0
"14649","NYI","PHI",2008020215,14194,20082009,1,60,1,3,-2,0,0,0,36,32,4,50,42,8,73,59,14,8,4,0,0
"14650","NYI","OTT",2008020229,14196,20082009,0,60,3,1,2,0,0,0,31,30,1,37,42,-5,48,53,-5,5,6,0,0
"14651","NYI","OTT",2008020244,14198,20082009,1,60,3,2,1,0,0,0,31,40,-9,46,48,-2,62,66,-4,6,6,0,0
"14652","NYI","VAN",2008020257,14200,20082009,1,65,1,1,0,0,0,0,35,32,3,43,49,-6,63,65,-2,5,4,0,0
"14653","NYI","N.J",2008020280,14204,20082009,0,60,2,5,-3,0,0,0,27,33,-6,35,47,-12,46,66,-20,4,6,0,0
"14654","NYI","BUF",2008020287,14205,20082009,0,60,4,2,2,0,0,0,26,37,-11,33,46,-13,40,64,-24,6,2,0,0
"14655","NYI","MTL",2008020301,14207,20082009,0,65,3,3,0,0,0,0,25,26,-1,35,48,-13,45,73,-28,5,7,0,0
"14656","NYI","PIT",2008020310,14209,20082009,1,60,3,5,-2,0,0,0,25,30,-5,34,39,-5,44,59,-15,4,3,0,0
"14657","NYI","BOS",2008020323,14211,20082009,0,60,2,7,-5,0,0,0,24,39,-15,32,53,-21,37,67,-30,4,5,0,0
"14658","NYI","OTT",2008020339,14212,20082009,1,60,4,2,2,0,0,0,25,21,4,39,33,6,59,57,2,5,1,0,0
"14659","NYI","WSH",2008020368,14217,20082009,0,60,2,5,-3,0,0,0,29,47,-18,38,59,-21,52,77,-25,9,6,0,0
"14660","NYI","ATL",2008020383,14219,20082009,1,60,1,5,-4,0,0,0,29,17,12,44,27,17,59,42,17,7,10,0,0
"14661","NYI","TOR",2008020398,14221,20082009,0,60,2,4,-2,0,0,0,28,37,-9,36,47,-11,51,68,-17,3,4,0,0
"14662","NYI","PHI",2008020402,14222,20082009,0,60,3,4,-1,0,0,0,27,25,2,44,33,11,60,52,8,4,4,0,0
"14663","NYI","PIT",2008020417,14224,20082009,0,60,2,9,-7,0,0,0,26,38,-12,36,53,-17,50,62,-12,6,12,0,0
"14664","NYI","CBJ",2008020436,14226,20082009,0,60,1,3,-2,0,0,0,25,35,-10,30,51,-21,39,69,-30,4,3,0,0
"14665","NYI","WSH",2008020446,14229,20082009,1,64.8166666666667,4,5,-1,0,0,0,39,40,-1,49,55,-6,72,71,1,5,3,0,0
"14666","NYI","MIN",2008020471,14232,20082009,0,60,1,4,-3,0,0,0,16,39,-23,19,52,-33,31,63,-32,5,4,0,0
"14667","NYI","NSH",2008020481,14233,20082009,0,60,0,1,-1,0,0,0,23,28,-5,27,42,-15,38,61,-23,2,2,0,0
"14668","NYI","ATL",2008020495,14236,20082009,1,60,2,4,-2,0,0,0,25,27,-2,34,41,-7,59,53,6,3,3,0,0
"14669","NYI","TOR",2008020508,14239,20082009,1,60,4,1,3,0,0,0,31,29,2,38,38,0,53,61,-8,3,4,0,0
"14670","NYI","BUF",2008020516,14240,20082009,0,65,3,3,0,0,0,0,35,37,-2,46,45,1,61,57,4,4,6,0,0
"14671","NYI","NYR",2008020533,14242,20082009,0,60,4,5,-1,0,0,0,24,37,-13,29,53,-24,37,67,-30,2,5,0,0
"14672","NYI","FLA",2008020547,14244,20082009,1,60,4,2,2,0,0,0,35,29,6,48,41,7,58,57,1,6,4,0,0
"14673","NYI","ARI",2008020563,14246,20082009,0,60,4,5,-1,0,0,0,33,33,0,41,49,-8,50,64,-14,1,3,0,0
"14674","NYI","S.J",2008020575,14247,20082009,0,60,3,5,-2,0,0,0,24,47,-23,35,62,-27,45,84,-39,4,6,0,0
"14675","NYI","EDM",2008020584,14249,20082009,0,60,2,3,-1,0,0,0,27,26,1,38,41,-3,44,60,-16,2,3,0,0
"14676","NYI","CGY",2008020606,14252,20082009,0,60,2,5,-3,0,0,0,26,41,-15,40,59,-19,53,75,-22,6,4,0,0
"14677","NYI","NYR",2008020632,14257,20082009,1,60,1,2,-1,0,0,0,34,29,5,47,39,8,64,63,1,2,3,0,0
"14678","NYI","BOS",2008020646,14259,20082009,1,60,1,2,-1,0,0,0,41,27,14,58,35,23,81,45,36,3,3,0,0
"14679","NYI","N.J",2008020665,14261,20082009,1,60,1,3,-2,0,0,0,33,36,-3,52,50,2,71,74,-3,2,1,0,0
"14680","NYI","WSH",2008020678,14263,20082009,1,61.7666666666667,1,2,-1,0,0,0,28,38,-10,45,47,-2,61,66,-5,5,4,0,0
"14681","NYI","ANA",2008020693,14265,20082009,1,60,2,1,1,0,0,0,14,40,-26,21,54,-33,30,82,-52,1,5,0,0
"14682","NYI","ATL",2008020718,14273,20082009,0,60,5,4,1,0,0,0,33,37,-4,40,50,-10,50,66,-16,4,5,0,0
"14683","NYI","FLA",2008020735,14275,20082009,1,60,3,1,2,0,0,0,30,38,-8,39,53,-14,51,77,-26,4,4,0,0
"14684","NYI","T.B",2008020749,14278,20082009,1,60,3,1,2,0,0,0,27,30,-3,41,43,-2,51,54,-3,6,7,0,0
"14685","NYI","FLA",2008020766,14280,20082009,0,60,2,3,-1,0,0,0,22,29,-7,37,38,-1,55,50,5,4,2,0,0
"14686","NYI","T.B",2008020785,14282,20082009,0,60,0,1,-1,0,0,0,28,28,0,31,44,-13,41,59,-18,4,4,0,0
"14687","NYI","L.A",2008020796,14285,20082009,1,65,3,3,0,0,0,0,25,39,-14,39,58,-19,61,84,-23,3,5,0,0
"14688","NYI","N.J",2008020802,14286,20082009,0,60,2,4,-2,0,0,0,25,50,-25,32,63,-31,40,71,-31,3,5,0,0
"14689","NYI","PHI",2008020825,14289,20082009,0,60,1,5,-4,0,0,0,39,34,5,48,45,3,66,61,5,2,1,0,0
"14690","NYI","PIT",2008020841,14291,20082009,1,65,2,2,0,0,0,0,30,37,-7,44,51,-7,63,70,-7,2,4,0,0
"14691","NYI","NYR",2008020854,14293,20082009,0,60,1,3,-2,0,0,0,26,38,-12,39,51,-12,48,67,-19,5,6,0,0
"14692","NYI","CAR",2008020859,14294,20082009,1,60,2,6,-4,0,0,0,24,30,-6,37,43,-6,54,65,-11,5,3,0,0
"14693","NYI","N.J",2008020881,14296,20082009,1,60,4,0,4,0,0,0,38,40,-2,50,47,3,73,60,13,5,3,0,0
"14694","NYI","PIT",2008020906,14300,20082009,0,60,0,1,-1,0,0,0,21,28,-7,32,48,-16,50,64,-14,3,3,0,0
"14695","NYI","TOR",2008020910,14301,20082009,1,65,4,4,0,0,0,0,44,33,11,58,45,13,89,57,32,8,4,0,0
"14696","NYI","BUF",2008020928,14303,20082009,1,60,2,0,2,0,0,0,34,31,3,40,45,-5,59,67,-8,5,5,0,0
"14697","NYI","COL",2008020940,14305,20082009,1,60,4,2,2,0,0,0,31,22,9,41,38,3,64,58,6,2,3,0,0
"14698","NYI","NYR",2008020956,14308,20082009,1,60,2,4,-2,0,0,0,30,23,7,45,36,9,60,48,12,3,6,0,0
"14699","NYI","N.J",2008020970,14310,20082009,1,60,7,3,4,0,0,0,28,38,-10,35,53,-18,45,71,-26,2,6,0,0
"14700","NYI","ARI",2008020979,14311,20082009,1,60,3,2,1,0,0,0,26,42,-16,35,55,-20,54,66,-12,2,6,0,0
"14701","NYI","TOR",2008020992,14313,20082009,0,60.8333333333333,2,3,-1,0,0,0,30,28,2,54,41,13,73,56,17,5,2,0,0
"14702","NYI","MTL",2008021009,14315,20082009,0,60.4333333333333,3,2,1,0,0,0,39,26,13,47,41,6,61,63,-2,6,7,0,0
"14703","NYI","BOS",2008021018,14317,20082009,0,60,1,2,-1,0,0,0,22,25,-3,32,34,-2,51,47,4,6,4,0,0
"14704","NYI","CHI",2008021033,14318,20082009,0,60,4,2,2,0,0,0,19,42,-23,22,54,-32,30,73,-43,7,6,0,0
"14705","NYI","CAR",2008021064,14323,20082009,0,60,4,5,-1,0,0,0,32,37,-5,45,55,-10,64,75,-11,1,4,0,0
"14706","NYI","OTT",2008021072,14324,20082009,0,60,2,5,-3,0,0,0,22,26,-4,29,33,-4,41,43,-2,5,3,0,0
"14707","NYI","MIN",2008021097,14328,20082009,1,60,2,6,-4,0,0,0,34,28,6,47,44,3,61,57,4,8,11,0,0
"14708","NYI","DET",2008021112,14330,20082009,0,60,2,0,2,0,0,0,30,42,-12,36,66,-30,37,80,-43,3,6,0,0
"14709","NYI","PHI",2008021120,14331,20082009,1,65,3,3,0,0,0,0,33,36,-3,47,46,1,65,60,5,5,4,0,0
"14710","NYI","WSH",2008021144,14335,20082009,0,60,3,5,-2,0,0,0,27,43,-16,38,62,-24,58,87,-29,4,4,0,0
"14711","NYI","MTL",2008021151,14336,20082009,1,60,1,5,-4,0,0,0,27,38,-11,36,57,-21,48,73,-25,3,8,0,0
"14712","NYI","T.B",2008021168,14338,20082009,1,60,3,1,2,0,0,0,21,30,-9,31,37,-6,41,56,-15,6,4,0,0
"14713","NYI","CAR",2008021187,14341,20082009,0,60,0,9,-9,0,0,0,12,57,-45,19,78,-59,30,96,-66,1,10,0,0
"14714","NYI","PIT",2008021204,14343,20082009,0,60,1,6,-5,0,0,0,29,37,-8,41,46,-5,58,59,-1,7,2,0,0
"14715","NYI","PHI",2008021215,14345,20082009,1,60,2,3,-1,0,0,0,32,27,5,45,35,10,56,40,16,3,3,0,0
"14716","NYI","BOS",2008021228,14346,20082009,1,60,2,6,-4,0,0,0,34,33,1,41,45,-4,58,66,-8,4,5,0,0
"14717","NYI","PIT",2009020013,14520,20092010,1,65,3,3,0,0,0,0,28,42,-14,42,60,-18,60,89,-29,6,3,0,0
"14718","NYI","OTT",2009020037,14525,20092010,0,60.5333333333333,2,3,-1,0,0,0,25,28,-3,40,39,1,61,52,9,4,2,0,0
"14719","NYI","BOS",2009020049,14527,20092010,0,65,3,3,0,0,0,0,38,30,8,51,46,5,63,57,6,6,5,0,0
"14720","NYI","L.A",2009020065,14529,20092010,1,60,1,2,-1,0,0,0,29,22,7,40,29,11,53,44,9,3,3,0,0
"14721","NYI","BUF",2009020088,14533,20092010,0,60,3,6,-3,0,0,0,39,34,5,49,47,2,61,57,4,2,5,0,0
"14722","NYI","S.J",2009020097,14534,20092010,1,60,1,4,-3,0,0,0,32,29,3,39,38,1,51,62,-11,5,5,0,0
"14723","NYI","CAR",2009020113,14538,20092010,1,65,3,3,0,0,0,0,29,38,-9,38,53,-15,42,71,-29,3,4,0,0
"14724","NYI","MTL",2009020118,14539,20092010,0,60,1,5,-4,0,0,0,22,43,-21,32,53,-21,44,82,-38,3,6,0,0
"14725","NYI","WSH",2009020132,14541,20092010,1,61,2,3,-1,0,0,0,30,24,6,38,43,-5,49,68,-19,2,4,0,0
"14726","NYI","MTL",2009020149,14543,20092010,0,61.5333333333333,2,3,-1,0,0,0,31,31,0,37,49,-12,53,75,-22,7,2,0,0
"14727","NYI","NYR",2009020156,14545,20092010,1,60,3,1,2,0,0,0,32,35,-3,41,50,-9,51,66,-15,4,5,0,0
"14728","NYI","WSH",2009020172,14547,20092010,0,60.8833333333333,4,3,1,0,0,0,30,40,-10,43,51,-8,57,68,-11,3,5,0,0
"14729","NYI","BUF",2009020185,14548,20092010,1,60,5,0,5,0,0,0,30,38,-8,36,52,-16,46,71,-25,4,7,0,0
"14730","NYI","EDM",2009020195,14550,20092010,1,60,3,1,2,0,0,0,37,23,14,48,36,12,65,49,16,5,1,0,0
"14731","NYI","BUF",2009020203,14552,20092010,0,60,0,3,-3,0,0,0,24,39,-15,34,54,-20,42,66,-24,4,7,0,0
"14732","NYI","N.J",2009020219,14554,20092010,0,60,1,2,-1,0,0,0,24,31,-7,27,37,-10,30,40,-10,3,5,0,0
"14733","NYI","ATL",2009020230,14555,20092010,1,60,6,3,3,0,0,0,45,34,11,55,50,5,72,65,7,4,4,0,0
"14734","NYI","WSH",2009020249,14559,20092010,0,65,4,4,0,0,0,0,31,41,-10,39,50,-11,56,77,-21,3,3,0,0
"14735","NYI","CAR",2009020263,14561,20092010,0,64.75,4,3,1,0,0,0,25,28,-3,38,51,-13,44,75,-31,5,5,0,0
"14736","NYI","FLA",2009020272,14562,20092010,0,65,4,4,0,0,0,0,40,42,-2,49,59,-10,56,80,-24,4,5,0,0
"14737","NYI","BOS",2009020283,14564,20092010,0,60,4,1,3,0,0,0,21,29,-8,30,40,-10,40,55,-15,6,4,0,0
"14738","NYI","MIN",2009020310,14568,20092010,0,60,2,3,-1,0,0,0,29,29,0,40,40,0,52,54,-2,7,6,0,0
"14739","NYI","STL",2009020320,14569,20092010,0,60,1,4,-3,0,0,0,24,26,-2,39,44,-5,49,55,-6,3,4,0,0
"14740","NYI","TOR",2009020329,14571,20092010,0,64.2833333333333,4,3,1,0,0,0,21,61,-40,41,88,-47,56,116,-60,2,6,0,0
"14741","NYI","PHI",2009020340,14573,20092010,1,60,1,2,-1,0,0,0,29,28,1,43,41,2,66,50,16,5,1,0,0
"14742","NYI","PIT",2009020357,14575,20092010,1,60,3,2,1,0,0,0,37,21,16,58,34,24,73,48,25,5,6,0,0
"14743","NYI","N.J",2009020367,14576,20092010,0,60,1,6,-5,0,0,0,23,42,-19,30,51,-21,36,57,-21,4,3,0,0
"14744","NYI","ATL",2009020401,14581,20092010,0,60,4,1,3,0,0,0,27,27,0,41,33,8,55,46,9,3,2,0,0
"14745","NYI","T.B",2009020423,14583,20092010,0,60,0,4,-4,0,0,0,30,25,5,40,38,2,58,51,7,7,4,0,0
"14746","NYI","PHI",2009020438,14586,20092010,0,60,2,6,-4,0,0,0,24,37,-13,41,47,-6,52,58,-6,9,6,0,0
"14747","NYI","TOR",2009020443,14587,20092010,0,60,2,3,-1,0,0,0,32,35,-3,40,49,-9,55,69,-14,5,6,0,0
"14748","NYI","BOS",2009020469,14590,20092010,1,60.4,3,2,1,0,0,0,19,32,-13,25,45,-20,34,61,-27,2,3,0,0
"14749","NYI","FLA",2009020482,14592,20092010,1,60,1,7,-6,0,0,0,31,26,5,37,36,1,59,53,6,2,2,0,0
"14750","NYI","NYR",2009020495,14594,20092010,0,60,2,1,1,0,0,0,28,26,2,46,45,1,53,73,-20,4,4,0,0
"14751","NYI","NYR",2009020503,14595,20092010,1,60,2,5,-3,0,0,0,37,22,15,54,31,23,71,44,27,9,9,0,0
"14752","NYI","MTL",2009020523,14597,20092010,1,60,0,3,-3,0,0,0,40,28,12,51,46,5,75,58,17,6,6,0,0
"14753","NYI","T.B",2009020532,14599,20092010,1,60,2,4,-2,0,0,0,38,28,10,51,40,11,67,52,15,6,4,0,0
"14754","NYI","TOR",2009020546,14601,20092010,1,60,3,1,2,0,0,0,23,27,-4,38,37,1,53,66,-13,4,2,0,0
"14755","NYI","NYR",2009020559,14604,20092010,0,64.2166666666667,3,2,1,0,0,0,22,38,-16,31,56,-25,47,82,-35,4,4,0,0
"14756","NYI","PHI",2009020570,14605,20092010,1,60,1,2,-1,0,0,0,29,30,-1,38,47,-9,56,67,-11,5,5,0,0
"14757","NYI","CBJ",2009020585,14607,20092010,1,65,1,1,0,0,0,0,25,42,-17,40,51,-11,56,79,-23,4,3,0,0
"14758","NYI","OTT",2009020599,14609,20092010,0,65,2,2,0,0,0,0,27,36,-9,35,46,-11,48,65,-17,6,5,0,0
"14759","NYI","ATL",2009020615,14611,20092010,1,65,5,5,0,0,0,0,36,27,9,50,40,10,62,57,5,5,6,0,0
"14760","NYI","COL",2009020643,14615,20092010,0,60,3,2,1,0,0,0,35,32,3,45,40,5,56,58,-2,2,3,0,0
"14761","NYI","ARI",2009020669,14618,20092010,0,65,4,4,0,0,0,0,30,29,1,43,41,2,48,61,-13,4,5,0,0
"14762","NYI","DET",2009020681,14621,20092010,1,60,6,0,6,0,0,0,31,16,15,44,29,15,74,44,30,3,3,0,0
"14763","NYI","BUF",2009020713,14625,20092010,1,65,2,2,0,0,0,0,38,33,5,50,50,0,71,70,1,5,3,0,0
"14764","NYI","N.J",2009020724,14627,20092010,1,60,4,0,4,0,0,0,46,20,26,55,36,19,77,65,12,4,2,0,0
"14765","NYI","PIT",2009020738,14628,20092010,0,60,4,6,-2,0,0,0,35,29,6,41,42,-1,51,55,-4,4,6,0,0
"14766","NYI","FLA",2009020746,14630,20092010,1,65,1,1,0,0,0,0,36,34,2,51,48,3,79,69,10,1,3,0,0
"14767","NYI","N.J",2009020763,14632,20092010,1,60,2,4,-2,0,0,0,22,28,-6,38,35,3,61,61,0,2,1,0,0
"14768","NYI","WSH",2009020779,14635,20092010,1,60,2,7,-5,0,0,0,31,33,-2,40,38,2,58,57,1,5,2,0,0
"14769","NYI","CAR",2009020795,14637,20092010,0,60,1,4,-3,0,0,0,27,23,4,49,36,13,69,47,22,2,3,0,0
"14770","NYI","PHI",2009020810,14639,20092010,0,60,1,2,-1,0,0,0,32,32,0,42,39,3,61,58,3,6,7,0,0
"14771","NYI","FLA",2009020820,14640,20092010,0,60,0,2,-2,0,0,0,33,25,8,49,41,8,70,47,23,6,5,0,0
"14772","NYI","T.B",2009020845,14644,20092010,0,60,2,5,-3,0,0,0,36,31,5,50,37,13,61,45,16,4,3,0,0
"14773","NYI","CAR",2009020860,14646,20092010,1,60,1,3,-2,0,0,0,35,25,10,47,35,12,70,49,21,5,4,0,0
"14774","NYI","NSH",2009020877,14649,20092010,1,65,3,3,0,0,0,0,32,27,5,53,36,17,73,53,20,7,6,0,0
"14775","NYI","PIT",2009020887,14650,20092010,0,60,1,3,-2,0,0,0,38,28,10,53,42,11,64,50,14,6,5,0,0
"14776","NYI","T.B",2009020905,14653,20092010,1,60,5,4,1,0,0,0,33,42,-9,43,50,-7,51,64,-13,4,5,0,0
"14777","NYI","OTT",2009020919,14654,20092010,1,60,3,4,-1,0,0,0,37,35,2,50,44,6,65,61,4,5,2,0,0
"14778","NYI","CHI",2009020925,14670,20092010,1,60,5,3,2,0,0,0,23,44,-21,31,61,-30,40,82,-42,0,3,0,0
"14779","NYI","ATL",2009020945,14672,20092010,0,60,3,6,-3,0,0,0,37,22,15,43,31,12,55,40,15,5,3,0,0
"14780","NYI","BOS",2009020956,14674,20092010,1,60,2,3,-1,0,0,0,39,34,5,51,45,6,67,60,7,1,2,0,0
"14781","NYI","PHI",2009020977,14677,20092010,0,60,2,3,-1,0,0,0,25,35,-10,34,47,-13,50,70,-20,1,4,0,0
"14782","NYI","STL",2009020991,14679,20092010,1,65,1,1,0,0,0,0,30,36,-6,43,50,-7,60,69,-9,5,6,0,0
"14783","NYI","N.J",2009021009,14681,20092010,1,60,4,2,2,0,0,0,29,40,-11,41,48,-7,58,63,-5,3,3,0,0
"14784","NYI","TOR",2009021018,14682,20092010,1,60,4,1,3,0,0,0,32,27,5,45,36,9,58,52,6,8,9,0,0
"14785","NYI","VAN",2009021038,14684,20092010,0,60,5,2,3,0,0,0,20,37,-17,32,51,-19,37,72,-35,4,2,0,0
"14786","NYI","ANA",2009021056,14687,20092010,0,60.2333333333333,4,5,-1,0,0,0,31,39,-8,39,55,-16,44,71,-27,5,4,0,0
"14787","NYI","L.A",2009021067,14688,20092010,0,60,0,1,-1,0,0,0,26,26,0,46,36,10,60,44,16,4,4,0,0
"14788","NYI","NYR",2009021090,14692,20092010,0,60,0,5,-5,0,0,0,27,44,-17,42,58,-16,64,81,-17,3,6,0,0
"14789","NYI","CGY",2009021098,14693,20092010,1,60,3,2,1,0,0,0,22,23,-1,33,33,0,50,52,-2,2,5,0,0
"14790","NYI","CBJ",2009021117,14695,20092010,0,62.9666666666667,4,3,1,0,0,0,28,37,-9,45,48,-3,52,62,-10,0,4,0,0
"14791","NYI","NYR",2009021135,14698,20092010,1,60,3,4,-1,0,0,0,28,27,1,35,38,-3,50,53,-3,5,3,0,0
"14792","NYI","PHI",2009021151,14700,20092010,1,60,6,4,2,0,0,0,28,35,-7,32,43,-11,47,65,-18,3,3,0,0
"14793","NYI","OTT",2009021165,14702,20092010,1,60,4,1,3,0,0,0,33,29,4,43,39,4,56,51,5,3,3,0,0
"14794","NYI","MTL",2009021184,14705,20092010,1,65,3,3,0,0,0,0,42,31,11,55,38,17,81,52,29,4,3,0,0
"14795","NYI","PIT",2009021200,14707,20092010,0,60,3,7,-4,0,0,0,35,35,0,46,48,-2,66,57,9,7,7,0,0
"14796","NYI","N.J",2009021216,14709,20092010,0,60,1,7,-6,0,0,0,19,37,-18,30,52,-22,39,61,-22,5,7,0,0
"14797","NYI","PIT",2009021228,14710,20092010,1,64.4166666666667,5,6,-1,0,0,0,38,37,1,48,46,2,62,64,-2,11,8,0,0
"14798","NYI","DAL",2010020015,14891,20102011,1,65,4,4,0,7.16903303560113,3.00816223930451,4.16087079629662,47,22,25,69,33,36,82,49,33,8,7,0,0
"14799","NYI","NYR",2010020028,14893,20102011,1,60,6,4,2,4.8421226486098,4.72879235527944,0.113330293330364,32,33,-1,37,45,-8,51,63,-12,6,5,0,0
"14800","NYI","WSH",2010020037,14895,20102011,0,60,1,2,-1,4.25447444933525,2.65727610571776,1.59719834361749,24,26,-2,39,35,4,61,48,13,3,4,0,0
"14801","NYI","PIT",2010020050,14897,20102011,0,61.85,2,3,-1,3.79135311219989,4.7688948766845,-0.977541764484613,24,29,-5,36,46,-10,50,65,-15,4,8,0,0
"14802","NYI","COL",2010020057,14898,20102011,1,60,5,2,3,5.96273784839035,4.73288643230146,1.22985141608889,25,30,-5,30,48,-18,44,61,-17,7,4,0,0
"14803","NYI","TOR",2010020069,14900,20102011,0,63.4333333333333,2,1,1,2.7326668676203,5.28994970997684,-2.55728284235654,20,30,-10,28,51,-23,38,74,-36,3,3,0,0
"14804","NYI","T.B",2010020087,14903,20102011,0,61.9333333333333,3,2,1,2.23577612376539,3.42104747143821,-1.18527134767282,25,30,-5,40,41,-1,45,58,-13,5,4,0,0
"14805","NYI","FLA",2010020103,14905,20102011,0,60,3,4,-1,2.87059775530361,2.86567079937885,0.00492695592475911,33,30,3,38,39,-1,46,48,-2,5,6,0,0
"14806","NYI","MTL",2010020125,14909,20102011,0,60,3,5,-2,3.20673473289753,5.64402785861838,-2.43729312572085,21,35,-14,26,49,-23,39,63,-24,4,4,0,0
"14807","NYI","MTL",2010020137,14911,20102011,1,60,1,3,-2,3.55147696955819,5.37646588645028,-1.82498891689209,31,26,5,48,41,7,74,50,24,7,3,0,0
"14808","NYI","PHI",2010020146,14912,20102011,0,60,1,6,-5,2.73144727274421,6.14038699370595,-3.40893972096174,31,29,2,40,48,-8,52,63,-11,7,9,0,0
"14809","NYI","CAR",2010020166,14916,20102011,0,60,2,7,-5,6.15108679120951,3.36766882994561,2.78341796126389,33,32,1,52,41,11,66,56,10,3,4,0,0
"14810","NYI","OTT",2010020175,14917,20102011,0,60,1,4,-3,6.06098680949981,5.17562678821196,0.885360021287852,29,27,2,36,37,-1,53,52,1,2,3,0,0
"14811","NYI","PHI",2010020191,14919,20102011,1,60,1,2,-1,3.51105981513917,4.36163310871596,-0.85057329357679,32,26,6,49,43,6,75,52,23,6,2,0,0
"14812","NYI","ANA",2010020216,14923,20102011,0,60,0,1,-1,1.91275481761841,1.82015108832456,0.0926037292938418,27,14,13,48,21,27,63,34,29,6,2,0,0
"14813","NYI","S.J",2010020226,14924,20102011,0,65,1,1,0,3.60894448483918,3.95654870625731,-0.347604221418123,25,38,-13,38,58,-20,49,79,-30,1,5,0,0
"14814","NYI","L.A",2010020243,14926,20102011,0,60,1,5,-4,2.53407886037965,4.2059856976266,-1.67190683724696,19,34,-15,30,51,-21,40,61,-21,5,4,0,0
"14815","NYI","T.B",2010020257,14930,20102011,1,60,2,4,-2,5.70749811240799,3.92364117652585,1.78385693588214,36,40,-4,45,50,-5,66,61,5,3,5,0,0
"14816","NYI","FLA",2010020286,14933,20102011,1,60,1,4,-3,5.07966069130998,3.71457912828191,1.36508156302807,40,31,9,52,46,6,76,65,11,4,6,0,0
"14817","NYI","ATL",2010020294,14934,20102011,0,61.5,1,2,-1,4.66148489236366,3.76452200984144,0.896962882522217,29,35,-6,35,48,-13,54,71,-17,4,4,0,0
"14818","NYI","CBJ",2010020308,14937,20102011,1,62.5166666666667,3,4,-1,6.15868960649095,4.66762845973245,1.4910611467585,24,38,-14,36,48,-12,48,64,-16,4,6,0,0
"14819","NYI","N.J",2010020322,14939,20102011,1,60,2,0,2,2.80410823361308,5.30227383380419,-2.49816560019111,20,29,-9,26,48,-22,37,75,-38,2,4,0,0
"14820","NYI","NYR",2010020368,14945,20102011,1,60,5,6,-1,3.69748377567157,4.6055528355937,-0.908069059922127,32,26,6,43,43,0,57,58,-1,1,2,0,0
"14821","NYI","NYR",2010020373,14946,20102011,0,60,0,2,-2,2.89441357314893,3.39603660357216,-0.501623030423225,17,21,-4,29,31,-2,42,53,-11,4,7,0,0
"14822","NYI","PHI",2010020391,14948,20102011,1,60,2,3,-1,4.05925049465208,3.72932909437632,0.329921400275763,30,27,3,41,45,-4,64,63,1,4,4,0,0
"14823","NYI","BOS",2010020411,14952,20102011,0,60,2,5,-3,3.88847397002344,7.61922151977342,-3.73074754974998,35,37,-2,46,50,-4,62,70,-8,4,5,0,0
"14824","NYI","ATL",2010020429,14954,20102011,1,60,4,5,-1,4.38871887335435,4.73618066775594,-0.347461794401585,29,35,-6,43,51,-8,68,76,-8,5,5,0,0
"14825","NYI","NSH",2010020443,14956,20102011,0,60,0,5,-5,2.51863842041058,5.00493153385469,-2.48629311344411,28,26,2,41,39,2,53,52,1,3,4,0,0
"14826","NYI","ANA",2010020460,14959,20102011,1,60,3,2,1,4.27598263289524,5.33183614133263,-1.05585350843738,29,32,-3,39,48,-9,52,68,-16,4,6,0,0
"14827","NYI","ARI",2010020475,14961,20102011,1,65,3,3,0,6.38485249763471,8.00837245949043,-1.62351996185572,44,35,9,51,56,-5,66,85,-19,8,7,0,0
"14828","NYI","T.B",2010020502,14965,20102011,1,63.3833333333333,2,1,1,6.09584679435033,2.88405321547179,3.21179357887853,28,35,-7,47,46,1,60,64,-4,2,6,0,0
"14829","NYI","N.J",2010020508,14966,20102011,0,60,5,1,4,3.23659961821977,5.92002233660605,-2.68342271838628,14,35,-21,19,50,-31,23,63,-40,1,4,0,0
"14830","NYI","MTL",2010020521,14969,20102011,1,60,4,1,3,2.07542234803306,5.45759007479994,-3.38216772676688,25,39,-14,35,56,-21,43,73,-30,7,3,0,0
"14831","NYI","NYR",2010020530,14970,20102011,0,60,2,7,-5,3.28043302587139,5.45612177194562,-2.17568874607423,20,52,-32,26,63,-37,39,73,-34,5,7,0,0
"14832","NYI","PIT",2010020546,14972,20102011,1,65,1,1,0,3.02573297148971,10.5001798940948,-7.47444692260504,26,38,-12,36,56,-20,42,84,-42,6,5,0,0
"14833","NYI","DET",2010020560,14974,20102011,0,63.95,4,3,1,4.54971092526102,7.23079226745176,-2.68108134219074,23,41,-18,35,55,-20,41,78,-37,2,5,0,0
"14834","NYI","CGY",2010020583,14977,20102011,0,60,5,2,3,5.43853276276059,5.71692307498597,-0.278390312225383,26,43,-17,34,61,-27,52,79,-27,2,2,0,0
"14835","NYI","EDM",2010020602,14980,20102011,0,60,1,2,-1,4.86364904834772,2.12340210088587,2.74024694746186,31,22,9,49,27,22,72,46,26,8,2,0,0
"14836","NYI","COL",2010020613,14982,20102011,0,63.8666666666667,4,3,1,4.53683992521837,4.0494285330642,0.487411392154172,27,37,-10,41,47,-6,51,73,-22,4,3,0,0
"14837","NYI","CHI",2010020626,14983,20102011,0,60,0,5,-5,1.9895978346467,3.4502638548438,-1.4606660201971,29,45,-16,38,59,-21,53,78,-25,3,6,0,0
"14838","NYI","VAN",2010020634,14985,20102011,1,65,3,3,0,6.24866469897097,9.58475069353881,-3.33608599456784,41,51,-10,51,64,-13,67,79,-12,2,2,0,0
"14839","NYI","OTT",2010020648,14987,20102011,1,60,4,6,-2,1.93372480242084,5.42197491638944,-3.4882501139686,24,38,-14,34,47,-13,51,59,-8,3,4,0,0
"14840","NYI","BUF",2010020663,14989,20102011,1,60,5,3,2,5.06221949633618,11.0693308255941,-6.0071113292579,37,43,-6,50,63,-13,65,83,-18,3,5,0,0
"14841","NYI","N.J",2010020678,14991,20102011,1,60,2,5,-3,5.62881405939606,3.19186131079914,2.43695274859692,29,27,2,48,34,14,59,44,15,3,2,0,0
"14842","NYI","WSH",2010020699,14994,20102011,1,60,1,2,-1,4.20105617772788,3.68912525457563,0.511930923152249,25,24,1,36,36,0,56,44,12,6,2,0,0
"14843","NYI","BUF",2010020708,14995,20102011,0,60,5,2,3,5.30660907243146,7.68277491186745,-2.376165839436,29,38,-9,39,54,-15,44,70,-26,3,3,0,0
"14844","NYI","BUF",2010020724,14997,20102011,1,60,3,5,-2,5.61325666221092,3.74765936295091,1.86559729926,34,23,11,45,34,11,61,49,12,4,2,0,0
"14845","NYI","PIT",2010020736,14999,20102011,0,60,0,1,-1,3.35876626399113,1.79559473304471,1.56317153094642,29,31,-2,34,41,-7,50,51,-1,3,3,0,0
"14846","NYI","CAR",2010020743,15000,20102011,1,60,2,4,-2,4.13213241722673,4.16960161881434,-0.0374692015876148,25,31,-6,42,45,-3,60,55,5,5,7,0,0
"14847","NYI","ATL",2010020756,15006,20102011,0,60,4,1,3,3.89218818204245,5.10700151120545,-1.21481332916301,33,26,7,40,42,-2,57,52,5,1,1,0,0
"14848","NYI","PIT",2010020765,15007,20102011,0,60,0,3,-3,4.2664712105963,3.34822642545657,0.918244785139731,20,23,-3,32,36,-4,57,51,6,8,9,0,0
"14849","NYI","OTT",2010020786,15010,20102011,1,60,5,3,2,5.96421492370428,3.10861329839906,2.85560162530521,38,23,15,47,34,13,61,56,5,7,4,0,0
"14850","NYI","TOR",2010020803,15013,20102011,1,60,3,5,-2,4.2324506354596,3.91910490356341,0.313345731896195,34,26,8,43,38,5,63,49,14,4,5,0,0
"14851","NYI","MTL",2010020819,15015,20102011,0,65,3,3,0,5.64482755344943,5.24255437203101,0.402273181418423,33,40,-7,48,54,-6,62,76,-14,5,4,0,0
"14852","NYI","PIT",2010020823,15016,20102011,1,60,9,3,6,3.84265654527871,5.13188030154561,-1.28922375626689,36,38,-2,47,51,-4,63,73,-10,14,14,0,0
"14853","NYI","BUF",2010020837,15018,20102011,0,62.9166666666667,7,6,1,3.4061261956158,5.63873604137916,-2.23260984576336,26,28,-2,34,41,-7,45,59,-14,6,3,0,0
"14854","NYI","OTT",2010020850,15020,20102011,0,65,3,3,0,5.46496548787864,5.23737162340964,0.227593864469,28,31,-3,46,41,5,53,60,-7,4,5,0,0
"14855","NYI","BOS",2010020863,15022,20102011,1,60,3,6,-3,6.26115175726591,3.42999012264772,2.83116163461818,37,34,3,50,44,6,64,61,3,1,2,0,0
"14856","NYI","L.A",2010020879,15024,20102011,1,60,3,0,3,3.50043246520012,4.04761755823813,-0.54718509303801,23,35,-12,33,46,-13,47,65,-18,4,5,0,0
"14857","NYI","FLA",2010020891,15026,20102011,1,60,5,1,4,7.48154184488513,1.79937476952909,5.68216707535604,37,21,16,49,33,16,64,56,8,3,5,0,0
"14858","NYI","TOR",2010020894,15027,20102011,0,60,1,2,-1,4.98554728916497,3.57006111582114,1.41548617334383,29,25,4,40,39,1,52,57,-5,7,5,0,0
"14859","NYI","PHI",2010020909,15029,20102011,0,64.7,3,4,-1,5.24530100169773,6.13015815175459,-0.88485715005686,35,43,-8,43,57,-14,66,79,-13,1,1,0,0
"14860","NYI","WSH",2010020930,15031,20102011,1,60,2,3,-1,4.13088746315392,3.74341936805286,0.387468095101063,31,22,9,40,36,4,58,57,1,4,2,0,0
"14861","NYI","WSH",2010020943,15034,20102011,0,61.9166666666667,1,2,-1,5.6478850179119,4.33664501377474,1.31124000413716,29,42,-13,44,52,-8,62,71,-9,4,2,0,0
"14862","NYI","MIN",2010020954,15035,20102011,1,60,4,1,3,0,0,0,41,34,7,51,54,-3,64,82,-18,4,2,0,0
"14863","NYI","STL",2010020973,15038,20102011,1,60,5,2,3,2.70700441157533,3.90285788275824,-1.19585347118291,22,23,-1,36,36,0,48,50,-2,5,4,0,0
"14864","NYI","N.J",2010020983,15039,20102011,1,65,2,2,0,2.41233995840776,4.48076034890255,-2.06842039049479,22,29,-7,32,38,-6,44,54,-10,4,2,0,0
"14865","NYI","TOR",2010020993,15041,20102011,1,64.0333333333333,4,3,1,7.32157719894944,4.2894744129444,3.03210278600504,40,27,13,52,38,14,66,55,11,2,4,0,0
"14866","NYI","BOS",2010021015,15044,20102011,1,60,4,2,2,7.42694403946371,3.82220473733469,3.60473930212902,42,28,14,52,45,7,76,61,15,3,4,0,0
"14867","NYI","N.J",2010021025,15045,20102011,0,63.15,2,3,-1,2.62784213619307,5.23555079121661,-2.60770865502354,15,35,-20,23,49,-26,33,67,-34,1,5,0,0
"14868","NYI","NYR",2010021043,15048,20102011,0,60,3,6,-3,2.71893511749863,6.45061503565057,-3.73167991815194,28,47,-19,31,56,-25,42,64,-22,7,9,0,0
"14869","NYI","CAR",2010021068,15051,20102011,0,63.9666666666667,2,3,-1,5.28903857444675,5.31968284961366,-0.0306442751669067,37,35,2,48,50,-2,65,73,-8,4,2,0,0
"14870","NYI","FLA",2010021074,15052,20102011,0,65,3,3,0,3.71732041265932,4.40858902062337,-0.691268607964048,21,32,-11,35,50,-15,50,66,-16,3,3,0,0
"14871","NYI","T.B",2010021093,15055,20102011,0,60,5,2,3,4.39746667317789,4.12525847495999,0.2722081982179,28,38,-10,34,50,-16,44,72,-28,6,8,0,0
"14872","NYI","ATL",2010021103,15057,20102011,1,60,1,2,-1,1.58488617089461,4.05877551030972,-2.47388933941511,15,34,-19,27,53,-26,47,74,-27,5,4,0,0
"14873","NYI","PHI",2010021120,15059,20102011,1,60,1,4,-3,6.5629245499149,2.92473164077542,3.63819290913948,37,22,15,51,33,18,67,41,26,4,1,0,0
"14874","NYI","N.J",2010021146,15063,20102011,0,60,2,3,-1,3.13997602824384,1.63520532326902,1.50477070497482,29,20,9,33,28,5,43,39,4,3,5,0,0
"14875","NYI","NYR",2010021151,15064,20102011,1,60,6,2,4,4.75843958941459,3.34850810628268,1.40993148313191,33,27,6,43,43,0,57,60,-3,5,11,0,0
"14876","NYI","CAR",2010021170,15066,20102011,1,60,2,4,-2,4.25534197269008,4.74772941480108,-0.492387442111002,31,26,5,39,40,-1,52,58,-6,5,4,0,0
"14877","NYI","BOS",2010021193,15070,20102011,0,60,2,3,-1,2.30530011428527,3.7529459700454,-1.44764585576013,32,33,-1,36,45,-9,51,61,-10,3,6,0,0
"14878","NYI","PIT",2010021205,15072,20102011,1,65,3,3,0,5.75885535124689,3.44382410626739,2.31503124497951,38,38,0,47,47,0,60,55,5,8,6,0,0
"14879","NYI","PHI",2010021218,15073,20102011,0,60,4,7,-3,9.22677906946875,6.76513387328237,2.46164519618638,36,39,-3,54,51,3,68,69,-1,7,6,0,0
"14880","NYI","FLA",2011020014,15255,20112012,1,60,0,2,-2,4.14775019704393,4.36566294749298,-0.217912750449045,27,29,-2,37,41,-4,50,65,-15,4,6,0,0
"14881","NYI","MIN",2011020027,15257,20112012,1,60,2,1,1,1.32311057401375,2.47563538036206,-1.15252480634831,14,21,-7,23,37,-14,38,54,-16,4,8,0,0
"14882","NYI","T.B",2011020038,15260,20112012,1,60,5,1,4,4.79272425926213,3.10533569630472,1.6873885629574,34,35,-1,44,46,-2,57,61,-4,5,4,0,0
"14883","NYI","NYR",2011020051,15262,20112012,1,60,4,2,2,5.72966458165081,3.18192845513662,2.54773612651418,34,31,3,45,37,8,59,45,14,8,4,0,0
"14884","NYI","T.B",2011020084,15267,20112012,0,60,1,4,-3,2.23173412507595,4.98936091020551,-2.75762678512956,17,30,-13,29,46,-17,39,69,-30,3,4,0,0
"14885","NYI","FLA",2011020105,15269,20112012,0,60,2,4,-2,3.74168590389309,5.86863906128701,-2.12695315739393,28,33,-5,39,48,-9,46,57,-11,5,3,0,0
"14886","NYI","PIT",2011020114,15272,20112012,1,60,0,3,-3,3.80114643054549,5.14477266115318,-1.3436262306077,33,29,4,38,40,-2,64,57,7,3,2,0,0
"14887","NYI","PIT",2011020129,15274,20112012,0,65,2,2,0,1.94576034451666,2.77223840745864,-0.826478062941987,19,32,-13,30,48,-18,44,71,-27,3,7,0,0
"14888","NYI","S.J",2011020144,15276,20112012,1,61.1166666666667,2,3,-1,5.3262768223135,4.47511775029125,0.851159072022254,37,30,7,45,40,5,61,53,8,4,4,0,0
"14889","NYI","WPG",2011020168,15281,20112012,1,60,0,3,-3,5.07803905842593,6.83041411414158,-1.75237505571565,34,26,8,48,40,8,67,49,18,3,0,0,0
"14890","NYI","WSH",2011020187,15283,20112012,1,60,5,3,2,5.75431329935964,5.11983642715495,0.634476872204687,35,28,7,41,40,1,55,59,-4,4,1,0,0
"14891","NYI","BOS",2011020200,15285,20112012,0,60,2,6,-4,5.60642015450867,6.13539186998969,-0.528971715481021,26,37,-11,35,45,-10,47,53,-6,4,1,0,0
"14892","NYI","COL",2011020218,15288,20112012,0,62.65,3,4,-1,4.01568269242125,7.06816747700123,-3.05248478457997,33,51,-18,39,61,-22,56,85,-29,5,7,0,0
"14893","NYI","VAN",2011020243,15291,20112012,0,60,1,4,-3,2.74339159583906,8.60651994244108,-5.86312834660202,24,36,-12,30,54,-24,51,81,-30,0,3,0,0
"14894","NYI","NYR",2011020249,15293,20112012,1,60,2,4,-2,4.02483862487134,3.49272370879815,0.532114916073187,33,30,3,40,50,-10,62,65,-3,6,5,0,0
"14895","NYI","MTL",2011020261,15295,20112012,1,60,4,3,1,7.36173904443353,2.80930783848739,4.55243120594614,33,29,4,46,40,6,56,56,0,3,4,0,0
"14896","NYI","BOS",2011020279,15297,20112012,1,60,0,6,-6,3.48882131358667,5.2025175057388,-1.71369619215213,23,30,-7,29,42,-13,43,60,-17,1,5,0,0
"14897","NYI","PIT",2011020291,15299,20112012,0,60,0,5,-5,3.29904910676123,7.68059184287407,-4.38154273611283,29,36,-7,36,46,-10,48,61,-13,6,4,0,0
"14898","NYI","PHI",2011020302,15301,20112012,1,62.5666666666667,3,4,-1,5.06934270425546,4.83082905708579,0.238513647169668,32,33,-1,42,48,-6,57,73,-16,5,5,0,0
"14899","NYI","N.J",2011020314,15303,20112012,1,60,0,1,-1,3.10149660165189,3.64866317869858,-0.547166577046691,23,23,0,28,33,-5,49,50,-1,4,2,0,0
"14900","NYI","N.J",2011020326,15304,20112012,0,60,3,2,1,2.39144347333803,2.78491560951807,-0.393472136180034,26,26,0,31,31,0,44,39,5,2,3,0,0
"14901","NYI","BUF",2011020345,15307,20112012,0,60,2,1,1,4.7329986281693,6.93706606270644,-2.20406743453714,30,31,-1,38,43,-5,44,62,-18,3,4,0,0
"14902","NYI","CHI",2011020368,15310,20112012,0,65,4,4,0,5.66141843583381,4.38940873918333,1.27200969665048,41,36,5,49,48,1,64,65,-1,4,4,0,0
"14903","NYI","DAL",2011020381,15311,20112012,0,60,5,4,1,5.43880097841611,6.01333531794826,-0.574534339532152,27,34,-7,43,48,-5,50,76,-26,5,4,0,0
"14904","NYI","T.B",2011020393,15314,20112012,1,60,5,1,4,3.71849432802048,2.48148134721907,1.23701298080141,34,24,10,42,31,11,60,48,12,5,3,0,0
"14905","NYI","CHI",2011020407,15316,20112012,1,61.5666666666667,2,3,-1,3.61716270225224,4.1819126860355,-0.564749983783258,33,28,5,41,34,7,53,48,5,6,3,0,0
"14906","NYI","MTL",2011020443,15321,20112012,0,60,3,5,-2,4.27871952385934,5.98120844137156,-1.70248891751223,32,29,3,43,38,5,57,60,-3,3,5,0,0
"14907","NYI","DAL",2011020451,15323,20112012,1,60,2,3,-1,0,0,0,27,29,-2,36,39,-3,50,50,0,5,8,0,0
"14908","NYI","MIN",2011020474,15325,20112012,0,65,1,1,0,6.79428474865492,2.38936063941219,4.40492410924273,36,21,15,54,34,20,67,45,22,2,1,0,0
"14909","NYI","WPG",2011020492,15328,20112012,0,65,2,2,0,4.33605191856623,5.77859960867863,-1.44254769011241,33,38,-5,45,57,-12,56,75,-19,3,1,0,0
"14910","NYI","NYR",2011020501,15330,20112012,0,60,2,4,-2,2.84825322750839,5.17182341567241,-2.32357018816401,26,25,1,33,35,-2,47,51,-4,6,6,0,0
"14911","NYI","TOR",2011020510,15331,20112012,1,60,3,5,-2,7.34143420972396,4.93557248392608,2.40586172579788,33,27,6,45,37,8,58,52,6,5,4,0,0
"14912","NYI","NYR",2011020521,15334,20112012,0,60,0,3,-3,4.37651020506746,3.78313960940432,0.593370595663146,28,31,-3,40,40,0,59,50,9,5,4,0,0
"14913","NYI","CGY",2011020542,15337,20112012,1,60,3,1,2,9.29661697199145,4.61260691017378,4.68401006181767,34,30,4,52,40,12,69,59,10,2,3,0,0
"14914","NYI","EDM",2011020557,15339,20112012,1,60,4,1,3,2.88964049434435,4.6593075064302,-1.76966701208585,29,29,0,37,41,-4,47,56,-9,3,4,0,0
"14915","NYI","CAR",2011020577,15342,20112012,0,65,3,3,0,7.57021558115957,6.09926540523884,1.47095017592073,36,40,-4,54,57,-3,69,71,-2,2,1,0,0
"14916","NYI","ANA",2011020597,15345,20112012,0,60,2,4,-2,2.75107915655462,4.04027037404012,-1.2891912174855,21,20,1,37,34,3,56,52,4,3,2,0,0
"14917","NYI","ARI",2011020608,15346,20112012,0,60,1,5,-4,3.8506484462996,3.53462306369329,0.316025382606313,32,25,7,42,39,3,57,52,5,2,3,0,0
"14918","NYI","DET",2011020618,15349,20112012,1,60,5,1,4,3.71406903778552,5.55485496883193,-1.84078593104641,30,24,6,42,46,-4,52,67,-15,3,3,0,0
"14919","NYI","PHI",2011020632,15351,20112012,1,60,2,3,-1,4.36121808276221,5.65212559072097,-1.29090750795876,35,22,13,45,32,13,64,44,20,4,3,0,0
"14920","NYI","BUF",2011020651,15353,20112012,1,60,4,2,2,6.01510261052908,3.0646348768496,2.95046773367949,40,25,15,54,37,17,70,55,15,2,1,0,0
"14921","NYI","NSH",2011020664,15355,20112012,1,60,1,3,-2,4.64376124930482,4.46216039397405,0.181600855330771,37,32,5,46,42,4,65,51,14,3,1,0,0
"14922","NYI","WSH",2011020675,15356,20112012,0,60,3,0,3,3.95446954285035,1.93054819243162,2.02392135041873,28,17,11,39,30,9,52,48,4,6,3,0,0
"14923","NYI","PHI",2011020688,15358,20112012,0,60,4,1,3,5.59062265763828,5.2155760056994,0.375046651938874,27,41,-14,34,55,-21,42,80,-38,5,6,0,0
"14924","NYI","CAR",2011020703,15360,20112012,1,63.9666666666667,2,1,1,5.46423248201534,2.89657869012069,2.56765379189465,40,33,7,52,44,8,75,63,12,2,3,0,0
"14925","NYI","TOR",2011020716,15362,20112012,0,60,0,3,-3,3.99618085388647,5.24167033877166,-1.24548948488518,25,35,-10,35,53,-18,53,73,-20,0,2,0,0
"14926","NYI","TOR",2011020723,15363,20112012,1,62.1,3,4,-1,4.00379235257788,3.00170328101376,1.00208907156411,32,21,11,50,32,18,61,62,-1,1,3,0,0
"14927","NYI","CAR",2011020740,15370,20112012,0,60,5,2,3,6.07076459002928,3.19900531822805,2.87175927180124,26,23,3,38,37,1,51,60,-9,4,2,0,0
"14928","NYI","OTT",2011020762,15373,20112012,0,62.5833333333333,2,1,1,3.79459910726291,2.5376264306251,1.25697267663782,32,24,8,41,36,5,56,63,-7,2,2,0,0
"14929","NYI","BUF",2011020772,15374,20112012,1,65,3,3,0,5.65800488933019,5.59167519193218,0.0663296973980083,38,37,1,50,55,-5,55,79,-24,2,1,0,0
"14930","NYI","PHI",2011020787,15377,20112012,0,65,0,0,0,3.84956784837414,5.43249222016391,-1.58292437178977,18,45,-27,33,62,-29,52,86,-34,3,3,0,0
"14931","NYI","MTL",2011020802,15379,20112012,1,60,2,4,-2,4.71375392313348,7.74233828607248,-3.028584362939,33,32,1,46,43,3,65,58,7,2,1,0,0
"14932","NYI","L.A",2011020818,15381,20112012,1,61.6,2,1,1,2.85268547755338,4.72808231348781,-1.87539683593443,25,35,-10,35,46,-11,46,68,-22,2,2,0,0
"14933","NYI","FLA",2011020827,15382,20112012,1,60,1,4,-3,4.06717109458987,2.50012574971652,1.56704534487335,27,19,8,46,25,21,68,36,32,2,1,0,0
"14934","NYI","WPG",2011020844,15384,20112012,0,60,3,1,2,4.36638376367773,7.05276861489983,-2.6863848512221,25,38,-13,37,56,-19,44,72,-28,3,5,0,0
"14935","NYI","STL",2011020854,15386,20112012,0,60,1,5,-4,5.09538078281912,2.47835326655695,2.61702751626217,27,26,1,40,42,-2,60,51,9,5,3,0,0
"14936","NYI","CAR",2011020868,15388,20112012,1,60,4,3,1,2.95362610764278,4.48131550550033,-1.52768939785756,31,36,-5,39,50,-11,45,71,-26,4,5,0,0
"14937","NYI","OTT",2011020883,15390,20112012,1,60,0,6,-6,3.4679526550247,4.36297440585258,-0.89502175082788,28,32,-4,37,43,-6,44,55,-11,3,5,0,0
"14938","NYI","BUF",2011020885,15391,20112012,0,60,1,2,-1,2.64118045632495,5.94577793535427,-3.30459747902933,31,37,-6,39,42,-3,49,50,-1,2,2,0,0
"14939","NYI","NYR",2011020909,15394,20112012,1,65,3,3,0,4.52631836105138,5.88922114654201,-1.36290278549063,27,36,-9,36,47,-11,48,64,-16,5,5,0,0
"14940","NYI","OTT",2011020928,15396,20112012,0,60,2,5,-3,3.04824410419678,6.54037299356423,-3.49212888936745,30,24,6,42,39,3,50,57,-7,1,3,0,0
"14941","NYI","WSH",2011020939,15398,20112012,0,61.5833333333333,2,3,-1,2.36277201891062,3.13704147193494,-0.774269453024317,24,34,-10,33,53,-20,46,72,-26,3,4,0,0
"14942","NYI","PHI",2011020952,15400,20112012,0,60,3,6,-3,2.81944320062757,6.07422167406185,-3.25477847343427,24,30,-6,32,44,-12,48,68,-20,2,1,0,0
"14943","NYI","BOS",2011020965,15402,20112012,0,60,3,2,1,4.72250677064585,3.40540137392236,1.31710539672349,25,34,-9,37,51,-14,42,64,-22,3,5,0,0
"14944","NYI","N.J",2011020974,15403,20112012,1,60,1,0,1,4.33176697941963,1.37594382053794,2.95582315888169,25,24,1,38,30,8,56,57,-1,6,2,0,0
"14945","NYI","N.J",2011020999,15407,20112012,0,60,1,5,-4,4.39539388322737,1.57170673948713,2.82368714374024,30,20,10,39,29,10,47,34,13,3,3,0,0
"14946","NYI","N.J",2011021018,15409,20112012,1,60,1,2,-1,2.9428863893412,4.37599340111774,-1.43310701177654,24,35,-11,31,45,-14,44,65,-21,3,4,0,0
"14947","NYI","NYR",2011021030,15410,20112012,0,64.9,3,4,-1,1.87866589846089,4.75077312592784,-2.87210722746695,19,36,-17,26,51,-25,40,61,-21,4,7,0,0
"14948","NYI","WSH",2011021037,15412,20112012,1,65,4,4,0,0,0,0,30,28,2,40,43,-3,57,56,1,5,0,0,0
"14949","NYI","PHI",2011021053,15414,20112012,1,60,2,3,-1,2.81980209960602,4.28499950064361,-1.46519740103759,31,22,9,35,32,3,54,46,8,2,0,0,0
"14950","NYI","MTL",2011021068,15416,20112012,0,65,2,2,0,5.95010752187227,5.06574341416854,0.884364107703732,38,30,8,51,40,11,70,59,11,4,5,0,0
"14951","NYI","TOR",2011021088,15419,20112012,0,60,5,2,3,6.06616339076027,3.73290509410435,2.33325829665591,34,14,20,48,21,27,66,34,32,4,1,0,0
"14952","NYI","T.B",2011021122,15423,20112012,0,60,3,4,-1,0,0,0,37,26,11,47,32,15,72,41,31,3,3,0,0
"14953","NYI","FLA",2011021129,15424,20112012,0,65,2,2,0,6.42388808081091,3.15070083655883,3.27318724425209,37,35,2,51,45,6,60,59,1,2,2,0,0
"14954","NYI","BOS",2011021169,15430,20112012,1,60,3,6,-3,3.68288139716606,5.02448865609442,-1.34160725892837,22,27,-5,36,38,-2,56,54,2,2,1,0,0
"14955","NYI","OTT",2011021181,15431,20112012,1,60,1,5,-4,3.40963430116481,2.65197274682305,0.757661554341759,30,32,-2,39,42,-3,50,64,-14,3,3,0,0
"14956","NYI","N.J",2011021191,15433,20112012,0,60,1,3,-2,2.34089712288176,4.75074619016959,-2.40984906728784,20,20,0,29,26,3,40,38,2,0,4,0,0
"14957","NYI","WPG",2011021202,15435,20112012,1,60,5,4,1,2.8232141105691,3.85765167352536,-1.03443756295627,28,25,3,37,40,-3,48,57,-9,3,3,0,0
"14958","NYI","CBJ",2011021224,15437,20112012,0,60,3,7,-4,4.11209179225261,7.24192640049362,-3.129834608241,38,37,1,47,42,5,55,51,4,2,3,0,0
"14959","NYI","N.J",2012020006,15724,20122013,1,60,1,2,-1,4.13678787730169,2.25363999124966,1.88314788605203,19,28,-9,31,34,-3,40,50,-10,4,2,0,0
"14960","NYI","T.B",2012020021,15726,20122013,1,60,4,3,1,5.76473156199791,2.98084036782141,2.78389119417649,44,26,18,56,36,20,66,44,22,8,4,0,0
"14961","NYI","TOR",2012020040,15729,20122013,0,60,7,4,3,4.22403355210554,4.84823980145437,-0.624206249348831,34,43,-9,44,53,-9,50,69,-19,2,5,0,0
"14962","NYI","BOS",2012020050,15730,20122013,0,60,2,4,-2,1.8277054323511,4.53492714057526,-2.70722170822417,26,27,-1,31,42,-11,46,61,-15,4,4,0,0
"14963","NYI","WPG",2012020070,15732,20122013,0,61.9833333333333,4,5,-1,3.97079865847627,4.37241678807186,-0.40161812959559,25,35,-10,47,55,-8,66,71,-5,5,7,0,0
"14964","NYI","N.J",2012020094,15736,20122013,0,62.0166666666667,5,4,1,5.09509890417576,4.91991431071074,0.175184593465019,35,32,3,38,43,-5,47,57,-10,4,5,0,0
"14965","NYI","N.J",2012020122,15739,20122013,1,60,0,3,-3,1.87109695983236,4.35490693059344,-2.48380997076108,22,27,-5,29,40,-11,51,53,-2,7,5,0,0
"14966","NYI","NYR",2012020143,15743,20122013,0,60,1,4,-3,2.44573204434732,5.35261792793108,-2.90688588358376,28,25,3,39,34,5,56,43,13,5,2,0,0
"14967","NYI","BUF",2012020161,15745,20122013,1,60,2,3,-1,4.34806637791917,2.337903074309,2.01016330361017,43,15,28,59,23,36,82,37,45,4,3,0,0
"14968","NYI","CAR",2012020173,15747,20122013,1,60,4,6,-2,4.53635989705799,7.61100449299556,-3.07464459593757,28,31,-3,36,41,-5,57,59,-2,7,4,0,0
"14969","NYI","NYR",2012020191,15750,20122013,0,65,3,3,0,2.64266482420499,4.650387358015,-2.00772253381001,31,39,-8,44,49,-5,60,70,-10,1,4,0,0
"14970","NYI","N.J",2012020207,15752,20122013,1,60,5,1,4,4.50481183108039,2.47574238528244,2.02906944579795,33,31,2,43,43,0,55,60,-5,6,5,0,0
"14971","NYI","PHI",2012020220,15754,20122013,1,60,0,7,-7,2.21812089370519,3.04975160576942,-0.831630712064225,19,25,-6,29,35,-6,52,43,9,5,4,0,0
"14972","NYI","OTT",2012020228,15755,20122013,0,60,1,3,-2,7.34637063994887,4.7741970710631,2.57217356888577,38,26,12,51,41,10,66,54,12,4,5,0,0
"14973","NYI","MTL",2012020241,15757,20122013,0,63.2,4,3,1,2.9271723969141,3.55100752803264,-0.62383513111854,25,33,-8,31,41,-10,55,63,-8,5,6,0,0
"14974","NYI","BUF",2012020254,15759,20122013,0,60,4,0,4,5.0265638170531,3.60624219250167,1.42032162455143,32,35,-3,44,43,1,57,59,-2,7,10,0,0
"14975","NYI","CAR",2012020265,15760,20122013,1,60,2,4,-2,1.75958185317523,6.36938884027768,-4.60980698710244,25,28,-3,38,45,-7,53,65,-12,3,3,0,0
"14976","NYI","BOS",2012020278,15762,20122013,1,60,1,4,-3,6.59086401531385,5.93099455937045,0.659869455943408,37,34,3,47,42,5,61,57,4,3,4,0,0
"14977","NYI","TOR",2012020289,15764,20122013,1,61.1833333333333,4,5,-1,3.18202860833844,3.28578426811146,-0.103755659773014,27,28,-1,38,38,0,54,52,2,0,0,0,0
"14978","NYI","OTT",2012020312,15767,20122013,1,65,2,2,0,5.93707900051959,4.36488193221157,1.57219706830801,35,31,4,50,44,6,74,60,14,5,3,0,0
"14979","NYI","MTL",2012020325,15769,20122013,1,60,6,3,3,3.51165192585904,3.69825021293946,-0.186598287080415,24,32,-8,30,42,-12,45,60,-15,5,5,0,0
"14980","NYI","NYR",2012020341,15771,20122013,1,60.7,1,2,-1,3.97784415171935,5.26197185812634,-1.28412770640699,29,37,-8,37,58,-21,56,77,-21,1,5,0,0
"14981","NYI","WSH",2012020356,15773,20122013,1,60,5,2,3,6.30239283619449,2.39593103772495,3.90646179846954,45,24,21,56,31,25,72,49,23,5,3,0,0
"14982","NYI","T.B",2012020395,15778,20122013,0,60,2,0,2,3.28254294146609,3.82575296431241,-0.543210022846324,29,18,11,37,31,6,49,46,3,1,2,0,0
"14983","NYI","FLA",2012020413,15780,20122013,0,60,4,3,1,3.97125943300125,5.91449843093869,-1.94323899793744,25,30,-5,32,49,-17,49,66,-17,0,1,0,0
"14984","NYI","OTT",2012020430,15783,20122013,1,60,3,5,-2,4.33081194170518,4.7358664742954,-0.405054532590219,29,23,6,37,33,4,49,48,1,6,1,0,0
"14985","NYI","MTL",2012020444,15785,20122013,1,60,2,5,-3,6.03598027435464,2.70569409185555,3.33028618249909,27,29,-2,40,40,0,60,49,11,4,4,0,0
"14986","NYI","FLA",2012020465,15788,20122013,1,60,3,0,3,5.19885801521013,3.1279845329118,2.07087348229834,37,26,11,41,38,3,52,56,-4,2,2,0,0
"14987","NYI","WSH",2012020481,15790,20122013,0,60,3,2,1,3.83819446829193,3.96594764517304,-0.127753176881103,31,22,9,40,40,0,51,66,-15,2,3,0,0
"14988","NYI","PHI",2012020493,15792,20122013,0,65,3,3,0,6.01511859170569,4.97788391914219,1.0372346725635,36,36,0,52,48,4,78,61,17,5,3,0,0
"14989","NYI","N.J",2012020522,15796,20122013,0,60,3,1,2,2.23918727040291,2.21656931750476,0.0226179528981447,21,25,-4,24,36,-12,31,57,-26,3,2,0,0
"14990","NYI","WPG",2012020532,15797,20122013,1,60,5,2,3,7.3058725867304,4.23966589887834,3.06620668785206,39,25,14,55,36,19,71,55,16,2,2,0,0
"14991","NYI","WSH",2012020545,15799,20122013,0,65,1,1,0,6.09757446389267,4.85715280100703,1.24042166288564,36,22,14,44,34,10,59,50,9,3,3,0,0
"14992","NYI","T.B",2012020564,15801,20122013,1,60,4,2,2,4.68709971996577,4.23426582053071,0.452833899435063,28,21,7,40,30,10,61,53,8,1,3,0,0
"14993","NYI","PHI",2012020582,15804,20122013,1,60,4,1,3,4.05673848961305,3.26946231728652,0.787276172326528,32,27,5,42,40,2,58,52,6,1,2,0,0
"14994","NYI","BOS",2012020596,15806,20122013,0,60,2,1,1,4.81203475279835,2.20190879117763,2.61012596162072,36,31,5,47,40,7,54,56,-2,1,1,0,0
"14995","NYI","NYR",2012020613,15808,20122013,1,63.1833333333333,0,1,-1,3.61523780302741,2.25488809498529,1.36034970804212,29,20,9,45,29,16,66,44,22,3,5,0,0
"14996","NYI","FLA",2012020632,15811,20122013,1,60,5,2,3,4.08078272324565,5.57206293396857,-1.49128021072292,31,28,3,43,45,-2,52,66,-14,3,6,0,0
"14997","NYI","TOR",2012020644,15813,20122013,0,60,5,3,2,6.95418330168468,4.17190931319783,2.78227398848685,38,21,17,52,36,16,64,58,6,5,4,0,0
"14998","NYI","WPG",2012020661,15815,20122013,0,65,4,4,0,5.08353216166142,6.50858451086674,-1.42505234920532,33,28,5,47,44,3,72,60,12,7,5,0,0
"14999","NYI","CAR",2012020683,15818,20122013,0,65,3,3,0,6.61179023732439,4.89898296922911,1.71280726809528,39,32,7,64,43,21,77,57,20,2,0,0,0
"15000","NYI","PHI",2012020694,15820,20122013,0,60,1,2,-1,2.75109352975142,4.74814497608168,-1.99705144633026,22,30,-8,34,44,-10,50,56,-6,2,4,0,0
"15001","NYI","BUF",2012020704,15821,20122013,0,65,1,1,0,2.91424921650582,1.85575358780625,1.05849562869957,31,22,9,41,35,6,50,51,-1,4,3,0,0
"15002","NYI","PIT",2012030111,15826,20122013,0,60,0,5,-5,4.10534515702898,3.47624362467297,0.629101532356003,26,26,0,40,36,4,62,48,14,4,3,0,0
"15003","NYI","PIT",2012030112,15828,20122013,0,60,4,3,1,9.87618090687752,5.73218299314613,4.14399791373139,42,33,9,60,44,16,79,57,22,5,4,0,0
"15004","NYI","PIT",2012030113,15830,20122013,1,68.7333333333333,4,5,-1,4.38035980606219,4.84736428575206,-0.467004479689876,36,25,11,46,40,6,64,55,9,4,6,0,0
"15005","NYI","PIT",2012030114,15832,20122013,1,60,6,4,2,5.56873919636564,5.144448754259,0.424290442106638,24,31,-7,37,41,-4,53,57,-4,5,3,0,0
"15006","NYI","PIT",2012030115,15834,20122013,0,60,0,4,-4,4.4136591181159,7.50142403441714,-3.08776491630124,31,31,0,43,52,-9,57,61,-4,5,8,0,0
"15007","NYI","PIT",2012030116,15836,20122013,1,67.8166666666667,3,4,-1,3.30075369294493,3.10024531866657,0.200508374278367,38,21,17,55,33,22,73,56,17,3,1,0,0
"15008","NYI","N.J",2013020016,15982,20132014,0,65,3,3,0,5.06006936414633,3.88542650542144,1.17464285872489,26,29,-3,30,41,-11,39,55,-16,2,2,0,0
"15009","NYI","CBJ",2013020024,15983,20132014,1,65,2,2,0,3.04284639825346,3.96100707244477,-0.918160674191313,30,29,1,38,40,-2,51,61,-10,2,2,0,0
"15010","NYI","ARI",2013020038,15986,20132014,1,60,6,1,5,2.77780941528636,3.9989836666291,-1.22117425134275,28,34,-6,37,49,-12,46,56,-10,8,5,0,0
"15011","NYI","CHI",2013020061,15989,20132014,0,60,2,3,-1,4.1160163130844,2.62607363599091,1.4899426770935,19,28,-9,27,42,-15,40,69,-29,3,5,0,0
"15012","NYI","NSH",2013020071,15990,20132014,0,60,2,3,-1,2.02058658888564,4.33884467293592,-2.31825808405029,16,31,-15,23,43,-20,40,60,-20,2,2,0,0
"15013","NYI","BUF",2013020083,15993,20132014,1,65,3,3,0,4.1923449563094,6.39584467202076,-2.20349971571136,44,34,10,60,50,10,78,66,12,5,6,0,0
"15014","NYI","EDM",2013020098,15995,20132014,1,60,3,2,1,3.49856590263653,2.44027681582018,1.05828908681634,40,29,11,48,35,13,58,48,10,5,3,0,0
"15015","NYI","CAR",2013020117,15997,20132014,1,60,3,4,-1,4.72608462601056,2.30200037470672,2.42408425130384,25,23,2,33,35,-2,49,48,1,5,3,0,0
"15016","NYI","VAN",2013020130,16000,20132014,1,62.2666666666667,4,5,-1,6.8434200690057,6.16159487002369,0.681825198982011,32,33,-1,47,52,-5,64,72,-8,4,2,0,0
"15017","NYI","PHI",2013020160,16004,20132014,1,60,2,5,-3,3.59570538104163,7.55049696110655,-3.95479158006492,28,32,-4,40,52,-12,58,65,-7,4,4,0,0
"15018","NYI","NYR",2013020176,16007,20132014,1,60,2,3,-1,5.58821957829224,2.82450474302638,2.76371483526586,24,24,0,42,37,5,59,46,13,5,7,0,0
"15019","NYI","OTT",2013020194,16010,20132014,0,65,4,4,0,10.1520836641794,5.19996391638489,4.95211974779448,57,31,26,78,37,41,90,59,31,5,3,0,0
"15020","NYI","BOS",2013020204,16011,20132014,1,60,3,1,2,3.34984205846195,3.20852773927618,0.141314319185767,34,27,7,47,43,4,67,62,5,4,4,0,0
"15021","NYI","WSH",2013020218,16014,20132014,0,60,2,6,-4,4.39360510862797,4.95367420991528,-0.560069101287311,36,39,-3,50,51,-1,66,66,0,6,7,0,0
"15022","NYI","CAR",2013020234,16016,20132014,0,60,0,1,-1,2.24999283417128,6.71369611111004,-4.46370327693876,21,24,-3,44,38,6,57,54,3,5,4,0,0
"15023","NYI","CBJ",2013020250,16018,20132014,0,60,2,5,-3,6.01994908379856,3.13811398109829,2.88183510270028,26,29,-3,35,40,-5,44,53,-9,2,5,0,0
"15024","NYI","MTL",2013020255,16019,20132014,0,60,2,4,-2,3.4846168545543,7.10092316300143,-3.61630630844712,26,31,-5,37,46,-9,60,59,1,4,4,0,0
"15025","NYI","NSH",2013020264,16021,20132014,1,60,3,1,2,6.66626607247025,3.1598381195023,3.50642795296795,33,33,0,50,41,9,77,57,20,5,2,0,0
"15026","NYI","L.A",2013020278,16023,20132014,1,60,2,3,-1,3.29327507978087,3.91469461995918,-0.621419540178306,25,24,1,36,33,3,47,48,-1,4,3,0,0
"15027","NYI","DET",2013020297,16025,20132014,1,65,4,4,0,5.48701209793944,2.94645799315913,2.54055410478031,41,23,18,49,32,17,69,41,28,5,1,0,0
"15028","NYI","TOR",2013020313,16028,20132014,0,60,2,5,-3,5.7375490359999,4.27739506992657,1.46015396607334,37,24,13,47,38,9,66,54,12,2,2,0,0
"15029","NYI","PHI",2013020346,16032,20132014,0,60,2,5,-3,8.42533784624845,5.65856044681188,2.76677739943658,38,30,8,48,50,-2,66,71,-5,3,3,0,0
"15030","NYI","WPG",2013020367,16036,20132014,1,60,2,3,-1,3.09847437241115,3.82136937035102,-0.722894997939875,30,29,1,45,41,4,66,58,8,4,2,0,0
"15031","NYI","DET",2013020382,16038,20132014,1,60,0,5,-5,5.22660661219561,6.0072446570266,-0.780638044830994,29,30,-1,42,40,2,59,50,9,1,2,0,0
"15032","NYI","WSH",2013020397,16039,20132014,1,62.1166666666667,2,3,-1,4.41788602800807,3.65129632976641,0.76658969824166,39,30,9,47,42,5,65,58,7,2,1,0,0
"15033","NYI","STL",2013020428,16044,20132014,0,60,1,5,-4,3.17936715950191,2.64757010312587,0.531797056376035,23,26,-3,36,35,1,42,47,-5,5,8,0,0
"15034","NYI","L.A",2013020448,16046,20132014,0,60,0,3,-3,1.90254851080681,5.73164681084199,-3.82909830003518,16,24,-8,24,36,-12,34,51,-17,7,8,0,0
"15035","NYI","ANA",2013020457,16048,20132014,0,60,2,5,-3,5.07367651726236,2.95195869221061,2.12171782505175,37,31,6,50,41,9,71,57,14,5,3,0,0
"15036","NYI","S.J",2013020469,16049,20132014,0,65,2,2,0,6.30115166155156,7.18811665306566,-0.886964991514105,28,48,-20,37,68,-31,62,95,-33,1,4,0,0
"15037","NYI","ARI",2013020481,16051,20132014,0,60,3,6,-3,5.39571345727063,5.67492081967066,-0.27920736240003,24,37,-13,40,45,-5,56,66,-10,5,6,0,0
"15038","NYI","MTL",2013020493,16053,20132014,1,61.85,0,1,-1,1.60779839759925,4.62536591810931,-3.01756752051006,21,25,-4,24,38,-14,47,56,-9,4,3,0,0
"15039","NYI","T.B",2013020512,16056,20132014,1,65,2,2,0,3.58159558751504,4.97861279656587,-1.39701720905083,34,36,-2,41,46,-5,50,73,-23,2,1,0,0
"15040","NYI","NYR",2013020535,16059,20132014,0,60,5,3,2,3.70805710062268,5.2622125018388,-1.55415540121612,20,24,-4,28,36,-8,40,56,-16,6,8,0,0
"15041","NYI","ANA",2013020544,16060,20132014,1,60,3,5,-2,1.65372731236093,6.39546115451958,-4.74173384215865,21,31,-10,31,39,-8,44,62,-18,2,3,0,0
"15042","NYI","DET",2013020558,16062,20132014,0,60,3,0,3,2.34529311132444,4.37149199933629,-2.02619888801185,19,23,-4,24,36,-12,33,47,-14,1,1,0,0
"15043","NYI","N.J",2013020580,16067,20132014,1,60,1,2,-1,2.72948268451728,2.89114024119044,-0.161657556673163,31,25,6,40,33,7,60,48,12,3,1,0,0
"15044","NYI","MIN",2013020592,16068,20132014,0,60,5,4,1,6.14357543899678,3.85497459930775,2.28860083968902,31,37,-6,38,47,-9,48,63,-15,3,4,0,0
"15045","NYI","BOS",2013020602,16070,20132014,0,60,5,3,2,4.52684530618717,4.56215917220956,-0.0353138660223884,31,38,-7,41,47,-6,58,59,-1,9,4,0,0
"15046","NYI","CHI",2013020613,16072,20132014,1,60.9666666666667,3,2,1,3.81519853830105,4.37998199637514,-0.564783458074089,34,39,-5,45,47,-2,59,63,-4,2,1,0,0
"15047","NYI","CAR",2013020632,16074,20132014,1,60,2,3,-1,4.20256664508997,3.1304614704859,1.07210517460408,40,30,10,49,43,6,68,63,5,2,2,0,0
"15048","NYI","DAL",2013020643,16076,20132014,1,60,7,3,4,4.04045901160748,3.16765195316839,0.872807058439093,43,23,20,52,30,22,67,39,28,6,4,0,0
"15049","NYI","TOR",2013020648,16077,20132014,0,60,5,3,2,5.77898350782652,3.65251845968305,2.12646504814347,25,26,-1,36,42,-6,47,52,-5,1,5,0,0
"15050","NYI","COL",2013020672,16080,20132014,0,61.7666666666667,2,1,1,0,0,0,24,31,-7,30,38,-8,39,53,-14,2,2,0,0
"15051","NYI","DAL",2013020686,16082,20132014,0,60,4,2,2,7.04944617854198,4.33299265793175,2.71645352061023,31,31,0,49,48,1,73,60,13,2,2,0,0
"15052","NYI","FLA",2013020701,16084,20132014,0,60,2,4,-2,6.42363411311726,2.82400471805522,3.59962939506204,33,26,7,46,41,5,59,52,7,3,4,0,0
"15053","NYI","T.B",2013020713,16086,20132014,0,65,1,1,0,0,0,0,30,30,0,42,44,-2,57,56,1,4,3,0,0
"15054","NYI","PHI",2013020729,16088,20132014,0,60,4,6,-2,4.58407131904627,9.81851755035032,-5.23444623130405,29,32,-3,37,42,-5,52,61,-9,4,3,0,0
"15055","NYI","PHI",2013020740,16090,20132014,1,65,3,3,0,3.86142159736607,2.01298008361027,1.8484415137558,43,29,14,54,38,16,76,50,26,7,4,0,0
"15056","NYI","NYR",2013020748,16091,20132014,0,60,5,3,2,7.92454687109603,6.36745971853088,1.55708715256515,37,33,4,51,50,1,61,66,-5,5,5,0,0
"15057","NYI","STL",2013020775,16095,20132014,1,65,3,3,0,3.98174224322429,6.3014374839795,-2.31969524075521,36,35,1,44,50,-6,58,62,-4,7,4,0,0
"15058","NYI","BOS",2013020789,16097,20132014,1,60,3,6,-3,4.67456116194339,3.2732887645252,1.40127239741818,37,37,0,51,40,11,78,59,19,5,2,0,0
"15059","NYI","NYR",2013020806,16099,20132014,1,60,1,2,-1,4.26804893344524,3.83898147952277,0.429067453922471,31,34,-3,46,45,1,63,56,7,5,2,0,0
"15060","NYI","NYR",2013020819,16101,20132014,0,60,1,4,-3,4.05703227478156,6.04520717437845,-1.98817489959688,39,37,2,45,55,-10,63,70,-7,6,5,0,0
"15061","NYI","WSH",2013020849,16105,20132014,0,60,1,0,1,4.61553612391943,5.19383660668973,-0.578300482770299,28,22,6,40,34,6,61,49,12,7,7,0,0
"15062","NYI","CGY",2013020856,16107,20132014,1,60,2,4,-2,3.70771329079685,5.75101075528073,-2.04329746448389,30,22,8,43,33,10,69,47,22,5,2,0,0
"15063","NYI","COL",2013020878,16109,20132014,1,60,2,5,-3,4.36867590663314,3.75983081338927,0.608845093243872,33,26,7,54,32,22,66,38,28,6,3,0,0
"15064","NYI","TOR",2013020887,16128,20132014,1,61.9166666666667,5,4,1,3.99387196081628,2.70890009222642,1.28497186858986,35,22,13,47,32,15,55,51,4,4,4,0,0
"15065","NYI","N.J",2013020903,16130,20132014,1,60,1,6,-5,0,0,0,19,35,-16,25,44,-19,40,60,-20,3,8,0,0
"15066","NYI","FLA",2013020914,16131,20132014,1,60,3,5,-2,3.13652297050865,4.55186302754373,-1.41534005703508,38,34,4,46,44,2,60,56,4,12,10,0,0
"15067","NYI","WPG",2013020930,16133,20132014,0,63.8833333333333,3,2,1,5.47765552217322,6.10468245788908,-0.627026935715861,27,38,-11,40,54,-14,56,70,-14,2,6,0,0
"15068","NYI","EDM",2013020946,16135,20132014,0,62.4833333333333,2,3,-1,5.37383160933047,4.35886765960458,1.01496394972588,34,29,5,51,44,7,65,56,9,4,4,0,0
"15069","NYI","CGY",2013020951,16136,20132014,0,60,3,4,-1,4.77878580975812,3.1468062397625,1.63197956999562,26,23,3,36,39,-3,49,51,-2,7,4,0,0
"15070","NYI","VAN",2013020974,16139,20132014,0,60,7,4,3,5.90459898335394,3.79844306479208,2.10615591856185,28,24,4,40,37,3,57,50,7,7,4,0,0
"15071","NYI","S.J",2013020996,16143,20132014,1,60,3,4,-1,4.39029457801371,4.53071860552882,-0.14042402751511,38,26,12,49,40,9,62,50,12,0,1,0,0
"15072","NYI","BUF",2013021008,16144,20132014,1,60,4,1,3,7.23240630351602,3.91685793684692,3.31554836666909,38,34,4,51,49,2,68,68,0,4,7,0,0
"15073","NYI","MIN",2013021027,16147,20132014,1,60,0,6,-6,3.18881106745024,4.42875642207218,-1.23994535462194,36,22,14,44,33,11,66,51,15,3,3,0,0
"15074","NYI","CBJ",2013021066,16152,20132014,1,60,2,0,2,4.09316577054602,4.11147078115594,-0.0183050106099216,32,41,-9,45,51,-6,47,63,-16,5,7,0,0
"15075","NYI","CAR",2013021082,16154,20132014,0,60,5,4,1,0,0,0,32,28,4,43,44,-1,52,60,-8,3,4,0,0
"15076","NYI","T.B",2013021096,16156,20132014,0,65,2,2,0,2.30216996913077,4.4874522305613,-2.18528226143053,27,31,-4,35,43,-8,53,56,-3,3,3,0,0
"15077","NYI","N.J",2013021113,16158,20132014,1,65,1,1,0,2.92993784897152,4.33391666974057,-1.40397882076905,20,24,-4,36,38,-2,50,59,-9,2,3,0,0
"15078","NYI","FLA",2013021131,16161,20132014,1,60,4,2,2,4.03769492860815,3.7402754362192,0.297419492388958,40,22,18,51,35,16,71,54,17,5,4,0,0
"15079","NYI","OTT",2013021140,16162,20132014,0,60,2,1,1,3.0341777273527,7.1239233227353,-4.0897455953826,27,36,-9,40,61,-21,52,86,-34,4,5,0,0
"15080","NYI","WSH",2013021162,16165,20132014,1,65,3,3,0,5.02438421718398,2.77044312338694,2.25394109379704,38,29,9,51,40,11,67,63,4,4,6,0,0
"15081","NYI","CBJ",2013021172,16166,20132014,0,60,0,4,-4,1.68334648865858,4.24025965165492,-2.55691316299635,31,33,-2,37,42,-5,50,48,2,5,9,0,0
"15082","NYI","OTT",2013021181,16168,20132014,1,60,1,4,-3,3.65585910232782,3.71245120494885,-0.0565921026210301,46,32,14,58,48,10,64,56,8,5,7,0,0
"15083","NYI","MTL",2013021196,16170,20132014,0,60,2,0,2,5.40651435116888,2.99439552373951,2.41211882742937,30,19,11,48,27,21,71,45,26,1,4,0,0
"15084","NYI","N.J",2013021208,16171,20132014,0,65,2,2,0,3.73469799460145,1.3131320446555,2.42156594994594,30,27,3,39,34,5,46,41,5,3,1,0,0
"15085","NYI","BUF",2013021225,16173,20132014,0,65,3,3,0,4.7235253228669,6.86042088146496,-2.13689555859806,25,39,-14,42,53,-11,58,63,-5,3,3,0,0
"15086","NYI","CAR",2014020017,16353,20142015,0,60,5,3,2,5.58216732987421,3.9175991367083,1.66456819316591,26,24,2,38,44,-6,52,57,-5,3,5,0,0
"15087","NYI","CAR",2014020023,16354,20142015,1,60,4,3,1,3.64989754377166,4.21921415295219,-0.569316609180532,31,24,7,44,30,14,54,45,9,7,6,0,0
"15088","NYI","NYR",2014020038,16357,20142015,0,60,6,3,3,5.56270272024267,6.77971139722604,-1.21700867698337,27,43,-16,41,55,-14,50,75,-25,4,4,0,0
"15089","NYI","S.J",2014020050,16359,20142015,1,65,3,3,0,5.19527054345235,2.54033971204808,2.65493083140427,45,23,22,62,35,27,78,59,19,2,1,0,0
"15090","NYI","TOR",2014020081,16364,20142015,1,60,2,5,-3,3.26040607631367,1.74737719436069,1.51302888195298,36,28,8,50,31,19,61,43,18,7,5,0,0
"15091","NYI","BOS",2014020093,16366,20142015,0,60,3,2,1,6.77188338359701,6.19606575511318,0.575817628483832,38,32,6,50,50,0,54,69,-15,1,1,0,0
"15092","NYI","DAL",2014020110,16368,20142015,1,60,7,5,2,4.70451705095365,3.28435464727954,1.42016240367411,29,31,-2,40,41,-1,49,54,-5,2,5,0,0
"15093","NYI","WPG",2014020125,16371,20142015,1,60,3,4,-1,4.07590095625247,3.93775464327337,0.138146312979103,21,30,-9,39,38,1,49,48,1,8,4,0,0
"15094","NYI","COL",2014020146,16373,20142015,0,60,0,5,-5,3.82422583240259,5.71242724709904,-1.88820141469645,40,23,17,57,34,23,79,38,41,7,3,0,0
"15095","NYI","S.J",2014020152,16375,20142015,0,60,1,3,-2,4.05107790301554,6.09778488636948,-2.04670698335394,20,31,-11,38,43,-5,63,62,1,3,1,0,0
"15096","NYI","ANA",2014020186,16379,20142015,0,62.3,3,2,1,5.33591831941158,4.80417453035566,0.531743789055913,36,34,2,51,51,0,68,67,1,3,2,0,0
"15097","NYI","L.A",2014020195,16380,20142015,0,65,1,1,0,3.89960664337958,3.43779654143145,0.461810101948128,26,29,-3,46,44,2,57,62,-5,4,4,0,0
"15098","NYI","ARI",2014020212,16382,20142015,0,60,1,0,1,5.40133421018095,2.32554999245299,3.07578421772796,33,19,14,50,33,17,63,49,14,3,5,0,0
"15099","NYI","COL",2014020221,16385,20142015,1,60,6,0,6,7.311621320221,1.68466535577681,5.62695596444418,46,20,26,56,27,29,68,42,26,7,4,0,0
"15100","NYI","FLA",2014020246,16388,20142015,0,65,3,3,0,2.19548052557138,4.17544949061812,-1.97996896504674,34,38,-4,44,49,-5,67,66,1,3,6,0,0
"15101","NYI","T.B",2014020253,16389,20142015,0,60,2,5,-3,2.75348980076058,3.14635052141966,-0.392860720659079,27,28,-1,39,33,6,51,41,10,5,4,0,0
"15102","NYI","T.B",2014020269,16392,20142015,1,60,5,2,3,3.4062259736238,2.66715893948276,0.739067034141044,36,28,8,45,35,10,61,52,9,7,4,0,0
"15103","NYI","PHI",2014020313,16398,20142015,1,65,0,0,0,6.70566249757394,1.96347867800984,4.7421838195641,46,21,25,63,29,34,75,39,36,3,2,0,0
"15104","NYI","WSH",2014020324,16400,20142015,1,64.6,3,2,1,6.58108723336773,3.43832599454356,3.14276123882416,35,27,8,52,37,15,71,44,27,4,3,0,0
"15105","NYI","WSH",2014020335,16402,20142015,0,60,2,5,-3,5.87926685724708,6.55386228922642,-0.674595431979336,28,27,1,44,43,1,60,70,-10,2,2,0,0
"15106","NYI","N.J",2014020347,16403,20142015,1,60,3,1,2,6.0473540360108,4.62996132075386,1.41739271525694,28,35,-7,40,49,-9,55,75,-20,5,5,0,0
"15107","NYI","OTT",2014020363,16406,20142015,1,63.1,3,2,1,4.52843563398346,4.75141305621946,-0.222977422235999,28,18,10,41,33,8,58,47,11,2,1,0,0
"15108","NYI","OTT",2014020379,16408,20142015,0,60,2,1,1,3.86024487874238,6.40696130361175,-2.54671642486937,25,21,4,36,41,-5,48,63,-15,3,3,0,0
"15109","NYI","STL",2014020397,16410,20142015,1,60,4,6,-2,3.0212519345805,4.49353462118052,-1.47228268660001,27,40,-13,34,52,-18,51,72,-21,6,6,0,0
"15110","NYI","MIN",2014020415,16413,20142015,0,60,4,5,-1,2.53778025385691,7.17181484129321,-4.6340345874363,19,30,-11,29,45,-16,41,70,-29,5,5,0,0
"15111","NYI","STL",2014020427,16415,20142015,0,60,3,6,-3,2.85779055990861,4.78018936641399,-1.92239880650538,28,33,-5,41,45,-4,58,52,6,5,4,0,0
"15112","NYI","CHI",2014020439,16417,20142015,1,60,3,2,1,6.13278839923441,2.90419391495222,3.2285944842822,41,25,16,59,31,28,71,49,22,3,1,0,0
"15113","NYI","N.J",2014020451,16419,20142015,1,65,2,2,0,4.18754905511742,2.15037122485228,2.03717783026514,33,28,5,41,30,11,57,43,14,4,3,0,0
"15114","NYI","DET",2014020476,16423,20142015,0,60,2,1,1,4.00526441276998,2.05116375671351,1.95410065605646,32,18,14,38,29,9,48,44,4,3,2,0,0
"15115","NYI","T.B",2014020484,16424,20142015,1,60,3,1,2,7.11953845309881,3.13916744949529,3.98037100360352,48,21,27,59,33,26,76,48,28,3,2,0,0
"15116","NYI","MTL",2014020505,16427,20142015,1,60,1,3,-2,4.64668169982906,5.83509447146207,-1.18841277163301,38,21,17,48,30,18,70,48,22,3,4,0,0
"15117","NYI","BUF",2014020514,16431,20142015,0,65,3,3,0,5.28287879509614,4.20796752169554,1.0749112734006,36,26,10,46,33,13,66,47,19,4,5,0,0
"15118","NYI","WSH",2014020531,16433,20142015,1,62.8833333333333,4,3,1,6.429403555052,2.05674134768196,4.37266220737004,39,26,13,63,34,29,77,49,28,6,4,0,0
"15119","NYI","WPG",2014020545,16435,20142015,0,60,5,2,3,5.03910069813719,2.91330456279286,2.12579613534433,33,23,10,40,33,7,58,49,9,7,4,0,0
"15120","NYI","CGY",2014020564,16437,20142015,0,60,2,1,1,0,0,0,24,23,1,38,28,10,61,45,16,2,3,0,0
"15121","NYI","EDM",2014020582,16439,20142015,0,60,2,5,-3,4.22501282498706,4.4008799722651,-0.175867147278041,33,23,10,49,36,13,64,59,5,4,2,0,0
"15122","NYI","VAN",2014020593,16441,20142015,0,60,2,3,-1,2.55347999647802,2.01812166620905,0.535358330268963,23,20,3,33,30,3,59,46,13,3,2,0,0
"15123","NYI","N.J",2014020608,16444,20142015,0,63.0833333333333,3,2,1,2.80375777054596,3.14105616816889,-0.337298397622927,31,23,8,40,31,9,52,37,15,4,2,0,0
"15124","NYI","CBJ",2014020618,16445,20142015,0,60,5,2,3,7.16747101473256,2.34293492999814,4.82453608473442,40,18,22,53,27,26,62,43,19,7,4,0,0
"15125","NYI","NYR",2014020632,16448,20142015,0,60,3,0,3,4.81017158390023,2.53029737161341,2.27987421228681,44,27,17,56,41,15,72,64,8,3,2,0,0
"15126","NYI","MTL",2014020662,16452,20142015,0,60,4,6,-2,4.78043435933068,3.11451643929132,1.66591792003936,31,35,-4,47,47,0,70,60,10,3,4,0,0
"15127","NYI","PHI",2014020676,16454,20142015,1,60,7,4,3,6.35182229564452,3.44928870007425,2.90253359557028,41,29,12,49,37,12,61,52,9,4,3,0,0
"15128","NYI","NYR",2014020697,16462,20142015,1,60,4,1,3,4.3447723936826,5.00925645902828,-0.664484065345675,38,41,-3,48,52,-4,56,77,-21,4,4,0,0
"15129","NYI","BOS",2014020711,16464,20142015,1,60,2,5,-3,5.62063548444712,5.61194815488548,0.00868732956164031,45,33,12,58,43,15,74,60,14,2,1,0,0
"15130","NYI","DET",2014020728,16466,20142015,0,60,1,4,-3,3.30322544772279,2.73764930063869,0.565576147084103,23,19,4,35,27,8,46,39,7,5,5,0,0
"15131","NYI","FLA",2014020746,16469,20142015,1,60,2,4,-2,3.72966774960514,4.90589068517738,-1.17622293557224,34,30,4,48,40,8,68,56,12,3,2,0,0
"15132","NYI","PHI",2014020760,16471,20142015,0,65,2,2,0,3.773073808763,2.66505049949046,1.10802330927254,30,18,12,44,30,14,64,50,14,1,1,0,0
"15133","NYI","BOS",2014020775,16473,20142015,0,60,1,2,-1,5.50214024819434,4.63238870677014,0.869751541424193,40,36,4,52,44,8,69,55,14,4,3,0,0
"15134","NYI","BUF",2014020787,16474,20142015,0,60,3,2,1,4.21753358349611,3.50957803032361,0.707955553172496,31,10,21,47,19,28,68,28,40,3,4,0,0
"15135","NYI","EDM",2014020799,16476,20142015,1,60,3,2,1,3.03763282436114,4.85008445329731,-1.81245162893617,28,36,-8,42,42,0,57,53,4,3,4,0,0
"15136","NYI","TOR",2014020809,16478,20142015,1,60,3,2,1,4.68431747565046,2.93379820369335,1.75051927195711,41,34,7,48,47,1,70,59,11,3,3,0,0
"15137","NYI","CBJ",2014020826,16480,20142015,1,60,6,3,3,2.87670284004798,5.33988318536012,-2.46318034531214,46,37,9,54,51,3,72,71,1,5,5,0,0
"15138","NYI","NYR",2014020838,16482,20142015,1,60,5,6,-1,7.22182999536967,7.5285973129794,-0.306767317609729,43,42,1,56,52,4,67,71,-4,4,3,0,0
"15139","NYI","CAR",2014020849,16483,20142015,0,60,4,1,3,7.19052422074614,4.43256995072105,2.75795427002509,30,38,-8,48,58,-10,63,81,-18,2,2,0,0
"15140","NYI","NSH",2014020859,16485,20142015,1,60,5,2,3,3.70180709921351,2.36232841448873,1.33947868472478,40,32,8,50,39,11,68,63,5,5,3,0,0
"15141","NYI","WSH",2014020873,16487,20142015,0,65,2,2,0,8.90666077734204,5.47924964712001,3.42741113022203,32,27,5,51,40,11,75,67,8,1,1,0,0
"15142","NYI","VAN",2014020887,16488,20142015,1,60,0,4,-4,4.34043711182312,3.99685463698336,0.343582474839764,37,24,13,52,30,22,68,35,33,5,3,0,0
"15143","NYI","ARI",2014020895,16490,20142015,1,60,5,1,4,6.50672641733945,4.87064945400084,1.63607696333861,39,28,11,50,45,5,72,69,3,2,4,0,0
"15144","NYI","CGY",2014020918,16493,20142015,1,60,2,1,1,6.89608729961401,4.18286895526398,2.71321834435003,39,27,12,47,39,8,65,57,8,4,4,0,0
"15145","NYI","CAR",2014020925,16494,20142015,1,60,3,5,-2,2.69088997330982,5.51710105876191,-2.82621108545209,24,41,-17,33,47,-14,46,70,-24,2,5,0,0
"15146","NYI","DAL",2014020948,16497,20142015,0,62.3,2,3,-1,6.68522650838368,3.96840768179391,2.71681882658978,37,35,2,54,62,-8,73,85,-12,3,4,0,0
"15147","NYI","NSH",2014020961,16499,20142015,0,60,4,3,1,5.3348559680162,5.27595585676318,0.0589001112530241,26,31,-5,37,51,-14,51,67,-16,2,1,0,0
"15148","NYI","FLA",2014020973,16501,20142015,0,65,3,3,0,3.60197938858801,3.33778868021909,0.264190708368915,28,18,10,40,24,16,55,36,19,5,3,0,0
"15149","NYI","TOR",2014020986,16503,20142015,0,64.6333333333333,4,3,1,8.07316306169378,4.76226071898418,3.3109023427096,43,25,18,59,35,24,78,43,35,5,4,0,0
"15150","NYI","NYR",2014020991,16504,20142015,1,60,1,2,-1,4.94130557912285,3.75224050121494,1.18906507790791,30,22,8,43,33,10,57,58,-1,4,4,0,0
"15151","NYI","OTT",2014021013,16507,20142015,1,60,1,2,-1,4.19134552849573,2.62931727627711,1.56202825221862,35,28,7,45,38,7,64,58,6,3,1,0,0
"15152","NYI","MTL",2014021023,16508,20142015,1,60,1,3,-2,5.5850100409064,3.38669098986111,2.19831905104529,36,30,6,48,36,12,72,45,27,5,4,0,0
"15153","NYI","CHI",2014021047,16511,20142015,0,60,1,4,-3,6.47189319256631,5.95500245556468,0.516890737001631,39,30,9,50,42,8,63,54,9,1,1,0,0
"15154","NYI","N.J",2014021072,16515,20142015,0,60,3,0,3,3.98929327188853,2.40488732955419,1.58440594233434,30,26,4,40,37,3,47,49,-2,1,1,0,0
"15155","NYI","MIN",2014021090,16518,20142015,1,65,1,1,0,5.03784663180977,4.51163364812965,0.526212983680125,38,32,6,51,47,4,72,65,7,1,1,0,0
"15156","NYI","L.A",2014021103,16520,20142015,1,60,2,3,-1,2.47340055955465,5.9323680157022,-3.45896745614755,27,37,-10,35,44,-9,56,65,-9,2,2,0,0
"15157","NYI","ANA",2014021117,16522,20142015,1,60,2,3,-1,6.90300210512942,3.25881684850901,3.6441852566204,31,24,7,47,35,12,69,49,20,4,0,0,0
"15158","NYI","DET",2014021130,16523,20142015,1,60,5,4,1,2.82551912488051,3.61869243971887,-0.793173314838363,27,25,2,36,34,2,53,51,2,5,4,0,0
"15159","NYI","CBJ",2014021153,16527,20142015,0,65,3,3,0,2.2743772836111,5.48453950393014,-3.21016222031903,28,39,-11,38,50,-12,47,67,-20,2,2,0,0
"15160","NYI","BUF",2014021173,16529,20142015,1,60,3,0,3,4.16510581942566,2.72294886200689,1.44215695741877,36,21,15,54,31,23,68,45,23,3,4,0,0
"15161","NYI","PHI",2014021191,16532,20142015,0,60,4,5,-1,6.40809447308263,6.90481548728712,-0.496721014204494,40,27,13,48,43,5,68,60,8,5,3,0,0
"15162","NYI","CBJ",2014021223,16536,20142015,1,65,4,4,0,4.55685127989744,5.75478956854204,-1.1979382886446,52,37,15,69,51,18,90,66,24,6,6,0,0
"15163","NYI","WSH",2014030141,16540,20142015,0,60,4,1,3,6.62225979172217,3.79234260355588,2.82991718816629,27,25,2,48,36,12,65,55,10,3,2,0,0
"15164","NYI","WSH",2014030142,16542,20142015,0,60,3,4,-1,2.49904811230954,8.24184619476728,-5.74279808245774,21,35,-14,40,55,-15,51,82,-31,1,1,0,0
"15165","NYI","WSH",2014030143,16544,20142015,1,60.25,2,1,1,4.48534821269982,3.51482757541817,0.970520637281652,42,25,17,52,33,19,76,57,19,3,3,0,0
"15166","NYI","WSH",2014030144,16546,20142015,1,71.15,1,2,-1,4.61107910291685,4.62229159261119,-0.0112124896943433,37,30,7,57,42,15,78,66,12,4,1,0,0
"15167","NYI","WSH",2014030145,16548,20142015,0,60,1,5,-4,3.41096649145311,4.76547477226995,-1.35450828081684,23,41,-18,42,51,-9,60,67,-7,2,3,0,0
"15168","NYI","WSH",2014030146,16550,20142015,1,60,3,1,2,6.61074063921296,5.71619800792541,0.89454263128755,38,39,-1,48,51,-3,66,65,1,7,9,0,0
"15169","NYI","WSH",2014030147,16552,20142015,0,60,1,2,-1,5.25466081981722,3.02035410958342,2.2343067102338,11,26,-15,29,40,-11,49,60,-11,1,0,0,0
"15170","NYI","CHI",2015020015,16717,20152016,1,61.8166666666667,2,3,-1,4.83731691121648,4.69587922026403,0.141437690952444,36,35,1,50,43,7,70,57,13,2,3,0,0
"15171","NYI","CHI",2015020026,16718,20152016,0,60,1,4,-3,6.07886819364838,4.77328097843929,1.30558721520909,29,34,-5,42,42,0,56,52,4,2,7,0,0
"15172","NYI","WPG",2015020033,16720,20152016,1,60,4,2,2,7.54302215086682,3.99041120458605,3.55261094628077,44,24,20,57,35,22,73,51,22,9,5,0,0
"15173","NYI","NSH",2015020050,16723,20152016,1,60,4,3,1,3.21460787129844,5.56096925690678,-2.34636138560834,28,47,-19,35,64,-29,48,76,-28,3,3,0,0
"15174","NYI","S.J",2015020071,16725,20152016,1,60,6,3,3,4.70929984685384,4.32332086442329,0.385978982430546,34,25,9,44,37,7,58,49,9,4,2,0,0
"15175","NYI","CBJ",2015020084,16728,20152016,0,60,4,0,4,0,0,0,29,37,-8,39,51,-12,47,79,-32,3,8,0,0
"15176","NYI","BOS",2015020101,16731,20152016,1,60,3,5,-2,4.02855829172768,5.01898156457173,-0.990423272844055,26,26,0,32,38,-6,49,62,-13,2,3,0,0
"15177","NYI","STL",2015020111,16732,20152016,0,64,3,2,1,2.76662882301025,5.97778361556539,-3.21115479255513,22,40,-18,29,60,-31,46,79,-33,3,5,0,0
"15178","NYI","CGY",2015020121,16734,20152016,1,60,4,0,4,6.10422826895956,3.55318835692015,2.55103991203941,35,29,6,48,40,8,66,52,14,3,3,0,0
"15179","NYI","CAR",2015020137,16737,20152016,1,62.35,2,3,-1,1.49867552224896,1.85861462380853,-0.359939101559576,19,29,-10,29,39,-10,39,50,-11,2,2,0,0
"15180","NYI","N.J",2015020154,16739,20152016,0,65,2,2,0,3.3317953332371,1.19470543281932,2.13708990041778,26,17,9,40,22,18,49,33,16,3,4,0,0
"15181","NYI","BUF",2015020167,16740,20152016,1,60,1,2,-1,4.68851839491981,4.16388101753546,0.524637377384352,30,22,8,44,28,16,58,52,6,0,0,0,0
"15182","NYI","N.J",2015020173,16742,20152016,1,60,2,1,1,3.02030601307578,3.10689760322566,-0.0865915901498795,34,24,10,43,32,11,58,57,1,2,6,0,0
"15183","NYI","MTL",2015020187,16744,20152016,0,60,1,4,-3,3.04526935255853,5.65117274832963,-2.6059033957711,18,24,-6,29,35,-6,42,45,-3,4,3,0,0
"15184","NYI","BOS",2015020213,16747,20152016,1,60,1,2,-1,5.02626995902165,2.02484127995558,3.00142867906607,37,27,10,44,32,12,61,45,16,8,4,0,0
"15185","NYI","S.J",2015020227,16749,20152016,0,60,4,2,2,2.38438282970458,4.24659269384574,-1.86220986414116,25,36,-11,27,42,-15,49,59,-10,3,3,0,0
"15186","NYI","L.A",2015020241,16751,20152016,0,60,1,2,-1,5.02619562973268,3.58056433993625,1.44563128979644,32,22,10,47,41,6,62,55,7,3,3,0,0
"15187","NYI","ANA",2015020245,16752,20152016,0,60,4,1,3,5.77357600672985,6.1979682465687,-0.424392239838847,29,25,4,49,43,6,70,63,7,6,4,0,0
"15188","NYI","ARI",2015020261,16755,20152016,1,60,5,2,3,5.01337130235333,2.58352519234177,2.42984611001157,32,33,-1,37,39,-2,57,50,7,4,3,0,0
"15189","NYI","MTL",2015020290,16759,20152016,1,60,3,5,-2,2.02197910039058,2.89231891595409,-0.870339815563511,36,28,8,43,40,3,62,50,12,4,2,0,0
"15190","NYI","MTL",2015020306,16761,20152016,0,60,2,4,-2,3.54650486937767,3.93281984273062,-0.386314973352954,23,27,-4,33,41,-8,45,58,-13,5,5,0,0
"15191","NYI","PHI",2015020319,16764,20152016,1,60,3,1,2,5.91581606180129,2.81241896852241,3.10339709327888,36,18,18,43,27,16,65,48,17,2,5,0,0
"15192","NYI","FLA",2015020339,16766,20152016,0,65,2,2,0,3.82137696264545,3.30353952846716,0.51783743417829,25,27,-2,41,39,2,54,47,7,3,3,0,0
"15193","NYI","T.B",2015020345,16767,20152016,0,60,3,2,1,1.37784937023685,2.85049896744391,-1.47264959720707,22,31,-9,30,44,-14,36,59,-23,3,5,0,0
"15194","NYI","COL",2015020355,16769,20152016,1,60,5,3,2,5.76868775542996,3.33506513205793,2.43362262337203,28,28,0,40,38,2,56,53,3,3,3,0,0
"15195","NYI","NYR",2015020370,16771,20152016,1,65,1,1,0,4.71128591988249,4.03731588057053,0.673970039311955,37,34,3,47,50,-3,67,74,-7,3,4,0,0
"15196","NYI","STL",2015020384,16773,20152016,1,65,1,1,0,2.50246281275642,2.7559431042464,-0.253480291489978,25,32,-7,39,41,-2,51,50,1,3,3,0,0
"15197","NYI","OTT",2015020390,16774,20152016,0,63.5666666666667,2,3,-1,4.11371118828538,6.75135867563949,-2.63764748735412,31,29,2,48,48,0,66,65,1,1,3,0,0
"15198","NYI","PHI",2015020408,16777,20152016,0,65,3,3,0,7.7620680280852,5.8277150164231,1.9343530116621,26,46,-20,36,65,-29,51,89,-38,2,3,0,0
"15199","NYI","CBJ",2015020439,16781,20152016,0,62.2666666666667,3,2,1,2.88259008951718,3.75449582550209,-0.87190573598491,19,30,-11,30,45,-15,46,58,-12,3,0,0,0
"15200","NYI","N.J",2015020445,16782,20152016,1,60,4,0,4,4.10146705040825,3.43149605209353,0.669970998314714,30,27,3,37,35,2,51,48,3,4,4,0,0
"15201","NYI","FLA",2015020454,16784,20152016,1,60,1,5,-4,4.56875376905886,2.57562210159085,1.993131667468,34,17,17,52,23,29,62,30,32,5,4,0,0
"15202","NYI","COL",2015020475,16786,20152016,0,60,1,2,-1,4.07569270193198,4.25338036620815,-0.177687664276164,34,30,4,50,43,7,62,60,2,5,2,0,0
"15203","NYI","ARI",2015020491,16788,20152016,0,60,0,1,-1,3.15437928927713,3.4928574484675,-0.338478159190366,25,29,-4,38,42,-4,54,58,-4,3,2,0,0
"15204","NYI","ANA",2015020499,16790,20152016,1,60,5,2,3,4.8343731565401,3.24025992152747,1.59411323501263,31,29,2,43,35,8,59,54,5,4,2,0,0
"15205","NYI","TOR",2015020528,16796,20152016,1,60,1,3,-2,2.87399696922174,4.60593890954624,-1.7319419403245,26,38,-12,39,58,-19,66,68,-2,1,2,0,0
"15206","NYI","TOR",2015020542,16798,20152016,0,60,6,3,3,0,0,0,21,33,-12,31,54,-23,42,75,-33,4,4,0,0
"15207","NYI","BUF",2015020556,16800,20152016,0,60,2,1,1,5.1880815454424,4.58648743680909,0.601594108633307,33,43,-10,45,53,-8,61,68,-7,2,4,0,0
"15208","NYI","PIT",2015020574,16802,20152016,0,60,2,5,-3,4.07483758812305,4.05069445424306,0.0241431338799885,40,43,-3,52,54,-2,69,62,7,1,4,0,0
"15209","NYI","DAL",2015020579,16803,20152016,1,60,6,5,1,5.25309953330361,4.80245283076249,0.450646702541123,44,41,3,56,52,4,66,68,-2,4,4,0,0
"15210","NYI","WSH",2015020601,16807,20152016,1,60,1,4,-3,4.88335473423291,5.16241877194261,-0.279064037709702,35,38,-3,54,46,8,73,60,13,3,3,0,0
"15211","NYI","PHI",2015020615,16809,20152016,0,60,0,4,-4,3.42554453545745,4.89775301014015,-1.4722084746827,20,31,-11,30,48,-18,45,66,-21,3,5,0,0
"15212","NYI","CBJ",2015020634,16812,20152016,1,60,5,2,3,3.970714646141,5.20490782184061,-1.23419317569961,33,20,13,40,31,9,55,53,2,6,8,0,0
"15213","NYI","NYR",2015020646,16814,20152016,1,60,3,1,2,3.50587009355877,4.68430804075615,-1.17843794719738,32,35,-3,43,52,-9,53,73,-20,4,5,0,0
"15214","NYI","VAN",2015020671,16817,20152016,1,65,1,1,0,5.32179842729545,4.66566796367988,0.656130463615568,48,26,22,76,36,40,94,51,43,5,4,0,0
"15215","NYI","OTT",2015020706,16822,20152016,0,60,5,2,3,3.79542494076304,1.74064526524183,2.05477967552121,34,30,4,47,37,10,70,51,19,4,2,0,0
"15216","NYI","PHI",2015020716,16901,20152016,1,60,2,5,-3,1.70910946710501,5.4334531440788,-3.72434367697379,17,27,-10,22,36,-14,33,47,-14,4,4,0,0
"15217","NYI","DET",2015020725,16825,20152016,1,60,2,4,-2,2.9155740395654,4.72217937234382,-1.80660533277842,29,26,3,40,38,2,58,47,11,2,1,0,0
"15218","NYI","MIN",2015020746,16833,20152016,1,60,5,3,2,7.52737836184252,5.15188604194555,2.37549231989698,38,43,-5,55,53,2,69,64,5,1,4,0,0
"15219","NYI","WSH",2015020761,16835,20152016,0,60,2,3,-1,5.91625460342038,1.8346002131002,4.08165439032018,26,23,3,38,26,12,71,41,30,2,2,0,0
"15220","NYI","DET",2015020778,16837,20152016,0,60,1,5,-4,3.3516749514452,3.75904582469097,-0.407370873245775,29,20,9,43,30,13,57,40,17,6,4,0,0
"15221","NYI","EDM",2015020789,16838,20152016,1,60,8,1,7,6.93141767504267,4.49666706431708,2.43475061072559,31,31,0,41,38,3,52,46,6,7,4,0,0
"15222","NYI","CBJ",2015020798,16840,20152016,0,65,2,2,0,5.36945815128274,5.39735545017174,-0.0278972988890018,46,31,15,54,40,14,80,62,18,2,1,0,0
"15223","NYI","L.A",2015020809,16842,20152016,1,60,5,2,3,8.0380722410788,5.38130949808989,2.65676274298891,30,30,0,40,45,-5,53,69,-16,4,3,0,0
"15224","NYI","CAR",2015020828,16844,20152016,0,60,3,6,-3,3.71722651956952,7.08091386500746,-3.36368734543794,26,31,-5,43,40,3,55,50,5,3,3,0,0
"15225","NYI","DET",2015020840,16846,20152016,1,60,4,1,3,4.01194242811784,4.89540732240857,-0.883464894290733,32,29,3,40,39,1,57,61,-4,5,4,0,0
"15226","NYI","WSH",2015020858,16849,20152016,1,64.2666666666667,2,3,-1,2.52799229012453,4.89431887233513,-2.3663265822106,22,35,-13,33,42,-9,49,60,-11,4,7,0,0
"15227","NYI","N.J",2015020869,16850,20152016,0,60,1,0,1,3.14057563594542,3.28759973707929,-0.147024101133866,24,27,-3,32,33,-1,46,45,1,3,1,0,0
"15228","NYI","MIN",2015020898,16854,20152016,0,60,4,1,3,5.78920920080054,4.43394876833599,1.35526043246455,31,31,0,38,39,-1,44,61,-17,3,5,0,0
"15229","NYI","CGY",2015020913,16856,20152016,0,64.7,2,1,1,5.46649344081379,3.98454846506502,1.48194497574877,34,32,2,41,41,0,55,63,-8,2,2,0,0
"15230","NYI","EDM",2015020936,16859,20152016,0,60,1,3,-2,4.83215397835011,5.80683535820572,-0.97468137985561,37,26,11,50,36,14,70,56,14,4,1,0,0
"15231","NYI","VAN",2015020950,16861,20152016,0,60,3,2,1,5.9893469180098,5.05141588742845,0.937931030581353,24,33,-9,31,42,-11,44,59,-15,1,2,0,0
"15232","NYI","WPG",2015020961,16863,20152016,0,62.3333333333333,4,3,1,6.12537501442421,2.53171193733004,3.59366307709416,27,29,-2,36,37,-1,42,54,-12,4,4,0,0
"15233","NYI","NYR",2015020982,16866,20152016,0,60,6,4,2,4.88606388168409,3.83672225228656,1.04934162939753,32,26,6,48,43,5,60,57,3,3,3,0,0
"15234","NYI","PIT",2015020994,16868,20152016,1,60,2,1,1,3.85323314093694,3.30879322427248,0.544439916664459,27,35,-8,40,46,-6,53,68,-15,5,4,0,0
"15235","NYI","TOR",2015021001,16869,20152016,0,65,3,3,0,3.91844531398965,6.73699090865921,-2.81854559466956,27,36,-9,38,52,-14,48,65,-17,3,4,0,0
"15236","NYI","BOS",2015021018,16872,20152016,0,60,1,3,-2,4.31240403838456,3.73817051411606,0.574233524268493,26,31,-5,40,44,-4,57,62,-5,1,2,0,0
"15237","NYI","FLA",2015021033,16874,20152016,1,60,3,2,1,3.88743162367415,4.52185585869393,-0.634424235019779,28,25,3,44,37,7,59,55,4,3,3,0,0
"15238","NYI","PIT",2015021040,16875,20152016,0,65,1,1,0,3.6169238275902,5.01312368565406,-1.39619985806386,26,34,-8,36,47,-11,57,71,-14,4,4,0,0
"15239","NYI","NSH",2015021057,16877,20152016,0,60,2,4,-2,3.57579927443294,6.5965260748053,-3.02072680037236,22,32,-10,33,50,-17,43,63,-20,0,1,0,0
"15240","NYI","DAL",2015021074,16879,20152016,0,60,0,3,-3,3.30076058309101,5.47705981289721,-2.1762992298062,27,36,-9,39,56,-17,65,75,-10,2,4,0,0
"15241","NYI","PHI",2015021085,16881,20152016,1,60,1,4,-3,3.68273379173006,2.84344026085455,0.839293530875514,24,27,-3,36,33,3,54,48,6,3,4,0,0
"15242","NYI","OTT",2015021099,16883,20152016,1,60,3,1,2,3.05224292131606,2.06374799166355,0.988494929652518,23,23,0,34,26,8,48,39,9,3,1,0,0
"15243","NYI","T.B",2015021113,16885,20152016,0,60,4,7,-3,2.63213818112854,5.33323938393733,-2.70110120280879,31,42,-11,34,51,-17,49,67,-18,3,3,0,0
"15244","NYI","CAR",2015021124,16886,20152016,0,64.7666666666667,4,3,1,4.26061187366879,8.44469671832485,-4.18408484465606,31,36,-5,53,50,3,62,73,-11,2,1,0,0
"15245","NYI","CAR",2015021141,16889,20152016,1,65,1,1,0,4.54221811867319,3.82185945427045,0.720358664402738,31,27,4,44,33,11,61,46,15,3,1,0,0
"15246","NYI","CBJ",2015021153,16891,20152016,1,60,4,3,1,4.0655737532943,3.5350139712682,0.530559782026103,27,24,3,37,35,2,49,61,-12,3,4,0,0
"15247","NYI","PIT",2015021167,16893,20152016,1,60,0,5,-5,4.11792439715646,4.91325674742257,-0.795332350266108,24,33,-9,38,37,1,53,46,7,9,7,0,0
"15248","NYI","T.B",2015021183,16895,20152016,1,60,5,2,3,5.47487638150897,4.24632376048248,1.22855262102648,36,34,2,45,45,0,53,64,-11,3,5,0,0
"15249","NYI","WSH",2015021191,16896,20152016,0,62.2166666666667,4,3,1,0,0,0,27,32,-5,39,42,-3,62,57,5,4,3,0,0
"15250","NYI","NYR",2015021204,16898,20152016,0,60,4,1,3,3.70403736680601,4.80173767643629,-1.09770030963028,23,37,-14,34,48,-14,48,71,-23,4,5,0,0
"15251","NYI","BUF",2015021225,16900,20152016,1,62.7666666666667,3,4,-1,3.16238680478273,3.36701955922763,-0.204632754444901,24,26,-2,37,38,-1,49,55,-6,1,2,0,0
"15252","NYI","FLA",2015030111,16905,20152016,0,60,5,4,1,3.34815847198479,6.81542445100786,-3.46726597902307,26,46,-20,33,59,-26,42,77,-35,3,4,0,0
"15253","NYI","FLA",2015030112,16906,20152016,0,60,1,3,-2,3.51279379258631,4.40575270733098,-0.892958914744668,42,31,11,56,41,15,68,49,19,6,4,0,0
"15254","NYI","FLA",2015030113,16908,20152016,1,72.5166666666667,4,3,1,4.59401229970808,3.98564525396796,0.608367045740124,39,39,0,52,56,-4,66,73,-7,5,4,0,0
"15255","NYI","FLA",2015030114,16911,20152016,1,60,1,2,-1,5.08079393743463,2.72642069148878,2.35437324594585,27,29,-2,39,41,-2,49,63,-14,4,4,0,0
"15256","NYI","FLA",2015030115,16913,20152016,0,80,1,1,0,3.82513845822632,8.55400575046951,-4.72886729224319,36,41,-5,47,59,-12,54,83,-29,3,2,0,0
"15257","NYI","FLA",2015030116,16915,20152016,1,80,1,1,0,6.10841902629785,4.59093826708303,1.51748075921482,47,38,9,72,56,16,95,73,22,3,3,0,0
"15258","NYI","T.B",2015030211,16918,20152016,0,60,5,3,2,2.56845681142295,7.83958609533001,-5.27112928390706,22,36,-14,34,50,-16,44,65,-21,4,2,0,0
"15259","NYI","T.B",2015030212,16921,20152016,0,60,1,4,-3,2.33838220626352,4.59430397327484,-2.25592176701131,20,31,-11,32,45,-13,39,59,-20,8,9,0,0
"15260","NYI","T.B",2015030213,16924,20152016,1,62.8,4,5,-1,4.5368037922928,3.3455042891218,1.191299503171,39,41,-2,47,50,-3,59,73,-14,5,5,0,0
"15261","NYI","T.B",2015030214,16927,20152016,1,61.5666666666667,1,2,-1,4.69377812949369,3.49401092351764,1.19976720597606,28,24,4,45,35,10,67,45,22,3,3,0,0
"15262","NYI","T.B",2015030215,16929,20152016,0,60,0,4,-4,3.54089566918365,2.90983529287041,0.631060376313242,28,25,3,42,41,1,51,57,-6,4,7,0,0
"15263","NYI","NYR",2016020006,17087,20162017,0,60,3,5,-2,4.34621846571099,6.22053082119237,-1.87431235548138,28,39,-11,42,54,-12,58,73,-15,3,5,0,0
"15264","NYI","WSH",2016020022,17089,20162017,0,60,1,2,-1,4.9559189112079,2.84166805224959,2.11425085895832,22,28,-6,37,38,-1,51,58,-7,2,5,0,0
"15265","NYI","ANA",2016020030,17090,20162017,1,60.9,3,2,1,4.08005954948021,3.81444489769638,0.265614651783835,30,26,4,42,32,10,55,52,3,5,5,0,0
"15266","NYI","S.J",2016020038,17092,20162017,1,60,2,3,-1,3.71281719121725,3.33100855443809,0.381808636779169,23,27,-4,31,37,-6,44,54,-10,2,1,0,0
"15267","NYI","ARI",2016020062,17095,20162017,1,60,3,2,1,2.63201056236318,2.31239257569541,0.319617986667765,31,25,6,41,37,4,61,52,9,4,5,0,0
"15268","NYI","MIN",2016020078,17097,20162017,1,60,6,3,3,4.80454508349067,4.61959226097679,0.184952822513878,33,29,4,42,48,-6,53,71,-18,3,6,0,0
"15269","NYI","MTL",2016020094,17100,20162017,1,60,2,3,-1,4.21980334448745,4.49790111241327,-0.278097767925829,28,29,-1,36,46,-10,54,74,-20,2,1,0,0
"15270","NYI","PIT",2016020100,17101,20162017,0,60,2,4,-2,3.68711231631079,8.79168687529472,-5.10457455898393,37,35,2,45,57,-12,61,76,-15,6,5,0,0
"15271","NYI","TOR",2016020126,17104,20162017,1,60,5,1,4,3.69979784591123,4.95403323573737,-1.25423538982614,35,34,1,52,56,-4,59,78,-19,5,6,0,0
"15272","NYI","T.B",2016020131,17106,20162017,1,60,1,6,-5,3.99711120939673,4.10333530566717,-0.106224096270438,27,36,-9,35,45,-10,49,58,-9,6,7,0,0
"15273","NYI","PHI",2016020147,17108,20162017,1,65,2,2,0,5.7027146242771,5.35353729862254,0.349177325654563,27,42,-15,34,61,-27,43,79,-36,4,6,0,0
"15274","NYI","EDM",2016020167,17110,20162017,1,65,3,3,0,4.2324416837655,5.92812185018556,-1.69568016642006,33,23,10,40,43,-3,54,66,-12,4,4,0,0
"15275","NYI","VAN",2016020181,17112,20162017,1,60,4,2,2,0,0,0,32,32,0,48,42,6,61,65,-4,2,2,0,0
"15276","NYI","T.B",2016020201,17115,20162017,0,60,1,4,-3,5.1100230340145,2.68526191171259,2.42476112230192,32,28,4,43,39,4,58,59,-1,1,6,0,0
"15277","NYI","FLA",2016020214,17117,20162017,0,64.2333333333333,2,3,-1,2.999840092054,5.56103557054303,-2.56119547848903,21,43,-22,29,58,-29,40,85,-45,7,6,0,0
"15278","NYI","T.B",2016020229,17119,20162017,1,60,0,4,-4,5.89765777438879,4.60897436452797,1.28868340986082,34,31,3,46,39,7,64,55,9,4,4,0,0
"15279","NYI","PIT",2016020255,17123,20162017,1,61.4,2,3,-1,1.84791758736303,6.34153854455508,-4.49362095719205,22,35,-13,31,50,-19,47,74,-27,2,5,0,0
"15280","NYI","ANA",2016020287,17127,20162017,0,65,2,2,0,4.33560812508222,4.55445481150628,-0.218846686424058,35,41,-6,47,57,-10,58,71,-13,5,2,0,0
"15281","NYI","L.A",2016020298,17128,20162017,0,60,2,4,-2,3.90524877185817,6.46735205869481,-2.56210328683665,24,28,-4,34,47,-13,53,64,-11,2,2,0,0
"15282","NYI","S.J",2016020305,17130,20162017,0,60,2,3,-1,5.84012459870428,5.24136553479002,0.598759063914258,28,28,0,43,48,-5,55,63,-8,1,2,0,0
"15283","NYI","CGY",2016020328,17133,20162017,1,61.8833333333333,2,1,1,4.9233823409304,2.81828192356625,2.10510041736416,27,26,1,43,37,6,54,50,4,4,1,0,0
"15284","NYI","PIT",2016020342,17135,20162017,1,60,5,3,2,0,0,0,30,34,-4,46,48,-2,64,64,0,5,4,0,0
"15285","NYI","WSH",2016020348,17136,20162017,0,60,3,0,3,3.24403947024062,3.47860629132631,-0.234566821085696,28,38,-10,38,66,-28,47,87,-40,2,6,0,0
"15286","NYI","DET",2016020372,17139,20162017,1,61.0333333333333,3,4,-1,7.19170421428862,3.41660963074828,3.77509458354034,35,34,1,47,45,2,63,61,2,2,1,0,0
"15287","NYI","NYR",2016020384,17141,20162017,1,60,4,2,2,4.13344988517443,5.26658647094155,-1.13313658576712,32,38,-6,38,49,-11,44,77,-33,2,5,0,0
"15288","NYI","STL",2016020396,17143,20162017,1,60,3,2,1,2.06830907263793,3.24236798971966,-1.17405891708173,27,26,1,35,39,-4,52,61,-9,3,0,0,0
"15289","NYI","CBJ",2016020417,17145,20162017,0,60,2,6,-4,5.37534166558703,4.38862534789951,0.986716317687519,30,39,-9,40,49,-9,51,64,-13,3,4,0,0
"15290","NYI","WSH",2016020432,17148,20162017,1,60,2,4,-2,2.18663249199017,6.02357358289737,-3.8369410909072,28,38,-10,35,48,-13,52,67,-15,2,3,0,0
"15291","NYI","CHI",2016020446,17150,20162017,1,60,4,5,-1,6.35934908405761,2.67298247616884,3.68636660788877,32,32,0,43,44,-1,53,65,-12,2,3,0,0
"15292","NYI","BUF",2016020453,17151,20162017,0,60.7,2,3,-1,3.57441998188733,3.96722810927531,-0.39280812738798,35,37,-2,45,48,-3,53,62,-9,1,3,0,0
"15293","NYI","OTT",2016020473,17153,20162017,1,60,2,6,-4,3.49870313212159,5.07250062222715,-1.57379749010556,31,34,-3,44,48,-4,70,56,14,4,2,0,0
"15294","NYI","BOS",2016020481,17155,20162017,0,60,4,2,2,2.49565357036216,6.80710421940603,-4.31145064904387,29,50,-21,34,70,-36,44,95,-51,5,5,0,0
"15295","NYI","BUF",2016020505,17158,20162017,1,60,5,1,4,4.67850521698711,1.9929066761834,2.68559854080371,32,29,3,45,36,9,63,58,5,2,2,0,0
"15296","NYI","WSH",2016020518,17162,20162017,1,60,4,3,1,1.48252803782816,4.36400738952216,-2.881479351694,31,34,-3,42,47,-5,54,61,-7,4,4,0,0
"15297","NYI","MIN",2016020538,17164,20162017,0,60,4,6,-2,5.298349092016,6.87063779926393,-1.57228870724794,28,36,-8,41,49,-8,58,67,-9,5,3,0,0
"15298","NYI","WPG",2016020553,17166,20162017,0,60,6,2,4,3.23861723663867,3.97174628413632,-0.733129047497641,24,34,-10,30,42,-12,41,59,-18,2,3,0,0
"15299","NYI","COL",2016020588,17172,20162017,0,64.7166666666667,1,2,-1,5.16823625375764,7.15024065948091,-1.98200440572327,36,39,-3,52,46,6,71,66,5,5,6,0,0
"15300","NYI","ARI",2016020600,17173,20162017,0,65,1,1,0,4.29452075058362,5.06060599112425,-0.766085240540633,28,27,1,49,45,4,61,66,-5,4,2,0,0
"15301","NYI","FLA",2016020620,17177,20162017,1,60,1,2,-1,5.16530596096266,3.45266504539177,1.71264091557089,30,24,6,41,30,11,60,49,11,1,2,0,0
"15302","NYI","FLA",2016020636,17179,20162017,0,60,5,2,3,7.87436709355097,3.69962136581307,4.1747457277379,42,29,13,55,40,15,66,50,16,8,5,0,0
"15303","NYI","CAR",2016020646,17180,20162017,0,60,4,7,-3,6.9051930840069,11.6862180796452,-4.78102499563829,32,45,-13,47,62,-15,62,79,-17,0,0,0,0
"15304","NYI","BOS",2016020656,17182,20162017,0,60,4,0,4,6.20125134461523,5.13445121697821,1.06680012763702,27,32,-5,35,45,-10,50,55,-5,4,2,0,0
"15305","NYI","DAL",2016020677,17185,20162017,1,60,3,0,3,6.05575983809467,2.38931795535609,3.66644188273858,36,23,13,44,33,11,59,51,8,8,3,0,0
"15306","NYI","L.A",2016020695,17187,20162017,1,60,4,2,2,6.44041119845024,3.71958620345575,2.72082499499449,36,36,0,50,50,0,66,60,6,5,2,0,0
"15307","NYI","PHI",2016020705,17188,20162017,1,63.3333333333333,2,3,-1,2.31935624231119,6.8334925553936,-4.51413631308242,38,47,-9,48,68,-20,66,83,-17,2,3,0,0
"15308","NYI","CBJ",2016020716,17190,20162017,1,60,4,2,2,2.90255086851539,4.73542377683043,-1.83287290831504,29,23,6,36,34,2,49,50,-1,1,0,0,0
"15309","NYI","MTL",2016020730,17192,20162017,1,60,3,1,2,4.52686497963441,1.41410967138096,3.11275530825345,42,22,20,52,27,25,61,40,21,5,4,0,0
"15310","NYI","WSH",2016020741,17197,20162017,1,60,3,2,1,6.01617004908621,4.55796323164031,1.4582068174459,29,30,-1,45,44,1,54,60,-6,2,1,0,0
"15311","NYI","DET",2016020767,17200,20162017,0,60,4,5,-1,6.71289362400421,4.8236551721933,1.88923845181091,36,24,12,49,37,12,59,43,16,5,2,0,0
"15312","NYI","CAR",2016020777,17201,20162017,1,62.8666666666667,4,5,-1,2.25715230201604,4.46370047586854,-2.2065481738525,37,25,12,47,34,13,71,48,23,4,3,0,0
"15313","NYI","TOR",2016020788,17203,20162017,1,62.7,6,5,1,7.09995208008331,3.51367456295702,3.58627751712629,34,32,2,44,42,2,65,55,10,1,1,0,0
"15314","NYI","PHI",2016020805,17206,20162017,0,60,3,1,2,4.12718860141467,5.24658056999033,-1.11939196857566,30,35,-5,37,48,-11,57,80,-23,3,4,0,0
"15315","NYI","OTT",2016020816,17208,20162017,0,60,0,3,-3,5.28069738551029,4.42649935549707,0.854198030013215,33,24,9,49,33,16,68,50,18,2,3,0,0
"15316","NYI","COL",2016020830,17209,20162017,1,60,5,1,4,5.38370391786663,4.33757651818451,1.04612739968212,33,27,6,42,42,0,48,51,-3,8,6,0,0
"15317","NYI","TOR",2016020838,17211,20162017,0,60,1,7,-6,4.80660990369126,4.56433513290212,0.242274770789136,34,41,-7,52,59,-7,56,67,-11,5,3,0,0
"15318","NYI","NYR",2016020849,17213,20162017,1,60,4,2,2,3.20101367512393,2.36260714690434,0.838406528219593,23,27,-4,32,40,-8,52,58,-6,3,4,0,0
"15319","NYI","N.J",2016020862,17215,20162017,0,60,2,3,-1,5.39689273449767,3.87928508743369,1.51760764706398,42,21,21,54,36,18,72,45,27,4,2,0,0
"15320","NYI","N.J",2016020873,17216,20162017,1,60,6,4,2,4.79296495212475,7.34538609138144,-2.55242113925669,32,30,2,43,36,7,68,50,18,2,3,0,0
"15321","NYI","DET",2016020886,17218,20162017,0,60,3,1,2,5.60882096033311,4.79548564656807,0.813335313765037,22,27,-5,37,43,-6,46,54,-8,3,5,0,0
"15322","NYI","MTL",2016020895,17220,20162017,0,60,3,0,3,4.63767709043168,2.67991900251945,1.95775808791223,24,24,0,30,34,-4,46,61,-15,3,2,0,0
"15323","NYI","CBJ",2016020909,17222,20162017,0,60,0,7,-7,4.24590440289467,6.4859998524189,-2.24009544952423,24,45,-21,33,55,-22,44,71,-27,0,2,0,0
"15324","NYI","DAL",2016020943,17227,20162017,0,60,5,4,1,7.94784770611295,5.69127125889606,2.2565764472169,33,25,8,50,40,10,69,55,14,2,1,0,0
"15325","NYI","CHI",2016020949,17228,20162017,0,65,1,1,0,4.46646259703266,5.00377192691667,-0.53730932988401,32,31,1,42,53,-11,55,76,-21,3,2,0,0
"15326","NYI","CGY",2016020962,17230,20162017,0,60,2,5,-3,6.41254359902814,5.01644687569933,1.39609672332881,35,37,-2,48,48,0,64,64,0,4,3,0,0
"15327","NYI","EDM",2016020979,17232,20162017,0,60,4,1,3,3.86710500274785,2.93212392547139,0.934981077276461,27,28,-1,33,40,-7,46,59,-13,1,2,0,0
"15328","NYI","VAN",2016020992,17234,20162017,0,61.55,4,3,1,3.3852720470486,2.40380090371272,0.981471143335879,28,39,-11,35,47,-12,45,58,-13,3,3,0,0
"15329","NYI","STL",2016021007,17236,20162017,0,60,3,4,-1,4.67091586237075,2.98710738175751,1.68380848061324,24,24,0,40,30,10,59,35,24,3,1,0,0
"15330","NYI","CAR",2016021016,17238,20162017,1,60,4,8,-4,2.45660812812315,4.9227381271071,-2.46612999898394,27,33,-6,37,47,-10,46,59,-13,3,4,0,0
"15331","NYI","CAR",2016021026,17239,20162017,0,60.5666666666667,3,2,1,5.43885077266168,7.49857003398586,-2.05971926132418,34,32,2,50,54,-4,66,69,-3,1,3,0,0
"15332","NYI","WPG",2016021038,17241,20162017,1,60,2,4,-2,1.86382106741337,3.88776037896851,-2.02393931155515,29,28,1,40,42,-2,60,52,8,4,5,0,0
"15333","NYI","CBJ",2016021054,17243,20162017,1,61.3166666666667,2,3,-1,0,0,0,22,38,-16,37,46,-9,56,54,2,2,1,0,0
"15334","NYI","NYR",2016021087,17247,20162017,0,60,3,2,1,3.31787803690946,6.90462839030897,-3.58675035339951,28,36,-8,38,57,-19,53,71,-18,4,5,0,0
"15335","NYI","PIT",2016021101,17249,20162017,0,65,3,3,0,5.69543725787662,6.29501828126376,-0.599581023387145,46,40,6,54,52,2,69,76,-7,1,1,0,0
"15336","NYI","BOS",2016021111,17250,20162017,1,60,1,2,-1,1.43697415062343,2.43149228539551,-0.994518134772079,19,18,1,29,28,1,42,45,-3,6,3,0,0
"15337","NYI","NSH",2016021123,17252,20162017,1,60,1,3,-2,3.87433454371057,3.53152568489531,0.34280885881526,25,31,-6,37,44,-7,50,53,-3,3,4,0,0
"15338","NYI","PHI",2016021142,17255,20162017,0,60,3,6,-3,6.79920489490905,4.13815809326479,2.66104680164426,41,30,11,53,34,19,80,46,34,4,3,0,0
"15339","NYI","N.J",2016021151,17256,20162017,1,60,2,1,1,3.61741795228586,4.77560847615848,-1.15819052387262,38,27,11,48,39,9,58,56,2,10,3,0,0
"15340","NYI","BUF",2016021166,17258,20162017,0,60,4,2,2,3.4986469725809,4.5148500749201,-1.0162031023392,26,37,-11,33,46,-13,44,57,-13,1,4,0,0
"15341","NYI","NSH",2016021185,17260,20162017,0,61.4166666666667,2,1,1,3.9511937599184,3.15458884614054,0.796604913777855,32,23,9,54,36,18,72,49,23,2,1,0,0
"15342","NYI","CAR",2016021196,17262,20162017,0,60,3,0,3,4.76797399832867,4.00063268712467,0.767341311204,23,29,-6,35,40,-5,45,61,-16,3,3,0,0
"15343","NYI","N.J",2016021210,17264,20162017,0,60,4,2,2,3.71967838529963,7.60766545800945,-3.88798707270982,20,39,-19,28,50,-22,38,67,-29,4,3,0,0
"15344","NYI","OTT",2016021223,17265,20162017,1,60,4,2,2,4.17064944381127,4.03676370088942,0.133885742921848,21,34,-13,29,54,-25,41,67,-26,0,3,0,0
"15345","NYI","CBJ",2017020013,17445,20172018,0,60,0,5,-5,4.83938417674744,5.94902724123676,-1.10964306448932,29,37,-8,43,52,-9,61,67,-6,2,3,0,0
"15346","NYI","BUF",2017020020,17446,20172018,1,60,6,3,3,6.08372335827682,4.13202252103788,1.95170083723894,33,29,4,43,41,2,54,52,2,4,5,0,0
"15347","NYI","STL",2017020033,17448,20172018,1,65,2,2,0,7.03492859236752,4.63235345873047,2.40257513363705,42,35,7,57,40,17,70,53,17,6,6,0,0
"15348","NYI","ANA",2017020049,17450,20172018,0,60,2,3,-1,3.24987807660364,4.83484777531885,-1.58496969871521,41,30,11,53,47,6,75,59,16,5,4,0,0
"15349","NYI","S.J",2017020076,17453,20172018,0,60,3,1,2,3.37348733941326,4.82773109786517,-1.45424375845191,23,41,-18,31,53,-22,51,77,-26,4,2,0,0
"15350","NYI","L.A",2017020079,17454,20172018,0,60,2,3,-1,5.20573741548287,4.63299633393763,0.572741081545246,25,27,-2,42,33,9,60,47,13,2,3,0,0
"15351","NYI","NYR",2017020096,17458,20172018,0,65,3,3,0,6.32830249074323,6.66092594782822,-0.332623457084992,38,41,-3,47,54,-7,61,63,-2,3,1,0,0
"15352","NYI","S.J",2017020115,17460,20172018,1,60,5,3,2,2.98020847116052,4.76943178217334,-1.78922331101282,23,31,-8,34,46,-12,50,63,-13,2,4,0,0
"15353","NYI","ARI",2017020126,17463,20172018,1,60,5,3,2,2.94692187849432,4.32722052594181,-1.38029864744749,25,35,-10,33,47,-14,49,64,-15,3,3,0,0
"15354","NYI","MIN",2017020146,17465,20172018,0,60,4,6,-2,4.52739436344701,3.81679565004857,0.710598713398437,33,33,0,45,43,2,67,47,20,5,3,0,0
"15355","NYI","NSH",2017020163,17467,20172018,0,60,6,2,4,2.64211732437252,3.51186887459062,-0.869751550218098,23,30,-7,35,41,-6,43,55,-12,8,7,0,0
"15356","NYI","VGK",2017020170,17469,20172018,1,60,6,3,3,6.60148552322607,3.93707767461683,2.66440784860924,30,34,-4,40,45,-5,54,68,-14,5,5,0,0
"15357","NYI","WSH",2017020187,17472,20172018,0,60,3,4,-1,7.01774557970657,3.98806882696226,3.02967675274431,38,19,19,53,28,25,72,48,24,4,4,0,0
"15358","NYI","COL",2017020214,17475,20172018,1,60,6,4,2,3.44005277976248,3.73843816108638,-0.298385381323897,28,35,-7,40,45,-5,56,62,-6,2,4,0,0
"15359","NYI","EDM",2017020225,17477,20172018,1,60.6333333333333,1,2,-1,4.51375515788095,1.04158512689173,3.47217003098922,37,25,12,47,31,16,57,46,11,3,2,0,0
"15360","NYI","DAL",2017020246,17480,20172018,0,60,0,5,-5,2.51636110472473,4.17263180219105,-1.65627069746632,14,29,-15,26,45,-19,36,68,-32,4,4,0,0
"15361","NYI","STL",2017020257,17481,20172018,0,60,5,2,3,4.42265393459316,4.37634445249569,0.0463094820974712,29,37,-8,34,54,-20,49,69,-20,3,5,0,0
"15362","NYI","CAR",2017020279,17486,20172018,1,60,6,4,2,7.88058687461307,3.87755210138857,4.0030347732245,36,32,4,48,40,8,60,57,3,3,3,0,0
"15363","NYI","T.B",2017020299,17488,20172018,0,60,5,3,2,5.31322643862222,6.06915916015141,-0.755932721529188,32,39,-7,41,56,-15,56,73,-17,2,1,0,0
"15364","NYI","CAR",2017020305,17489,20172018,0,60,2,4,-2,3.87383095438804,4.34848006185348,-0.474649107465439,29,32,-3,39,47,-8,61,56,5,7,5,0,0
"15365","NYI","PHI",2017020323,17492,20172018,1,60.5333333333333,4,3,1,5.48731412321709,4.17355409256243,1.31376003065467,39,38,1,52,47,5,72,57,15,5,2,0,0
"15366","NYI","PHI",2017020335,17494,20172018,0,62.7333333333333,5,4,1,7.92387584476228,5.01262107778166,2.91125476698062,37,30,7,51,47,4,67,65,2,4,3,0,0
"15367","NYI","OTT",2017020350,17495,20172018,0,60,2,1,1,3.46806648808456,3.78677353428668,-0.318707046202124,24,32,-8,35,45,-10,47,58,-11,5,6,0,0
"15368","NYI","VAN",2017020368,17498,20172018,1,60,5,2,3,5.73922359265271,2.28000239702574,3.45922119562696,36,25,11,50,35,15,59,51,8,3,2,0,0
"15369","NYI","OTT",2017020389,17501,20172018,1,60,5,6,-1,4.05805272647454,6.76053827074543,-2.70248554427089,37,35,2,44,48,-4,57,60,-3,3,3,0,0
"15370","NYI","FLA",2017020413,17504,20172018,0,65,4,4,0,6.76086780260084,5.74426288885297,1.01660491374787,32,43,-11,45,51,-6,54,59,-5,2,4,0,0
"15371","NYI","T.B",2017020420,17505,20172018,0,60,2,6,-4,3.56586306045119,4.48275926723676,-0.916896206785566,31,34,-3,38,47,-9,46,68,-22,2,4,0,0
"15372","NYI","PIT",2017020431,17507,20172018,0,61.4833333333333,3,4,-1,3.35466767475009,3.73449624737259,-0.3798285726225,26,32,-6,34,45,-11,56,58,-2,4,2,0,0
"15373","NYI","BOS",2017020444,17509,20172018,0,60,1,3,-2,4.59898535703542,3.58540836119138,1.01357699584404,31,33,-2,40,44,-4,61,54,7,2,4,0,0
"15374","NYI","WSH",2017020460,17511,20172018,1,60,3,1,2,3.06153591824113,3.59853246675216,-0.536996548511027,29,32,-3,46,40,6,54,57,-3,3,2,0,0
"15375","NYI","DAL",2017020476,17513,20172018,1,60,2,5,-3,3.61518291146785,2.64428869925905,0.970894212208805,34,27,7,45,35,10,53,44,9,3,2,0,0
"15376","NYI","CBJ",2017020481,17514,20172018,0,60,4,6,-2,0,0,0,25,35,-10,45,47,-2,67,64,3,4,2,0,0
"15377","NYI","L.A",2017020499,17516,20172018,1,61.9,4,3,1,4.22032831265254,3.4114973000486,0.808831012603945,33,29,4,45,44,1,63,56,7,5,3,0,0
"15378","NYI","DET",2017020518,17519,20172018,1,60,3,6,-3,5.40030555140766,5.2403023664765,0.160003184931156,37,22,15,41,41,0,51,59,-8,3,1,0,0
"15379","NYI","ANA",2017020531,17521,20172018,1,64.05,4,5,-1,4.94239998588455,7.41037568348838,-2.46797569760383,26,40,-14,36,54,-18,53,71,-18,4,3,0,0
"15380","NYI","WPG",2017020544,17523,20172018,1,60,5,2,3,5.48861392777508,3.82322304445552,1.66539088331956,29,40,-11,36,55,-19,44,71,-27,3,3,0,0
"15381","NYI","BUF",2017020560,17527,20172018,1,61.1333333333333,3,2,1,5.02930407038434,3.82300997411949,1.20629409626486,34,37,-3,45,47,-2,57,62,-5,2,4,0,0
"15382","NYI","WPG",2017020582,17529,20172018,0,60,2,4,-2,4.41938033698534,5.16766669832759,-0.748286361342252,44,37,7,60,52,8,81,75,6,4,5,0,0
"15383","NYI","COL",2017020597,17531,20172018,0,60,1,6,-5,3.28148815690757,7.95343359167861,-4.67194543477104,28,48,-20,36,58,-22,59,77,-18,3,5,0,0
"15384","NYI","BOS",2017020603,17533,20172018,1,60,1,5,-4,4.124965618852,4.60857176303216,-0.483606144180158,26,38,-12,40,48,-8,58,66,-8,5,4,0,0
"15385","NYI","PHI",2017020618,17535,20172018,0,60,4,6,-2,5.1138165879529,4.0081604746083,1.10565611334459,31,32,-1,42,49,-7,59,66,-7,2,5,0,0
"15386","NYI","PIT",2017020628,17536,20172018,1,60,0,4,-4,5.63743054639644,4.35281968512572,1.28461086127072,31,38,-7,42,52,-10,54,61,-7,4,3,0,0
"15387","NYI","N.J",2017020642,17538,20172018,1,65,4,4,0,3.81694620627968,4.15467697495336,-0.33773076867368,38,46,-8,43,55,-12,65,69,-4,3,5,0,0
"15388","NYI","NYR",2017020670,17544,20172018,0,60,7,2,5,4.7021143431848,4.90226858342157,-0.20015424023677,37,39,-2,52,57,-5,66,78,-12,2,3,0,0
"15389","NYI","MTL",2017020686,17546,20172018,0,61.85,5,4,1,2.1805063648535,11.8336130031603,-9.65310663830678,24,56,-32,33,69,-36,51,85,-34,2,4,0,0
"15390","NYI","N.J",2017020688,17547,20172018,1,60,1,4,-3,4.6210073800286,5.94347840182621,-1.3224710217976,26,42,-16,38,59,-21,51,69,-18,2,3,0,0
"15391","NYI","BOS",2017020696,17549,20172018,1,60,2,5,-3,1.57265295810066,6.08384130617992,-4.51118834807926,24,34,-10,29,47,-18,44,58,-14,2,1,0,0
"15392","NYI","CHI",2017020718,17551,20172018,0,60,7,3,4,4.03181616919755,3.42834327707003,0.603472892127527,46,39,7,56,46,10,70,69,1,4,1,0,0
"15393","NYI","ARI",2017020731,17553,20172018,0,62.35,2,3,-1,6.46302993084043,6.08157069994195,0.381459230898486,34,33,1,43,58,-15,51,73,-22,2,2,0,0
"15394","NYI","VGK",2017020758,17556,20172018,0,60,2,1,1,2.3022942427524,5.77917846181663,-3.47688421906423,25,39,-14,32,54,-22,39,74,-35,1,2,0,0
"15395","NYI","FLA",2017020763,17561,20172018,1,60,1,4,-3,4.82202725077514,6.26866899602942,-1.44664174525428,33,40,-7,40,51,-11,56,62,-6,1,0,0,0
"15396","NYI","TOR",2017020773,17562,20172018,0,60,0,5,-5,4.87571573787818,6.9263298841106,-2.05061414623242,28,50,-22,42,69,-27,62,85,-23,1,2,0,0
"15397","NYI","CBJ",2017020798,17565,20172018,1,60,4,3,1,4.3008532114327,5.31766274343681,-1.01680953200412,38,49,-11,49,71,-22,65,88,-23,3,4,0,0
"15398","NYI","NSH",2017020809,17567,20172018,1,63.7,4,5,-1,4.36875555833103,5.81685448495685,-1.44809892662582,28,47,-19,36,60,-24,48,73,-25,5,4,0,0
"15399","NYI","BUF",2017020826,17570,20172018,0,60,3,4,-1,3.98143499103026,3.16519621460361,0.816238776426644,29,22,7,42,31,11,49,40,9,3,2,0,0
"15400","NYI","DET",2017020835,17571,20172018,1,63.25,7,6,1,6.0081423620577,7.10495094256461,-1.09680858050692,29,39,-10,41,48,-7,52,63,-11,2,2,0,0
"15401","NYI","CGY",2017020858,17573,20172018,1,60,2,3,-1,4.97004314238097,5.25059675914235,-0.280553616761381,25,42,-17,39,58,-19,51,77,-26,5,4,0,0
"15402","NYI","CBJ",2017020866,17575,20172018,1,60,1,4,-3,4.5982319641624,6.43414612715424,-1.83591416299183,30,51,-21,38,67,-29,56,86,-30,4,5,0,0
"15403","NYI","NYR",2017020880,17577,20172018,1,60,3,0,3,4.43299062107859,4.89299776748521,-0.460007146406619,35,50,-15,43,63,-20,55,79,-24,2,3,0,0
"15404","NYI","CAR",2017020891,17578,20172018,0,60,3,0,3,4.29676916901371,8.68638634408126,-4.38961717506754,23,45,-22,30,65,-35,43,92,-49,1,3,0,0
"15405","NYI","MIN",2017020912,17581,20172018,1,60,3,5,-2,5.79681104419433,3.62908362462713,2.1677274195672,35,32,3,49,37,12,75,50,25,4,1,0,0
"15406","NYI","TOR",2017020930,17584,20172018,0,65,3,3,0,5.7855421545348,2.85358228586847,2.93195986866633,35,31,4,46,40,6,60,59,1,2,3,0,0
"15407","NYI","N.J",2017020952,17586,20172018,0,60,1,2,-1,4.41584075900028,2.80981378130673,1.60602697769355,31,33,-2,42,37,5,51,52,-1,2,1,0,0
"15408","NYI","MTL",2017020978,17590,20172018,0,60,1,3,-2,7.36705988932988,2.38719246041728,4.9798674289126,28,26,2,50,34,16,82,50,32,2,2,0,0
"15409","NYI","MTL",2017020991,17592,20172018,1,60,3,6,-3,2.4494745728407,4.38319891458377,-1.93372434174307,35,25,10,49,37,12,62,42,20,4,3,0,0
"15410","NYI","PIT",2017021004,17593,20172018,0,63.8,2,3,-1,4.73159371426027,6.50385883639683,-1.77226512213656,27,50,-23,35,65,-30,53,82,-29,2,2,0,0
"15411","NYI","VAN",2017021019,17595,20172018,0,62.7833333333333,3,4,-1,3.24561374058248,3.39785218391626,-0.152238443333772,34,23,11,45,31,14,58,47,11,4,2,0,0
"15412","NYI","EDM",2017021041,17598,20172018,0,65,1,1,0,4.85428206052165,9.47923332100618,-4.62495126048452,31,36,-5,43,55,-12,61,76,-15,1,3,0,0
"15413","NYI","CGY",2017021060,17601,20172018,0,60,5,2,3,3.02198530464148,8.10604837891879,-5.08406307427731,27,52,-25,36,74,-38,48,94,-46,1,4,0,0
"15414","NYI","WSH",2017021084,17605,20172018,1,60,3,7,-4,4.26292449008385,3.34916981153947,0.913754678544379,38,22,16,51,26,25,68,35,33,3,1,0,0
"15415","NYI","WSH",2017021092,17606,20172018,0,60,3,6,-3,5.64426706633628,5.43950806672729,0.204758999608991,25,31,-6,38,48,-10,57,60,-3,5,8,0,0
"15416","NYI","CAR",2017021111,17608,20172018,1,60,3,4,-1,4.9683019705778,5.35888985860431,-0.390587888026515,29,39,-10,38,49,-11,50,62,-12,4,4,0,0
"15417","NYI","PIT",2017021121,17610,20172018,1,60,4,1,3,6.50144733045454,5.69127781843641,0.810169512018128,40,37,3,50,51,-1,64,64,0,6,2,0,0
"15418","NYI","T.B",2017021136,17612,20172018,1,60,6,7,-1,4.71346689142229,3.23097707427223,1.48248981715005,41,36,5,50,45,5,68,58,10,5,4,0,0
"15419","NYI","CHI",2017021158,17614,20172018,1,60,1,3,-2,1.72368959896266,2.73088953629485,-1.00719993733219,32,25,7,37,30,7,53,49,4,2,2,0,0
"15420","NYI","FLA",2017021169,17616,20172018,1,60,0,3,-3,4.33782634220552,5.47031636509394,-1.13249002288842,32,41,-9,39,60,-21,58,77,-19,4,5,0,0
"15421","NYI","OTT",2017021178,17617,20172018,0,60,4,3,1,4.44194935238193,4.08481846007236,0.357130892309563,31,36,-5,39,51,-12,54,74,-20,2,4,0,0
"15422","NYI","TOR",2017021200,17620,20172018,1,60,4,5,-1,4.81375063890266,5.35121480457019,-0.537464165667529,33,32,1,50,45,5,58,66,-8,4,3,0,0
"15423","NYI","N.J",2017021210,17621,20172018,0,60,3,4,-1,4.41124256816693,3.52522752324148,0.886015044925443,30,35,-5,38,45,-7,50,51,-1,2,2,0,0
"15424","NYI","PHI",2017021230,17624,20172018,1,60,5,4,1,3.1193267951603,4.44718392909272,-1.32785713393241,37,31,6,46,46,0,62,59,3,6,4,0,0
"15425","NYI","NYR",2017021242,17626,20172018,1,60,2,1,1,0.954111258910054,5.28115025406078,-4.32703899515072,22,35,-13,34,44,-10,44,61,-17,2,3,0,0
"15426","NYI","DET",2017021260,17628,20172018,0,63.2666666666667,4,3,1,9.65064499127948,6.57193415699294,3.07871083428654,40,39,1,56,51,5,68,70,-2,2,1,0,0
"15427","NYI","CAR",2018020008,17808,20182019,0,60.7166666666667,2,1,1,1.59367106161699,5.88316154016872,-4.28949047855173,20,46,-26,31,67,-36,39,89,-50,3,3,0,0
"15428","NYI","NSH",2018020021,17810,20182019,1,60,3,4,-1,3.70217689444183,3.09197115736606,0.610205737075773,29,23,6,37,30,7,53,37,16,5,2,0,0
"15429","NYI","S.J",2018020033,17812,20182019,1,60,4,0,4,4.19324834696312,3.48453679625527,0.708711550707847,30,35,-5,41,47,-6,50,70,-20,4,4,0,0
"15430","NYI","NSH",2018020066,17817,20182019,0,60,2,5,-3,3.31141261332823,2.82046961697051,0.490942996357717,22,29,-7,35,41,-6,46,52,-6,1,2,0,0
"15431","NYI","ANA",2018020089,17821,20182019,0,60,1,4,-3,4.86140273917408,4.94460262044288,-0.0831998812687971,35,25,10,57,37,20,69,48,21,5,4,0,0
"15432","NYI","L.A",2018020097,17822,20182019,0,60,7,2,5,4.97916746297415,2.34061061858228,2.63855684439187,32,35,-3,42,49,-7,52,63,-11,3,4,0,0
"15433","NYI","S.J",2018020114,17824,20182019,0,60,1,4,-3,2.26714334856227,7.498000358912,-5.23085701034972,25,41,-16,31,61,-30,41,76,-35,5,6,0,0
"15434","NYI","FLA",2018020130,17828,20182019,1,60.55,2,3,-1,3.32483676041011,4.43630354586264,-1.11146678545254,22,41,-19,25,58,-33,37,71,-34,4,6,0,0
"15435","NYI","PHI",2018020149,17831,20182019,0,60,6,1,5,3.05556556990854,3.1041470067007,-0.048581436792162,22,23,-1,32,32,0,47,52,-5,3,3,0,0
"15436","NYI","CAR",2018020161,17832,20182019,0,60,2,1,1,3.52069379857699,4.20679601065012,-0.686102212073137,20,39,-19,27,54,-27,39,74,-35,4,3,0,0
"15437","NYI","PIT",2018020168,17834,20182019,0,60,6,3,3,4.2372155681951,5.10710533593829,-0.869889767743189,25,38,-13,30,52,-22,40,72,-32,4,3,0,0
"15438","NYI","PIT",2018020181,17836,20182019,1,65,2,2,0,4.43288224813296,4.80618489143671,-0.373302643303759,26,31,-5,39,42,-3,51,53,-2,3,5,0,0
"15439","NYI","N.J",2018020198,17838,20182019,1,60,3,0,3,6.21901699021691,5.10383408620205,1.11518290401487,33,35,-2,45,51,-6,58,71,-13,4,4,0,0
"15440","NYI","MTL",2018020211,17840,20182019,1,65,3,3,0,4.05445112939924,5.64827057626098,-1.59381944686174,24,35,-11,35,47,-12,50,70,-20,5,4,0,0
"15441","NYI","T.B",2018020232,17843,20182019,0,60,2,4,-2,3.0126849131193,3.97049160905641,-0.957806695937109,37,27,10,47,33,14,62,45,17,5,4,0,0
"15442","NYI","FLA",2018020248,17845,20182019,0,60,2,4,-2,3.02061778636562,6.54930807141136,-3.52869028504574,31,31,0,41,40,1,52,49,3,5,6,0,0
"15443","NYI","VAN",2018020266,17848,20182019,1,60,5,2,3,4.86047639709432,3.11255489097452,1.74792150611979,34,24,10,43,32,11,57,41,16,4,5,0,0
"15444","NYI","NYR",2018020277,17850,20182019,1,60,7,5,2,3.44928231497564,4.10409726636677,-0.654814951391139,24,41,-17,27,50,-23,41,64,-23,4,4,0,0
"15445","NYI","DAL",2018020303,17853,20182019,1,60,2,6,-4,4.26054648772219,5.49961014627479,-1.2390636585526,39,33,6,50,38,12,61,51,10,2,2,0,0
"15446","NYI","NYR",2018020320,17856,20182019,0,60,0,5,-5,3.65095358794497,3.99339802699285,-0.342444439047881,29,27,2,46,34,12,70,51,19,2,4,0,0
"15447","NYI","N.J",2018020334,17858,20182019,0,63.6666666666667,4,3,1,2.9590735602745,4.54271327165043,-1.58363971137592,35,42,-7,45,56,-11,55,69,-14,3,3,0,0
"15448","NYI","CAR",2018020352,17859,20182019,1,60,4,1,3,2.95381723331229,5.57069679338019,-2.6168795600679,19,27,-8,27,46,-19,34,66,-32,1,3,0,0
"15449","NYI","WSH",2018020364,17861,20182019,1,60,1,4,-3,4.71498580300249,2.68879707352608,2.02618872947642,33,24,9,45,35,10,62,47,15,4,2,0,0
"15450","NYI","BOS",2018020382,17864,20182019,0,65,1,1,0,4.62390536547173,5.33657187822973,-0.712666512758005,29,36,-7,36,54,-18,52,70,-18,1,1,0,0
"15451","NYI","CBJ",2018020401,17866,20182019,1,60,3,2,1,2.81178913696203,4.62765119657171,-1.81586205960968,29,30,-1,33,41,-8,46,54,-8,4,3,0,0
"15452","NYI","WPG",2018020418,17869,20182019,1,60,1,3,-2,4.10577344917692,3.56711824506056,0.538655204116367,28,24,4,41,29,12,58,45,13,2,3,0,0
"15453","NYI","PIT",2018020432,17871,20182019,0,60,2,6,-4,3.82886144509259,5.07634248642717,-1.24748104133457,24,28,-4,32,31,1,47,48,-1,3,4,0,0
"15454","NYI","DET",2018020448,17873,20182019,0,60,3,2,1,4.02483316080179,4.01101840343622,0.0138147573655738,19,25,-6,29,36,-7,43,47,-4,5,4,0,0
"15455","NYI","PIT",2018020461,17875,20182019,1,65,1,1,0,1.90089269241435,5.08603041782044,-3.18513772540609,26,24,2,30,45,-15,54,63,-9,5,4,0,0
"15456","NYI","VGK",2018020475,17877,20182019,1,60,2,3,-1,2.47176443804346,3.40176177932881,-0.929997341285343,25,17,8,36,29,7,51,41,10,1,1,0,0
"15457","NYI","DET",2018020498,17880,20182019,1,65,3,3,0,5.71925236075185,4.07647601334838,1.64277634740347,48,21,27,59,25,34,71,37,34,6,1,0,0
"15458","NYI","COL",2018020516,17882,20182019,0,60,4,1,3,4.89331436962402,3.89733969495865,0.995974674665376,21,31,-10,37,46,-9,50,70,-20,4,5,0,0
"15459","NYI","ARI",2018020525,17883,20182019,0,60,3,1,2,4.9687862640825,5.00753077082857,-0.0387445067460703,32,37,-5,48,54,-6,63,77,-14,2,3,0,0
"15460","NYI","VGK",2018020540,17885,20182019,0,60,2,4,-2,2.51378999307781,6.99697796086548,-4.48318796778767,21,47,-26,36,57,-21,49,73,-24,3,3,0,0
"15461","NYI","DAL",2018020564,17888,20182019,0,60,3,1,2,5.45873451919761,3.31506163524318,2.14367288395442,28,20,8,45,29,16,59,38,21,5,3,0,0
"15462","NYI","OTT",2018020581,17893,20182019,1,60,6,3,3,9.71120238152798,2.09791963088901,7.61328275063897,39,27,12,47,36,11,65,50,15,3,3,0,0
"15463","NYI","TOR",2018020588,17894,20182019,0,60,4,0,4,4.28151473019133,4.06157102045836,0.219943709732974,28,36,-8,44,51,-7,55,70,-15,3,2,0,0
"15464","NYI","BUF",2018020601,17896,20182019,0,60,3,1,2,6.55560058983974,3.07811067361035,3.47748991622939,33,40,-7,45,49,-4,56,65,-9,2,2,0,0
"15465","NYI","CHI",2018020624,17899,20182019,1,61.8,3,2,1,6.89878728884914,3.33481058129109,3.56397670755805,50,21,29,60,32,28,72,46,26,2,2,0,0
"15466","NYI","STL",2018020642,17901,20182019,0,60,4,3,1,4.84491024471876,4.06747830986569,0.77743193485307,14,32,-18,29,45,-16,44,59,-15,2,5,0,0
"15467","NYI","CAR",2018020659,17904,20182019,1,60,3,4,-1,4.06346353740082,3.49353007748766,0.569933459913159,31,24,7,41,32,9,54,43,11,3,2,0,0
"15468","NYI","NYR",2018020673,17906,20182019,0,60,4,3,1,3.96404769422952,6.92749849054962,-2.9634507963201,20,30,-10,28,44,-16,42,64,-22,4,4,0,0
"15469","NYI","NYR",2018020688,17908,20182019,1,60,1,2,-1,4.38797986403926,1.87150472424037,2.51647513979889,25,26,-1,42,32,10,51,45,6,6,4,0,0
"15470","NYI","T.B",2018020702,17909,20182019,1,60,5,1,4,4.88347690909344,4.58194749930408,0.301529409789364,28,39,-11,35,55,-20,44,81,-37,1,3,0,0
"15471","NYI","STL",2018020711,17911,20182019,1,61.6166666666667,2,1,1,2.86833815320279,2.71088168727874,0.157456465924042,25,31,-6,32,46,-14,42,63,-21,3,3,0,0
"15472","NYI","N.J",2018020727,17913,20182019,1,60,4,1,3,4.57694590516621,2.23652433165444,2.34042157351178,26,17,9,41,26,15,60,39,21,3,2,0,0
"15473","NYI","WSH",2018020735,17914,20182019,0,60,2,0,2,4.98732976963583,2.93054573986956,2.05678402976628,25,19,6,37,34,3,52,50,2,2,2,0,0
"15474","NYI","ANA",2018020752,17916,20182019,1,60,3,0,3,3.28890426389989,1.54867090251355,1.74023336138634,28,19,9,39,27,12,50,39,11,3,1,0,0
"15475","NYI","CHI",2018020762,17918,20182019,0,65,2,2,0,7.59794867523306,5.99758148213732,1.60036719309574,36,40,-4,51,53,-2,71,69,2,2,3,0,0
"15476","NYI","T.B",2018020783,17928,20182019,1,65,0,0,0,3.75990399520379,5.89213280309923,-2.13222880789544,36,41,-5,44,48,-4,60,64,-4,4,1,0,0
"15477","NYI","L.A",2018020794,17929,20182019,1,60,4,2,2,5.14951825217577,3.79353946947086,1.35597878270491,32,36,-4,38,50,-12,52,65,-13,2,3,0,0
"15478","NYI","BOS",2018020809,17932,20182019,0,60,1,3,-2,4.02106341591571,4.23196828911202,-0.210904873196313,29,27,2,35,37,-2,52,52,0,5,3,0,0
"15479","NYI","N.J",2018020825,17934,20182019,0,65,1,1,0,3.56947886469425,3.59279796348892,-0.0233190987946728,28,31,-3,40,41,-1,53,51,2,5,4,0,0
"15480","NYI","COL",2018020841,17936,20182019,1,62.3833333333333,4,3,1,6.42515375335825,4.29675861488272,2.12839513847553,41,28,13,53,40,13,65,53,12,4,2,0,0
"15481","NYI","MIN",2018020856,17937,20182019,1,60,2,1,1,2.65665248042734,3.31014583506208,-0.653493354634742,34,27,7,44,38,6,58,56,2,6,3,0,0
"15482","NYI","BUF",2018020864,17939,20182019,0,60,1,3,-2,5.34234751688189,4.85420641221572,0.488141104666177,25,22,3,37,36,1,51,41,10,0,1,0,0
"15483","NYI","CBJ",2018020878,17941,20182019,0,60,3,0,3,2.99499658169225,3.43498234499452,-0.439985763302275,27,31,-4,36,44,-8,48,65,-17,2,1,0,0
"15484","NYI","EDM",2018020896,17943,20182019,1,60,5,2,3,5.94413248838828,5.76800251071109,0.176129977677192,24,36,-12,31,46,-15,39,62,-23,4,6,0,0
"15485","NYI","CGY",2018020927,17947,20182019,0,60,2,4,-2,3.02864251256688,5.1040828140489,-2.07544030148202,19,32,-13,28,48,-20,47,68,-21,4,5,0,0
"15486","NYI","EDM",2018020938,17948,20182019,0,61.3666666666667,3,4,-1,2.75625385704916,6.55029351371923,-3.79403965667007,23,41,-18,28,52,-24,45,77,-32,3,5,0,0
"15487","NYI","VAN",2018020955,17950,20182019,0,60,4,0,4,4.4731764443568,5.0357375870943,-0.562561142737508,23,36,-13,28,50,-22,36,75,-39,1,4,0,0
"15488","NYI","CGY",2018020969,17953,20182019,1,60,1,3,-2,3.16441907371336,3.91526525855943,-0.750846184846068,27,27,0,42,37,5,53,55,-2,4,5,0,0
"15489","NYI","TOR",2018020985,17955,20182019,1,60,6,1,5,5.68775167566491,2.44720029056771,3.24055138509721,37,35,2,49,40,9,56,57,-1,1,2,0,0
"15490","NYI","WSH",2018020993,17956,20182019,1,60,1,3,-2,1.71507087097552,4.68203792977147,-2.96696705879594,21,29,-8,29,44,-15,40,69,-29,3,3,0,0
"15491","NYI","PHI",2018021010,17958,20182019,1,60,1,4,-3,4.14069482305786,3.23494672900415,0.905748094053706,30,26,4,43,33,10,62,45,17,2,1,0,0
"15492","NYI","OTT",2018021021,17960,20182019,1,65,4,4,0,6.10682878014632,5.35587338966077,0.750955390485543,38,27,11,48,40,8,60,54,6,3,0,0,0
"15493","NYI","OTT",2018021035,17962,20182019,0,60,4,2,2,4.06278788797988,4.56287493550553,-0.500087047525653,31,37,-6,42,48,-6,64,73,-9,4,4,0,0
"15494","NYI","PHI",2018021052,17964,20182019,1,60,2,5,-3,4.39576058187356,3.33582658896921,1.05993399290435,27,25,2,43,33,10,59,47,12,3,4,0,0
"15495","NYI","CBJ",2018021066,17966,20182019,1,60,2,0,2,2.80220530077349,4.18886926405685,-1.38666396328335,20,31,-11,29,46,-17,33,62,-29,3,2,0,0
"15496","NYI","MTL",2018021084,17969,20182019,1,60,2,1,1,6.19650692549658,4.65185634462978,1.5446505808668,38,34,4,53,48,5,69,58,11,2,2,0,0
"15497","NYI","DET",2018021100,17971,20182019,0,60,1,2,-1,4.8867302616145,3.55433725223338,1.33239300938112,42,22,20,58,31,27,66,40,26,2,3,0,0
"15498","NYI","MIN",2018021113,17972,20182019,0,61.0666666666667,3,2,1,3.45730037408794,5.11105185665656,-1.65375148256862,20,34,-14,28,47,-19,34,69,-35,2,6,0,0
"15499","NYI","BOS",2018021123,17974,20182019,1,60,0,5,-5,2.52497715246864,5.80377139903339,-3.27879424656476,13,39,-26,22,48,-26,31,68,-37,2,1,0,0
"15500","NYI","MTL",2018021139,17976,20182019,0,60,0,4,-4,5.67043119319715,2.95724402753709,2.71318716566006,28,34,-6,33,45,-12,50,64,-14,3,2,0,0
"15501","NYI","PHI",2018021151,17978,20182019,0,60,4,2,2,9.34999342309311,3.67092103057075,5.67907239252236,40,24,16,61,37,24,78,54,24,4,3,0,0
"15502","NYI","ARI",2018021165,17979,20182019,1,60,2,0,2,1.70646209723782,5.39607897292626,-3.68961687568844,26,31,-5,34,39,-5,48,58,-10,1,1,0,0
"15503","NYI","CBJ",2018021179,17981,20182019,0,60,0,4,-4,2.46139358776857,4.65012750332244,-2.18873391555387,26,33,-7,36,46,-10,50,55,-5,1,2,0,0
"15504","NYI","WPG",2018021193,17983,20182019,0,60,5,4,1,5.60300719671734,3.69211634912062,1.91089084759672,44,37,7,56,43,13,66,61,5,4,4,0,0
"15505","NYI","BUF",2018021208,17985,20182019,1,60,5,1,4,3.33457214317059,6.01781077357191,-2.68323863040132,38,32,6,51,43,8,67,59,8,2,2,0,0
"15506","NYI","TOR",2018021223,17987,20182019,1,60,1,2,-1,4.27791729625358,6.40919142396951,-2.13127412771594,29,38,-9,38,54,-16,57,65,-8,4,2,0,0
"15507","NYI","FLA",2018021244,17990,20182019,0,65,1,1,0,4.49552774219774,6.02152767953151,-1.52599993733378,36,30,6,52,38,14,72,52,20,3,2,0,0
"15508","NYI","WSH",2018021265,17992,20182019,0,60,3,0,3,5.9581091273285,3.84217982373775,2.11592930359075,24,29,-5,29,44,-15,40,58,-18,1,2,0,0
"15509","NYI","PIT",2018030141,17996,20182019,1,64.65,4,3,1,3.36302204262626,4.18260227848077,-0.819580235854511,33,44,-11,49,66,-17,62,83,-21,4,5,0,0
"15510","NYI","PIT",2018030142,17998,20182019,1,60,3,1,2,2.65465679824223,4.95307364497182,-2.29841684672959,34,33,1,43,47,-4,59,62,-3,8,4,0,0
"15511","NYI","PIT",2018030143,18000,20182019,0,60,4,1,3,6.01902284683633,2.12781137452112,3.89121147231521,36,26,10,48,35,13,61,58,3,3,4,0,0
"15512","NYI","PIT",2018030144,18002,20182019,0,60,3,1,2,4.44893240735675,3.82896537939092,0.619967027965835,26,33,-7,38,51,-13,54,74,-20,4,4,0,0
"15513","NYI","CAR",2018030221,18012,20182019,1,64.0666666666667,0,1,-1,2.26880242804594,5.35929723960795,-3.09049481156201,31,32,-1,39,41,-2,57,60,-3,5,3,0,0
"15514","NYI","CAR",2018030222,18014,20182019,1,60,1,2,-1,6.46367272653151,2.74289220949868,3.72078051703284,27,18,9,43,35,8,56,51,5,2,3,0,0
"15515","NYI","CAR",2018030223,18017,20182019,0,60,2,5,-3,4.84583991059714,7.8484043045221,-3.00256439392495,30,38,-8,39,60,-21,56,76,-20,3,2,0,0
"15516","NYI","CAR",2018030224,18019,20182019,0,60,2,5,-3,6.78529755929799,2.98083346686326,3.80446409243473,28,21,7,42,32,10,62,43,19,4,5,0,0
"15517","NYR","T.B",2008020001,14156,20082009,0,60,2,1,1,0,0,0,41,21,20,53,31,22,66,37,29,7,4,0,0
"15518","NYR","T.B",2008020003,14157,20082009,1,60,2,1,1,0,0,0,39,19,20,52,32,20,72,44,28,4,5,0,0
"15519","NYR","CHI",2008020010,14162,20082009,1,60,4,2,2,0,0,0,29,32,-3,39,45,-6,51,53,-2,3,3,0,0
"15520","NYR","PHI",2008020019,14163,20082009,0,60,4,3,1,0,0,0,27,28,-1,38,41,-3,50,50,0,7,7,0,0
"15521","NYR","N.J",2008020034,14165,20082009,1,60,4,1,3,0,0,0,24,27,-3,32,39,-7,45,58,-13,6,5,0,0
"15522","NYR","BUF",2008020044,14167,20082009,1,60,1,3,-2,0,0,0,20,19,1,32,24,8,50,33,17,4,3,0,0
"15523","NYR","TOR",2008020057,14169,20082009,1,65,0,0,0,0,0,0,32,21,11,57,33,24,76,43,33,8,4,0,0
"15524","NYR","DET",2008020070,14170,20082009,0,60.3833333333333,4,5,-1,0,0,0,32,45,-13,38,62,-24,47,72,-25,2,3,0,0
"15525","NYR","DAL",2008020079,14172,20082009,1,60,1,2,-1,0,0,0,29,27,2,43,39,4,59,47,12,3,4,0,0
"15526","NYR","CBJ",2008020101,14176,20082009,0,60,3,1,2,0,0,0,32,26,6,44,39,5,58,50,8,8,7,0,0
"15527","NYR","PIT",2008020109,14177,20082009,1,65,2,2,0,0,0,0,44,29,15,53,45,8,68,54,14,5,2,0,0
"15528","NYR","NYI",2008020121,14179,20082009,0,60,4,2,2,0,0,0,39,30,9,48,40,8,68,50,18,10,6,0,0
"15529","NYR","ATL",2008020137,14182,20082009,1,60,3,2,1,0,0,0,33,29,4,50,41,9,65,58,7,6,4,0,0
"15530","NYR","TOR",2008020153,14184,20082009,0,60,2,5,-3,0,0,0,20,35,-15,31,52,-21,46,69,-23,2,5,0,0
"15531","NYR","NYI",2008020171,14187,20082009,1,60,1,2,-1,0,0,0,36,19,17,55,25,30,87,37,50,7,5,0,0
"15532","NYR","T.B",2008020182,14189,20082009,1,60,5,2,3,0,0,0,35,38,-3,52,48,4,65,66,-1,9,4,0,0
"15533","NYR","WSH",2008020200,14191,20082009,0,60,1,3,-2,0,0,0,29,28,1,41,42,-1,50,54,-4,3,4,0,0
"15534","NYR","EDM",2008020213,14193,20082009,1,65,2,2,0,0,0,0,42,31,11,58,41,17,68,51,17,6,5,0,0
"15535","NYR","N.J",2008020222,14195,20082009,0,60,5,2,3,0,0,0,42,32,10,49,38,11,66,45,21,7,5,0,0
"15536","NYR","BOS",2008020245,14198,20082009,1,65,2,2,0,0,0,0,31,25,6,56,32,24,71,39,32,6,2,0,0
"15537","NYR","OTT",2008020258,14200,20082009,1,65,1,1,0,0,0,0,27,28,-1,41,36,5,60,41,19,4,4,0,0
"15538","NYR","VAN",2008020269,14202,20082009,1,60,3,6,-3,0,0,0,42,33,9,58,43,15,73,50,23,6,4,0,0
"15539","NYR","OTT",2008020286,14205,20082009,0,60,1,4,-3,0,0,0,19,36,-17,33,51,-18,46,64,-18,3,7,0,0
"15540","NYR","ARI",2008020299,14207,20082009,1,60,4,1,3,0,0,0,36,36,0,54,49,5,66,65,1,2,1,0,0
"15541","NYR","T.B",2008020314,14209,20082009,0,65,2,2,0,0,0,0,35,29,6,46,43,3,60,51,9,7,7,0,0
"15542","NYR","FLA",2008020331,14211,20082009,0,65,3,3,0,0,0,0,46,41,5,54,48,6,64,57,7,6,7,0,0
"15543","NYR","FLA",2008020346,14213,20082009,1,60,0,4,-4,0,0,0,37,30,7,49,46,3,68,58,10,6,4,0,0
"15544","NYR","PIT",2008020362,14216,20082009,1,65,2,2,0,0,0,0,27,31,-4,43,48,-5,61,69,-8,3,4,0,0
"15545","NYR","MTL",2008020366,14217,20082009,0,60,2,6,-4,0,0,0,20,39,-19,34,48,-14,59,62,-3,4,5,0,0
"15546","NYR","CGY",2008020393,14220,20082009,1,60,0,3,-3,0,0,0,31,20,11,47,36,11,56,43,13,4,2,0,0
"15547","NYR","ATL",2008020408,14223,20082009,0,60.3,3,2,1,0,0,0,33,29,4,41,37,4,56,51,5,4,7,0,0
"15548","NYR","N.J",2008020422,14225,20082009,0,60,5,8,-3,0,0,0,36,34,2,55,38,17,69,47,22,11,6,0,0
"15549","NYR","CAR",2008020435,14226,20082009,1,65,2,2,0,0,0,0,29,31,-2,36,47,-11,44,59,-15,5,7,0,0
"15550","NYR","ANA",2008020454,14229,20082009,0,60,3,1,2,0,0,0,30,20,10,41,29,12,48,38,10,5,4,0,0
"15551","NYR","L.A",2008020459,14230,20082009,0,63.6833333333333,3,2,1,0,0,0,30,41,-11,48,56,-8,56,65,-9,2,4,0,0
"15552","NYR","S.J",2008020485,14233,20082009,0,60,2,3,-1,0,0,0,34,30,4,44,48,-4,64,58,6,2,5,0,0
"15553","NYR","WSH",2008020496,14236,20082009,1,60.9833333333333,4,5,-1,0,0,0,28,36,-8,47,51,-4,58,63,-5,3,5,0,0
"15554","NYR","N.J",2008020520,14240,20082009,1,60,2,4,-2,0,0,0,33,35,-2,41,53,-12,57,59,-2,4,4,0,0
"15555","NYR","NYI",2008020533,14242,20082009,1,60,5,4,1,0,0,0,37,24,13,53,29,24,67,37,30,5,2,0,0
"15556","NYR","WSH",2008020569,14247,20082009,0,60,1,2,-1,0,0,0,22,31,-9,28,44,-16,41,61,-20,4,5,0,0
"15557","NYR","PIT",2008020583,14249,20082009,1,60,4,0,4,0,0,0,26,27,-1,40,49,-9,47,55,-8,8,8,0,0
"15558","NYR","MTL",2008020596,14251,20082009,1,60,3,6,-3,0,0,0,39,25,14,52,39,13,65,47,18,3,5,0,0
"15559","NYR","BUF",2008020610,14253,20082009,0,65,1,1,0,0,0,0,44,33,11,55,42,13,71,55,16,2,0,0,0
"15560","NYR","OTT",2008020617,14254,20082009,0,60,2,0,2,0,0,0,27,33,-6,34,48,-14,39,57,-18,5,5,0,0
"15561","NYR","NYI",2008020632,14257,20082009,0,60,2,1,1,0,0,0,29,34,-5,39,47,-8,63,64,-1,3,2,0,0
"15562","NYR","CHI",2008020660,14260,20082009,0,62.3833333333333,3,2,1,0,0,0,22,34,-12,25,42,-17,35,57,-22,5,10,0,0
"15563","NYR","PIT",2008020673,14262,20082009,0,60,0,3,-3,0,0,0,33,23,10,45,32,13,54,41,13,3,6,0,0
"15564","NYR","ANA",2008020684,14264,20082009,1,60,4,2,2,0,0,0,30,34,-4,48,51,-3,55,60,-5,7,5,0,0
"15565","NYR","CAR",2008020702,14271,20082009,1,60,3,2,1,0,0,0,31,35,-4,41,48,-7,50,68,-18,2,4,0,0
"15566","NYR","PIT",2008020712,14272,20082009,0,60,2,6,-4,0,0,0,34,33,1,47,45,2,70,57,13,5,6,0,0
"15567","NYR","BOS",2008020731,14275,20082009,0,60,0,1,-1,0,0,0,35,27,8,44,43,1,55,53,2,1,2,0,0
"15568","NYR","ATL",2008020750,14278,20082009,1,65,1,1,0,0,0,0,40,22,18,52,36,16,67,40,27,2,3,0,0
"15569","NYR","DAL",2008020776,14281,20082009,0,60,2,10,-8,0,0,0,22,39,-17,33,56,-23,43,65,-22,6,10,0,0
"15570","NYR","N.J",2008020793,14284,20082009,0,60,0,3,-3,0,0,0,27,31,-4,35,43,-8,48,46,2,7,7,0,0
"15571","NYR","WSH",2008020803,14286,20082009,1,65,4,4,0,0,0,0,32,30,2,56,35,21,72,45,27,5,2,0,0
"15572","NYR","FLA",2008020821,14288,20082009,0,65,1,1,0,0,0,0,35,43,-8,46,56,-10,58,65,-7,4,4,0,0
"15573","NYR","PHI",2008020835,14290,20082009,1,60,2,5,-3,0,0,0,37,20,17,52,31,21,70,42,28,5,4,0,0
"15574","NYR","STL",2008020843,14291,20082009,0,60,1,2,-1,0,0,0,20,33,-13,31,42,-11,45,57,-12,3,3,0,0
"15575","NYR","NYI",2008020854,14293,20082009,1,60,3,1,2,0,0,0,38,26,12,51,39,12,67,48,19,6,5,0,0
"15576","NYR","BUF",2008020879,14296,20082009,0,60,2,4,-2,0,0,0,33,33,0,41,43,-2,56,52,4,2,4,0,0
"15577","NYR","TOR",2008020890,14297,20082009,1,63,2,3,-1,0,0,0,41,26,15,51,41,10,63,48,15,4,6,0,0
"15578","NYR","TOR",2008020905,14300,20082009,0,65,1,1,0,0,0,0,32,24,8,54,36,18,75,50,25,4,4,0,0
"15579","NYR","FLA",2008020911,14301,20082009,1,60,1,2,-1,0,0,0,41,22,19,54,30,24,70,42,28,3,4,0,0
"15580","NYR","COL",2008020929,14303,20082009,1,60,6,1,5,0,0,0,30,24,6,50,31,19,61,45,16,9,6,0,0
"15581","NYR","NYI",2008020956,14308,20082009,0,60,4,2,2,0,0,0,23,30,-7,36,45,-9,48,60,-12,6,3,0,0
"15582","NYR","BOS",2008020980,14311,20082009,1,60,4,3,1,0,0,0,30,39,-9,44,52,-8,60,60,0,6,5,0,0
"15583","NYR","CAR",2008020986,14312,20082009,0,60,0,3,-3,0,0,0,28,36,-8,35,46,-11,54,59,-5,5,7,0,0
"15584","NYR","NSH",2008021011,14315,20082009,0,60,4,2,2,0,0,0,32,21,11,46,31,15,59,47,12,4,6,0,0
"15585","NYR","PHI",2008021019,14317,20082009,0,60,2,4,-2,0,0,0,41,29,12,57,36,21,73,53,20,4,3,0,0
"15586","NYR","PHI",2008021031,14318,20082009,1,60,4,1,3,0,0,0,39,25,14,56,35,21,74,47,27,7,6,0,0
"15587","NYR","MTL",2008021041,14320,20082009,0,65,3,3,0,0,0,0,42,29,13,55,38,17,72,54,18,4,6,0,0
"15588","NYR","BUF",2008021073,14324,20082009,1,60,5,3,2,0,0,0,31,40,-9,42,57,-15,56,78,-22,5,7,0,0
"15589","NYR","OTT",2008021082,14325,20082009,1,60,1,2,-1,0,0,0,29,22,7,51,30,21,68,43,25,5,3,0,0
"15590","NYR","MIN",2008021089,14327,20082009,1,60,2,1,1,0,0,0,30,19,11,44,24,20,54,36,18,6,3,0,0
"15591","NYR","ATL",2008021103,14329,20082009,0,65,4,4,0,0,0,0,27,30,-3,37,39,-2,49,46,3,10,6,0,0
"15592","NYR","PIT",2008021116,14331,20082009,0,60,3,4,-1,0,0,0,29,28,1,36,38,-2,55,56,-1,5,8,0,0
"15593","NYR","N.J",2008021134,14333,20082009,1,60,3,0,3,0,0,0,37,38,-1,43,47,-4,58,63,-5,9,6,0,0
"15594","NYR","CAR",2008021152,14336,20082009,0,60,2,4,-2,0,0,0,38,23,15,60,39,21,85,58,27,7,6,0,0
"15595","NYR","BOS",2008021164,14338,20082009,0,60,0,1,-1,0,0,0,31,24,7,41,33,8,58,42,16,4,4,0,0
"15596","NYR","MTL",2008021185,14341,20082009,1,60,3,1,2,0,0,0,44,25,19,57,33,24,71,49,22,3,3,0,0
"15597","NYR","PHI",2008021200,14343,20082009,1,60,2,1,1,0,0,0,31,38,-7,41,46,-5,54,67,-13,3,5,0,0
"15598","NYR","PHI",2008021229,14346,20082009,0,60,4,3,1,0,0,0,31,31,0,38,41,-3,47,56,-9,7,5,0,0
"15599","NYR","WSH",2008030121,14349,20082009,0,60,4,3,1,0,0,0,21,35,-14,38,51,-13,48,72,-24,4,7,0,0
"15600","NYR","WSH",2008030122,14352,20082009,0,60,1,0,1,0,0,0,24,35,-11,35,59,-24,48,88,-40,5,3,0,0
"15601","NYR","WSH",2008030123,14354,20082009,1,60,0,4,-4,0,0,0,33,40,-7,51,55,-4,64,68,-4,7,8,0,0
"15602","NYR","WSH",2008030124,14356,20082009,1,60,2,1,1,0,0,0,21,39,-18,32,54,-22,39,70,-31,3,6,0,0
"15603","NYR","WSH",2008030125,14358,20082009,0,60,0,4,-4,0,0,0,20,21,-1,26,32,-6,47,43,4,7,9,0,0
"15604","NYR","WSH",2008030126,14360,20082009,1,60,3,5,-2,0,0,0,32,22,10,40,35,5,52,46,6,11,5,0,0
"15605","NYR","WSH",2008030127,14362,20082009,0,60,1,2,-1,0,0,0,15,24,-9,34,34,0,45,50,-5,1,2,0,0
"15606","NYR","PIT",2009020006,14519,20092010,0,60,2,3,-1,0,0,0,27,31,-4,40,42,-2,62,60,2,4,2,0,0
"15607","NYR","OTT",2009020014,14520,20092010,1,60,5,2,3,0,0,0,34,34,0,52,44,8,64,63,1,5,4,0,0
"15608","NYR","N.J",2009020024,14522,20092010,0,60,3,2,1,0,0,0,26,27,-1,37,41,-4,44,50,-6,9,9,0,0
"15609","NYR","WSH",2009020039,14525,20092010,0,60,4,3,1,0,0,0,29,28,1,40,46,-6,48,68,-20,5,9,0,0
"15610","NYR","ANA",2009020062,14528,20092010,1,60,3,0,3,0,0,0,38,18,20,56,28,28,67,42,25,4,3,0,0
"15611","NYR","TOR",2009020066,14529,20092010,1,60,7,2,5,0,0,0,33,29,4,49,35,14,58,49,9,7,5,0,0
"15612","NYR","L.A",2009020076,14531,20092010,1,60,4,2,2,0,0,0,21,36,-15,29,50,-21,37,63,-26,3,7,0,0
"15613","NYR","TOR",2009020094,14534,20092010,0,60,4,1,3,0,0,0,28,35,-7,42,55,-13,57,70,-13,4,6,0,0
"15614","NYR","S.J",2009020106,14536,20092010,1,60,3,7,-4,0,0,0,29,30,-1,47,43,4,60,50,10,3,7,0,0
"15615","NYR","N.J",2009020119,14539,20092010,1,60,2,4,-2,0,0,0,31,25,6,40,38,2,55,50,5,3,1,0,0
"15616","NYR","MTL",2009020130,14541,20092010,0,62.7,4,5,-1,0,0,0,27,31,-4,41,47,-6,58,71,-13,2,4,0,0
"15617","NYR","ARI",2009020148,14543,20092010,1,60,5,2,3,0,0,0,24,32,-8,43,47,-4,52,77,-25,5,6,0,0
"15618","NYR","NYI",2009020156,14545,20092010,0,60,1,3,-2,0,0,0,35,32,3,50,41,9,66,51,15,5,4,0,0
"15619","NYR","MIN",2009020175,14547,20092010,0,60,2,3,-1,0,0,0,20,32,-12,33,47,-14,40,58,-18,2,3,0,0
"15620","NYR","BOS",2009020191,14549,20092010,1,60,1,0,1,0,0,0,23,29,-6,29,41,-12,43,55,-12,2,5,0,0
"15621","NYR","VAN",2009020201,14551,20092010,0,60,1,4,-3,0,0,0,23,30,-7,36,48,-12,49,61,-12,4,7,0,0
"15622","NYR","EDM",2009020216,14553,20092010,0,60,4,2,2,0,0,0,39,28,11,51,38,13,66,66,0,6,4,0,0
"15623","NYR","CGY",2009020235,14555,20092010,0,60,1,3,-2,0,0,0,33,22,11,46,39,7,57,55,2,4,4,0,0
"15624","NYR","ATL",2009020254,14560,20092010,1,60,3,5,-2,0,0,0,36,27,9,48,38,10,55,52,3,6,6,0,0
"15625","NYR","OTT",2009020269,14562,20092010,0,65,1,1,0,0,0,0,28,36,-8,32,54,-22,52,74,-22,4,5,0,0
"15626","NYR","WSH",2009020289,14565,20092010,1,60,2,4,-2,0,0,0,20,26,-6,35,40,-5,49,53,-4,5,5,0,0
"15627","NYR","FLA",2009020317,14569,20092010,1,60,2,3,-1,0,0,0,34,28,6,46,34,12,63,44,19,1,2,0,0
"15628","NYR","CBJ",2009020330,14571,20092010,1,60,7,4,3,0,0,0,33,30,3,40,37,3,53,49,4,4,1,0,0
"15629","NYR","FLA",2009020344,14573,20092010,0,65,1,1,0,0,0,0,28,26,2,43,43,0,53,56,-3,4,5,0,0
"15630","NYR","T.B",2009020361,14575,20092010,0,60,1,5,-4,0,0,0,27,31,-4,39,37,2,57,51,6,6,6,0,0
"15631","NYR","PIT",2009020373,14576,20092010,0,60,3,8,-5,0,0,0,25,33,-8,30,46,-16,41,59,-18,3,6,0,0
"15632","NYR","PIT",2009020383,14578,20092010,1,60,2,5,-3,0,0,0,31,33,-2,47,45,2,66,55,11,3,5,0,0
"15633","NYR","BUF",2009020417,14583,20092010,0,60,2,1,1,0,0,0,32,37,-5,41,50,-9,50,63,-13,2,3,0,0
"15634","NYR","DET",2009020427,14584,20092010,1,60,1,3,-2,0,0,0,29,31,-2,40,42,-2,50,61,-11,4,3,0,0
"15635","NYR","CHI",2009020448,14587,20092010,0,63.7166666666667,1,2,-1,0,0,0,18,41,-23,21,58,-37,32,75,-43,2,6,0,0
"15636","NYR","BUF",2009020470,14590,20092010,1,60,2,3,-1,0,0,0,38,32,6,48,37,11,70,47,23,6,4,0,0
"15637","NYR","ATL",2009020483,14592,20092010,1,65,2,2,0,0,0,0,48,27,21,61,37,24,78,51,27,5,3,0,0
"15638","NYR","NYI",2009020495,14594,20092010,1,60,1,2,-1,0,0,0,26,28,-2,45,46,-1,73,53,20,4,4,0,0
"15639","NYR","NYI",2009020503,14595,20092010,0,60,5,2,3,0,0,0,22,37,-15,31,54,-23,44,71,-27,9,9,0,0
"15640","NYR","PHI",2009020517,14597,20092010,0,60,2,1,1,0,0,0,24,37,-13,38,47,-9,50,59,-9,2,5,0,0
"15641","NYR","CAR",2009020534,14599,20092010,0,60,3,1,2,0,0,0,31,33,-2,44,46,-2,54,64,-10,1,3,0,0
"15642","NYR","FLA",2009020547,14601,20092010,1,60,4,1,3,0,0,0,32,34,-2,48,40,8,75,60,15,6,6,0,0
"15643","NYR","NYI",2009020559,14604,20092010,1,64.2166666666667,2,3,-1,0,0,0,38,22,16,56,31,25,82,47,35,4,4,0,0
"15644","NYR","PHI",2009020592,14608,20092010,1,60,0,6,-6,0,0,0,22,31,-9,38,38,0,57,49,8,4,2,0,0
"15645","NYR","CAR",2009020603,14609,20092010,0,60,2,1,1,0,0,0,35,18,17,45,34,11,62,49,13,5,4,0,0
"15646","NYR","CAR",2009020611,14611,20092010,1,63.75,1,2,-1,0,0,0,28,19,9,47,27,20,60,43,17,3,4,0,0
"15647","NYR","BOS",2009020627,14613,20092010,1,60,3,2,1,0,0,0,35,28,7,48,45,3,61,69,-8,5,3,0,0
"15648","NYR","DAL",2009020640,14615,20092010,1,60,5,2,3,0,0,0,25,27,-2,37,35,2,47,51,-4,6,6,0,0
"15649","NYR","ATL",2009020647,14616,20092010,0,65,1,1,0,0,0,0,30,32,-2,37,40,-3,48,58,-10,7,6,0,0
"15650","NYR","BOS",2009020660,14618,20092010,0,60,3,1,2,0,0,0,34,30,4,42,38,4,49,52,-3,4,2,0,0
"15651","NYR","N.J",2009020682,14621,20092010,1,65,0,0,0,0,0,0,51,45,6,68,55,13,84,68,16,2,2,0,0
"15652","NYR","OTT",2009020694,14623,20092010,1,60,0,2,-2,0,0,0,32,34,-2,46,48,-2,65,57,8,3,2,0,0
"15653","NYR","STL",2009020716,14625,20092010,0,60,1,4,-3,0,0,0,22,25,-3,37,38,-1,51,50,1,2,4,0,0
"15654","NYR","MTL",2009020721,14626,20092010,1,60,6,2,4,0,0,0,34,20,14,46,36,10,54,50,4,10,9,0,0
"15655","NYR","T.B",2009020733,14628,20092010,1,60,8,2,6,0,0,0,31,23,8,41,29,12,59,35,24,4,5,0,0
"15656","NYR","PHI",2009020747,14630,20092010,0,60,0,2,-2,0,0,0,24,27,-3,35,43,-8,47,61,-14,3,4,0,0
"15657","NYR","MTL",2009020762,14632,20092010,0,60,0,6,-6,0,0,0,32,31,1,47,41,6,58,48,10,4,7,0,0
"15658","NYR","PIT",2009020775,14634,20092010,1,60,2,4,-2,0,0,0,30,28,2,41,38,3,60,56,4,3,2,0,0
"15659","NYR","CAR",2009020787,14636,20092010,1,60,1,5,-4,0,0,0,38,24,14,48,29,19,61,37,24,5,4,0,0
"15660","NYR","ARI",2009020814,14639,20092010,0,60,2,3,-1,0,0,0,26,24,2,39,33,6,57,45,12,3,7,0,0
"15661","NYR","COL",2009020822,14640,20092010,0,60,3,1,2,0,0,0,34,35,-1,44,48,-4,55,61,-6,6,6,0,0
"15662","NYR","L.A",2009020834,14642,20092010,0,60,1,2,-1,0,0,0,21,21,0,31,41,-10,43,51,-8,4,4,0,0
"15663","NYR","WSH",2009020842,14644,20092010,1,60,5,6,-1,0,0,0,38,32,6,53,51,2,68,69,-1,6,9,0,0
"15664","NYR","N.J",2009020861,14646,20092010,1,60,3,1,2,0,0,0,25,42,-17,31,54,-23,39,72,-33,5,7,0,0
"15665","NYR","NSH",2009020884,14650,20092010,1,60,1,2,-1,0,0,0,38,36,2,46,46,0,61,59,2,6,5,0,0
"15666","NYR","PIT",2009020901,14652,20092010,0,61.0333333333333,3,2,1,0,0,0,39,27,12,46,42,4,57,56,1,3,2,0,0
"15667","NYR","T.B",2009020916,14654,20092010,1,60,5,2,3,0,0,0,23,29,-6,38,40,-2,46,55,-9,6,5,0,0
"15668","NYR","OTT",2009020928,14670,20092010,0,60,4,1,3,0,0,0,25,25,0,34,38,-4,53,53,0,1,3,0,0
"15669","NYR","PIT",2009020942,14672,20092010,1,63.7,4,5,-1,0,0,0,16,55,-39,25,71,-46,39,90,-51,7,7,0,0
"15670","NYR","WSH",2009020958,14674,20092010,0,60,0,2,-2,0,0,0,30,28,2,43,37,6,61,50,11,2,4,0,0
"15671","NYR","BUF",2009020969,14675,20092010,1,62.3666666666667,1,2,-1,0,0,0,36,32,4,49,44,5,64,66,-2,2,2,0,0
"15672","NYR","N.J",2009020986,14678,20092010,0,60,3,6,-3,0,0,0,19,27,-8,27,35,-8,34,41,-7,3,2,0,0
"15673","NYR","ATL",2009021003,14680,20092010,0,60,5,2,3,0,0,0,35,31,4,44,39,5,54,51,3,7,5,0,0
"15674","NYR","PHI",2009021015,14682,20092010,1,60,3,1,2,0,0,0,21,18,3,37,30,7,55,45,10,6,5,0,0
"15675","NYR","MTL",2009021028,14684,20092010,1,60,1,3,-2,0,0,0,20,35,-15,35,40,-5,45,47,-2,6,5,0,0
"15676","NYR","STL",2009021043,14686,20092010,1,60,3,4,-1,0,0,0,29,16,13,45,32,13,56,48,8,6,3,0,0
"15677","NYR","BOS",2009021068,14689,20092010,0,60,1,2,-1,0,0,0,24,31,-7,31,40,-9,45,51,-6,8,6,0,0
"15678","NYR","NYI",2009021090,14692,20092010,1,60,5,0,5,0,0,0,44,27,17,58,42,16,81,64,17,6,3,0,0
"15679","NYR","N.J",2009021097,14693,20092010,0,65,3,3,0,0,0,0,31,38,-7,39,46,-7,43,59,-16,4,4,0,0
"15680","NYR","TOR",2009021113,14695,20092010,0,60.65,2,3,-1,0,0,0,38,32,6,43,47,-4,63,63,0,2,2,0,0
"15681","NYR","NYI",2009021135,14698,20092010,0,60,4,3,1,0,0,0,27,28,-1,38,35,3,53,50,3,3,5,0,0
"15682","NYR","T.B",2009021159,14701,20092010,0,60,5,0,5,0,0,0,22,30,-8,29,45,-16,37,54,-17,3,4,0,0
"15683","NYR","FLA",2009021170,14702,20092010,0,60,4,1,3,0,0,0,27,20,7,40,31,9,54,42,12,1,4,0,0
"15684","NYR","BUF",2009021182,14705,20092010,0,60,2,5,-3,0,0,0,32,30,2,38,37,1,50,45,5,5,6,0,0
"15685","NYR","TOR",2009021193,14706,20092010,1,60,5,1,4,0,0,0,32,27,5,42,42,0,52,58,-6,6,6,0,0
"15686","NYR","PHI",2009021207,14708,20092010,1,60,4,3,1,0,0,0,25,27,-2,44,47,-3,60,60,0,3,2,0,0
"15687","NYR","PHI",2009021223,14710,20092010,0,65,1,1,0,0,0,0,25,47,-22,35,64,-29,47,78,-31,3,5,0,0
"15688","NYR","BUF",2010020013,14891,20102011,0,60,6,3,3,5.19946188301074,3.58855678130219,1.61090510170855,28,36,-8,40,48,-8,60,67,-7,4,5,0,0
"15689","NYR","NYI",2010020028,14893,20102011,0,60,4,6,-2,4.72879235527944,4.8421226486098,-0.113330293330364,33,32,1,45,37,8,63,51,12,5,6,0,0
"15690","NYR","TOR",2010020049,14897,20102011,1,63.1333333333333,3,4,-1,3.00983769823506,2.512337925976,0.497499772259062,24,38,-14,45,49,-4,52,61,-9,6,8,0,0
"15691","NYR","COL",2010020070,14900,20102011,1,60,1,3,-2,4.65900462126592,2.77854844092485,1.88045618034107,32,34,-2,48,44,4,71,52,19,7,4,0,0
"15692","NYR","TOR",2010020083,14903,20102011,0,60,2,1,1,3.23101826860714,3.66091646224959,-0.429898193642445,32,25,7,43,34,9,55,64,-9,2,5,0,0
"15693","NYR","BOS",2010020098,14905,20102011,0,60,3,2,1,3.46993586995964,3.46489965012083,0.00503621983880986,30,37,-7,43,50,-7,61,65,-4,5,6,0,0
"15694","NYR","N.J",2010020112,14906,20102011,1,60,3,1,2,4.30138087412342,4.65804255459256,-0.356661680469138,34,28,6,44,44,0,56,65,-9,7,4,0,0
"15695","NYR","ATL",2010020123,14909,20102011,1,60,4,6,-2,3.17960345267784,3.31630362708529,-0.136700174407451,28,26,2,41,36,5,62,50,12,1,3,0,0
"15696","NYR","CAR",2010020138,14911,20102011,1,60,3,4,-1,4.46201629599909,5.79367741598981,-1.33166111999071,43,38,5,52,45,7,64,67,-3,7,5,0,0
"15697","NYR","TOR",2010020143,14912,20102011,0,60,2,0,2,3.34402709361166,5.73278724929644,-2.38876015568478,24,36,-12,29,57,-28,35,92,-57,2,3,0,0
"15698","NYR","CHI",2010020157,14914,20102011,1,60,3,2,1,3.20995677646715,5.53772440853322,-2.32776763206607,23,35,-12,34,45,-11,49,78,-29,3,4,0,0
"15699","NYR","PHI",2010020173,14917,20102011,0,60,1,4,-3,3.92786124622216,3.45397900129319,0.473882244928973,21,21,0,34,27,7,54,42,12,4,5,0,0
"15700","NYR","N.J",2010020179,14918,20102011,0,60,3,0,3,3.18932515697179,3.7848150108215,-0.595489853849713,20,33,-13,29,46,-17,38,53,-15,4,3,0,0
"15701","NYR","STL",2010020200,14920,20102011,1,60,0,2,-2,2.57324826772674,2.88386615167838,-0.310617883951636,27,22,5,38,30,8,54,42,12,3,4,0,0
"15702","NYR","WSH",2010020204,14922,20102011,1,60,3,5,-2,2.94553896778962,4.16883618530119,-1.22329721751157,28,24,4,39,31,8,46,51,-5,6,6,0,0
"15703","NYR","BUF",2010020218,14924,20102011,1,61.5333333333333,3,2,1,3.13920771521644,4.35989272932056,-1.22068501410413,28,31,-3,45,44,1,58,56,2,6,3,0,0
"15704","NYR","EDM",2010020244,14927,20102011,1,60,8,2,6,6.16595737822354,2.57221935513617,3.59373802308737,31,21,10,46,29,17,59,46,13,3,4,0,0
"15705","NYR","PIT",2010020251,14928,20102011,0,63.6333333333333,3,2,1,5.53897722246457,4.67996741920979,0.859009803254785,25,39,-14,33,58,-25,47,78,-31,3,8,0,0
"15706","NYR","BOS",2010020258,14930,20102011,1,60,2,3,-1,4.22319139467436,1.88300809078373,2.34018330389063,36,20,16,47,30,17,62,42,20,4,3,0,0
"15707","NYR","COL",2010020279,14932,20102011,0,60,1,5,-4,2.78785425133538,3.54475242205307,-0.756898170717696,26,26,0,32,34,-2,48,42,6,5,1,0,0
"15708","NYR","MIN",2010020290,14933,20102011,0,60,5,2,3,2.80835980844038,5.08370599853606,-2.27534619009568,30,28,2,37,42,-5,42,55,-13,5,4,0,0
"15709","NYR","CGY",2010020300,14935,20102011,1,60,2,1,1,3.45646648824913,7.79507146769902,-4.33860497944988,24,32,-8,34,46,-12,45,63,-18,3,3,0,0
"15710","NYR","T.B",2010020314,14937,20102011,0,60,3,5,-2,2.65931723621645,3.9466455715301,-1.28732833531365,20,34,-14,27,43,-16,45,54,-9,6,8,0,0
"15711","NYR","FLA",2010020331,14939,20102011,0,60,3,0,3,2.54143608717575,4.10550046220783,-1.56406437503207,19,40,-21,32,49,-17,41,59,-18,3,4,0,0
"15712","NYR","NSH",2010020340,14940,20102011,0,65,1,1,0,2.79684897892002,3.44208303403622,-0.645234055116191,24,30,-6,34,43,-9,45,66,-21,5,4,0,0
"15713","NYR","PIT",2010020348,14942,20102011,1,60,1,3,-2,3.28578178863972,2.16654320904274,1.11923857959698,26,27,-1,41,36,5,54,49,5,4,2,0,0
"15714","NYR","NYI",2010020368,14945,20102011,0,60,6,5,1,4.6055528355937,3.69748377567157,0.908069059922127,26,32,-6,43,43,0,58,57,1,2,1,0,0
"15715","NYR","NYI",2010020373,14946,20102011,1,60,2,0,2,3.39603660357216,2.89441357314893,0.501623030423225,21,17,4,31,29,2,53,42,11,7,4,0,0
"15716","NYR","OTT",2010020392,14948,20102011,1,60,1,3,-2,3.41212776326574,3.77718475840084,-0.365056995135092,26,25,1,41,40,1,51,55,-4,4,1,0,0
"15717","NYR","OTT",2010020415,14952,20102011,0,60,5,3,2,6.60749244329054,4.60649347025901,2.00099897303153,28,27,1,37,40,-3,42,60,-18,4,4,0,0
"15718","NYR","CBJ",2010020431,14954,20102011,0,60,1,3,-2,2.51221096219626,4.58465014956892,-2.07243918737265,33,23,10,43,27,16,55,35,20,5,2,0,0
"15719","NYR","WSH",2010020438,14955,20102011,1,60,7,0,7,4.36924527365818,4.98168979364618,-0.612444519988003,20,31,-11,34,50,-16,40,67,-27,5,6,0,0
"15720","NYR","PIT",2010020451,14958,20102011,0,60,4,1,3,3.91854182275026,6.36530631311325,-2.44676449036299,22,28,-6,31,43,-12,40,65,-25,3,3,0,0
"15721","NYR","ARI",2010020461,14959,20102011,1,65,3,3,0,4.7572710745153,5.60223926187609,-0.844968187360791,36,33,3,48,42,6,57,59,-2,5,4,0,0
"15722","NYR","PHI",2010020473,14961,20102011,0,60,1,4,-3,2.86573476911872,3.98194413298012,-1.1162093638614,25,39,-14,37,52,-15,52,64,-12,4,4,0,0
"15723","NYR","T.B",2010020509,14966,20102011,1,65,3,3,0,5.56097449006484,3.06906079815235,2.49191369191249,37,24,13,56,37,19,74,52,22,1,1,0,0
"15724","NYR","NYI",2010020530,14970,20102011,1,60,7,2,5,5.45612177194562,3.28043302587139,2.17568874607423,52,20,32,63,26,37,73,39,34,7,5,0,0
"15725","NYR","N.J",2010020545,14972,20102011,0,60,3,1,2,4.67064465011117,5.32525211343921,-0.654607463328034,26,44,-18,31,53,-22,37,61,-24,4,4,0,0
"15726","NYR","T.B",2010020570,14975,20102011,0,60.3166666666667,1,2,-1,3.46389943722647,3.94584232544429,-0.481942888217816,35,33,2,44,41,3,61,54,7,2,3,0,0
"15727","NYR","CAR",2010020591,14979,20102011,1,63.15,2,1,1,5.53878023623363,2.98782342999766,2.55095680623597,35,32,3,57,38,19,67,51,16,3,3,0,0
"15728","NYR","DAL",2010020608,14981,20102011,0,65,2,2,0,3.97788192178086,5.231823081827,-1.25394116004613,31,30,1,37,45,-8,51,58,-7,4,4,0,0
"15729","NYR","STL",2010020618,14982,20102011,0,60,2,1,1,2.42660449919595,2.52594575261935,-0.0993412534234039,24,25,-1,35,38,-3,40,54,-14,5,5,0,0
"15730","NYR","MTL",2010020635,14985,20102011,1,60,1,2,-1,4.08599207713269,3.95912504971413,0.126867027418557,26,38,-12,40,44,-4,51,59,-8,3,3,0,0
"15731","NYR","VAN",2010020649,14987,20102011,1,60,1,0,1,5.56753685363219,3.94476109243988,1.62277576119232,35,31,4,49,48,1,61,72,-11,3,3,0,0
"15732","NYR","MTL",2010020662,14989,20102011,0,60,2,3,-1,5.31785177190613,6.53509169165483,-1.2172399197487,33,41,-8,45,52,-7,58,65,-7,6,6,0,0
"15733","NYR","PHI",2010020674,14990,20102011,1,60,2,3,-1,7.19095618469169,2.74938452047354,4.44157166421815,36,27,9,49,36,13,73,46,27,5,6,0,0
"15734","NYR","TOR",2010020693,14993,20102011,1,60,7,0,7,3.22191426597789,5.03306948527552,-1.81115521929763,28,22,6,30,37,-7,39,57,-18,4,4,0,0
"15735","NYR","CAR",2010020701,14994,20102011,0,60,1,4,-3,8.32419645797927,4.57738816272467,3.7468082952546,40,39,1,61,46,15,68,56,12,2,2,0,0
"15736","NYR","ATL",2010020718,14996,20102011,0,65,2,2,0,3.8461211505055,3.74339023954235,0.102730910963146,31,22,9,35,35,0,56,50,6,2,3,0,0
"15737","NYR","WSH",2010020728,14998,20102011,0,65,1,1,0,3.43749826743442,2.83475378715229,0.602744480282126,29,23,6,35,30,5,45,48,-3,3,3,0,0
"15738","NYR","FLA",2010020734,14999,20102011,1,60,3,4,-1,3.01410147480419,2.35177055541372,0.662330919390471,35,17,18,50,19,31,66,30,36,4,1,0,0
"15739","NYR","PIT",2010020753,15006,20102011,1,65,3,3,0,4.17445404392492,3.75150345630804,0.422950587616889,29,26,3,37,29,8,54,39,15,4,3,0,0
"15740","NYR","N.J",2010020772,15008,20102011,1,60,2,3,-1,3.79271192836677,2.64980903148654,1.14290289688023,27,18,9,40,29,11,47,41,6,6,3,0,0
"15741","NYR","MTL",2010020783,15010,20102011,0,60,0,2,-2,6.85571103284846,2.534599989792,4.32111104305646,35,29,6,48,36,12,68,52,16,6,4,0,0
"15742","NYR","DET",2010020797,15012,20102011,0,60,2,3,-1,6.61605319842873,4.35849520705233,2.2575579913764,47,35,12,59,44,15,70,58,12,4,2,0,0
"15743","NYR","ATL",2010020825,15016,20102011,0,60,2,3,-1,0,0,0,29,35,-6,36,51,-15,47,67,-20,5,6,0,0
"15744","NYR","PIT",2010020838,15018,20102011,1,60,5,3,2,5.10170057680443,4.47398292354774,0.627717653256695,31,29,2,46,37,9,60,63,-3,5,5,0,0
"15745","NYR","L.A",2010020864,15022,20102011,1,65,3,3,0,0,0,0,37,28,9,44,41,3,59,66,-7,3,4,0,0
"15746","NYR","N.J",2010020870,15023,20102011,0,60,0,1,-1,2.08761779390625,5.10065299275993,-3.01303519885369,16,28,-12,21,42,-21,29,53,-24,2,1,0,0
"15747","NYR","PHI",2010020887,15025,20102011,1,60,2,4,-2,5.47017561113575,4.1568032848736,1.31337232626214,39,24,15,53,33,20,74,50,24,0,3,0,0
"15748","NYR","CAR",2010020896,15027,20102011,0,65,3,3,0,6.71108797049965,6.42593232130821,0.285155649191438,46,33,13,63,46,17,87,72,15,4,3,0,0
"15749","NYR","WSH",2010020915,15030,20102011,0,60,6,0,6,2.92984956435976,4.78088449611096,-1.8510349317512,28,35,-7,37,54,-17,46,72,-26,3,5,0,0
"15750","NYR","T.B",2010020932,15032,20102011,1,60,1,2,-1,2.5264938840279,3.13461889354949,-0.608125009521586,23,19,4,34,26,8,49,35,14,4,6,0,0
"15751","NYR","BUF",2010020942,15034,20102011,1,60,2,3,-1,3.78680012339464,2.92665916832539,0.860140955069255,31,26,5,40,36,4,56,48,8,4,4,0,0
"15752","NYR","MIN",2010020958,15036,20102011,1,60,1,3,-2,5.78210979349114,3.32924763456685,2.45286215892429,41,19,22,62,25,37,77,35,42,5,1,0,0
"15753","NYR","OTT",2010020969,15037,20102011,0,60,4,1,3,2.53448738726615,3.47591861723777,-0.941431229971613,27,29,-2,35,42,-7,47,62,-15,5,4,0,0
"15754","NYR","PHI",2010020984,15039,20102011,1,60,7,0,7,4.72355685777876,5.14477998191433,-0.42122312413557,36,24,12,45,39,6,56,59,-3,6,6,0,0
"15755","NYR","ANA",2010021007,15042,20102011,0,60,2,5,-3,2.83948418619025,5.76949225956605,-2.9300080733758,32,33,-1,45,46,-1,55,59,-4,3,3,0,0
"15756","NYR","S.J",2010021032,15045,20102011,0,65,2,2,0,4.89497543103062,4.10704027352995,0.787935157500669,22,33,-11,31,49,-18,45,77,-32,2,4,0,0
"15757","NYR","NYI",2010021043,15048,20102011,1,60,6,3,3,6.45061503565057,2.71893511749863,3.73167991815194,47,28,19,56,31,25,64,42,22,9,7,0,0
"15758","NYR","MTL",2010021067,15051,20102011,1,60,6,3,3,3.45417113978669,3.67687640705844,-0.222705267271758,31,25,6,47,34,13,60,48,12,7,6,0,0
"15759","NYR","PIT",2010021080,15053,20102011,0,60,5,2,3,6.64294947790404,6.86201802474193,-0.219068546837889,27,40,-13,34,56,-22,43,72,-29,2,3,0,0
"15760","NYR","FLA",2010021089,15055,20102011,1,60,1,0,1,2.61284946778324,2.3829168927766,0.229932575006631,33,22,11,38,31,7,51,43,8,1,0,0,0
"15761","NYR","OTT",2010021104,15057,20102011,1,65,1,1,0,3.78350811549171,4.63091561745387,-0.847407501962152,30,30,0,38,38,0,49,50,-1,5,5,0,0
"15762","NYR","BOS",2010021116,15059,20102011,0,60,1,0,1,2.27681029323127,2.50292828894453,-0.22611799571326,23,26,-3,37,36,1,45,65,-20,4,1,0,0
"15763","NYR","BUF",2010021145,15063,20102011,0,60,0,1,-1,3.0761977439106,5.04098453823303,-1.96478679432244,23,35,-12,43,40,3,57,48,9,3,2,0,0
"15764","NYR","NYI",2010021151,15064,20102011,0,60,2,6,-4,3.34850810628268,4.75843958941459,-1.40993148313191,27,33,-6,43,43,0,60,57,3,11,5,0,0
"15765","NYR","PHI",2010021175,15067,20102011,0,65,2,2,0,5.20111924941906,7.42487172130495,-2.22375247188589,34,34,0,47,48,-1,63,71,-8,4,5,0,0
"15766","NYR","BOS",2010021182,15068,20102011,1,60,5,3,2,4.70220070284518,5.11312155163478,-0.410920848789601,26,30,-4,41,42,-1,61,60,1,4,1,0,0
"15767","NYR","ATL",2010021201,15071,20102011,1,60,0,3,-3,4.26869058798547,4.5329339139862,-0.264243326000724,29,26,3,41,41,0,60,52,8,4,2,0,0
"15768","NYR","N.J",2010021215,15073,20102011,1,60,5,2,3,6.39231394315721,2.72830423977575,3.66400970338145,29,26,3,36,43,-7,42,57,-15,1,1,0,0
"15769","NYR","WSH",2010030111,15077,20102011,0,78.4,1,2,-1,5.90251132990852,8.88915217306203,-2.98664084315351,25,33,-8,33,52,-19,65,80,-15,2,2,0,0
"15770","NYR","WSH",2010030112,15079,20102011,0,60,0,2,-2,1.89368413762077,3.35003867388605,-1.45635453626528,22,18,4,27,31,-4,48,46,2,2,4,0,0
"15771","NYR","WSH",2010030113,15081,20102011,1,60,3,2,1,4.18994379159955,3.55698200693587,0.632961784663678,35,25,10,49,40,9,60,52,8,8,4,0,0
"15772","NYR","WSH",2010030114,15084,20102011,1,80,3,3,0,4.15294570277348,4.51874372182779,-0.36579801905431,35,48,-13,44,64,-20,63,90,-27,6,4,0,0
"15773","NYR","WSH",2010030115,15087,20102011,0,60,1,3,-2,3.86839971492009,5.16062872818293,-1.29222901326284,27,27,0,35,43,-8,54,63,-9,5,7,0,0
"15774","NYR","L.A",2011020009,15254,20112012,0,64.1333333333333,2,3,-1,1.87204868615822,2.5948123409762,-0.722763654817982,26,30,-4,32,43,-11,48,50,-2,1,5,0,0
"15775","NYR","ANA",2011020020,15255,20112012,0,65,1,1,0,2.4794803540757,3.28976860914565,-0.810288255069949,15,28,-13,28,42,-14,45,60,-15,9,8,0,0
"15776","NYR","NYI",2011020051,15262,20112012,0,60,2,4,-2,3.18192845513662,5.72966458165081,-2.54773612651418,31,34,-3,37,45,-8,45,59,-14,4,8,0,0
"15777","NYR","VAN",2011020076,15265,20112012,0,60,4,0,4,2.07766323854776,5.31057432864327,-3.23291109009551,19,40,-21,27,59,-32,35,82,-47,4,8,0,0
"15778","NYR","CGY",2011020087,15267,20112012,0,64.9666666666667,3,2,1,5.7929527662161,6.87145631219028,-1.07850354597418,29,35,-6,36,49,-13,45,65,-20,3,6,0,0
"15779","NYR","EDM",2011020107,15269,20112012,0,60,0,2,-2,3.09370718037826,2.90869267382459,0.185014506553671,19,27,-8,32,39,-7,44,49,-5,5,4,0,0
"15780","NYR","WPG",2011020112,15271,20112012,0,60,2,1,1,3.22020010265987,2.55061306375137,0.669587038908503,17,28,-11,30,42,-12,38,56,-18,5,1,0,0
"15781","NYR","TOR",2011020127,15274,20112012,1,60,2,4,-2,4.33903542024473,3.35021509642115,0.988820323823575,30,36,-6,36,47,-11,45,66,-21,4,5,0,0
"15782","NYR","OTT",2011020140,15276,20112012,1,65,4,4,0,6.61852025290224,5.74179030728545,0.87672994561679,28,40,-12,40,51,-11,49,65,-16,1,4,0,0
"15783","NYR","S.J",2011020157,15278,20112012,1,60,5,2,3,3.94122124326714,2.72696838238615,1.21425286088099,31,26,5,43,38,5,55,54,1,5,3,0,0
"15784","NYR","ANA",2011020169,15281,20112012,1,65,1,1,0,2.9692346372467,2.93917730352095,0.0300573337257504,25,28,-3,42,38,4,59,53,6,5,3,0,0
"15785","NYR","MTL",2011020188,15283,20112012,1,60,5,3,2,6.20396305975737,4.25471624887723,1.94924681088014,29,28,1,38,45,-7,44,60,-16,10,3,0,0
"15786","NYR","WPG",2011020197,15284,20112012,1,60,3,0,3,5.32923739048542,3.24633274262305,2.08290464786236,27,23,4,42,35,7,53,46,7,6,4,0,0
"15787","NYR","OTT",2011020211,15287,20112012,0,60,3,2,1,4.23666197364219,6.42168744322674,-2.18502546958456,19,31,-12,29,45,-16,37,68,-31,1,2,0,0
"15788","NYR","CAR",2011020223,15289,20112012,1,60,5,1,4,6.71984103462273,4.88051489999956,1.83932613462317,40,35,5,47,51,-4,57,68,-11,3,2,0,0
"15789","NYR","NYI",2011020249,15293,20112012,0,60,4,2,2,3.49272370879815,4.02483862487134,-0.532114916073187,30,33,-3,50,40,10,65,62,3,5,6,0,0
"15790","NYR","MTL",2011020278,15297,20112012,0,60,0,4,-4,2.09270622906942,4.46326693962328,-2.37056071055386,17,31,-14,29,45,-16,46,65,-19,5,8,0,0
"15791","NYR","FLA",2011020307,15301,20112012,0,60,1,2,-1,3.92841606942238,3.5649688016274,0.363447267794982,20,38,-18,28,51,-23,39,59,-20,4,3,0,0
"15792","NYR","WSH",2011020317,15303,20112012,0,60,6,3,3,5.50780847625356,2.96377572333381,2.54403275291975,33,21,12,45,33,12,57,46,11,5,4,0,0
"15793","NYR","PHI",2011020327,15304,20112012,1,60,2,0,2,2.98095820437811,2.96164482147135,0.0193133829067573,32,29,3,41,38,3,55,59,-4,4,4,0,0
"15794","NYR","PIT",2011020346,15307,20112012,1,60,4,3,1,6.04706533113495,3.01524854436229,3.03181678677265,30,27,3,43,40,3,54,60,-6,9,7,0,0
"15795","NYR","CAR",2011020359,15309,20112012,0,60,5,3,2,6.4188016274129,5.94725073828886,0.471550889124046,27,31,-4,38,38,0,59,60,-1,4,1,0,0
"15796","NYR","T.B",2011020377,15311,20112012,0,60,4,2,2,5.1583739767666,2.81685581442389,2.34151816234271,36,26,10,47,33,14,56,43,13,2,1,0,0
"15797","NYR","TOR",2011020387,15313,20112012,1,60,2,4,-2,4.95590158650884,2.72725644030288,2.22864514620596,32,30,2,45,38,7,59,55,4,5,4,0,0
"15798","NYR","T.B",2011020408,15316,20112012,1,65,2,2,0,2.57500138436851,8.51343044212105,-5.93842905775254,30,31,-1,39,45,-6,62,63,-1,12,10,0,0
"15799","NYR","BUF",2011020422,15318,20112012,0,60,4,1,3,4.45686827940517,4.55553976001798,-0.0986714806128077,33,33,0,41,46,-5,52,66,-14,4,3,0,0
"15800","NYR","FLA",2011020433,15319,20112012,1,60,6,1,5,5.21173627397711,3.68793467228534,1.52380160169177,33,21,12,41,34,7,58,53,5,3,6,0,0
"15801","NYR","DAL",2011020439,15321,20112012,1,60,0,1,-1,4.7603640595022,2.9858175466361,1.7745465128661,34,28,6,47,37,10,63,50,13,5,3,0,0
"15802","NYR","STL",2011020456,15323,20112012,0,60,1,4,-3,2.77053265855648,5.57164030600688,-2.80110764745041,26,36,-10,37,50,-13,44,61,-17,0,1,0,0
"15803","NYR","ARI",2011020475,15325,20112012,0,60,3,2,1,5.42211814441544,3.55143944731345,1.87067869710199,30,23,7,41,32,9,48,45,3,7,3,0,0
"15804","NYR","N.J",2011020487,15328,20112012,0,60,4,1,3,4.90822566760471,1.89084998477483,3.01737568282988,21,31,-10,33,38,-5,39,52,-13,2,4,0,0
"15805","NYR","NYI",2011020501,15330,20112012,1,60,4,2,2,5.17182341567241,2.84825322750839,2.32357018816401,25,26,-1,35,33,2,51,47,4,6,6,0,0
"15806","NYR","PHI",2011020511,15331,20112012,1,60,4,2,2,3.05134301027283,3.41239944193512,-0.361056431662291,24,30,-6,38,46,-8,53,62,-9,4,4,0,0
"15807","NYR","NYI",2011020521,15334,20112012,1,60,3,0,3,3.78313960940432,4.37651020506746,-0.593370595663146,31,28,3,40,40,0,50,59,-9,4,5,0,0
"15808","NYR","WSH",2011020537,15336,20112012,0,60,1,4,-3,4.84408353765829,3.39512164263715,1.44896189502114,32,23,9,48,31,17,68,49,19,5,2,0,0
"15809","NYR","FLA",2011020553,15338,20112012,0,60,4,1,3,3.23303805466276,3.70878211698437,-0.47574406232161,25,28,-3,31,42,-11,37,60,-23,2,4,0,0
"15810","NYR","PHI",2011020569,15341,20112012,0,60,3,2,1,5.09189859192702,5.37815279886127,-0.286254206934245,33,36,-3,41,50,-9,49,70,-21,3,4,0,0
"15811","NYR","FLA",2011020586,15344,20112012,1,63.4833333333333,3,2,1,5.22668785478891,3.26620441750856,1.96048343728035,41,21,20,57,25,32,74,39,35,3,1,0,0
"15812","NYR","PIT",2011020594,15345,20112012,0,60,3,1,2,1.94399369023768,3.35486351375039,-1.41086982351271,21,38,-17,28,52,-24,37,77,-40,2,4,0,0
"15813","NYR","ARI",2011020619,15349,20112012,1,65,1,1,0,6.0524353277724,3.19845607446041,2.85397925331199,32,19,13,45,29,16,60,45,15,3,1,0,0
"15814","NYR","OTT",2011020633,15351,20112012,1,60,0,3,-3,2.63942855188423,4.34924748245794,-1.70981893057371,34,24,10,41,33,8,50,49,1,4,2,0,0
"15815","NYR","TOR",2011020649,15353,20112012,0,60,3,0,3,3.79741834155908,2.57645716461695,1.22096117694212,30,20,10,42,30,12,63,53,10,2,2,0,0
"15816","NYR","MTL",2011020660,15354,20112012,0,60,1,4,-3,5.20530829737861,2.52037044608733,2.68493785129128,29,29,0,52,39,13,70,51,19,1,1,0,0
"15817","NYR","NSH",2011020672,15356,20112012,1,60,3,0,3,4.71177870736392,4.67554458853556,0.0362341188283608,29,27,2,42,38,4,49,56,-7,2,2,0,0
"15818","NYR","PIT",2011020687,15358,20112012,1,60,1,4,-3,2.95566237570182,5.73033878585294,-2.77467641015112,31,36,-5,40,44,-4,57,59,-2,3,3,0,0
"15819","NYR","BOS",2011020699,15360,20112012,0,64.9333333333333,3,2,1,3.18303403328821,5.973697424899,-2.79066339161079,33,34,-1,37,44,-7,51,66,-15,3,5,0,0
"15820","NYR","WPG",2011020724,15363,20112012,1,60,3,0,3,2.40152675374702,2.75156308524311,-0.350036331496085,31,22,9,42,39,3,55,56,-1,4,2,0,0
"15821","NYR","N.J",2011020737,15370,20112012,0,65,3,3,0,4.47108421951998,3.75695797407278,0.714126245447201,26,29,-3,34,37,-3,48,55,-7,3,3,0,0
"15822","NYR","BUF",2011020749,15371,20112012,0,65,0,0,0,3.80006936122663,4.12156434312148,-0.321494981894851,29,34,-5,34,42,-8,45,58,-13,3,6,0,0
"15823","NYR","PHI",2011020781,15375,20112012,1,60,5,2,3,4.44045193891725,4.34690542507451,0.0935465138427389,38,23,15,47,35,12,57,60,-3,5,6,0,0
"15824","NYR","N.J",2011020786,15377,20112012,1,60,0,1,-1,6.39653168832615,2.72887288182392,3.66765880650223,30,22,8,44,32,12,61,47,14,3,4,0,0
"15825","NYR","T.B",2011020803,15379,20112012,1,62.6166666666667,4,3,1,2.7075130858866,1.80668165256156,0.900831433325038,31,17,14,41,26,15,62,42,20,4,3,0,0
"15826","NYR","PHI",2011020819,15381,20112012,0,60,5,2,3,4.209175641984,3.75827705041198,0.450898591572024,26,33,-7,40,48,-8,52,64,-12,9,6,0,0
"15827","NYR","WSH",2011020828,15382,20112012,1,60,3,2,1,4.35274211087402,5.65713358977501,-1.304391478901,28,26,2,41,38,3,54,63,-9,2,2,0,0
"15828","NYR","BOS",2011020837,15384,20112012,0,60,3,0,3,2.26168615493225,8.89434837411682,-6.63266221918457,20,42,-22,24,57,-33,31,79,-48,3,3,0,0
"15829","NYR","CHI",2011020851,15386,20112012,1,60,2,4,-2,3.94895307312254,1.70115197980203,2.2478010933205,24,22,2,35,29,6,48,46,2,8,5,0,0
"15830","NYR","CBJ",2011020879,15389,20112012,1,60.3666666666667,3,2,1,4.34144521910079,3.49647607907536,0.84496914002543,35,23,12,46,28,18,66,38,28,2,4,0,0
"15831","NYR","PIT",2011020887,15391,20112012,0,60,0,2,-2,4.60732442195877,4.36712319034118,0.24020123161759,27,31,-4,37,46,-9,48,60,-12,5,4,0,0
"15832","NYR","NYI",2011020909,15394,20112012,0,65,3,3,0,5.88922114654201,4.52631836105138,1.36290278549063,36,27,9,47,36,11,64,48,16,5,5,0,0
"15833","NYR","BUF",2011020920,15395,20112012,1,62.9833333333333,3,2,1,0,0,0,28,20,8,44,32,12,64,41,23,3,3,0,0
"15834","NYR","N.J",2011020932,15397,20112012,1,60,2,0,2,3.64864170050714,2.16812134688371,1.48052035362343,15,13,2,27,27,0,29,45,-16,4,3,0,0
"15835","NYR","CAR",2011020953,15400,20112012,0,60,3,2,1,7.52997937638429,4.07276628981344,3.45721308657085,25,23,2,44,35,9,63,55,8,4,5,0,0
"15836","NYR","T.B",2011020961,15401,20112012,0,61.9666666666667,3,4,-1,4.0274074357003,5.07348026371938,-1.04607282801908,19,31,-12,27,50,-23,42,63,-21,3,4,0,0
"15837","NYR","BOS",2011020975,15403,20112012,1,60,4,3,1,4.26906611694722,4.66255565086612,-0.39348953391891,17,33,-16,26,61,-35,37,76,-39,2,3,0,0
"15838","NYR","N.J",2011020985,15405,20112012,0,60,1,4,-3,3.0786100985299,5.35153762891986,-2.27292753038996,26,29,-3,32,41,-9,38,51,-13,2,4,0,0
"15839","NYR","OTT",2011021003,15407,20112012,0,60,1,4,-3,4.81946979416534,3.92087117032401,0.898598623841337,26,22,4,38,34,4,53,45,8,5,3,0,0
"15840","NYR","CHI",2011021012,15408,20112012,0,60,3,4,-1,1.92128850208246,4.95591129476088,-3.03462279267842,25,22,3,37,34,3,48,51,-3,2,1,0,0
"15841","NYR","NYI",2011021030,15410,20112012,1,64.9,4,3,1,4.75077312592784,1.87866589846089,2.87210722746695,36,19,17,51,26,25,61,40,21,7,4,0,0
"15842","NYR","CAR",2011021038,15412,20112012,1,60,4,2,2,4.99833635403775,2.64353176471008,2.35480458932767,28,29,-1,46,41,5,59,60,-1,3,4,0,0
"15843","NYR","PIT",2011021054,15414,20112012,1,60,2,5,-3,3.75860660756007,4.25246333284304,-0.493856725282967,31,32,-1,38,41,-3,48,58,-10,2,3,0,0
"15844","NYR","COL",2011021070,15416,20112012,1,60,1,3,-2,4.91336067665634,3.9385074125807,0.974853264075636,42,20,22,58,26,32,69,37,32,5,2,0,0
"15845","NYR","N.J",2011021083,15418,20112012,1,60,4,2,2,2.68329656900539,2.71228400833138,-0.0289874393259879,27,22,5,36,31,5,45,44,1,4,4,0,0
"15846","NYR","DET",2011021099,15420,20112012,1,62.7,2,1,1,3.440587180492,3.18369080412208,0.256896376369923,34,27,7,46,37,9,66,55,11,3,1,0,0
"15847","NYR","BUF",2011021111,15422,20112012,1,60,1,4,-3,3.04390829016063,4.1006848521065,-1.05677656194587,27,26,1,41,40,1,56,57,-1,2,1,0,0
"15848","NYR","TOR",2011021119,15423,20112012,0,65,3,3,0,2.45351274845598,4.46731161402614,-2.01379886557016,33,25,8,47,39,8,58,59,-1,2,3,0,0
"15849","NYR","MIN",2011021147,15426,20112012,0,60,3,2,1,6.31149786384776,6.24278508968013,0.0687127741676328,32,26,6,45,34,11,54,50,4,4,2,0,0
"15850","NYR","WPG",2011021148,15427,20112012,0,60,4,2,2,4.25000992433622,3.13002849495388,1.11998142938234,28,24,4,36,37,-1,48,61,-13,4,5,0,0
"15851","NYR","MTL",2011021161,15429,20112012,1,60,4,1,3,2.49554454098688,2.85654761067053,-0.361003069683647,29,20,9,33,29,4,45,47,-2,4,3,0,0
"15852","NYR","BOS",2011021182,15431,20112012,1,60,1,2,-1,5.02820077986689,3.04765806152136,1.98054271834553,34,21,13,46,34,12,55,53,2,3,2,0,0
"15853","NYR","PHI",2011021192,15433,20112012,0,60,5,3,2,4.27575131705822,7.62027986630892,-3.3445285492507,24,40,-16,29,62,-33,38,82,-44,6,9,0,0
"15854","NYR","PIT",2011021204,15435,20112012,0,60,2,5,-3,3.75692602871299,5.29370588567609,-1.5367798569631,37,32,5,39,38,1,51,45,6,5,2,0,0
"15855","NYR","WSH",2011021218,15437,20112012,1,60,1,4,-3,3.36309269879246,2.45058149329907,0.912511205493388,36,17,19,46,22,24,55,32,23,4,4,0,0
"15856","NYR","OTT",2011030111,15442,20112012,1,60,4,2,2,4.85376933991347,3.23202323477017,1.6217461051433,31,32,-1,47,44,3,59,64,-5,5,4,0,0
"15857","NYR","OTT",2011030112,15444,20112012,1,61.2833333333333,2,3,-1,3.20211542378064,5.14258497407683,-1.94046955029619,29,32,-3,39,49,-10,49,74,-25,4,3,0,0
"15858","NYR","OTT",2011030113,15446,20112012,0,60,1,0,1,4.30697837596386,8.37882599157456,-4.0718476156107,23,39,-16,31,55,-24,48,76,-28,5,5,0,0
"15859","NYR","OTT",2011030114,15448,20112012,0,62.7,2,3,-1,5.7999032586813,8.58690793942052,-2.78700468073922,33,31,2,41,55,-14,49,85,-36,7,5,0,0
"15860","NYR","OTT",2011030115,15451,20112012,1,60,0,2,-2,5.96445762156642,4.59306243409038,1.37139518747605,41,30,11,50,42,8,60,61,-1,5,5,0,0
"15861","NYR","OTT",2011030116,15453,20112012,0,60,3,2,1,3.84402678720653,5.21499961598863,-1.3709728287821,22,27,-5,35,36,-1,50,53,-3,7,5,0,0
"15862","NYR","OTT",2011030117,15456,20112012,1,60,2,1,1,3.03016972279875,4.53352419580551,-1.50335447300677,29,27,2,43,40,3,51,63,-12,3,2,0,0
"15863","NYR","WSH",2011030211,15458,20112012,1,60,3,1,2,2.95591542576585,5.69914891402004,-2.74323348825419,14,18,-4,32,34,-2,47,49,-2,4,4,0,0
"15864","NYR","WSH",2011030212,15460,20112012,1,60,2,3,-1,3.26255501434207,2.76108680150355,0.501468212838518,28,25,3,41,32,9,65,46,19,4,4,0,0
"15865","NYR","WSH",2011030213,15462,20112012,0,80,1,1,0,3.72409733174339,5.30037044706205,-1.57627311531866,37,37,0,46,56,-10,71,86,-15,3,3,0,0
"15866","NYR","WSH",2011030214,15465,20112012,0,60,2,3,-1,3.04989167128224,3.03691986668855,0.0129718045936897,20,26,-6,26,33,-7,52,40,12,2,2,0,0
"15867","NYR","WSH",2011030215,15467,20112012,1,61.5833333333333,3,2,1,5.6830607088632,3.46693991706707,2.21612079179613,38,18,20,53,25,28,78,35,43,4,4,0,0
"15868","NYR","WSH",2011030216,15469,20112012,0,60,1,2,-1,5.73751082554372,4.67109898069668,1.06641184484704,31,23,8,44,36,8,68,42,26,5,3,0,0
"15869","NYR","WSH",2011030217,15472,20112012,1,60,2,1,1,5.3044282476767,2.12448621589851,3.17994203177818,31,23,8,42,36,6,57,55,2,2,1,0,0
"15870","NYR","N.J",2011030311,15474,20112012,1,60,3,0,3,2.80897763469053,2.81414763196687,-0.0051699972763366,28,21,7,41,36,5,56,62,-6,4,4,0,0
"15871","NYR","N.J",2011030312,15476,20112012,1,60,2,3,-1,3.35668083769269,3.27917695109096,0.0775038866017326,25,27,-2,32,43,-11,39,59,-20,4,3,0,0
"15872","NYR","N.J",2011030313,15479,20112012,0,60,3,0,3,2.72088104658225,3.34508989946335,-0.624208852881099,22,36,-14,26,46,-20,32,65,-33,2,6,0,0
"15873","NYR","N.J",2011030314,15481,20112012,0,60,1,4,-3,3.9847152193488,5.20953192291199,-1.22481670356319,29,30,-1,37,40,-3,50,52,-2,4,9,0,0
"15874","NYR","N.J",2011030315,15483,20112012,1,60,3,5,-2,5.04431391444412,3.20509715361613,1.83921676082799,28,17,11,42,30,12,58,47,11,4,4,0,0
"15875","NYR","N.J",2011030316,15485,20112012,0,61.05,2,3,-1,3.84760098802485,2.64153457933571,1.20606640868914,35,29,6,43,37,6,58,45,13,3,3,0,0
"15876","NYR","BOS",2012020004,15724,20122013,0,60,1,3,-2,2.31427725345539,2.54656386198232,-0.232286608526927,21,34,-13,31,43,-12,36,53,-17,5,7,0,0
"15877","NYR","PIT",2012020015,15725,20122013,1,60,3,6,-3,4.54048952268204,5.73285520242644,-1.1923656797444,34,39,-5,48,48,0,64,64,0,5,6,0,0
"15878","NYR","BOS",2012020037,15728,20122013,1,60.45,4,3,1,3.36333393832319,4.794004969802,-1.43067103147881,33,29,4,45,40,5,54,65,-11,6,6,0,0
"15879","NYR","PHI",2012020041,15729,20122013,0,60,1,2,-1,4.50127017765772,6.57251457948092,-2.0712444018232,19,33,-14,28,49,-21,48,64,-16,4,4,0,0
"15880","NYR","TOR",2012020058,15731,20122013,1,60,5,2,3,5.19982452536351,2.30156914105937,2.89825538430414,42,17,25,53,26,27,68,39,29,4,4,0,0
"15881","NYR","PHI",2012020080,15734,20122013,1,60,2,1,1,3.50515355984317,3.60792690682138,-0.102773346978211,28,27,1,35,36,-1,51,49,2,3,7,0,0
"15882","NYR","PIT",2012020095,15736,20122013,1,60,0,3,-3,2.83002127060627,4.10733379484736,-1.2773125242411,28,29,-1,36,41,-5,45,54,-9,5,7,0,0
"15883","NYR","T.B",2012020113,15738,20122013,0,60,3,2,1,5.18081637535943,4.26235416009403,0.918462215265393,30,32,-2,47,42,5,55,52,3,2,1,0,0
"15884","NYR","N.J",2012020128,15741,20122013,0,60,1,3,-2,3.05581240247193,3.21940447240027,-0.163592069928345,25,22,3,33,31,2,47,39,8,4,4,0,0
"15885","NYR","NYI",2012020143,15743,20122013,1,60,4,1,3,5.35261792793108,2.44573204434732,2.90688588358376,25,28,-3,34,39,-5,43,56,-13,2,5,0,0
"15886","NYR","T.B",2012020169,15746,20122013,1,60,5,1,4,4.66319523798302,3.56446332236681,1.09873191561621,32,20,12,49,29,20,65,37,28,3,2,0,0
"15887","NYR","BOS",2012020179,15748,20122013,0,65,3,3,0,1.70464732093726,5.03917598198178,-3.33452866104453,29,40,-11,32,49,-17,41,74,-33,4,4,0,0
"15888","NYR","NYI",2012020191,15750,20122013,1,65,3,3,0,4.650387358015,2.64266482420499,2.00772253381001,39,31,8,49,44,5,70,60,10,4,1,0,0
"15889","NYR","WSH",2012020217,15753,20122013,1,60,2,1,1,2.23190240323493,2.44371304969536,-0.211810646460435,40,28,12,51,39,12,69,51,18,5,4,0,0
"15890","NYR","MTL",2012020227,15755,20122013,1,60,1,3,-2,3.1952503741195,3.52481935385731,-0.329568979737815,25,18,7,37,28,9,53,48,5,2,1,0,0
"15891","NYR","OTT",2012020242,15757,20122013,0,65,2,2,0,8.09167363488814,7.34276037944887,0.748913255439271,34,37,-3,50,48,2,70,65,5,4,2,0,0
"15892","NYR","MTL",2012020255,15759,20122013,0,60,0,3,-3,1.71683765909984,2.76354937236374,-1.0467117132639,17,18,-1,34,35,-1,52,54,-2,3,5,0,0
"15893","NYR","WPG",2012020275,15762,20122013,1,60,3,4,-1,2.6147080172226,3.95004818439691,-1.33534016717431,33,32,1,42,36,6,60,50,10,2,3,0,0
"15894","NYR","T.B",2012020290,15764,20122013,1,60,4,1,3,5.10335555730853,3.31004840189553,1.793307155413,42,25,17,46,34,12,69,47,22,4,3,0,0
"15895","NYR","BUF",2012020317,15767,20122013,1,65,2,2,0,3.88377076096367,4.48217450996799,-0.598403749004319,28,30,-2,49,39,10,69,54,15,2,5,0,0
"15896","NYR","PHI",2012020329,15769,20122013,1,60,4,2,2,3.26908489975904,2.30042132141534,0.968663578343694,20,25,-5,34,33,1,47,52,-5,4,3,0,0
"15897","NYR","NYI",2012020341,15771,20122013,0,60.7,2,1,1,5.26197185812634,3.97784415171935,1.28412770640699,37,29,8,58,37,21,77,56,21,5,1,0,0
"15898","NYR","OTT",2012020350,15772,20122013,1,60,2,3,-1,3.12004424049519,6.23485110254842,-3.11480686205323,35,39,-4,47,54,-7,58,77,-19,3,4,0,0
"15899","NYR","WSH",2012020365,15774,20122013,0,60,4,1,3,6.07419994025258,4.48987643755888,1.58432350269371,30,29,1,39,44,-5,54,64,-10,3,4,0,0
"15900","NYR","BUF",2012020377,15776,20122013,0,60,1,3,-2,5.01479487245457,2.08357974729734,2.93121512515723,33,22,11,40,36,4,57,50,7,1,5,0,0
"15901","NYR","WPG",2012020396,15778,20122013,0,60,1,3,-2,2.91865258026519,4.34103272578795,-1.42238014552277,29,33,-4,46,44,2,67,62,5,2,2,0,0
"15902","NYR","PIT",2012020406,15780,20122013,0,60,0,3,-3,5.98616250022314,4.34562019463556,1.64054230558759,23,27,-4,28,48,-20,44,66,-22,3,4,0,0
"15903","NYR","CAR",2012020422,15782,20122013,1,65,1,1,0,5.40179604361765,4.39501200200175,1.0067840416159,36,30,6,59,45,14,75,65,10,3,3,0,0
"15904","NYR","N.J",2012020429,15783,20122013,0,60,3,2,1,4.87085122067947,4.08145395776955,0.789397262909915,22,31,-9,31,45,-14,37,60,-23,2,4,0,0
"15905","NYR","FLA",2012020445,15785,20122013,1,60,1,3,-2,0,0,0,45,24,21,53,35,18,77,41,36,3,2,0,0
"15906","NYR","WSH",2012020467,15788,20122013,1,65,2,2,0,4.76826453988906,4.72111679909358,0.0471477407954808,32,24,8,44,42,2,55,65,-10,3,4,0,0
"15907","NYR","PHI",2012020483,15790,20122013,0,60,5,2,3,4.28802744770292,5.00675106906336,-0.718723621360448,31,34,-3,43,43,0,61,63,-2,3,1,0,0
"15908","NYR","OTT",2012020495,15792,20122013,0,60,0,3,-3,2.38594438888282,3.26929256817725,-0.883348179294432,24,29,-5,37,39,-2,55,55,0,4,2,0,0
"15909","NYR","MTL",2012020512,15794,20122013,0,60,0,3,-3,4.78795567633642,3.35072755737929,1.43722811895714,34,26,8,48,42,6,72,58,14,1,2,0,0
"15910","NYR","WPG",2012020523,15796,20122013,1,60,4,2,2,3.96571785063134,3.64093024772592,0.324787602905417,35,28,7,42,45,-3,57,70,-13,1,5,0,0
"15911","NYR","PIT",2012020538,15798,20122013,1,60,6,1,5,5.51142600850289,6.41400919191074,-0.902583183407842,39,27,12,50,36,14,63,45,18,5,3,0,0
"15912","NYR","PIT",2012020554,15800,20122013,0,65,1,1,0,5.63198791937521,3.96522714802404,1.66676077135116,35,27,8,58,29,29,78,44,34,2,2,0,0
"15913","NYR","CAR",2012020565,15801,20122013,0,60,4,1,3,5.76824085388853,6.89088484846264,-1.12264399457411,39,49,-10,52,67,-15,60,89,-29,5,5,0,0
"15914","NYR","TOR",2012020578,15803,20122013,0,60,3,4,-1,7.33544720360078,3.87030748117832,3.46513972242246,34,28,6,56,38,18,74,54,20,2,2,0,0
"15915","NYR","TOR",2012020592,15805,20122013,1,65,2,2,0,4.31179995840648,4.20319992647273,0.108600031933747,28,25,3,40,37,3,60,43,17,3,2,0,0
"15916","NYR","NYI",2012020613,15808,20122013,0,63.1833333333333,1,0,1,2.25488809498529,3.61523780302741,-1.36034970804212,20,29,-9,29,45,-16,44,66,-22,5,3,0,0
"15917","NYR","PHI",2012020635,15811,20122013,0,60,2,4,-2,8.97585466135024,3.29875741423123,5.67709724711901,40,22,18,52,33,19,71,47,24,5,2,0,0
"15918","NYR","FLA",2012020645,15813,20122013,1,60,6,1,5,5.28689624590334,3.04072888324791,2.24616736265543,30,35,-5,42,45,-3,50,57,-7,4,1,0,0
"15919","NYR","BUF",2012020655,15814,20122013,0,60,8,4,4,1.74071091384394,4.24215879037729,-2.50144787653335,29,28,1,33,39,-6,44,56,-12,1,4,0,0
"15920","NYR","N.J",2012020671,15816,20122013,1,60,4,1,3,3.40898576260952,4.89877422875634,-1.48978846614682,22,27,-5,30,41,-11,41,55,-14,8,3,0,0
"15921","NYR","FLA",2012020685,15818,20122013,0,60,2,3,-1,6.57795396133588,3.33438739361009,3.24356656772579,38,16,22,49,22,27,66,37,29,3,2,0,0
"15922","NYR","CAR",2012020696,15820,20122013,0,62.9166666666667,4,3,1,5.75066112793138,4.47905635709132,1.27160477084006,38,21,17,49,33,16,68,53,15,3,2,0,0
"15923","NYR","N.J",2012020714,15822,20122013,1,60,4,0,4,3.93489758567216,4.37204832218788,-0.437150736515719,21,20,1,31,30,1,37,51,-14,6,4,0,0
"15924","NYR","WSH",2012030131,15827,20122013,0,60,1,3,-2,4.05401482094567,3.305036782439,0.748978038506664,36,30,6,54,38,16,79,53,26,5,6,0,0
"15925","NYR","WSH",2012030132,15829,20122013,0,68,0,1,-1,4.80517358670477,8.64906709711067,-3.84389351040591,24,38,-14,44,54,-10,57,75,-18,5,4,0,0
"15926","NYR","WSH",2012030133,15831,20122013,1,60,4,3,1,4.83306395648321,2.69508490656153,2.13797904992168,30,31,-1,44,45,-1,58,64,-6,6,3,0,0
"15927","NYR","WSH",2012030134,15833,20122013,1,60,4,3,1,3.44077550282054,4.81350469470172,-1.37272919188118,34,30,4,42,49,-7,62,82,-20,4,2,0,0
"15928","NYR","WSH",2012030135,15835,20122013,0,69.4,1,2,-1,2.81023198214825,6.45183529699898,-3.64160331485073,25,35,-10,37,52,-15,67,81,-14,4,2,0,0
"15929","NYR","WSH",2012030136,15837,20122013,1,60,1,0,1,5.32707412718446,3.4097350372798,1.91733908990466,29,27,2,47,42,5,66,59,7,7,2,0,0
"15930","NYR","WSH",2012030137,15838,20122013,0,60,5,0,5,3.01357533788541,5.15066326142551,-2.13708792354009,27,35,-8,38,52,-14,47,79,-32,2,2,0,0
"15931","NYR","BOS",2012030221,15841,20122013,0,75.6666666666667,2,3,-1,5.82848381553777,8.40710984396889,-2.57862602843113,35,48,-13,45,64,-19,66,93,-27,3,4,0,0
"15932","NYR","BOS",2012030222,15844,20122013,0,60,2,5,-3,3.0577003102851,3.98921130340403,-0.93151099311893,37,32,5,44,38,6,59,50,9,7,3,0,0
"15933","NYR","BOS",2012030223,15846,20122013,1,60,1,2,-1,4.55944111570716,6.66322478328948,-2.10378366758232,24,34,-10,40,58,-18,60,75,-15,3,1,0,0
"15934","NYR","BOS",2012030224,15848,20122013,1,67.05,4,3,1,6.65132666511124,6.89707114943303,-0.24574448432179,32,40,-8,49,57,-8,70,74,-4,4,4,0,0
"15935","NYR","BOS",2012030225,15850,20122013,0,60,1,3,-2,4.69294467030522,6.6097949590478,-1.91685028874257,29,32,-3,36,48,-12,52,61,-9,3,4,0,0
"15936","NYR","ARI",2013020013,15981,20132014,0,60,1,4,-3,2.87938042532551,2.98950892082667,-0.110128495501158,24,32,-8,34,42,-8,51,60,-9,5,4,0,0
"15937","NYR","L.A",2013020036,15985,20132014,0,60,3,1,2,4.15898684079548,4.35387744457012,-0.194890603774638,28,29,-1,44,44,0,56,60,-4,5,3,0,0
"15938","NYR","S.J",2013020044,15986,20132014,0,60,2,9,-7,3.39770074433181,7.21536877695439,-3.81766803262258,20,47,-27,38,69,-31,54,91,-37,3,3,0,0
"15939","NYR","ANA",2013020057,15988,20132014,0,60,0,6,-6,3.04817859998002,3.64507458292064,-0.596895982940623,34,37,-3,40,46,-6,53,57,-4,3,7,0,0
"15940","NYR","STL",2013020070,15990,20132014,0,60,3,5,-2,3.25233666998321,5.55596091130076,-2.30362424131755,29,34,-5,40,45,-5,53,60,-7,7,8,0,0
"15941","NYR","WSH",2013020094,15994,20132014,0,60,2,0,2,4.25574528161087,3.62751728022704,0.628228001383832,36,22,14,48,35,13,61,57,4,4,5,0,0
"15942","NYR","N.J",2013020116,15997,20132014,0,60,0,4,-4,3.90682954900933,1.91385625270709,1.99297329630224,22,19,3,28,23,5,37,27,10,3,4,0,0
"15943","NYR","PHI",2013020141,16002,20132014,0,60,1,2,-1,6.02963666131687,6.37405875592958,-0.344422094612714,31,27,4,44,38,6,61,50,11,2,3,0,0
"15944","NYR","DET",2013020158,16004,20132014,0,64.7833333333333,3,2,1,4.58661421727447,4.75461127927304,-0.167997061998562,40,34,6,49,46,3,54,53,1,3,4,0,0
"15945","NYR","MTL",2013020173,16006,20132014,1,60,0,2,-2,1.75198206735801,2.90106677366788,-1.14908470630987,27,27,0,36,35,1,64,46,18,6,7,0,0
"15946","NYR","NYI",2013020176,16007,20132014,0,60,3,2,1,2.82450474302638,5.58821957829224,-2.76371483526586,24,24,0,37,42,-5,46,59,-13,7,5,0,0
"15947","NYR","BUF",2013020189,16009,20132014,1,60,2,0,2,3.69299450221443,3.38326095371992,0.309733548494513,46,29,17,56,40,16,76,50,26,3,1,0,0
"15948","NYR","CAR",2013020205,16011,20132014,1,60,5,1,4,4.89938849885948,3.32554969389457,1.57383880496491,38,28,10,50,40,10,65,50,15,6,5,0,0
"15949","NYR","ANA",2013020215,16013,20132014,1,60,1,2,-1,5.38095927232644,4.11419327871408,1.26676599361235,33,25,8,46,32,14,66,42,24,3,2,0,0
"15950","NYR","PIT",2013020226,16015,20132014,1,60,5,1,4,5.95838701992761,4.17559433545102,1.78279268447659,25,29,-4,42,39,3,52,48,4,7,8,0,0
"15951","NYR","CBJ",2013020235,16016,20132014,0,60,4,2,2,5.3049049268011,5.03947121358317,0.265433713217931,34,34,0,40,43,-3,54,58,-4,4,3,0,0
"15952","NYR","FLA",2013020257,16019,20132014,1,60,4,3,1,2.47843401381397,4.62808446609415,-2.14965045228018,29,27,2,43,42,1,58,55,3,4,4,0,0
"15953","NYR","N.J",2013020265,16021,20132014,1,60,2,3,-1,5.07737594065838,2.06920322701332,3.00817271364506,35,28,7,45,35,10,63,51,12,6,4,0,0
"15954","NYR","MTL",2013020295,16025,20132014,0,60,1,0,1,6.75606916222023,3.94927379947126,2.80679536274897,34,22,12,52,35,17,67,56,11,3,2,0,0
"15955","NYR","L.A",2013020305,16026,20132014,1,60,0,1,-1,5.30388051867669,2.19848805756943,3.10539246110726,37,30,7,48,43,5,63,61,2,5,1,0,0
"15956","NYR","BOS",2013020317,16028,20132014,1,60,1,2,-1,5.61758642357286,5.59928662516177,0.0182997984110926,44,22,22,62,32,30,85,53,32,4,3,0,0
"15957","NYR","DAL",2013020331,16030,20132014,0,60,3,2,1,7.00930077249037,5.36830712723895,1.64099364525142,27,43,-16,49,70,-21,58,91,-33,3,5,0,0
"15958","NYR","NSH",2013020348,16032,20132014,0,60,2,0,2,3.7465651697421,2.89732966237803,0.849235507364071,34,17,17,47,30,17,56,35,21,3,2,0,0
"15959","NYR","T.B",2013020358,16034,20132014,0,60,0,5,-5,3.09043871492031,2.62425479098715,0.466183923933158,37,25,12,50,32,18,74,39,35,6,3,0,0
"15960","NYR","FLA",2013020372,16036,20132014,0,60,5,2,3,4.35285343471332,3.25228712881653,1.10056630589679,22,33,-11,31,40,-9,39,52,-13,3,2,0,0
"15961","NYR","BOS",2013020380,16038,20132014,0,60,2,3,-1,2.47609319380717,6.06648789462489,-3.59039470081771,19,28,-9,26,41,-15,36,56,-20,7,4,0,0
"15962","NYR","VAN",2013020392,16039,20132014,1,60,5,2,3,3.27573702606605,4.66415588953532,-1.38841886346927,24,37,-13,36,47,-11,52,60,-8,3,3,0,0
"15963","NYR","WPG",2013020406,16041,20132014,1,60,2,5,-3,5.2043523565153,5.33571295189358,-0.131360595378283,37,30,7,42,40,2,63,44,19,2,2,0,0
"15964","NYR","BUF",2013020422,16044,20132014,0,60,3,1,2,4.41936505081685,4.41054604426608,0.00881900655076606,31,28,3,46,37,9,61,53,8,2,2,0,0
"15965","NYR","N.J",2013020444,16046,20132014,1,61.25,3,4,-1,3.6131467751984,2.12241879576322,1.49072797943518,24,24,0,38,36,2,61,48,13,4,2,0,0
"15966","NYR","WSH",2013020451,16047,20132014,1,60,1,4,-3,3.25679536571261,4.89672405317106,-1.63992868745845,31,36,-5,41,47,-6,58,56,2,3,4,0,0
"15967","NYR","NSH",2013020463,16049,20132014,1,60,1,4,-3,4.0516041281353,5.89397619030206,-1.84237206216676,29,26,3,38,36,2,62,56,6,2,2,0,0
"15968","NYR","CBJ",2013020473,16051,20132014,1,60,2,4,-2,3.85921649674128,4.64721419199486,-0.78799769525358,34,27,7,50,38,12,69,48,21,6,4,0,0
"15969","NYR","CGY",2013020502,16054,20132014,1,65,3,3,0,3.87478616152657,3.54691272873409,0.327873432792479,32,21,11,47,30,17,76,43,33,5,5,0,0
"15970","NYR","PIT",2013020522,16057,20132014,1,65,3,3,0,5.84562254861885,6.29987158809672,-0.454249039477872,32,32,0,48,42,6,68,53,15,6,4,0,0
"15971","NYR","NYI",2013020535,16059,20132014,1,60,3,5,-2,5.2622125018388,3.70805710062268,1.55415540121612,24,20,4,36,28,8,56,40,16,8,6,0,0
"15972","NYR","MIN",2013020551,16061,20132014,1,60,4,1,3,6.33929831963178,3.84434225421865,2.49495606541313,36,25,11,45,31,14,47,43,4,3,3,0,0
"15973","NYR","TOR",2013020554,16062,20132014,1,65,1,1,0,7.79231242730748,4.45170269088703,3.34060973642045,43,26,17,56,33,23,66,42,24,4,4,0,0
"15974","NYR","WSH",2013020570,16066,20132014,0,60,2,3,-1,6.03977801196015,4.29299115275228,1.74678685920787,40,34,6,52,40,12,71,55,16,5,6,0,0
"15975","NYR","T.B",2013020591,16068,20132014,0,60,4,3,1,3.8153949517,4.86414118652465,-1.04874623482465,29,40,-11,33,49,-16,45,64,-19,3,2,0,0
"15976","NYR","FLA",2013020600,16070,20132014,0,65,1,1,0,4.01908144937806,4.43898212439672,-0.419900675018653,31,22,9,36,38,-2,49,47,2,3,3,0,0
"15977","NYR","PIT",2013020623,16073,20132014,0,60,2,5,-3,3.87103528738953,2.47103316080756,1.40000212658197,35,28,7,48,37,11,63,45,18,4,3,0,0
"15978","NYR","TOR",2013020629,16074,20132014,0,60,7,1,6,8.85383253273176,2.91928152242326,5.9345510103085,50,26,24,70,44,26,85,53,32,4,2,0,0
"15979","NYR","CBJ",2013020644,16076,20132014,1,65,3,3,0,8.38171759809484,4.90193969697723,3.47977790111761,43,39,4,59,51,8,70,68,2,7,2,0,0
"15980","NYR","CHI",2013020658,16078,20132014,0,60,3,2,1,4.79165009975213,3.45378706301562,1.33786303673651,32,37,-5,36,46,-10,48,57,-9,2,3,0,0
"15981","NYR","DAL",2013020669,16080,20132014,1,60,3,2,1,3.85107101709582,3.31955294511044,0.531518071985374,34,26,8,44,47,-3,60,61,-1,3,2,0,0
"15982","NYR","PHI",2013020688,16082,20132014,1,60,4,1,3,6.31000322797697,2.26648210618984,4.04352112178713,35,38,-3,51,45,6,69,59,10,6,3,0,0
"15983","NYR","T.B",2013020697,16084,20132014,1,60,1,2,-1,4.52242587990511,3.26455821447598,1.25786766542913,34,25,9,46,32,14,66,51,15,2,2,0,0
"15984","NYR","DET",2013020710,16086,20132014,1,60,1,0,1,4.74421525756588,4.35516596633413,0.389049291231759,48,38,10,56,49,7,71,58,13,2,2,0,0
"15985","NYR","OTT",2013020723,16088,20132014,0,60,4,1,3,4.28597523255372,4.21938270284939,0.0665925297043355,31,30,1,44,44,0,62,55,7,5,3,0,0
"15986","NYR","WSH",2013020738,16089,20132014,1,60,4,1,3,3.89489546567141,5.27345525219937,-1.37855978652795,26,25,1,36,41,-5,50,64,-14,6,5,0,0
"15987","NYR","NYI",2013020748,16091,20132014,1,60,3,5,-2,6.36745971853088,7.92454687109603,-1.55708715256515,33,37,-4,50,51,-1,66,61,5,5,5,0,0
"15988","NYR","STL",2013020760,16093,20132014,1,60,1,2,-1,3.67204115381719,2.45854477234244,1.21349638147476,35,25,10,43,35,8,60,53,7,4,3,0,0
"15989","NYR","N.J",2013020784,16096,20132014,0,60,7,3,4,4.70542951279367,3.99225860549505,0.713170907298625,26,22,4,33,33,0,44,45,-1,4,2,0,0
"15990","NYR","NYI",2013020806,16099,20132014,0,60,2,1,1,3.83898147952277,4.26804893344524,-0.429067453922471,34,31,3,45,46,-1,56,63,-7,2,5,0,0
"15991","NYR","NYI",2013020819,16101,20132014,1,60,4,1,3,6.04520717437845,4.05703227478156,1.98817489959688,37,39,-2,55,45,10,70,63,7,5,6,0,0
"15992","NYR","COL",2013020845,16105,20132014,1,60,5,1,4,6.06667895700502,4.68017042457359,1.38650853243144,43,28,15,55,40,15,71,57,14,3,3,0,0
"15993","NYR","EDM",2013020857,16107,20132014,1,60,1,2,-1,6.97971530323525,4.14458545331217,2.83512984992308,36,31,5,50,42,8,65,51,14,0,1,0,0
"15994","NYR","PIT",2013020868,16108,20132014,0,65,3,3,0,9.83162551791611,2.32574997912161,7.5058755387945,41,29,12,58,41,17,68,55,13,8,7,0,0
"15995","NYR","CHI",2013020888,16128,20132014,1,60,2,1,1,4.54859712332836,3.29429516103028,1.25430196229809,24,32,-8,34,45,-11,39,62,-23,1,3,0,0
"15996","NYR","PHI",2013020904,16130,20132014,0,60,2,4,-2,7.17443387239473,6.68739620700944,0.487037665385287,35,31,4,54,45,9,78,67,11,4,5,0,0
"15997","NYR","BOS",2013020916,16131,20132014,1,60,3,6,-3,4.78925351222279,4.84850498458218,-0.0592514723593922,42,33,9,55,46,9,73,63,10,6,2,0,0
"15998","NYR","TOR",2013020934,16134,20132014,1,61.85,2,3,-1,5.08047721046023,4.23660421160093,0.843872998859297,37,29,8,58,37,21,79,48,31,2,4,0,0
"15999","NYR","CAR",2013020948,16136,20132014,0,60,4,2,2,9.46814436446556,2.95762843298144,6.51051593148412,44,24,20,60,37,23,75,48,27,5,6,0,0
"16000","NYR","DET",2013020965,16138,20132014,1,60,3,0,3,0,0,0,31,30,1,40,34,6,57,43,14,3,3,0,0
"16001","NYR","CAR",2013020978,16140,20132014,0,60,1,3,-2,4.68689004587155,5.30547839439913,-0.618588348527581,25,35,-10,38,49,-11,54,66,-12,4,5,0,0
"16002","NYR","MIN",2013020994,16142,20132014,0,60,1,2,-1,4.41470580737223,3.24190871464089,1.17279709273134,30,26,4,37,31,6,53,42,11,3,3,0,0
"16003","NYR","WPG",2013021001,16143,20132014,0,60,4,2,2,1.28737087400879,4.77220186816703,-3.48483099415824,23,32,-9,29,42,-13,48,66,-18,4,4,0,0
"16004","NYR","S.J",2013021016,16145,20132014,1,60,0,1,-1,5.59430832431826,3.6689678186321,1.92534050568616,41,29,12,53,37,16,75,56,19,3,1,0,0
"16005","NYR","OTT",2013021031,16147,20132014,0,60,8,4,4,7.04133450242807,4.45514770442969,2.58618679799838,39,39,0,52,52,0,65,72,-7,3,2,0,0
"16006","NYR","CBJ",2013021051,16150,20132014,0,60,3,1,2,8.00963238699478,5.36129244797554,2.64833993901924,32,26,6,42,35,7,57,50,7,6,5,0,0
"16007","NYR","N.J",2013021061,16151,20132014,0,60,2,0,2,5.84554608784674,2.78704873750591,3.05849735034083,27,21,6,33,34,-1,40,48,-8,4,2,0,0
"16008","NYR","ARI",2013021073,16153,20132014,1,61.9333333333333,4,3,1,5.6056782626365,1.52191789188828,4.08376037074822,36,21,15,48,30,18,63,45,18,3,5,0,0
"16009","NYR","PHI",2013021090,16155,20132014,1,60,3,1,2,2.75005928028258,4.62390968041291,-1.87385040013032,29,31,-2,41,39,2,55,60,-5,5,5,0,0
"16010","NYR","CGY",2013021106,16157,20132014,0,60,3,4,-1,9.73771571999532,3.2098183062626,6.52789741373272,41,28,13,55,37,18,72,42,30,1,2,0,0
"16011","NYR","EDM",2013021124,16159,20132014,0,60,5,0,5,2.82640199741581,3.7828816856545,-0.956479688238687,32,26,6,53,37,16,66,47,19,6,5,0,0
"16012","NYR","VAN",2013021137,16161,20132014,0,60,3,1,2,3.05488625483122,5.62176432961132,-2.56687807478011,31,35,-4,40,44,-4,50,58,-8,2,2,0,0
"16013","NYR","COL",2013021151,16163,20132014,0,65,2,2,0,4.42380368757332,6.06876506489634,-1.64496137732302,31,37,-6,42,50,-8,47,57,-10,5,4,0,0
"16014","NYR","OTT",2013021166,16165,20132014,1,60,2,3,-1,8.00955334390457,4.70603712805314,3.30351621585143,43,34,9,57,44,13,78,57,21,4,3,0,0
"16015","NYR","CAR",2013021182,16168,20132014,1,60,4,1,3,5.65125326591078,3.67580368986819,1.97544957604259,36,28,8,46,36,10,70,52,18,3,0,0,0
"16016","NYR","BUF",2013021194,16170,20132014,1,60,2,1,1,4.4196056481973,1.84384356578084,2.57576208241646,30,24,6,43,31,12,64,37,27,5,3,0,0
"16017","NYR","MTL",2013021214,16172,20132014,0,62.0666666666667,0,1,-1,6.07642703040906,3.47616736171949,2.60025966868957,41,27,14,54,40,14,66,57,9,5,6,0,0
"16018","NYR","PHI",2013030141,16177,20132014,1,60,4,1,3,5.2298259631425,2.44707730298978,2.78274866015272,36,15,21,47,26,21,69,42,27,6,2,0,0
"16019","NYR","PHI",2013030142,16180,20132014,1,60,2,4,-2,3.55848028482433,2.88467783361193,0.673802451212396,33,25,8,43,31,12,65,44,21,9,6,0,0
"16020","NYR","PHI",2013030143,16182,20132014,0,60,4,1,3,4.62560828381902,6.23353209575635,-1.60792381193733,23,32,-9,38,52,-14,49,80,-31,5,6,0,0
"16021","NYR","PHI",2013030144,16185,20132014,0,60,1,2,-1,3.24662025026009,3.36236287517386,-0.115742624913764,38,25,13,58,40,18,72,61,11,5,3,0,0
"16022","NYR","PHI",2013030145,16187,20132014,1,60,4,2,2,3.80352266817681,4.76759630331071,-0.9640736351339,22,26,-4,31,38,-7,41,50,-9,3,5,0,0
"16023","NYR","PHI",2013030146,16189,20132014,0,60,2,5,-3,8.72975240502827,5.01301082399201,3.71674158103626,36,29,7,55,41,14,79,55,24,6,4,0,0
"16024","NYR","PHI",2013030147,16190,20132014,1,60,2,1,1,4.53535312632295,5.73193865187932,-1.19658552555636,33,27,6,44,37,7,57,59,-2,1,2,0,0
"16025","NYR","PIT",2013030221,16192,20132014,0,63.1,3,2,1,6.94490238284,3.08201671595452,3.86288566688548,27,36,-9,41,48,-7,53,63,-10,4,4,0,0
"16026","NYR","PIT",2013030222,16194,20132014,0,60,0,3,-3,1.66320360911777,4.14321876305621,-2.48001515393844,22,35,-13,28,46,-18,41,64,-23,6,5,0,0
"16027","NYR","PIT",2013030223,16195,20132014,1,60,0,2,-2,4.6912576938048,1.29037344440843,3.40088424939637,35,15,20,52,21,31,69,38,31,4,1,0,0
"16028","NYR","PIT",2013030224,16197,20132014,1,60,2,4,-2,2.58069625259951,4.74896157404921,-2.1682653214497,15,27,-12,25,46,-21,38,66,-28,2,3,0,0
"16029","NYR","PIT",2013030225,16199,20132014,0,60,5,1,4,6.08924168537487,3.70287084818119,2.38637083719368,35,32,3,49,46,3,65,57,8,6,7,0,0
"16030","NYR","PIT",2013030226,16201,20132014,1,60,3,1,2,3.79331400422451,5.22991451430789,-1.43660051008338,29,37,-8,39,46,-7,51,68,-17,8,6,0,0
"16031","NYR","PIT",2013030227,16203,20132014,0,60,2,1,1,3.26864430637215,6.14177626598394,-2.87313195961178,20,36,-16,32,49,-17,38,65,-27,3,2,0,0
"16032","NYR","MTL",2013030311,16207,20132014,0,60,7,2,5,3.91799856431317,3.42651302251033,0.491485541802831,28,22,6,41,29,12,62,52,10,7,3,0,0
"16033","NYR","MTL",2013030312,16209,20132014,0,60,3,1,2,7.94013609144818,4.6830213538413,3.25711473760689,30,41,-11,36,63,-27,44,80,-36,5,6,0,0
"16034","NYR","MTL",2013030313,16212,20132014,1,61.2,2,3,-1,6.44867759628788,6.38702457337602,0.0616530229118535,37,25,12,53,38,15,75,53,22,2,2,0,0
"16035","NYR","MTL",2013030314,16215,20132014,1,66.0333333333333,3,2,1,5.71307437583701,4.12509771020268,1.58797666563433,29,29,0,39,42,-3,56,56,0,4,9,0,0
"16036","NYR","MTL",2013030315,16217,20132014,0,60,4,7,-3,3.28415967547039,4.48529940404465,-1.20113972857426,27,28,-1,37,40,-3,56,47,9,11,7,0,0
"16037","NYR","MTL",2013030316,16219,20132014,1,60,1,0,1,3.50823589025822,1.87481940202497,1.63341648823325,32,18,14,42,26,16,58,36,22,4,2,0,0
"16038","NYR","L.A",2013030411,16225,20132014,0,64.6,2,3,-1,4.89941244355683,4.05427199730184,0.845140446254995,27,43,-16,48,52,-4,63,64,-1,4,5,0,0
"16039","NYR","L.A",2013030412,16228,20132014,0,80,4,4,0,8.57438382810687,9.18241940251561,-0.608035574408733,37,38,-1,54,65,-11,70,81,-11,5,4,0,0
"16040","NYR","L.A",2013030413,16230,20132014,1,60,0,3,-3,3.35377152982376,2.36660900141578,0.987162528407978,32,15,17,39,22,17,59,33,26,6,4,0,0
"16041","NYR","L.A",2013030414,16232,20132014,1,60,2,1,1,2.63415830407757,5.25108172246837,-2.6169234183908,19,41,-22,33,51,-18,48,71,-23,4,3,0,0
"16042","NYR","L.A",2013030415,16234,20132014,0,80,2,2,0,7.49297668223153,7.78313340365639,-0.290156721424864,25,42,-17,46,76,-30,57,97,-40,4,4,0,0
"16043","NYR","STL",2014020011,16352,20142015,0,60,3,2,1,3.09483894693976,2.64205061167013,0.452788335269631,25,25,0,31,34,-3,43,52,-9,5,7,0,0
"16044","NYR","CBJ",2014020025,16354,20142015,0,60,2,5,-3,4.6914787517411,3.23175487280241,1.45972387893869,26,24,2,34,35,-1,44,48,-4,4,5,0,0
"16045","NYR","TOR",2014020033,16355,20142015,1,60,3,6,-3,4.75436470143723,5.9375565823284,-1.18319188089117,38,36,2,51,50,1,65,63,2,2,4,0,0
"16046","NYR","NYI",2014020038,16357,20142015,1,60,3,6,-3,6.77971139722604,5.56270272024267,1.21700867698337,43,27,16,55,41,14,75,50,25,4,4,0,0
"16047","NYR","CAR",2014020057,16359,20142015,1,65,1,1,0,4.52836304134689,4.57270581130535,-0.0443427699584582,34,30,4,44,39,5,66,47,19,6,4,0,0
"16048","NYR","S.J",2014020075,16362,20142015,1,60,4,0,4,3.76037993328646,5.09755727648735,-1.33717734320089,29,33,-4,40,43,-3,53,58,-5,2,4,0,0
"16049","NYR","N.J",2014020080,16364,20142015,0,62.7,4,3,1,4.55093515381304,3.97147899217089,0.579456161642156,25,31,-6,32,38,-6,40,49,-9,3,5,0,0
"16050","NYR","MTL",2014020108,16368,20142015,0,60,1,3,-2,4.41884741889953,4.43937443150207,-0.0205270126025425,35,30,5,48,39,9,68,51,17,2,1,0,0
"16051","NYR","MIN",2014020122,16370,20142015,1,60,5,4,1,3.31276527514098,3.73547634135139,-0.422711066210411,20,30,-10,25,44,-19,31,54,-23,1,2,0,0
"16052","NYR","WPG",2014020158,16375,20142015,1,65,0,0,0,5.77709053314368,7.27927577684492,-1.50218524370124,38,25,13,54,42,12,72,62,10,5,3,0,0
"16053","NYR","STL",2014020171,16377,20142015,1,65,3,3,0,5.92572114012748,3.47771657076669,2.44800456936079,39,34,5,54,48,6,72,61,11,5,4,0,0
"16054","NYR","DET",2014020185,16379,20142015,1,61.8333333333333,4,3,1,2.85077288839966,5.12939840409672,-2.27862551569706,30,28,2,37,48,-11,50,65,-15,5,8,0,0
"16055","NYR","TOR",2014020204,16382,20142015,0,60,4,5,-1,4.72732108166091,4.70775654971658,0.0195645319443347,35,31,4,44,40,4,60,53,7,2,2,0,0
"16056","NYR","EDM",2014020215,16383,20142015,1,60,1,3,-2,3.85290261651971,4.00623876248574,-0.153336145966023,21,33,-12,33,42,-9,46,60,-14,1,3,0,0
"16057","NYR","PIT",2014020222,16385,20142015,1,60,5,0,5,5.44120896144887,3.88919216143222,1.55201680001664,35,33,2,45,46,-1,57,64,-7,4,3,0,0
"16058","NYR","COL",2014020233,16387,20142015,1,65,3,3,0,6.30350833723787,5.64567648724187,0.657831849996001,33,29,4,47,34,13,60,45,15,3,2,0,0
"16059","NYR","PIT",2014020255,16389,20142015,0,65,2,2,0,3.84583396944981,4.32531423173936,-0.479480262289542,31,38,-7,41,50,-9,51,66,-15,6,4,0,0
"16060","NYR","T.B",2014020266,16391,20142015,1,60,1,5,-4,2.25436918194754,3.92914190523629,-1.67477272328875,16,30,-14,29,39,-10,50,55,-5,3,3,0,0
"16061","NYR","PHI",2014020278,16393,20142015,1,60,2,0,2,3.86947570802295,3.33251898712479,0.536956720898161,34,31,3,40,41,-1,48,47,1,4,4,0,0
"16062","NYR","BUF",2014020291,16486,20142015,0,60,3,1,2,7.72057209121522,4.78357128569041,2.9370008055248,43,25,18,62,36,26,75,43,32,4,3,0,0
"16063","NYR","MTL",2014020309,16397,20142015,1,60,5,0,5,2.58248504360654,2.89430133559007,-0.311816291983533,34,21,13,44,36,8,61,47,14,4,3,0,0
"16064","NYR","T.B",2014020326,16400,20142015,0,60,3,4,-1,5.27121980306929,3.40133238959243,1.86988741347687,19,29,-10,31,42,-11,44,49,-5,3,4,0,0
"16065","NYR","PHI",2014020333,16402,20142015,0,60,3,0,3,2.31175968201842,3.21874949598472,-0.906989813966297,24,26,-2,33,38,-5,50,57,-7,6,5,0,0
"16066","NYR","PHI",2014020348,16403,20142015,1,60,5,2,3,3.41662682080641,2.96787686307115,0.448749957735266,35,23,12,45,32,13,58,46,12,3,1,0,0
"16067","NYR","T.B",2014020357,16405,20142015,1,60,3,6,-3,4.69181926321471,4.41453879074834,0.277280472466373,35,21,14,47,31,16,66,49,17,4,5,0,0
"16068","NYR","DET",2014020393,16410,20142015,0,60,2,3,-1,2.18014640716101,5.23667672724939,-3.05653032008838,29,34,-5,44,45,-1,55,57,-2,6,2,0,0
"16069","NYR","PIT",2014020406,16412,20142015,1,63.75,4,3,1,3.08565869968152,8.97581432283914,-5.89015562315763,29,35,-6,38,50,-12,47,63,-16,3,1,0,0
"16070","NYR","VAN",2014020446,16417,20142015,0,60,5,1,4,2.72655009012669,6.09856499815942,-3.37201490803272,23,30,-7,28,36,-8,35,53,-18,1,1,0,0
"16071","NYR","EDM",2014020450,16418,20142015,0,60,2,0,2,4.05836503143655,2.76081333763432,1.29755169380223,22,16,6,36,29,7,46,50,-4,1,2,0,0
"16072","NYR","CGY",2014020462,16420,20142015,0,60,5,2,3,4.1228045168682,3.7021092659233,0.420695250944902,23,31,-8,30,38,-8,38,64,-26,3,4,0,0
"16073","NYR","CAR",2014020486,16424,20142015,0,65,2,2,0,9.73539975238037,4.14230154520192,5.59309820717845,34,20,14,56,34,22,75,46,29,2,4,0,0
"16074","NYR","CAR",2014020494,16425,20142015,1,60,1,0,1,2.55317530306638,2.24848892039154,0.304686382674845,31,18,13,40,22,18,56,29,27,3,1,0,0
"16075","NYR","WSH",2014020506,16427,20142015,1,60,4,2,2,6.04699312632965,3.71049448005357,2.33649864627608,27,32,-5,36,44,-8,48,60,-12,6,5,0,0
"16076","NYR","N.J",2014020517,16431,20142015,1,60,3,1,2,6.30031220627143,4.25266116519924,2.04765104107219,28,20,8,36,32,4,52,41,11,3,4,0,0
"16077","NYR","DAL",2014020538,16433,20142015,0,60,2,3,-1,4.38948453075585,3.56794735282892,0.821537177926928,30,27,3,41,38,3,58,55,3,3,5,0,0
"16078","NYR","FLA",2014020551,16435,20142015,0,60,5,2,3,5.58341736381408,3.21495041181953,2.36846695199455,34,20,14,42,29,13,49,45,4,3,4,0,0
"16079","NYR","BUF",2014020569,16438,20142015,1,60,6,1,5,5.92167285937467,3.48016591946362,2.44150693991105,39,25,14,56,30,26,74,39,35,5,4,0,0
"16080","NYR","ANA",2014020597,16442,20142015,0,60,4,1,3,5.39343262996408,2.06148425170977,3.33194837825431,30,25,5,46,49,-3,60,68,-8,1,3,0,0
"16081","NYR","L.A",2014020607,16443,20142015,0,60,4,3,1,6.34342201575843,3.20149169037904,3.14193032537939,26,31,-5,40,45,-5,51,60,-9,4,4,0,0
"16082","NYR","S.J",2014020623,16445,20142015,0,60,3,1,2,5.54648890843032,4.87450590115986,0.671983007270455,32,31,1,43,45,-2,63,63,0,2,3,0,0
"16083","NYR","NYI",2014020632,16448,20142015,1,60,0,3,-3,2.53029737161341,4.81017158390023,-2.27987421228681,27,44,-17,41,56,-15,64,72,-8,2,3,0,0
"16084","NYR","BOS",2014020644,16450,20142015,0,60,0,3,-3,4.73848112879274,3.58654531369773,1.15193581509502,30,32,-2,41,41,0,49,55,-6,4,3,0,0
"16085","NYR","CBJ",2014020656,16451,20142015,0,60,2,1,1,2.3604685455324,4.2853846832586,-1.9249161377262,26,36,-10,28,45,-17,40,65,-25,2,4,0,0
"16086","NYR","PIT",2014020672,16453,20142015,0,60,5,2,3,2.84086748069505,6.48204326294217,-3.64117578224712,31,34,-3,36,46,-10,52,60,-8,6,3,0,0
"16087","NYR","OTT",2014020683,16455,20142015,1,62.9166666666667,3,2,1,7.59298422788311,5.4577018803684,2.1352823475147,35,35,0,46,42,4,60,58,2,3,2,0,0
"16088","NYR","NYI",2014020697,16462,20142015,0,60,1,4,-3,5.00925645902828,4.3447723936826,0.664484065345675,41,38,3,52,48,4,77,56,21,4,4,0,0
"16089","NYR","MTL",2014020712,16464,20142015,1,60,0,1,-1,2.05852092776331,5.82303077490011,-3.7645098471368,24,26,-2,37,44,-7,49,56,-7,5,6,0,0
"16090","NYR","CAR",2014020732,16466,20142015,1,60,4,1,3,5.80838031847088,4.6353120241547,1.17306829431618,37,32,5,49,44,5,64,62,2,2,3,0,0
"16091","NYR","FLA",2014020742,16468,20142015,1,60,6,3,3,6.91113168663287,5.75284888921306,1.15828279741982,38,36,2,51,48,3,60,64,-4,5,3,0,0
"16092","NYR","BOS",2014020756,16470,20142015,1,60,3,2,1,6.50419173740289,4.01412039444237,2.49007134296052,25,20,5,37,34,3,57,52,5,2,2,0,0
"16093","NYR","NSH",2014020773,16473,20142015,0,60,2,3,-1,5.31394213969179,4.26397136470769,1.0499707749841,32,23,9,47,38,9,60,49,11,2,1,0,0
"16094","NYR","DAL",2014020789,16474,20142015,1,61.0333333333333,2,3,-1,0,0,0,36,25,11,50,37,13,68,48,20,3,3,0,0
"16095","NYR","TOR",2014020800,16476,20142015,0,60,5,4,1,5.90486646471254,4.87731490960973,1.02755155510281,39,34,5,50,47,3,63,59,4,2,2,0,0
"16096","NYR","COL",2014020816,16478,20142015,0,60,6,3,3,3.52856666663311,4.46805005289551,-0.939483386262406,31,29,2,36,43,-7,53,55,-2,3,6,0,0
"16097","NYR","ARI",2014020829,16480,20142015,0,60,5,1,4,5.9739328537043,7.25506134959869,-1.28112849589439,32,35,-3,47,56,-9,62,66,-4,0,3,0,0
"16098","NYR","NYI",2014020838,16482,20142015,0,60,6,5,1,7.5285973129794,7.22182999536967,0.306767317609729,42,43,-1,52,56,-4,71,67,4,3,4,0,0
"16099","NYR","VAN",2014020860,16485,20142015,1,65,4,4,0,4.03635064611444,6.48711501297657,-2.45076436686213,34,28,6,39,41,-2,51,53,-2,5,3,0,0
"16100","NYR","CBJ",2014020890,16488,20142015,1,65,3,3,0,5.53307225327859,4.37539616245442,1.15767609082417,37,30,7,49,38,11,62,54,8,4,3,0,0
"16101","NYR","CGY",2014020896,16490,20142015,1,60,1,0,1,3.08955592455459,2.35237906177645,0.737176862778142,29,21,8,41,30,11,61,40,21,2,0,0,0
"16102","NYR","ARI",2014020909,16492,20142015,1,60,4,3,1,5.67472160575562,7.50855696536428,-1.83383535960866,38,40,-2,49,56,-7,68,64,4,3,4,0,0
"16103","NYR","PHI",2014020929,16494,20142015,0,60,2,4,-2,5.62862627626332,6.1985236041146,-0.56989732785128,36,34,2,45,46,-1,66,66,0,3,3,0,0
"16104","NYR","NSH",2014020939,16496,20142015,1,60,4,1,3,6.42898530871909,4.16585589628085,2.26312941243824,40,26,14,57,42,15,63,53,10,1,3,0,0
"16105","NYR","DET",2014020953,16498,20142015,0,61.15,1,2,-1,7.87766943697352,4.18374400371977,3.69392543325375,40,31,9,55,36,19,61,50,11,4,3,0,0
"16106","NYR","CHI",2014020985,16502,20142015,0,60.5333333333333,1,0,1,3.78837216182728,3.06465887033846,0.723713291488821,36,29,7,40,42,-2,48,60,-12,2,4,0,0
"16107","NYR","NYI",2014020991,16504,20142015,0,60,2,1,1,3.75224050121494,4.94130557912285,-1.18906507790791,22,30,-8,33,43,-10,58,57,1,4,4,0,0
"16108","NYR","WSH",2014021000,16505,20142015,0,60,3,1,2,4.72171351438247,6.16494457255062,-1.44323105816815,31,29,2,38,48,-10,53,68,-15,4,4,0,0
"16109","NYR","BUF",2014021021,16508,20142015,0,60,2,0,2,6.08379682672237,4.33551973167572,1.74827709504665,33,20,13,54,22,32,72,26,46,3,3,0,0
"16110","NYR","FLA",2014021030,16509,20142015,1,60,2,1,1,6.2224347187439,4.86368831241271,1.35874640633119,34,39,-5,44,62,-18,52,98,-46,2,3,0,0
"16111","NYR","CHI",2014021050,16512,20142015,1,60,0,1,-1,4.89585208712379,5.36492214275495,-0.469070055631164,25,31,-6,42,45,-3,54,58,-4,2,2,0,0
"16112","NYR","CAR",2014021073,16515,20142015,0,65,2,2,0,4.49021490787459,5.88098824373446,-1.39077333585988,29,30,-1,44,46,-2,54,70,-16,2,2,0,0
"16113","NYR","ANA",2014021081,16516,20142015,1,60,7,2,5,5.0673554094974,6.68521064336528,-1.61785523386789,29,38,-9,41,59,-18,54,72,-18,3,2,0,0
"16114","NYR","L.A",2014021091,16518,20142015,1,60,2,4,-2,3.76341976936965,4.5403810920543,-0.776961322684656,36,35,1,45,47,-2,56,62,-6,1,2,0,0
"16115","NYR","OTT",2014021107,16520,20142015,0,60,5,1,4,4.25270571492136,5.27455150824971,-1.02184579332835,32,24,8,42,39,3,53,53,0,1,7,0,0
"16116","NYR","BOS",2014021116,16522,20142015,0,60,2,4,-2,3.83955407500434,4.2234229836904,-0.383868908686054,32,30,2,42,43,-1,57,53,4,1,2,0,0
"16117","NYR","WSH",2014021128,16523,20142015,1,60,2,5,-3,3.87950552121436,4.90015506141935,-1.020649540205,25,31,-6,39,38,1,50,50,0,5,4,0,0
"16118","NYR","WPG",2014021148,16525,20142015,0,60,3,2,1,3.83067472005496,4.57316035020949,-0.742485630154533,24,34,-10,30,49,-19,39,73,-34,3,2,0,0
"16119","NYR","MIN",2014021159,16527,20142015,0,60,3,2,1,3.51057874791877,8.17071311082168,-4.66013436290291,26,28,-2,33,39,-6,43,46,-3,5,2,0,0
"16120","NYR","N.J",2014021174,16529,20142015,1,60,6,1,5,7.73121890141419,4.87931518611731,2.85190371529688,32,36,-4,42,47,-5,52,68,-16,2,5,0,0
"16121","NYR","CBJ",2014021186,16531,20142015,1,64.1666666666667,4,3,1,5.27898230070872,4.21582671100623,1.06315558970249,42,32,10,50,45,5,67,60,7,3,3,0,0
"16122","NYR","N.J",2014021190,16532,20142015,0,60,4,2,2,4.9607417892048,2.65191784431008,2.30882394489472,40,21,19,48,30,18,57,37,20,7,2,0,0
"16123","NYR","OTT",2014021203,16534,20142015,1,60,0,3,-3,3.55472903593909,6.5693987124401,-3.01466967650101,26,27,-1,37,40,-3,55,45,10,2,2,0,0
"16124","NYR","WSH",2014021217,16536,20142015,0,60,4,2,2,4.90861247199791,3.50163054049995,1.40698193149797,34,24,10,41,38,3,53,55,-2,5,2,0,0
"16125","NYR","PIT",2014030131,16541,20142015,1,60,2,1,1,4.41431358884438,2.0047695490363,2.40954403980808,38,25,13,44,29,15,55,51,4,5,1,0,0
"16126","NYR","PIT",2014030132,16543,20142015,1,60,3,4,-1,5.18627912691635,1.42223561247955,3.7640435144368,26,22,4,42,30,12,62,37,25,7,4,0,0
"16127","NYR","PIT",2014030133,16545,20142015,0,60,2,1,1,4.83671865038923,5.62922641499426,-0.792507764605034,26,24,2,36,38,-2,50,55,-5,5,4,0,0
"16128","NYR","PIT",2014030134,16547,20142015,0,63.2333333333333,2,1,1,4.78601673201941,5.04788962617221,-0.261872894152794,24,23,1,33,31,2,50,50,0,3,3,0,0
"16129","NYR","PIT",2014030135,16549,20142015,1,70.8666666666667,2,1,1,7.05158041662071,5.83180804608855,1.21977237053216,36,38,-2,52,55,-3,65,74,-9,3,3,0,0
"16130","NYR","WSH",2014030221,16555,20142015,1,60,1,2,-1,4.11199868842959,4.50486542269937,-0.392866734269774,32,29,3,46,45,1,65,60,5,3,3,0,0
"16131","NYR","WSH",2014030222,16557,20142015,1,60,3,2,1,4.08253128052456,3.09983884683606,0.982692433688499,35,32,3,48,48,0,63,60,3,4,1,0,0
"16132","NYR","WSH",2014030223,16559,20142015,0,60,0,1,-1,3.65481068007648,5.34084531744884,-1.68603463737236,30,22,8,42,37,5,69,49,20,2,2,0,0
"16133","NYR","WSH",2014030224,16561,20142015,0,60,1,2,-1,3.30799018205289,5.75805223226052,-2.45006205020763,29,30,-1,41,42,-1,66,49,17,5,4,0,0
"16134","NYR","WSH",2014030225,16563,20142015,1,69.6166666666667,2,1,1,4.03128053546243,4.34089799864159,-0.309617463179165,43,29,14,53,35,18,66,56,10,2,2,0,0
"16135","NYR","WSH",2014030226,16565,20142015,0,60,4,3,1,5.46673949537217,7.83523828529814,-2.36849878992598,28,45,-17,40,62,-22,55,96,-41,3,4,0,0
"16136","NYR","WSH",2014030227,16568,20142015,1,71.4,2,1,1,5.97561668067304,3.63312828875496,2.34248839191808,39,36,3,53,49,4,74,68,6,4,3,0,0
"16137","NYR","T.B",2014030311,16571,20142015,1,60,2,1,1,4.78279995801859,1.75338550437823,3.02941445364036,30,24,6,44,35,9,61,50,11,2,4,0,0
"16138","NYR","T.B",2014030312,16573,20142015,1,60,2,6,-4,0,0,0,37,26,11,46,31,15,63,41,22,6,6,0,0
"16139","NYR","T.B",2014030313,16575,20142015,0,63.55,5,6,-1,3.32008766906802,6.18095610385678,-2.86086843478877,28,40,-12,45,50,-5,58,64,-6,5,3,0,0
"16140","NYR","T.B",2014030314,16577,20142015,0,60,5,1,4,1.67790363889935,3.91291411113343,-2.23501047223408,24,39,-15,33,52,-19,42,61,-19,8,8,0,0
"16141","NYR","T.B",2014030315,16579,20142015,1,60,0,2,-2,1.81046053469252,2.99478359262214,-1.18432305792962,26,22,4,34,31,3,58,42,16,5,4,0,0
"16142","NYR","T.B",2014030316,16581,20142015,0,60,7,3,4,7.50158956153899,4.86016180553725,2.64142775600175,34,39,-5,43,48,-5,55,65,-10,4,4,0,0
"16143","NYR","T.B",2014030317,16584,20142015,1,60,0,2,-2,3.47205524728633,3.49844614771428,-0.0263909004279412,22,25,-3,33,32,1,53,44,9,2,0,0,0
"16144","NYR","CHI",2015020002,16715,20152016,0,60,3,2,1,6.1170808870811,5.90410337418143,0.21297751289967,27,34,-7,38,48,-10,41,63,-22,1,2,0,0
"16145","NYR","CBJ",2015020013,16717,20152016,0,60,4,2,2,3.47417394833079,2.49571046751856,0.978463480812231,25,33,-8,30,41,-11,38,53,-15,3,6,0,0
"16146","NYR","CBJ",2015020021,16718,20152016,1,60,5,2,3,3.25817655317951,5.59996317258629,-2.34178661940678,29,39,-10,36,55,-19,41,68,-27,4,6,0,0
"16147","NYR","WPG",2015020038,16721,20152016,1,60,1,4,-3,3.61459645305406,2.52462976424431,1.08996668880975,41,29,12,47,35,12,60,47,13,6,6,0,0
"16148","NYR","MTL",2015020053,16723,20152016,0,60,0,3,-3,6.00835395872637,3.96780336330397,2.0405505954224,25,32,-7,41,42,-1,58,55,3,6,6,0,0
"16149","NYR","N.J",2015020075,16726,20152016,1,63.1166666666667,1,2,-1,2.43958460539579,3.42869826141396,-0.989113656018162,27,24,3,40,36,4,58,42,16,2,3,0,0
"16150","NYR","S.J",2015020080,16727,20152016,1,60,4,0,4,2.76139930563512,2.15031009772622,0.611089207908901,28,22,6,40,28,12,50,49,1,1,2,0,0
"16151","NYR","ARI",2015020092,16730,20152016,1,60,4,1,3,3.3937119062175,6.13466826024601,-2.7409563540285,28,35,-7,34,47,-13,49,52,-3,3,3,0,0
"16152","NYR","PHI",2015020110,16732,20152016,0,65,2,2,0,5.90124382663635,9.95289195178107,-4.05164812514473,39,48,-9,54,61,-7,70,77,-7,3,2,0,0
"16153","NYR","CGY",2015020119,16733,20152016,1,60,4,1,3,1.5625714141531,3.47495229342758,-1.91238087927448,26,23,3,38,37,1,54,55,-1,3,3,0,0
"16154","NYR","TOR",2015020146,16738,20152016,1,60,3,1,2,4.86806010792498,2.94720310196863,1.92085700595635,26,25,1,38,38,0,49,51,-2,3,0,0,0
"16155","NYR","WSH",2015020174,16742,20152016,1,60,5,2,3,2.57470051616838,4.57181929715443,-1.99711878098606,22,34,-12,32,47,-15,38,67,-29,1,2,0,0
"16156","NYR","COL",2015020197,16745,20152016,0,60,2,1,1,2.18344896852126,4.8440256989561,-2.66057673043485,33,30,3,36,39,-3,43,49,-6,3,6,0,0
"16157","NYR","ARI",2015020208,16746,20152016,0,60,4,1,3,4.37229410826694,5.47345869638993,-1.10116458812298,30,40,-10,40,52,-12,47,72,-25,3,4,0,0
"16158","NYR","CAR",2015020217,16749,20152016,1,60,3,0,3,2.4243485619106,4.13124204758155,-1.70689348567095,23,33,-10,28,48,-20,37,67,-30,2,6,0,0
"16159","NYR","STL",2015020231,16751,20152016,1,60,6,3,3,5.16504321430357,6.04914455680409,-0.884101342500529,22,34,-12,33,47,-14,49,68,-19,3,4,0,0
"16160","NYR","OTT",2015020246,16753,20152016,0,65,1,1,0,6.12509426640463,4.06833143867698,2.05676282772765,34,23,11,38,39,-1,53,56,-3,3,4,0,0
"16161","NYR","TOR",2015020259,16754,20152016,1,60,4,3,1,4.4330203908612,3.96678831003024,0.46623208083096,30,26,4,44,37,7,50,55,-5,2,3,0,0
"16162","NYR","T.B",2015020284,16758,20152016,0,60,1,2,-1,2.84034400599194,1.91989221281256,0.920451793179382,21,28,-7,30,36,-6,46,52,-6,6,5,0,0
"16163","NYR","FLA",2015020296,16760,20152016,0,62.0166666666667,5,4,1,5.62564241571818,6.44809148102468,-0.8224490653065,31,43,-12,38,62,-24,46,74,-28,4,8,0,0
"16164","NYR","NSH",2015020309,16762,20152016,1,60,3,0,3,2.49714200301356,3.45013184796881,-0.952989844955241,19,31,-12,27,49,-22,41,75,-34,5,5,0,0
"16165","NYR","MTL",2015020320,16764,20152016,1,60,1,5,-4,4.87810833565891,2.95584862976884,1.92225970589007,34,25,9,40,35,5,53,47,6,5,4,0,0
"16166","NYR","BOS",2015020330,16766,20152016,0,60,3,4,-1,1.97974833415356,3.8464864619018,-1.86673812774825,27,34,-7,42,49,-7,55,64,-9,3,3,0,0
"16167","NYR","PHI",2015020342,16767,20152016,1,60,0,3,-3,2.69996491627535,4.03512915790902,-1.33516424163368,24,34,-10,35,41,-6,52,54,-2,2,2,0,0
"16168","NYR","CAR",2015020356,16769,20152016,1,60,4,3,1,2.60677868072298,7.31098783863126,-4.70420915790828,22,36,-14,28,50,-22,37,75,-38,5,4,0,0
"16169","NYR","NYI",2015020370,16771,20152016,0,65,1,1,0,4.03731588057053,4.71128591988249,-0.673970039311955,34,37,-3,50,47,3,74,67,7,4,3,0,0
"16170","NYR","COL",2015020373,16772,20152016,1,60,1,2,-1,6.44749803486047,4.29170209819858,2.15579593666189,25,18,7,43,25,18,65,36,29,1,0,0,0
"16171","NYR","OTT",2015020401,16775,20152016,1,60,4,1,3,4.96490120669114,2.3527496009192,2.61215160577194,31,24,7,47,37,10,57,61,-4,2,2,0,0
"16172","NYR","VAN",2015020420,16778,20152016,0,60,1,2,-1,1.86024183662585,2.47009686323872,-0.609855026612877,33,25,8,44,30,14,60,43,17,6,6,0,0
"16173","NYR","EDM",2015020432,16780,20152016,0,60,5,7,-2,4.25990178633947,4.27220466688595,-0.0123028805464855,34,37,-3,46,45,1,56,56,0,2,3,0,0
"16174","NYR","CGY",2015020443,16781,20152016,0,62.15,4,5,-1,0,0,0,29,27,2,40,41,-1,59,53,6,5,3,0,0
"16175","NYR","EDM",2015020455,16784,20152016,1,60,4,2,2,3.41911817280634,2.1395778789938,1.27954029381254,21,20,1,32,30,2,48,53,-5,5,6,0,0
"16176","NYR","MIN",2015020472,16786,20152016,0,60,2,5,-3,1.85014959906403,7.03520773065725,-5.18505813159322,23,35,-12,30,46,-16,41,56,-15,3,4,0,0
"16177","NYR","WPG",2015020482,16787,20152016,0,60,2,5,-3,6.81316491085454,4.90561981174687,1.90754509910767,28,36,-8,38,53,-15,54,67,-13,3,4,0,0
"16178","NYR","WSH",2015020497,16789,20152016,1,60,3,7,-4,6.30822421091216,4.24838838562209,2.05983582529007,36,30,6,52,42,10,66,52,14,7,5,0,0
"16179","NYR","ANA",2015020508,16791,20152016,1,62.6166666666667,3,2,1,4.22787709694735,1.90563064934031,2.32224644760704,22,19,3,35,27,8,44,41,3,5,4,0,0
"16180","NYR","NSH",2015020537,16797,20152016,0,60,3,5,-2,3.37409558077411,5.61817061780084,-2.24407503702673,29,35,-6,42,46,-4,52,65,-13,1,2,0,0
"16181","NYR","T.B",2015020554,16799,20152016,0,60,5,2,3,5.65716390789021,4.89467794777011,0.762485960120102,26,22,4,36,36,0,52,51,1,3,5,0,0
"16182","NYR","FLA",2015020572,16802,20152016,0,60,0,3,-3,6.57213764957237,3.13328898570365,3.43884866386872,40,20,20,54,34,20,70,37,33,6,5,0,0
"16183","NYR","DAL",2015020590,16805,20152016,1,60,6,2,4,3.95546253563191,2.84824024746194,1.10722228816996,29,23,6,40,32,8,57,53,4,3,3,0,0
"16184","NYR","WSH",2015020614,16809,20152016,1,61.4166666666667,3,4,-1,3.76589607044466,5.27057340530155,-1.50467733485689,26,31,-5,44,40,4,62,52,10,3,3,0,0
"16185","NYR","BOS",2015020630,16811,20152016,1,60,2,1,1,5.71326656639576,5.6382782922592,0.0749882741365582,30,33,-3,39,47,-8,47,71,-24,0,1,0,0
"16186","NYR","NYI",2015020646,16814,20152016,0,60,1,3,-2,4.68430804075615,3.50587009355877,1.17843794719738,35,32,3,52,43,9,73,53,20,5,4,0,0
"16187","NYR","PHI",2015020660,16816,20152016,0,65,2,2,0,4.80006053659599,8.45082452442148,-3.65076398782548,31,36,-5,43,49,-6,57,79,-22,5,4,0,0
"16188","NYR","WSH",2015020673,16817,20152016,0,60,2,5,-3,4.41486911773291,3.59862386549321,0.816245252239696,33,24,9,44,35,9,61,57,4,4,4,0,0
"16189","NYR","VAN",2015020683,16819,20152016,1,63.9,3,2,1,4.36628053125605,3.63618728448637,0.730093246769684,49,20,29,65,27,38,78,37,41,1,1,0,0
"16190","NYR","CAR",2015020705,16822,20152016,0,60,4,1,3,4.51172901266546,4.50623573578196,0.00549327688349877,32,31,1,49,43,6,57,56,1,1,1,0,0
"16191","NYR","OTT",2015020721,16824,20152016,0,60,0,3,-3,6.29493765742518,5.86733652808471,0.427601129340474,35,33,2,50,47,3,64,74,-10,3,2,0,0
"16192","NYR","BUF",2015020726,16825,20152016,1,60,6,3,3,4.67181787907617,5.27647505077948,-0.604657171703309,33,26,7,47,37,10,58,53,5,4,1,0,0
"16193","NYR","N.J",2015020745,16833,20152016,0,60,2,3,-1,2.290758391704,4.38556254615105,-2.09480415444705,33,25,8,42,33,9,50,41,9,4,2,0,0
"16194","NYR","MIN",2015020760,16835,20152016,1,60,4,2,2,4.72091092464402,4.32162653264822,0.399284391995792,30,18,12,50,31,19,66,43,23,3,3,0,0
"16195","NYR","PHI",2015020776,16837,20152016,0,65,2,2,0,4.38244035137177,5.80825886392267,-1.4258185125509,28,28,0,38,46,-8,54,64,-10,2,7,0,0
"16196","NYR","N.J",2015020790,16839,20152016,1,60,2,1,1,4.13902344240341,5.42756409427167,-1.28854065186826,37,28,9,47,36,11,74,49,25,5,0,0,0
"16197","NYR","PIT",2015020807,16841,20152016,0,60,3,0,3,5.33340245753061,3.19448210217394,2.13892035535667,22,34,-12,33,48,-15,41,73,-32,1,2,0,0
"16198","NYR","L.A",2015020819,16843,20152016,1,63.1666666666667,4,5,-1,3.78193831692192,6.92777541355281,-3.14583709663088,28,34,-6,33,49,-16,43,72,-29,1,2,0,0
"16199","NYR","PHI",2015020839,16845,20152016,1,60,3,1,2,4.78097197480713,6.13027434183459,-1.34930236702746,30,22,8,37,50,-13,51,70,-19,6,6,0,0
"16200","NYR","CHI",2015020855,16848,20152016,1,60,3,5,-2,5.70451120342113,3.9905246362614,1.71398656715974,34,20,14,47,28,19,63,38,25,1,4,0,0
"16201","NYR","TOR",2015020860,16849,20152016,0,60,4,2,2,2.93912218924717,4.56142454936824,-1.62230236012107,20,37,-17,27,53,-26,37,73,-36,2,8,0,0
"16202","NYR","DET",2015020885,16852,20152016,1,61.9833333333333,1,0,1,3.03881925276073,4.03913835569983,-1.0003191029391,30,22,8,46,34,12,58,52,6,6,5,0,0
"16203","NYR","N.J",2015020893,16854,20152016,0,60,2,5,-3,1.36479517038173,4.2583369021886,-2.89354173180688,19,36,-17,25,46,-21,39,52,-13,2,4,0,0
"16204","NYR","STL",2015020910,16856,20152016,0,60,2,1,1,2.38499606441032,3.93956737595047,-1.55457131154015,23,36,-13,31,51,-20,39,67,-28,2,2,0,0
"16205","NYR","DAL",2015020925,16858,20152016,0,60,3,2,1,5.80067380162654,10.4677095619845,-4.66703576035798,29,38,-9,43,59,-16,61,85,-24,3,1,0,0
"16206","NYR","CBJ",2015020937,16860,20152016,1,60,2,1,1,5.40485251130303,2.11546392389573,3.2893885874073,23,27,-4,34,37,-3,50,59,-9,1,1,0,0
"16207","NYR","PIT",2015020957,16863,20152016,0,60,1,4,-3,3.43814205572222,3.83817219855564,-0.400030142833417,28,26,2,40,32,8,52,44,8,2,3,0,0
"16208","NYR","WSH",2015020966,16864,20152016,0,60,3,2,1,7.61139334735486,5.85930939228274,1.75208395507212,23,34,-11,35,50,-15,48,77,-29,3,3,0,0
"16209","NYR","NYI",2015020982,16866,20152016,1,60,4,6,-2,3.83672225228656,4.88606388168409,-1.04934162939753,26,32,-6,43,48,-5,57,60,-3,3,3,0,0
"16210","NYR","BUF",2015020993,16868,20152016,0,60,4,2,2,5.78918870267808,2.9698240592993,2.81936464337878,26,36,-10,39,45,-6,52,56,-4,2,2,0,0
"16211","NYR","DET",2015021019,16872,20152016,0,63.05,2,3,-1,3.58029810226526,5.76623204178759,-2.18593393952233,25,43,-18,38,61,-23,45,77,-32,4,5,0,0
"16212","NYR","PIT",2015021030,16873,20152016,1,60,3,5,-2,3.97327024557489,5.4362747403793,-1.46300449480441,27,33,-6,41,39,2,57,57,0,5,4,0,0
"16213","NYR","ANA",2015021052,16876,20152016,0,60,2,1,1,4.40567721000116,3.87813005068165,0.527547159319511,23,23,0,31,37,-6,44,55,-11,3,0,0,0
"16214","NYR","L.A",2015021060,16877,20152016,0,61.5666666666667,3,4,-1,3.33583354840812,6.77415552828461,-3.43832197987649,26,37,-11,32,57,-25,41,72,-31,2,3,0,0
"16215","NYR","S.J",2015021069,16879,20152016,0,60,1,4,-3,2.73962221166585,8.72121672911244,-5.9815945174466,26,52,-26,39,63,-24,56,81,-25,3,4,0,0
"16216","NYR","FLA",2015021086,16881,20152016,1,60,4,2,2,5.02686622968758,4.80340012708962,0.223466102597968,32,27,5,39,33,6,50,48,2,4,3,0,0
"16217","NYR","BOS",2015021100,16883,20152016,1,60,5,2,3,4.63457584014031,7.5676646351208,-2.93308879498048,24,41,-17,37,57,-20,46,75,-29,5,2,0,0
"16218","NYR","MTL",2015021120,16886,20152016,0,60,5,2,3,5.8395378581216,5.97592309809988,-0.136385239978289,23,26,-3,39,39,0,56,53,3,4,7,0,0
"16219","NYR","PIT",2015021130,16887,20152016,1,64.5,2,3,-1,5.01826411456568,5.30926102922149,-0.290996914655807,27,32,-5,42,53,-11,66,79,-13,2,2,0,0
"16220","NYR","CAR",2015021155,16891,20152016,0,60,3,4,-1,4.91546094359364,3.51296961211483,1.40249133147881,27,28,-1,38,41,-3,50,51,-1,3,2,0,0
"16221","NYR","BUF",2015021173,16893,20152016,1,60,3,4,-1,4.46789392520077,2.77693443393218,1.69095949126859,36,24,12,51,34,17,68,46,22,3,2,0,0
"16222","NYR","CBJ",2015021184,16895,20152016,0,60,4,2,2,0,0,0,30,29,1,47,43,4,64,63,1,1,4,0,0
"16223","NYR","T.B",2015021190,16896,20152016,1,60,3,2,1,3.11685270412863,5.42748686653067,-2.31063416240204,28,41,-13,39,54,-15,50,69,-19,6,6,0,0
"16224","NYR","NYI",2015021204,16898,20152016,1,60,1,4,-3,4.80173767643629,3.70403736680601,1.09770030963028,37,23,14,48,34,14,71,48,23,5,4,0,0
"16225","NYR","DET",2015021217,16900,20152016,1,60,3,2,1,3.50988043780671,6.5274361639531,-3.01755572614638,20,33,-13,33,45,-12,40,59,-19,2,4,0,0
"16226","NYR","PIT",2015030141,16904,20152016,0,60,2,5,-3,5.88421377194106,7.06504608500599,-1.18083231306492,37,31,6,56,46,10,78,56,22,4,5,0,0
"16227","NYR","PIT",2015030142,16907,20152016,0,60,4,2,2,3.04206700958841,3.80064760605455,-0.758580596466146,28,31,-3,33,41,-8,50,59,-9,5,7,0,0
"16228","NYR","PIT",2015030143,16910,20152016,1,60,1,3,-2,3.57391305977944,4.0553224452399,-0.481409385460459,17,31,-14,27,39,-12,42,58,-16,5,5,0,0
"16229","NYR","PIT",2015030144,16912,20152016,1,60,0,5,-5,4.365989676764,2.65941857040161,1.70657110636239,31,32,-1,56,44,12,71,56,15,5,6,0,0
"16230","NYR","PIT",2015030145,16914,20152016,0,60,3,6,-3,3.93375172131346,2.75343884719769,1.18031287411577,41,28,13,50,36,14,69,48,21,4,3,0,0
"16231","NYR","NYI",2016020006,17087,20162017,1,60,5,3,2,6.22053082119237,4.34621846571099,1.87431235548138,39,28,11,54,42,12,73,58,15,5,3,0,0
"16232","NYR","STL",2016020025,17089,20162017,0,60,2,3,-1,3.19341923319551,1.49375813372899,1.69966109946652,35,18,17,49,23,26,62,30,32,2,5,0,0
"16233","NYR","S.J",2016020033,17091,20162017,1,60,7,4,3,4.95165853719664,7.18930328544229,-2.23764474824566,29,31,-2,37,43,-6,44,61,-17,4,5,0,0
"16234","NYR","DET",2016020049,17093,20162017,1,60,1,2,-1,5.79359222182757,1.29329391522151,4.50029830660606,33,18,15,54,30,24,74,44,30,4,4,0,0
"16235","NYR","WSH",2016020071,17096,20162017,0,60,4,2,2,3.61636460066438,2.58376208374827,1.03260251691611,26,28,-2,35,37,-2,48,52,-4,3,2,0,0
"16236","NYR","ARI",2016020079,17097,20162017,1,60,3,2,1,3.87741462979466,4.7717138852604,-0.894299255465739,26,29,-3,42,41,1,50,69,-19,2,1,0,0
"16237","NYR","BOS",2016020095,17100,20162017,1,60,5,2,3,5.22552753775381,4.8256770535445,0.39985048420931,31,29,2,43,36,7,61,44,17,7,2,0,0
"16238","NYR","CAR",2016020108,17102,20162017,0,60,2,3,-1,4.91276690707309,2.96974159191359,1.9430253151595,30,21,9,43,32,11,55,46,9,2,1,0,0
"16239","NYR","T.B",2016020127,17104,20162017,1,60,6,1,5,4.50930415249331,5.28117969620507,-0.771875543711758,37,32,5,53,45,8,70,60,10,5,4,0,0
"16240","NYR","STL",2016020132,17106,20162017,1,60,5,0,5,4.1541816310633,4.90051852354327,-0.746336892479974,29,35,-6,39,47,-8,51,65,-14,7,3,0,0
"16241","NYR","EDM",2016020148,17108,20162017,1,60,5,3,2,6.8195730409825,3.15671212872394,3.66286091225857,31,24,7,43,32,11,54,37,17,3,3,0,0
"16242","NYR","BOS",2016020162,17110,20162017,0,60,5,2,3,4.18626385264048,4.03228977994877,0.15397407269171,24,37,-13,33,53,-20,44,71,-27,3,3,0,0
"16243","NYR","WPG",2016020177,17111,20162017,1,60,5,2,3,1.77005002416485,3.78354447454331,-2.01349445037845,18,26,-8,27,37,-10,37,58,-21,0,2,0,0
"16244","NYR","VAN",2016020184,17113,20162017,1,60,3,5,-2,3.84488317283109,3.49402830326402,0.350854869567069,26,29,-3,38,31,7,52,41,11,5,2,0,0
"16245","NYR","CGY",2016020222,17117,20162017,0,60,4,1,3,3.68647654976485,5.64095421411912,-1.95447766435427,28,36,-8,41,46,-5,49,70,-21,2,3,0,0
"16246","NYR","EDM",2016020228,17118,20162017,0,60,3,1,2,3.81661466159846,4.86535887967693,-1.04874421807847,27,39,-12,30,55,-25,40,77,-37,0,2,0,0
"16247","NYR","VAN",2016020241,17120,20162017,0,60,7,2,5,3.95186269224561,5.52878410817721,-1.5769214159316,25,38,-13,33,51,-18,39,72,-33,3,4,0,0
"16248","NYR","CBJ",2016020257,17123,20162017,0,60,2,4,-2,3.44383162329905,3.20410818095388,0.239723442345166,27,24,3,38,38,0,50,52,-2,2,2,0,0
"16249","NYR","FLA",2016020272,17125,20162017,1,65,2,2,0,3.59791397835943,3.78307800499442,-0.185164026634993,35,30,5,38,39,-1,46,60,-14,3,4,0,0
"16250","NYR","PIT",2016020277,17126,20162017,0,60,5,2,3,6.25858576278551,4.73357716660394,1.52500859618158,36,31,5,44,38,6,50,54,-4,3,4,0,0
"16251","NYR","PIT",2016020290,17128,20162017,1,60,1,6,-5,3.32507979350225,5.22720898553962,-1.90212919203736,17,38,-21,29,52,-23,43,71,-28,4,2,0,0
"16252","NYR","PHI",2016020302,17130,20162017,0,60,3,2,1,3.43927517614793,3.4075585914145,0.0317165847334309,23,42,-19,28,51,-23,39,78,-39,2,1,0,0
"16253","NYR","OTT",2016020326,17132,20162017,1,60,0,2,-2,6.11554343727767,5.23635699012084,0.879186447156826,33,20,13,48,30,18,71,51,20,5,3,0,0
"16254","NYR","CAR",2016020330,17134,20162017,1,60,3,2,1,2.44027676883661,3.34324220840335,-0.902965439566742,21,28,-7,32,38,-6,47,60,-13,4,3,0,0
"16255","NYR","BUF",2016020346,17136,20162017,0,60,3,4,-1,3.24694109757547,8.23208792431979,-4.98514682674431,25,34,-9,39,50,-11,48,71,-23,2,2,0,0
"16256","NYR","CAR",2016020360,17138,20162017,1,60,4,2,2,3.55807560409482,3.83405630156631,-0.275980697471482,23,28,-5,31,36,-5,46,57,-11,2,3,0,0
"16257","NYR","NYI",2016020384,17141,20162017,0,60,2,4,-2,5.26658647094155,4.13344988517443,1.13313658576712,38,32,6,49,38,11,77,44,33,5,2,0,0
"16258","NYR","WPG",2016020401,17143,20162017,0,60,2,1,1,3.24379133107141,2.53363646229263,0.710154868778773,24,18,6,32,26,6,47,36,11,4,3,0,0
"16259","NYR","CHI",2016020409,17144,20162017,0,60.9166666666667,1,0,1,5.07645815790238,1.79995304747717,3.27650511042521,37,26,11,46,33,13,62,54,8,2,1,0,0
"16260","NYR","N.J",2016020426,17146,20162017,1,60,5,0,5,5.29760428297368,3.99252716638148,1.3050771165922,31,19,12,44,27,17,60,41,19,6,5,0,0
"16261","NYR","CHI",2016020433,17148,20162017,1,60,1,2,-1,4.57296912994934,4.57485886593349,-0.00188973598415032,34,26,8,51,39,12,62,58,4,1,2,0,0
"16262","NYR","DAL",2016020452,17150,20162017,0,60,2,0,2,5.14848685658674,4.33069297541806,0.817793881168683,30,27,3,43,47,-4,56,61,-5,3,6,0,0
"16263","NYR","NSH",2016020468,17152,20162017,0,65,1,1,0,4.1758970891533,7.62096444884082,-3.44506735968753,27,32,-5,43,48,-5,56,65,-9,2,3,0,0
"16264","NYR","N.J",2016020475,17153,20162017,1,65,2,2,0,5.67867706720483,6.23369681334589,-0.555019746141056,27,31,-4,41,48,-7,58,64,-6,2,4,0,0
"16265","NYR","PIT",2016020483,17155,20162017,0,60,2,7,-5,3.6933175035237,5.93951652975193,-2.24619902622823,28,47,-19,34,62,-28,46,71,-25,3,4,0,0
"16266","NYR","MIN",2016020506,17158,20162017,1,60,4,7,-3,5.84658947197022,4.53108527910081,1.31550419286941,35,21,14,51,34,17,73,43,30,2,1,0,0
"16267","NYR","OTT",2016020519,17162,20162017,1,60,4,3,1,5.05542578469758,5.76799546176335,-0.712569677065765,25,36,-11,37,46,-9,48,60,-12,7,7,0,0
"16268","NYR","ARI",2016020543,17164,20162017,0,60,6,3,3,5.98723420696471,2.95424176227061,3.0329924446941,32,21,11,53,38,15,61,50,11,7,3,0,0
"16269","NYR","COL",2016020555,17166,20162017,0,60,6,2,4,7.37912460509688,3.26747197075343,4.11165263434344,37,27,10,45,40,5,52,48,4,5,3,0,0
"16270","NYR","BUF",2016020565,17169,20162017,1,60,1,4,-3,4.55486873372138,3.00734567761538,1.547523056106,25,19,6,40,30,10,52,45,7,1,5,0,0
"16271","NYR","PHI",2016020573,17170,20162017,0,60,5,2,3,8.66682141484387,4.80460005979694,3.86222135504693,28,32,-4,44,41,3,54,63,-9,2,3,0,0
"16272","NYR","CBJ",2016020598,17173,20162017,0,60,5,4,1,6.5642722878838,6.24597368198738,0.318298605896416,34,37,-3,43,50,-7,60,63,-3,3,4,0,0
"16273","NYR","TOR",2016020633,17179,20162017,1,60,2,4,-2,3.07304979465243,5.9331526506503,-2.86010285599787,36,27,9,53,35,18,67,51,16,6,4,0,0
"16274","NYR","MTL",2016020642,17180,20162017,0,60,4,5,-1,5.76241924492206,6.05561605765251,-0.293196812730457,33,32,1,43,40,3,62,58,4,2,2,0,0
"16275","NYR","DAL",2016020663,17183,20162017,1,60,6,7,-1,6.01194860815303,6.36655459103162,-0.354605982878581,40,31,9,51,42,9,71,54,17,3,2,0,0
"16276","NYR","TOR",2016020679,17185,20162017,0,60,5,2,3,5.77992366016159,2.90413854728104,2.87578511288056,41,25,16,56,40,16,65,58,7,5,3,0,0
"16277","NYR","DET",2016020703,17188,20162017,0,61.9333333333333,1,0,1,1.51111411209649,4.08584260160637,-2.57472848950988,19,21,-2,30,39,-9,41,56,-15,4,3,0,0
"16278","NYR","L.A",2016020708,17189,20162017,1,60,3,2,1,2.2763950212975,6.98396539647576,-4.70757037517826,17,38,-21,22,55,-33,35,80,-45,4,3,0,0
"16279","NYR","PHI",2016020725,17191,20162017,1,60,0,2,-2,4.83971050346756,4.13416836591205,0.705542137555511,34,26,8,53,40,13,69,48,21,3,3,0,0
"16280","NYR","CBJ",2016020742,17197,20162017,1,60,4,6,-2,6.91898995939846,3.65298747445922,3.26600248493924,37,26,11,59,29,30,70,42,28,3,2,0,0
"16281","NYR","BUF",2016020758,17199,20162017,0,63.9333333333333,2,1,1,6.73445880392728,6.21445064982219,0.520008154105093,44,37,7,61,57,4,69,65,4,4,4,0,0
"16282","NYR","CGY",2016020786,17202,20162017,1,60,4,3,1,7.53978204279701,8.50561800680589,-0.965835964008875,32,32,0,43,54,-11,56,70,-14,1,1,0,0
"16283","NYR","ANA",2016020791,17204,20162017,1,60,4,1,3,4.84003776675553,6.91830223154102,-2.07826446478549,20,44,-24,31,60,-29,40,83,-43,2,4,0,0
"16284","NYR","NSH",2016020804,17206,20162017,1,60,4,3,1,4.91325873178721,5.99276980303694,-1.07951107124973,30,37,-7,37,52,-15,46,62,-16,1,3,0,0
"16285","NYR","COL",2016020823,17208,20162017,1,60,4,2,2,3.25480205714121,7.12023156528812,-3.86542950814692,30,34,-4,36,42,-6,49,53,-4,3,1,0,0
"16286","NYR","CBJ",2016020834,17210,20162017,0,60,3,2,1,3.27926948532231,3.48595944989584,-0.206689964573534,23,32,-9,36,41,-5,50,58,-8,5,4,0,0
"16287","NYR","NYI",2016020849,17213,20162017,0,60,2,4,-2,2.36260714690434,3.20101367512393,-0.838406528219593,27,23,4,40,32,8,58,52,6,4,3,0,0
"16288","NYR","WSH",2016020869,17216,20162017,1,60,2,1,1,5.40276227192953,4.42578912303052,0.976973148899008,30,32,-2,39,45,-6,53,60,-7,3,3,0,0
"16289","NYR","MTL",2016020883,17218,20162017,1,65,2,2,0,4.95845911560536,4.75792880088557,0.200530314719799,30,28,2,42,42,0,55,52,3,4,3,0,0
"16290","NYR","TOR",2016020894,17220,20162017,0,65,1,1,0,4.30522493299538,6.11232187726921,-1.80709694427383,38,33,5,59,44,15,86,56,30,2,3,0,0
"16291","NYR","N.J",2016020905,17222,20162017,0,61.2666666666667,4,3,1,7.47975650115404,3.85504849084828,3.62470801030577,40,38,2,47,51,-4,60,57,3,1,2,0,0
"16292","NYR","CBJ",2016020914,17223,20162017,1,60,2,5,-3,3.82546846960048,3.32431997053166,0.501148499068822,30,26,4,45,34,11,65,49,16,2,3,0,0
"16293","NYR","WSH",2016020924,17225,20162017,1,60,1,4,-3,4.24332035413109,4.29586559523113,-0.0525452411000398,30,38,-8,43,47,-4,54,65,-11,4,2,0,0
"16294","NYR","BOS",2016020936,17227,20162017,0,60,2,1,1,2.72188847997859,6.25568702679892,-3.53379854682033,21,33,-12,33,49,-16,44,63,-19,4,2,0,0
"16295","NYR","MTL",2016020956,17229,20162017,1,60,1,4,-3,4.74854974495247,3.25347089505522,1.49507884989725,27,35,-8,38,49,-11,49,60,-11,1,2,0,0
"16296","NYR","T.B",2016020971,17231,20162017,0,63.9333333333333,1,0,1,5.18505138243199,4.46924016363019,0.715811218801804,34,38,-4,43,53,-10,47,66,-19,5,7,0,0
"16297","NYR","FLA",2016020976,17232,20162017,0,60,5,2,3,5.28074121601639,6.83531769003275,-1.55457647401636,28,45,-17,45,58,-13,52,73,-21,4,5,0,0
"16298","NYR","CAR",2016020985,17234,20162017,0,60,3,4,-1,11.1865821151277,4.04665104934247,7.13993106578528,43,30,13,57,38,19,71,50,21,5,4,0,0
"16299","NYR","DET",2016021011,17237,20162017,0,60,4,1,3,2.85898183134287,4.07212159235496,-1.21313976101209,31,24,7,36,40,-4,43,47,-4,2,4,0,0
"16300","NYR","T.B",2016021017,17238,20162017,1,60,2,3,-1,4.43574369447015,4.33818793507817,0.0975557593919802,28,16,12,41,30,11,55,40,15,1,2,0,0
"16301","NYR","FLA",2016021049,17242,20162017,1,65,3,3,0,3.88443603807291,4.12553065285232,-0.241094614779407,32,37,-5,44,46,-2,61,61,0,5,4,0,0
"16302","NYR","MIN",2016021059,17243,20162017,0,60,3,2,1,5.75935742725812,2.71098825134007,3.04836917591805,30,27,3,35,36,-1,51,52,-1,4,4,0,0
"16303","NYR","N.J",2016021077,17246,20162017,0,64.0833333333333,2,3,-1,6.9039228373731,4.70757880131714,2.19634403605596,40,29,11,57,35,22,68,41,27,2,3,0,0
"16304","NYR","NYI",2016021087,17247,20162017,1,60,2,3,-1,6.90462839030897,3.31787803690946,3.58675035339951,36,28,8,57,38,19,71,53,18,5,4,0,0
"16305","NYR","L.A",2016021116,17250,20162017,0,60,3,0,3,4.61255112994695,3.67993048328208,0.932620646664873,20,30,-10,31,52,-21,41,70,-29,3,4,0,0
"16306","NYR","ANA",2016021121,17251,20162017,0,60,3,6,-3,4.6997235461828,5.03219368845243,-0.332470142269631,28,34,-6,46,43,3,62,56,6,2,3,0,0
"16307","NYR","S.J",2016021136,17253,20162017,0,63.1666666666667,4,5,-1,3.50516697851208,3.85436969254448,-0.349202714032401,28,35,-7,44,56,-12,61,72,-11,4,3,0,0
"16308","NYR","PIT",2016021150,17256,20162017,1,65,3,3,0,4.63046837547881,5.90157512545557,-1.27110674997675,33,35,-2,47,49,-2,69,67,2,2,3,0,0
"16309","NYR","PHI",2016021173,17258,20162017,1,60,4,3,1,3.74615758865806,2.59218603319641,1.15397155546165,24,23,1,36,30,6,41,45,-4,4,3,0,0
"16310","NYR","WSH",2016021193,17261,20162017,0,60,0,2,-2,5.92135782862535,4.17593039579879,1.74542743282656,24,25,-1,36,38,-2,45,52,-7,2,4,0,0
"16311","NYR","OTT",2016021207,17264,20162017,0,60,1,3,-2,3.96931417065207,3.75129918038147,0.218014990270603,19,33,-14,31,45,-14,43,56,-13,3,4,0,0
"16312","NYR","PIT",2016021226,17265,20162017,1,60,3,2,1,3.39331157389097,4.56516339682275,-1.17185182293179,25,24,1,38,35,3,50,57,-7,1,0,0,0
"16313","NYR","MTL",2016030111,17268,20162017,0,60,2,0,2,7.44652538167429,4.24117445062389,3.2053509310504,31,31,0,42,44,-2,60,68,-8,5,4,0,0
"16314","NYR","MTL",2016030112,17270,20162017,0,78.5666666666667,3,4,-1,9.36659133075032,11.3988286334953,-2.03223730274496,38,58,-20,52,75,-23,69,103,-34,4,5,0,0
"16315","NYR","MTL",2016030113,17272,20162017,1,60,1,3,-2,3.04084018742287,3.8819652623949,-0.841125074972027,21,29,-8,32,38,-6,47,51,-4,3,2,0,0
"16316","NYR","MTL",2016030114,17274,20162017,1,60,2,1,1,2.98197359960917,3.47664267523214,-0.494669075622973,32,24,8,42,37,5,60,50,10,2,3,0,0
"16317","NYR","MTL",2016030115,17276,20162017,0,74.3666666666667,3,2,1,5.07459774739436,4.79995194361052,0.274645803783848,36,36,0,44,52,-8,72,80,-8,2,4,0,0
"16318","NYR","MTL",2016030116,17278,20162017,1,60,3,1,2,6.55723771464545,3.69061720406171,2.86662051058374,23,28,-5,37,40,-3,51,67,-16,2,4,0,0
"16319","NYR","OTT",2016030211,17283,20162017,0,60,1,2,-1,6.54295077714869,6.0297796443695,0.513171132779192,35,43,-8,48,52,-4,64,69,-5,4,4,0,0
"16320","NYR","OTT",2016030212,17285,20162017,0,80,5,5,0,5.12293386365127,6.66045033161333,-1.53751646796206,47,32,15,62,53,9,81,77,4,5,5,0,0
"16321","NYR","OTT",2016030213,17288,20162017,1,60,4,1,3,3.15800570969168,4.16546391884913,-1.00745820915745,30,27,3,45,35,10,56,54,2,4,4,0,0
"16322","NYR","OTT",2016030214,17290,20162017,1,60,4,1,3,6.05856588498681,5.91554630127393,0.143019583712872,30,23,7,46,35,11,58,57,1,13,8,0,0
"16323","NYR","OTT",2016030215,17292,20162017,0,66.4666666666667,4,5,-1,8.28830766771137,6.74935198325358,1.5389556844578,33,37,-4,43,52,-9,54,79,-25,5,5,0,0
"16324","NYR","OTT",2016030216,17295,20162017,1,60,2,4,-2,4.35705055071422,3.57018666813725,0.786863882576962,39,26,13,52,35,17,72,42,30,3,2,0,0
"16325","NYR","COL",2017020007,17444,20172018,1,60,2,4,-2,4.76856246689269,3.75945794093423,1.00910452595846,39,26,13,54,35,19,69,44,25,8,6,0,0
"16326","NYR","TOR",2017020016,17446,20172018,0,60,5,8,-3,5.27370717749,6.13799370935885,-0.864286531868856,35,42,-7,49,57,-8,56,75,-19,3,6,0,0
"16327","NYR","MTL",2017020031,17447,20172018,1,60,2,0,2,3.27319899032591,5.49860945219064,-2.22541046186473,25,34,-9,34,46,-12,43,63,-20,3,1,0,0
"16328","NYR","STL",2017020039,17449,20172018,1,60,1,3,-2,3.83453977693352,4.64806629810482,-0.813526521171298,33,23,10,43,32,11,63,42,21,4,4,0,0
"16329","NYR","CBJ",2017020059,17452,20172018,0,60,1,3,-2,4.14369640917019,4.02309452676005,0.120601882410139,38,43,-5,43,56,-13,56,70,-14,5,4,0,0
"16330","NYR","N.J",2017020065,17453,20172018,1,60,2,3,-1,2.96255969116328,4.48161703131575,-1.51905734015247,31,19,12,44,36,8,64,47,17,4,6,0,0
"16331","NYR","PIT",2017020082,17456,20172018,1,60.9666666666667,4,5,-1,3.99105630544066,6.34511350833965,-2.35405720289899,32,33,-1,46,39,7,63,50,13,7,5,0,0
"16332","NYR","NYI",2017020096,17458,20172018,1,65,3,3,0,6.66092594782822,6.32830249074323,0.332623457084992,41,38,3,54,47,7,63,61,2,1,3,0,0
"16333","NYR","NSH",2017020110,17460,20172018,1,60,4,2,2,4.82101407786831,2.83871416098947,1.98229991687885,15,25,-10,22,44,-22,38,62,-24,6,6,0,0
"16334","NYR","S.J",2017020124,17462,20172018,1,60,1,4,-3,4.96316591763753,2.99765735885923,1.96550855877829,34,24,10,48,29,19,59,36,23,6,1,0,0
"16335","NYR","ARI",2017020140,17465,20172018,1,60,5,2,3,5.04590489777456,4.62889575765879,0.417009140115773,30,29,1,45,37,8,59,50,9,3,3,0,0
"16336","NYR","MTL",2017020158,17467,20172018,0,60,4,5,-1,4.08292441873496,4.72605076070977,-0.643126341974806,26,43,-17,41,57,-16,61,71,-10,5,6,0,0
"16337","NYR","VGK",2017020178,17470,20172018,1,60,6,4,2,5.84573624184122,2.91652445117143,2.9292117906698,38,34,4,52,45,7,66,58,8,5,4,0,0
"16338","NYR","T.B",2017020189,17472,20172018,0,61.3166666666667,2,1,1,3.44414605517522,3.83634986839024,-0.392203813215019,35,28,7,41,45,-4,52,60,-8,3,3,0,0
"16339","NYR","FLA",2017020203,17474,20172018,0,61.1333333333333,5,4,1,7.7951113898439,6.03850658527226,1.75660480457164,44,34,10,53,43,10,64,59,5,3,2,0,0
"16340","NYR","CBJ",2017020219,17476,20172018,1,60,5,3,2,4.00465496444667,3.35316374138215,0.651491223064522,26,25,1,36,37,-1,48,53,-5,5,1,0,0
"16341","NYR","BOS",2017020233,17478,20172018,1,60,4,2,2,3.93583512193784,5.867400399904,-1.93156527796616,33,33,0,43,47,-4,56,68,-12,1,4,0,0
"16342","NYR","EDM",2017020249,17481,20172018,1,60,4,2,2,5.88212750229286,5.48396232438972,0.398165177903138,34,29,5,42,43,-1,48,54,-6,3,2,0,0
"16343","NYR","CHI",2017020276,17485,20172018,0,60,3,6,-3,5.45600587294877,5.72809901530854,-0.272093142359779,28,43,-15,41,53,-12,55,63,-8,2,5,0,0
"16344","NYR","CBJ",2017020290,17487,20172018,0,60,0,2,-2,5.46422555290337,6.16645902216416,-0.70223346926079,36,42,-6,49,52,-3,64,63,1,3,3,0,0
"16345","NYR","OTT",2017020307,17489,20172018,1,60,3,0,3,4.19928207757675,4.24963495184757,-0.0503528742708115,27,20,7,40,33,7,57,60,-3,3,2,0,0
"16346","NYR","CAR",2017020326,17492,20172018,0,60,6,1,5,6.18067962917848,2.58261299399601,3.59806663518248,27,33,-6,42,49,-7,48,67,-19,2,5,0,0
"16347","NYR","DET",2017020341,17494,20172018,1,60.6166666666667,2,1,1,2.93361627752893,5.58720574112249,-2.65358946359357,31,41,-10,42,61,-19,65,76,-11,2,4,0,0
"16348","NYR","VAN",2017020360,17496,20172018,1,65,3,3,0,5.81057742654957,4.34604049143672,1.46453693511285,20,32,-12,33,43,-10,49,63,-14,2,1,0,0
"16349","NYR","FLA",2017020369,17498,20172018,1,60,4,5,-1,4.89501739357365,4.55697981137928,0.338037582194374,37,27,10,54,36,18,69,48,21,4,3,0,0
"16350","NYR","CAR",2017020390,17501,20172018,1,60,5,1,4,6.05701453883376,4.17154715846203,1.88546738037172,26,33,-7,37,45,-8,54,60,-6,7,3,0,0
"16351","NYR","PIT",2017020416,17505,20172018,0,60,4,3,1,5.43032193637927,7.44332183146616,-2.01299989508689,29,44,-15,33,59,-26,50,76,-26,2,3,0,0
"16352","NYR","WSH",2017020440,17508,20172018,0,60,2,4,-2,2.33846921502258,3.4113981203908,-1.07292890536822,29,40,-11,40,51,-11,55,67,-12,3,4,0,0
"16353","NYR","N.J",2017020449,17509,20172018,1,60,5,2,3,3.06778799598876,5.81460207968419,-2.74681408369544,39,28,11,43,40,3,59,58,1,4,4,0,0
"16354","NYR","DAL",2017020461,17511,20172018,1,65,1,1,0,5.5798898018877,4.35809839043941,1.22179141144829,25,45,-20,34,63,-29,45,90,-45,0,3,0,0
"16355","NYR","OTT",2017020475,17513,20172018,0,60,2,3,-1,4.31621500819256,6.51079331245273,-2.19457830426018,29,30,-1,39,39,0,53,48,5,1,2,0,0
"16356","NYR","L.A",2017020493,17515,20172018,1,60,4,2,2,3.50930754165165,6.11957261304938,-2.61026507139773,28,35,-7,36,48,-12,50,73,-23,3,1,0,0
"16357","NYR","BOS",2017020497,17516,20172018,0,61.9333333333333,3,2,1,2.10634479147953,4.95083770028123,-2.84449290880169,28,35,-7,40,55,-15,46,71,-25,5,7,0,0
"16358","NYR","ANA",2017020519,17519,20172018,1,60,4,1,3,4.2226068144555,4.53154313145933,-0.308936317003827,32,40,-8,43,48,-5,49,64,-15,2,2,0,0
"16359","NYR","N.J",2017020530,17521,20172018,0,65,3,3,0,3.09036619787512,4.53842901393728,-1.44806281606216,28,48,-20,40,58,-18,49,72,-23,3,4,0,0
"16360","NYR","TOR",2017020548,17523,20172018,1,60,2,3,-1,3.93876125380884,6.21981222041359,-2.28105096660475,32,37,-5,39,46,-7,53,62,-9,5,8,0,0
"16361","NYR","WSH",2017020561,17527,20172018,1,65,0,0,0,5.12304613571719,2.11173712947332,3.01130900624387,37,30,7,52,35,17,64,54,10,3,2,0,0
"16362","NYR","DET",2017020578,17529,20172018,0,65,2,2,0,7.76639141885437,4.41538933731499,3.35100208153938,39,35,4,50,41,9,62,49,13,5,5,0,0
"16363","NYR","BUF",2017020601,17532,20172018,0,62.7166666666667,3,2,1,4.2153693123862,4.57792146055499,-0.362552148168788,42,33,9,50,48,2,61,58,3,3,5,0,0
"16364","NYR","CHI",2017020615,17534,20172018,1,60,2,5,-3,4.48571190040093,7.02978547863474,-2.54407357823381,25,35,-10,41,48,-7,58,70,-12,6,1,0,0
"16365","NYR","ARI",2017020639,17537,20172018,0,65,1,1,0,0,0,0,25,39,-14,39,53,-14,53,67,-14,1,2,0,0
"16366","NYR","VGK",2017020651,17538,20172018,0,60,1,2,-1,7.46202193619683,3.70847037748899,3.75355155870784,29,34,-5,42,40,2,51,64,-13,2,1,0,0
"16367","NYR","NYI",2017020670,17544,20172018,1,60,2,7,-5,4.90226858342157,4.7021143431848,0.20015424023677,39,37,2,57,52,5,78,66,12,3,2,0,0
"16368","NYR","PIT",2017020679,17545,20172018,0,60,2,5,-3,3.4889077109347,5.2906639794528,-1.8017562685181,28,47,-19,34,54,-20,41,65,-24,1,3,0,0
"16369","NYR","PHI",2017020689,17547,20172018,1,60,5,1,4,3.90634483715985,6.09178633798001,-2.18544150082016,29,26,3,34,38,-4,40,51,-11,2,3,0,0
"16370","NYR","BUF",2017020697,17549,20172018,1,60,4,3,1,3.7903106375461,6.56952721572634,-2.77921657818024,34,37,-3,47,51,-4,61,70,-9,4,6,0,0
"16371","NYR","COL",2017020710,17551,20172018,0,60,1,3,-2,5.77398205251666,8.26631381078914,-2.49233175827248,28,37,-9,36,46,-10,50,66,-16,1,1,0,0
"16372","NYR","L.A",2017020725,17552,20172018,0,60,2,4,-2,4.50763864540204,6.34856823351583,-1.8409295881138,23,30,-7,35,40,-5,46,56,-10,4,3,0,0
"16373","NYR","ANA",2017020742,17554,20172018,0,60,3,6,-3,7.30841764171811,6.37711475940887,0.931302882309238,44,31,13,52,47,5,56,56,0,3,6,0,0
"16374","NYR","S.J",2017020760,17556,20172018,0,60,6,5,1,3.86747606870046,6.25433102695388,-2.38685495825342,29,28,1,37,51,-14,50,62,-12,3,1,0,0
"16375","NYR","TOR",2017020779,17563,20172018,1,60,0,4,-4,2.43690780243924,6.98251789842709,-4.54561009598785,25,32,-7,38,43,-5,44,63,-19,3,1,0,0
"16376","NYR","NSH",2017020800,17565,20172018,0,60,2,5,-3,2.69692513647385,4.22729865039582,-1.53037351392197,22,28,-6,24,44,-20,38,54,-16,4,6,0,0
"16377","NYR","DAL",2017020810,17567,20172018,0,60,1,2,-1,6.82475456834072,5.20279159935308,1.62196296898765,32,41,-9,42,57,-15,55,85,-30,3,5,0,0
"16378","NYR","BOS",2017020824,17569,20172018,1,60,1,6,-5,3.09168625750681,7.92021757053044,-4.82853131302363,22,34,-12,30,48,-18,44,59,-15,2,2,0,0
"16379","NYR","CGY",2017020836,17571,20172018,1,60,4,3,1,5.99337214973146,5.10501514902221,0.888357000709249,36,38,-2,48,53,-5,56,72,-16,5,6,0,0
"16380","NYR","WPG",2017020854,17573,20172018,0,60,3,1,2,4.33590534038376,4.86156404271099,-0.525658702327227,28,38,-10,44,50,-6,56,69,-13,4,4,0,0
"16381","NYR","MIN",2017020872,17575,20172018,0,60,2,3,-1,3.5937849306938,3.44139298609662,0.152391944597184,34,29,5,43,34,9,57,44,13,4,2,0,0
"16382","NYR","NYI",2017020880,17577,20172018,0,60,0,3,-3,4.89299776748521,4.43299062107859,0.460007146406619,50,35,15,63,43,20,79,55,24,3,2,0,0
"16383","NYR","OTT",2017020895,17579,20172018,0,60,3,6,-3,6.56548079507775,3.43903389258776,3.12644690248999,38,33,5,53,42,11,71,57,14,2,2,0,0
"16384","NYR","PHI",2017020905,17580,20172018,1,60,4,7,-3,5.02941932682563,4.2610782803531,0.768341046472525,40,37,3,45,45,0,54,61,-7,0,1,0,0
"16385","NYR","MTL",2017020933,17584,20172018,0,60,1,3,-2,6.88368782717378,5.5634567785263,1.32023104864747,32,41,-9,49,51,-2,63,75,-12,4,5,0,0
"16386","NYR","MIN",2017020941,17585,20172018,1,60,1,4,-3,0,0,0,23,37,-14,33,48,-15,46,57,-11,1,1,0,0
"16387","NYR","DET",2017020960,17587,20172018,1,64.9,2,3,-1,5.10894582749461,6.1644486477453,-1.05550282025069,38,34,4,58,46,12,75,61,14,2,3,0,0
"16388","NYR","VAN",2017020982,17590,20172018,0,61.3666666666667,6,5,1,3.90130285522901,6.56607750849798,-2.66477465326898,27,55,-28,36,66,-30,44,81,-37,2,3,0,0
"16389","NYR","CGY",2017020996,17592,20172018,0,60,3,1,2,3.10327855499236,7.54707201528608,-4.44379346029372,27,51,-24,41,71,-30,48,87,-39,3,3,0,0
"16390","NYR","EDM",2017021007,17593,20172018,0,60,3,2,1,7.59459415235324,8.28436667635879,-0.689772524005548,34,37,-3,41,50,-9,58,63,-5,3,2,0,0
"16391","NYR","WPG",2017021022,17596,20172018,1,60,0,3,-3,5.12414363393327,3.61044710372153,1.51369653021175,31,34,-3,46,45,1,60,63,-3,2,1,0,0
"16392","NYR","T.B",2017021037,17598,20172018,0,60,3,5,-2,3.04191783649185,6.2015839209198,-3.15966608442795,30,45,-15,40,56,-16,50,72,-22,3,4,0,0
"16393","NYR","FLA",2017021056,17600,20172018,0,65,3,3,0,2.27664272777508,6.80980646068929,-4.5331637329142,37,35,2,46,54,-8,58,62,-4,1,2,0,0
"16394","NYR","CAR",2017021063,17602,20172018,1,60,6,3,3,4.57944844319718,4.58160226499604,-0.00215382179885637,23,44,-21,34,56,-22,41,86,-45,3,3,0,0
"16395","NYR","PIT",2017021079,17604,20172018,1,62.8833333333333,4,3,1,5.75712085658762,6.68514364515431,-0.928022788566691,33,40,-7,45,52,-7,57,63,-6,3,4,0,0
"16396","NYR","STL",2017021105,17607,20172018,0,61.0333333333333,3,4,-1,2.53974165173713,6.50090445535978,-3.96116280362265,20,33,-13,26,47,-21,43,62,-19,2,3,0,0
"16397","NYR","CBJ",2017021122,17610,20172018,1,60,3,5,-2,2.85876600611805,5.41095128975576,-2.55218528363771,32,31,1,43,51,-8,67,63,4,4,2,0,0
"16398","NYR","PHI",2017021137,17612,20172018,0,60,3,4,-1,5.2217229564759,5.96123148565675,-0.739508529180853,36,36,0,52,48,4,73,58,15,3,3,0,0
"16399","NYR","BUF",2017021159,17614,20172018,1,60,5,1,4,4.33005463694099,6.06266118183254,-1.73260654489155,23,44,-21,37,60,-23,47,67,-20,3,3,0,0
"16400","NYR","WSH",2017021170,17616,20172018,1,60,2,4,-2,3.87591842433903,3.86212897232582,0.0137894520132136,30,33,-3,47,38,9,62,47,15,4,3,0,0
"16401","NYR","WSH",2017021187,17618,20172018,0,60.6333333333333,2,3,-1,5.40860257554414,2.44314276018822,2.96545981535591,37,33,4,51,47,4,63,62,1,6,5,0,0
"16402","NYR","T.B",2017021201,17620,20172018,1,60,3,7,-4,4.69048527732957,7.62525904721406,-2.93477376988449,31,50,-19,38,63,-25,49,72,-23,6,6,0,0
"16403","NYR","CAR",2017021212,17621,20172018,0,60,2,1,1,2.17197300947737,7.28083954239992,-5.10886653292255,20,41,-21,28,64,-36,38,84,-46,1,3,0,0
"16404","NYR","N.J",2017021229,17624,20172018,0,60,2,5,-3,4.54126644874478,7.53750681759534,-2.99624036885056,24,44,-20,40,55,-15,49,67,-18,3,6,0,0
"16405","NYR","NYI",2017021242,17626,20172018,0,60,1,2,-1,5.28115025406078,0.954111258910054,4.32703899515072,35,22,13,44,34,10,61,44,17,3,2,0,0
"16406","NYR","PHI",2017021257,17628,20172018,0,60,0,5,-5,2.16413391253445,5.79842472403618,-3.63429081150173,17,40,-23,31,47,-16,49,61,-12,2,3,0,0
"16407","NYR","NSH",2018020006,17808,20182019,1,60,2,3,-1,7.23326832949533,5.25826280668844,1.9750055228069,36,33,3,47,41,6,58,61,-3,3,3,0,0
"16408","NYR","BUF",2018020017,17810,20182019,0,60,1,3,-2,4.61071382071077,4.79084119089703,-0.180127370186256,44,29,15,55,45,10,68,58,10,5,6,0,0
"16409","NYR","CAR",2018020029,17811,20182019,0,60,5,8,-3,3.04815547388197,5.67288996950083,-2.62473449561886,24,40,-16,35,61,-26,51,74,-23,5,6,0,0
"16410","NYR","S.J",2018020049,17815,20182019,1,60.6166666666667,3,2,1,4.45672125794772,4.96928445865977,-0.512563200712053,27,43,-16,37,61,-24,50,81,-31,3,4,0,0
"16411","NYR","EDM",2018020057,17817,20182019,1,60,1,2,-1,3.35306050513464,2.2459122731525,1.10714823198214,24,27,-3,37,40,-3,51,55,-4,2,4,0,0
"16412","NYR","COL",2018020079,17820,20182019,1,65,2,2,0,5.96274702501887,3.81317558327623,2.14957144174264,43,33,10,53,47,6,76,64,12,5,3,0,0
"16413","NYR","WSH",2018020087,17821,20182019,0,62.3,3,4,-1,5.75858757996684,3.29722662889311,2.46136095107374,32,38,-6,44,48,-4,54,65,-11,4,4,0,0
"16414","NYR","CGY",2018020115,17825,20182019,1,60,1,4,-3,6.10062108849885,3.57598458181383,2.52463650668502,45,26,19,57,35,22,77,51,26,3,3,0,0
"16415","NYR","FLA",2018020122,17827,20182019,1,60,5,2,3,5.01978706464082,4.28669872908563,0.733088335555192,22,38,-16,31,46,-15,48,64,-16,6,4,0,0
"16416","NYR","CHI",2018020139,17829,20182019,0,60,1,4,-3,2.53519501560368,5.01568352458438,-2.48048850898071,19,37,-18,31,48,-17,42,67,-25,2,4,0,0
"16417","NYR","L.A",2018020159,17832,20182019,0,60,3,4,-1,6.3470583192684,5.24144685361534,1.10561146565306,25,40,-15,37,51,-14,51,70,-19,3,4,0,0
"16418","NYR","S.J",2018020177,17834,20182019,0,65,3,3,0,3.27113022807264,6.35048124432797,-3.07935101625533,37,34,3,48,49,-1,63,65,-2,4,2,0,0
"16419","NYR","ANA",2018020189,17836,20182019,0,65,2,2,0,4.85010488196531,3.87079465188628,0.979310230079027,24,30,-6,39,40,-1,55,53,2,3,3,0,0
"16420","NYR","BUF",2018020208,17839,20182019,1,60,3,1,2,5.17591216659639,5.42079773626756,-0.244885569671169,22,40,-18,34,55,-21,43,72,-29,1,4,0,0
"16421","NYR","MTL",2018020216,17841,20182019,1,60,5,3,2,3.55553497246807,4.40173690444317,-0.846201931975097,32,34,-2,41,46,-5,57,60,-3,8,9,0,0
"16422","NYR","DET",2018020238,17844,20182019,0,64.9,2,3,-1,4.82418429841346,2.76000618451924,2.06417811389422,30,31,-1,45,47,-2,49,62,-13,3,2,0,0
"16423","NYR","CBJ",2018020251,17845,20182019,0,65,4,4,0,0.829962076502852,4.62614279609988,-3.79618071959703,19,38,-19,28,49,-21,41,65,-24,2,2,0,0
"16424","NYR","VAN",2018020260,17847,20182019,1,60,2,1,1,3.56839052212979,3.89955177434604,-0.331161252216248,27,26,1,32,41,-9,46,56,-10,6,4,0,0
"16425","NYR","NYI",2018020277,17850,20182019,0,60,5,7,-2,4.10409726636677,3.44928231497564,0.654814951391139,41,24,17,50,27,23,64,41,23,4,4,0,0
"16426","NYR","FLA",2018020296,17852,20182019,1,60,4,2,2,2.80031300302471,4.39476539449242,-1.59445239146771,24,41,-17,34,58,-24,47,79,-32,3,4,0,0
"16427","NYR","DAL",2018020309,17854,20182019,1,60,2,1,1,4.77351615051157,1.99226983324201,2.78124631726956,23,17,6,29,27,2,40,45,-5,2,4,0,0
"16428","NYR","NYI",2018020320,17856,20182019,1,60,5,0,5,3.99339802699285,3.65095358794497,0.342444439047881,27,29,-2,34,46,-12,51,70,-19,4,2,0,0
"16429","NYR","PHI",2018020332,17858,20182019,0,60,0,4,-4,6.55339494203413,6.48719986296745,0.0661950790666825,31,46,-15,39,58,-19,49,77,-28,3,1,0,0
"16430","NYR","WSH",2018020347,17859,20182019,1,60,3,5,-2,5.31707420968138,4.47408708523809,0.84298712444329,30,28,2,36,46,-10,47,54,-7,2,2,0,0
"16431","NYR","OTT",2018020365,17861,20182019,1,60,4,2,2,4.27851463621114,3.48828253895329,0.790232097257848,33,31,2,41,39,2,62,49,13,5,3,0,0
"16432","NYR","OTT",2018020384,17864,20182019,0,60,0,3,-3,4.22191477190063,5.84874734299228,-1.62683257109165,27,34,-7,38,49,-11,50,58,-8,0,1,0,0
"16433","NYR","MTL",2018020398,17866,20182019,0,60,2,5,-3,3.71096211702024,6.47644574126856,-2.76548362424832,22,41,-19,38,52,-14,53,62,-9,3,3,0,0
"16434","NYR","WPG",2018020408,17867,20182019,1,65,3,3,0,4.97799934407385,4.86640572617762,0.111593617896233,19,42,-23,28,54,-26,43,66,-23,2,4,0,0
"16435","NYR","FLA",2018020450,17873,20182019,0,65,4,4,0,3.96196620073377,5.96841979937381,-2.00645359864004,26,31,-5,35,42,-7,50,58,-8,1,4,0,0
"16436","NYR","T.B",2018020463,17875,20182019,0,60,3,6,-3,1.8084376401539,3.94331578076526,-2.13487814061136,26,36,-10,35,53,-18,46,64,-18,1,6,0,0
"16437","NYR","ARI",2018020488,17879,20182019,1,64.4666666666667,3,4,-1,8.54839742484934,5.2315234058799,3.31687401896944,30,34,-4,42,46,-4,52,66,-14,7,5,0,0
"16438","NYR","VGK",2018020505,17881,20182019,1,62.1833333333333,3,4,-1,6.60594577549585,3.48869153515261,3.11725424034324,30,41,-11,44,58,-14,52,82,-30,4,2,0,0
"16439","NYR","ANA",2018020519,17883,20182019,1,60,3,1,2,3.60871031496916,2.50330065766189,1.10540965730727,24,15,9,35,30,5,48,44,4,5,7,0,0
"16440","NYR","TOR",2018020552,17887,20182019,0,60,3,5,-2,5.16738610101515,7.02694185990777,-1.85955575889261,28,36,-8,47,54,-7,59,69,-10,2,2,0,0
"16441","NYR","PHI",2018020561,17888,20182019,1,65,2,2,0,2.68016131892409,4.33874837881021,-1.65858705988612,34,31,3,43,45,-2,53,63,-10,2,2,0,0
"16442","NYR","CBJ",2018020568,17892,20182019,1,60.5166666666667,3,4,-1,3.62315456563374,3.06725231016753,0.555902255466208,22,29,-7,27,37,-10,41,53,-12,1,1,0,0
"16443","NYR","NSH",2018020593,17894,20182019,0,60,4,3,1,5.56574944537967,7.0141023073229,-1.44835286194323,22,37,-15,34,55,-21,41,74,-33,2,5,0,0
"16444","NYR","STL",2018020605,17896,20182019,0,60,2,1,1,2.59974001414889,5.5293743690379,-2.929634354889,23,40,-17,28,56,-28,34,79,-45,3,4,0,0
"16445","NYR","PIT",2018020617,17898,20182019,1,60,2,7,-5,3.70575620788509,2.81503778134356,0.890718426541525,30,25,5,45,30,15,63,42,21,2,2,0,0
"16446","NYR","COL",2018020633,17900,20182019,0,60,1,6,-5,5.63676684259553,6.04976955297267,-0.413002710377136,25,47,-22,32,59,-27,41,78,-37,5,8,0,0
"16447","NYR","ARI",2018020645,17902,20182019,0,60,0,5,-5,6.62611076165922,3.72427065505326,2.90184010660596,23,40,-17,29,51,-22,43,69,-26,1,3,0,0
"16448","NYR","VGK",2018020666,17904,20182019,0,60,2,4,-2,2.35452894767831,3.71112276870299,-1.35659382102468,29,31,-2,41,44,-3,59,53,6,2,3,0,0
"16449","NYR","NYI",2018020673,17906,20182019,1,60,3,4,-1,6.92749849054962,3.96404769422952,2.9634507963201,30,20,10,44,28,16,64,42,22,4,4,0,0
"16450","NYR","NYI",2018020688,17908,20182019,0,60,2,1,1,1.87150472424037,4.38797986403926,-2.51647513979889,26,25,1,32,42,-10,45,51,-6,4,6,0,0
"16451","NYR","CBJ",2018020700,17909,20182019,0,60,5,7,-2,2.64650427096058,7.04724499491158,-4.400740723951,27,40,-13,38,54,-16,50,69,-19,3,5,0,0
"16452","NYR","CAR",2018020712,17911,20182019,1,60,6,2,4,6.34655211858291,5.33460286751506,1.01194925106785,28,36,-8,40,50,-10,53,71,-18,4,4,0,0
"16453","NYR","CHI",2018020728,17913,20182019,1,60,4,3,1,5.07277183735278,2.91438135970384,2.15839047764894,33,27,6,40,33,7,45,47,-2,1,3,0,0
"16454","NYR","BOS",2018020742,17915,20182019,0,60,3,2,1,3.23463967928958,2.47519519313937,0.759444486150205,20,29,-9,25,44,-19,28,56,-28,4,5,0,0
"16455","NYR","PHI",2018020774,17925,20182019,1,60,0,1,-1,5.81037608610632,4.47000494075473,1.34037114535158,38,19,19,47,23,24,66,30,36,2,2,0,0
"16456","NYR","N.J",2018020779,17927,20182019,0,60,4,3,1,4.82300644481517,4.88140655960888,-0.0584001147937041,25,22,3,43,35,8,54,44,10,4,4,0,0
"16457","NYR","T.B",2018020795,17929,20182019,1,60,2,3,-1,4.01705309974204,3.51202603681122,0.505027062930822,33,23,10,42,30,12,56,38,18,4,1,0,0
"16458","NYR","L.A",2018020806,17931,20182019,1,60.4166666666667,3,4,-1,3.35527988147805,2.93310191212311,0.422177969354946,27,30,-3,36,34,2,45,41,4,2,2,0,0
"16459","NYR","BOS",2018020822,17933,20182019,1,65,3,3,0,4.46975342139803,4.05395192496735,0.415801496430678,39,30,9,49,43,6,59,55,4,6,4,0,0
"16460","NYR","CAR",2018020837,17935,20182019,1,60,0,3,-3,4.07138143922202,6.71613832676667,-2.64475688754464,27,33,-6,40,47,-7,50,59,-9,3,3,0,0
"16461","NYR","TOR",2018020859,17937,20182019,1,60,4,1,3,5.41929921687188,7.67313436471522,-2.25383514784335,30,56,-26,38,68,-30,46,86,-40,1,4,0,0
"16462","NYR","WPG",2018020872,17939,20182019,0,60,3,4,-1,4.90237121471151,3.77974041888956,1.12263079582195,37,36,1,47,42,5,62,54,8,4,2,0,0
"16463","NYR","BUF",2018020888,17942,20182019,0,60,6,2,4,3.72168438544031,4.9130555234733,-1.19137113803299,29,33,-4,33,52,-19,41,61,-20,1,4,0,0
"16464","NYR","PIT",2018020904,17944,20182019,0,60,5,6,-1,5.07120571881912,4.76732338091824,0.303882337900873,44,41,3,61,47,14,71,65,6,2,4,0,0
"16465","NYR","CAR",2018020919,17946,20182019,0,60,2,1,1,2.52513622466358,7.93011348396976,-5.40497725930618,26,44,-18,42,70,-28,50,93,-43,4,2,0,0
"16466","NYR","MIN",2018020932,17948,20182019,1,60,1,4,-3,8.33340456709266,6.67000585796859,1.66339870912407,34,35,-1,43,50,-7,59,65,-6,2,1,0,0
"16467","NYR","N.J",2018020946,17950,20182019,1,60,5,2,3,5.68651970475003,2.525475180856,3.16104452389402,34,21,13,44,34,10,62,44,18,5,4,0,0
"16468","NYR","WSH",2018020956,17951,20182019,0,64.3333333333333,5,6,-1,5.39452402456509,7.54503331377398,-2.15050928920889,31,35,-4,40,55,-15,53,71,-18,8,7,0,0
"16469","NYR","T.B",2018020981,17954,20182019,1,63.4166666666667,3,4,-1,5.58834992157063,4.11529198202327,1.47305793954736,36,30,6,53,44,9,70,64,6,6,3,0,0
"16470","NYR","MTL",2018020994,17956,20182019,1,60,2,4,-2,3.89315728496877,4.35136867017718,-0.458211385208415,30,36,-6,40,42,-2,56,49,7,3,3,0,0
"16471","NYR","WSH",2018021009,17958,20182019,1,65,2,2,0,3.06189687659472,4.82822737949948,-1.76633050290476,24,39,-15,33,48,-15,42,60,-18,2,4,0,0
"16472","NYR","DAL",2018021025,17960,20182019,0,60,0,1,-1,3.99794628504549,2.8442608031459,1.15368548189959,28,32,-4,37,39,-2,55,56,-1,6,6,0,0
"16473","NYR","DET",2018021036,17962,20182019,0,65,2,2,0,2.34940925704164,5.52162653740379,-3.17221728036215,34,45,-11,41,65,-24,50,84,-34,2,4,0,0
"16474","NYR","N.J",2018021053,17964,20182019,1,60,4,2,2,6.27841488478589,2.84611667290011,3.43229821188578,41,24,17,60,30,30,72,39,33,6,3,0,0
"16475","NYR","EDM",2018021071,17966,20182019,0,60.5833333333333,2,3,-1,5.90591172091982,6.54303911798343,-0.637127397063608,30,33,-3,37,52,-15,47,62,-15,2,4,0,0
"16476","NYR","VAN",2018021082,17968,20182019,0,60,1,4,-3,3.42243435587307,3.12477968430176,0.297654671571308,22,28,-6,32,35,-3,42,43,-1,5,3,0,0
"16477","NYR","CGY",2018021097,17970,20182019,0,60,1,5,-4,2.62082401545194,4.6218421287158,-2.00101811326385,25,32,-7,31,40,-9,36,54,-18,5,5,0,0
"16478","NYR","MIN",2018021108,17971,20182019,0,60,2,5,-3,3.4730471327639,9.14781269476953,-5.67476556200563,28,47,-19,37,64,-27,63,76,-13,3,4,0,0
"16479","NYR","DET",2018021124,17974,20182019,1,60,2,3,-1,5.19985292712227,5.86538675349919,-0.665533826376926,43,30,13,59,38,21,76,48,28,3,1,0,0
"16480","NYR","TOR",2018021154,17978,20182019,0,61.8,2,1,1,2.53285834562848,6.18589131685545,-3.65303297122696,28,45,-17,45,71,-26,58,104,-46,3,3,0,0
"16481","NYR","PIT",2018021171,17980,20182019,1,60,2,5,-3,5.28203054458572,4.48420510661313,0.797825437972597,35,36,-1,46,48,-2,58,58,0,3,3,0,0
"16482","NYR","BOS",2018021186,17982,20182019,0,60,3,6,-3,3.3503701784648,7.43493380859582,-4.08456363013102,23,32,-9,30,43,-13,39,52,-13,6,8,0,0
"16483","NYR","STL",2018021197,17984,20182019,1,60,4,2,2,3.90924531252344,7.41949368875066,-3.51024837622722,25,46,-21,33,65,-32,43,78,-35,2,1,0,0
"16484","NYR","PHI",2018021215,17986,20182019,0,60,3,0,3,2.19387604578895,2.34293446553056,-0.149058419741612,25,29,-4,34,38,-4,46,60,-14,2,4,0,0
"16485","NYR","N.J",2018021222,17987,20182019,0,60,2,4,-2,3.44024631571854,5.24629077473684,-1.8060444590183,32,41,-9,46,52,-6,51,63,-12,3,5,0,0
"16486","NYR","OTT",2018021239,17989,20182019,1,60,1,4,-3,4.78512713141155,4.47953112944379,0.305596001967761,28,31,-3,44,37,7,54,46,8,2,6,0,0
"16487","NYR","CBJ",2018021254,17991,20182019,1,65,2,2,0,4.37130480734049,5.71575614856556,-1.34445134122507,27,41,-14,35,59,-24,44,74,-30,0,2,0,0
"16488","NYR","PIT",2018021264,17992,20182019,0,62.15,4,3,1,2.36193159760842,4.46796971731237,-2.10603811970395,30,39,-9,36,59,-23,43,79,-36,0,4,0,0
"16489","OTT","PIT",2008020002,14156,20082009,1,64.5833333333333,3,4,-1,0,0,0,35,30,5,47,43,4,58,64,-6,6,7,0,0
"16490","OTT","PIT",2008020004,14157,20082009,0,60,3,1,2,0,0,0,27,31,-4,41,37,4,56,51,5,5,8,0,0
"16491","OTT","DET",2008020017,14163,20082009,1,60,2,3,-1,0,0,0,22,41,-19,29,53,-24,36,66,-30,6,6,0,0
"16492","OTT","ARI",2008020056,14169,20082009,1,60,6,3,3,0,0,0,26,37,-11,34,44,-10,43,61,-18,3,0,0,0
"16493","OTT","BOS",2008020065,14170,20082009,1,60,2,4,-2,0,0,0,23,27,-4,35,36,-1,55,48,7,5,2,0,0
"16494","OTT","FLA",2008020087,14174,20082009,1,60,1,3,-2,0,0,0,42,21,21,55,31,24,70,44,26,5,4,0,0
"16495","OTT","ANA",2008020099,14176,20082009,1,60,3,4,-1,0,0,0,30,32,-2,46,44,2,59,52,7,7,3,0,0
"16496","OTT","TOR",2008020106,14177,20082009,0,60,2,3,-1,0,0,0,24,38,-14,32,49,-17,48,64,-16,2,6,0,0
"16497","OTT","BUF",2008020120,14179,20082009,0,60,5,2,3,0,0,0,28,27,1,35,34,1,49,59,-10,7,11,0,0
"16498","OTT","FLA",2008020139,14182,20082009,0,60,2,1,1,0,0,0,31,26,5,41,37,4,52,50,2,5,3,0,0
"16499","OTT","T.B",2008020157,14184,20082009,0,65,2,2,0,0,0,0,31,34,-3,48,44,4,64,57,7,3,4,0,0
"16500","OTT","WSH",2008020173,14187,20082009,1,64.3333333333333,2,1,1,0,0,0,44,27,17,53,34,19,61,49,12,5,1,0,0
"16501","OTT","PHI",2008020185,14189,20082009,1,60,4,1,3,0,0,0,25,18,7,35,29,6,51,44,7,0,3,0,0
"16502","OTT","CAR",2008020192,14190,20082009,0,60,1,2,-1,0,0,0,23,30,-7,36,48,-12,50,75,-25,6,7,0,0
"16503","OTT","MTL",2008020217,14194,20082009,0,60,0,4,-4,0,0,0,28,31,-3,44,42,2,66,56,10,5,5,0,0
"16504","OTT","NYI",2008020229,14196,20082009,1,60,1,3,-2,0,0,0,30,31,-1,42,37,5,53,48,5,6,5,0,0
"16505","OTT","NYI",2008020244,14198,20082009,0,60,2,3,-1,0,0,0,40,31,9,48,46,2,66,62,4,6,6,0,0
"16506","OTT","NYR",2008020258,14200,20082009,0,65,1,1,0,0,0,0,28,27,1,36,41,-5,41,60,-19,4,4,0,0
"16507","OTT","MTL",2008020273,14203,20082009,1,65,2,2,0,0,0,0,25,21,4,39,30,9,52,43,9,6,2,0,0
"16508","OTT","NYR",2008020286,14205,20082009,1,60,4,1,3,0,0,0,36,19,17,51,33,18,64,46,18,7,3,0,0
"16509","OTT","TOR",2008020321,14210,20082009,1,65,1,1,0,0,0,0,35,26,9,45,35,10,55,54,1,3,6,0,0
"16510","OTT","NYI",2008020339,14212,20082009,0,60,2,4,-2,0,0,0,21,25,-4,33,39,-6,57,59,-2,1,5,0,0
"16511","OTT","ATL",2008020361,14216,20082009,1,60,5,1,4,0,0,0,34,23,11,37,35,2,44,50,-6,5,8,0,0
"16512","OTT","PIT",2008020382,14219,20082009,1,60,3,2,1,0,0,0,31,19,12,39,34,5,59,45,14,2,3,0,0
"16513","OTT","FLA",2008020399,14221,20082009,1,64.8333333333333,3,4,-1,0,0,0,38,40,-2,49,49,0,66,69,-3,3,5,0,0
"16514","OTT","CHI",2008020410,14223,20082009,0,60,0,2,-2,0,0,0,23,30,-7,30,42,-12,39,54,-15,5,6,0,0
"16515","OTT","WSH",2008020423,14225,20082009,0,60,1,5,-4,0,0,0,33,34,-1,43,51,-8,55,67,-12,5,8,0,0
"16516","OTT","T.B",2008020433,14226,20082009,1,60,2,0,2,0,0,0,33,24,9,42,34,8,56,46,10,8,5,0,0
"16517","OTT","ATL",2008020450,14229,20082009,1,60,1,4,-3,0,0,0,29,25,4,41,33,8,56,46,10,5,7,0,0
"16518","OTT","N.J",2008020469,14232,20082009,0,60,1,5,-4,0,0,0,25,26,-1,34,34,0,40,44,-4,3,4,0,0
"16519","OTT","DAL",2008020477,14233,20082009,1,63.5,5,4,1,0,0,0,33,29,4,45,42,3,58,53,5,6,4,0,0
"16520","OTT","PHI",2008020497,14236,20082009,0,60,4,6,-2,0,0,0,21,32,-11,28,52,-24,44,66,-22,2,2,0,0
"16521","OTT","CGY",2008020526,14240,20082009,0,60,3,6,-3,0,0,0,30,42,-12,41,54,-13,44,69,-25,6,6,0,0
"16522","OTT","VAN",2008020532,14241,20082009,0,60,0,3,-3,0,0,0,18,32,-14,28,41,-13,40,49,-9,9,11,0,0
"16523","OTT","EDM",2008020545,14243,20082009,0,60,3,2,1,0,0,0,25,22,3,37,35,2,46,51,-5,3,1,0,0
"16524","OTT","TOR",2008020568,14247,20082009,0,60,1,3,-2,0,0,0,31,30,1,45,43,2,62,59,3,12,12,0,0
"16525","OTT","N.J",2008020578,14248,20082009,0,61.7166666666667,3,4,-1,0,0,0,20,35,-15,29,47,-18,34,59,-25,5,5,0,0
"16526","OTT","BUF",2008020586,14250,20082009,0,60,2,4,-2,0,0,0,33,26,7,47,33,14,58,38,20,6,6,0,0
"16527","OTT","BOS",2008020598,14252,20082009,0,60,4,6,-2,0,0,0,30,22,8,33,31,2,42,47,-5,1,2,0,0
"16528","OTT","NYR",2008020617,14254,20082009,1,60,0,2,-2,0,0,0,33,27,6,48,34,14,57,39,18,5,5,0,0
"16529","OTT","CAR",2008020637,14257,20082009,1,60,5,1,4,0,0,0,40,24,16,47,39,8,58,48,10,4,4,0,0
"16530","OTT","ATL",2008020643,14258,20082009,0,60,3,2,1,0,0,0,30,31,-1,37,44,-7,54,56,-2,7,4,0,0
"16531","OTT","MTL",2008020664,14261,20082009,1,65,4,4,0,0,0,0,27,32,-5,38,43,-5,52,62,-10,2,6,0,0
"16532","OTT","WSH",2008020686,14264,20082009,1,60,3,2,1,0,0,0,34,31,3,49,45,4,53,67,-14,6,5,0,0
"16533","OTT","N.J",2008020704,14271,20082009,1,60,1,4,-3,0,0,0,22,27,-5,34,32,2,51,44,7,4,4,0,0
"16534","OTT","STL",2008020721,14273,20082009,0,60,3,1,2,0,0,0,30,23,7,44,37,7,56,48,8,5,3,0,0
"16535","OTT","CBJ",2008020726,14274,20082009,0,60,0,1,-1,0,0,0,17,26,-9,19,38,-19,32,56,-24,6,7,0,0
"16536","OTT","WSH",2008020742,14276,20082009,0,60,4,7,-3,0,0,0,38,30,8,46,48,-2,66,62,4,6,5,0,0
"16537","OTT","L.A",2008020754,14278,20082009,1,60,0,1,-1,0,0,0,29,26,3,45,32,13,58,46,12,6,6,0,0
"16538","OTT","BOS",2008020765,14280,20082009,1,65,3,3,0,0,0,0,22,30,-8,29,39,-10,52,52,0,2,4,0,0
"16539","OTT","BUF",2008020781,14282,20082009,1,65,2,2,0,0,0,0,42,30,12,57,40,17,75,52,23,2,1,0,0
"16540","OTT","BUF",2008020805,14286,20082009,0,60,3,1,2,0,0,0,23,32,-9,33,42,-9,38,58,-20,8,13,0,0
"16541","OTT","PHI",2008020811,14287,20082009,0,60,5,2,3,0,0,0,23,36,-13,33,51,-18,46,70,-24,2,3,0,0
"16542","OTT","MIN",2008020831,14289,20082009,0,60,5,3,2,0,0,0,22,29,-7,38,42,-4,50,54,-4,2,5,0,0
"16543","OTT","NSH",2008020844,14291,20082009,0,60,2,0,2,0,0,0,24,24,0,30,32,-2,41,46,-5,4,4,0,0
"16544","OTT","COL",2008020851,14292,20082009,0,61.3333333333333,2,3,-1,0,0,0,22,27,-5,36,32,4,51,54,-3,4,4,0,0
"16545","OTT","VAN",2008020863,14294,20082009,1,60,2,5,-3,0,0,0,27,24,3,34,32,2,44,41,3,6,3,0,0
"16546","OTT","MTL",2008020875,14296,20082009,0,60,3,5,-2,0,0,0,47,32,15,59,39,20,78,53,25,10,7,0,0
"16547","OTT","CAR",2008020898,14299,20082009,1,60,4,2,2,0,0,0,22,43,-21,31,49,-18,43,68,-25,3,5,0,0
"16548","OTT","S.J",2008020914,14301,20082009,1,60,1,2,-1,0,0,0,24,24,0,31,31,0,47,43,4,4,4,0,0
"16549","OTT","TOR",2008020927,14303,20082009,1,60.55,3,4,-1,0,0,0,32,38,-6,39,54,-15,52,66,-14,2,4,0,0
"16550","OTT","CGY",2008020946,14306,20082009,1,60,3,6,-3,0,0,0,25,23,2,37,32,5,45,46,-1,6,5,0,0
"16551","OTT","EDM",2008020959,14308,20082009,1,60,4,2,2,0,0,0,32,26,6,42,35,7,57,43,14,4,4,0,0
"16552","OTT","BUF",2008020973,14310,20082009,1,60,6,3,3,0,0,0,36,30,6,45,42,3,52,53,-1,6,5,0,0
"16553","OTT","TOR",2008020987,14312,20082009,1,60,2,1,1,0,0,0,26,26,0,43,32,11,55,48,7,5,4,0,0
"16554","OTT","T.B",2008021000,14314,20082009,1,62.6333333333333,3,2,1,0,0,0,27,24,3,36,31,5,53,41,12,8,7,0,0
"16555","OTT","BOS",2008021003,14315,20082009,0,60,3,5,-2,0,0,0,28,22,6,39,31,8,50,42,8,5,4,0,0
"16556","OTT","PIT",2008021021,14317,20082009,0,65,3,3,0,0,0,0,39,30,9,47,40,7,61,52,9,8,5,0,0
"16557","OTT","BUF",2008021042,14320,20082009,1,60,4,2,2,0,0,0,36,13,23,45,22,23,56,32,24,9,4,0,0
"16558","OTT","MTL",2008021056,14322,20082009,1,60,5,4,1,0,0,0,39,32,7,45,41,4,55,58,-3,2,4,0,0
"16559","OTT","NYI",2008021072,14324,20082009,1,60,5,2,3,0,0,0,26,22,4,33,29,4,43,41,2,3,5,0,0
"16560","OTT","NYR",2008021082,14325,20082009,0,60,2,1,1,0,0,0,22,29,-7,30,51,-21,43,68,-25,3,5,0,0
"16561","OTT","CAR",2008021098,14328,20082009,0,60,1,2,-1,0,0,0,22,30,-8,29,43,-14,41,59,-18,2,4,0,0
"16562","OTT","ATL",2008021121,14331,20082009,0,60,3,6,-3,0,0,0,21,32,-11,28,39,-11,38,50,-12,7,9,0,0
"16563","OTT","T.B",2008021129,14332,20082009,0,60,3,0,3,0,0,0,30,20,10,39,28,11,52,45,7,6,5,0,0
"16564","OTT","FLA",2008021140,14334,20082009,0,60,2,5,-3,0,0,0,32,27,5,51,36,15,71,49,22,2,3,0,0
"16565","OTT","BOS",2008021150,14336,20082009,0,60,1,2,-1,0,0,0,32,33,-1,39,43,-4,58,53,5,5,4,0,0
"16566","OTT","PHI",2008021167,14338,20082009,1,65,3,3,0,0,0,0,38,34,4,46,41,5,63,53,10,3,3,0,0
"16567","OTT","MTL",2008021182,14340,20082009,0,60,3,2,1,0,0,0,23,22,1,34,29,5,55,41,14,5,5,0,0
"16568","OTT","BOS",2008021189,14341,20082009,1,60,3,2,1,0,0,0,32,33,-1,46,40,6,57,50,7,5,5,0,0
"16569","OTT","N.J",2008021203,14343,20082009,1,65,2,2,0,0,0,0,30,32,-2,41,48,-7,54,59,-5,4,7,0,0
"16570","OTT","TOR",2008021220,14345,20082009,0,60,2,5,-3,0,0,0,39,30,9,54,48,6,62,67,-5,6,7,0,0
"16571","OTT","NYR",2009020014,14520,20092010,0,60,2,5,-3,0,0,0,34,34,0,44,52,-8,63,64,-1,4,5,0,0
"16572","OTT","NYI",2009020037,14525,20092010,1,60.5333333333333,3,2,1,0,0,0,28,25,3,39,40,-1,52,61,-9,2,4,0,0
"16573","OTT","ATL",2009020051,14527,20092010,1,60,4,2,2,0,0,0,34,28,6,41,38,3,51,51,0,4,4,0,0
"16574","OTT","PIT",2009020068,14529,20092010,1,60,1,4,-3,0,0,0,31,28,3,46,38,8,60,49,11,8,7,0,0
"16575","OTT","T.B",2009020083,14532,20092010,1,60,7,1,6,0,0,0,35,17,18,46,33,13,60,47,13,8,8,0,0
"16576","OTT","MTL",2009020095,14534,20092010,0,60,3,1,2,0,0,0,21,28,-7,32,40,-8,44,66,-22,5,4,0,0
"16577","OTT","NSH",2009020122,14539,20092010,1,62.1833333333333,5,6,-1,0,0,0,32,37,-5,39,48,-9,48,58,-10,7,7,0,0
"16578","OTT","BOS",2009020131,14541,20092010,1,65,3,3,0,0,0,0,30,28,2,42,39,3,52,51,1,3,4,0,0
"16579","OTT","FLA",2009020160,14545,20092010,0,60,4,3,1,0,0,0,29,38,-9,38,52,-14,47,69,-22,1,7,0,0
"16580","OTT","T.B",2009020167,14546,20092010,0,60,2,5,-3,0,0,0,23,27,-4,32,36,-4,42,45,-3,5,8,0,0
"16581","OTT","ATL",2009020182,14548,20092010,1,60,1,3,-2,0,0,0,51,21,30,63,30,33,79,42,37,4,2,0,0
"16582","OTT","T.B",2009020211,14553,20092010,1,64.2833333333333,3,2,1,0,0,0,29,20,9,43,29,14,61,43,18,6,7,0,0
"16583","OTT","N.J",2009020229,14555,20092010,1,60,2,3,-1,0,0,0,21,25,-4,24,35,-11,37,54,-17,3,7,0,0
"16584","OTT","EDM",2009020244,14558,20092010,1,65,3,3,0,0,0,0,25,34,-9,34,45,-11,51,58,-7,1,2,0,0
"16585","OTT","PHI",2009020255,14560,20092010,0,60,1,5,-4,0,0,0,23,27,-4,35,35,0,46,53,-7,1,4,0,0
"16586","OTT","NYR",2009020269,14562,20092010,1,65,1,1,0,0,0,0,36,28,8,54,32,22,74,52,22,5,4,0,0
"16587","OTT","TOR",2009020291,14565,20092010,1,60,3,2,1,0,0,0,21,32,-11,27,42,-15,42,59,-17,4,1,0,0
"16588","OTT","PIT",2009020301,14567,20092010,1,60,6,2,4,0,0,0,31,27,4,49,42,7,60,64,-4,3,5,0,0
"16589","OTT","WSH",2009020331,14571,20092010,1,61.2333333333333,4,3,1,0,0,0,37,28,9,46,42,4,63,58,5,3,3,0,0
"16590","OTT","N.J",2009020339,14573,20092010,0,60,1,3,-2,0,0,0,25,21,4,31,27,4,36,38,-2,2,5,0,0
"16591","OTT","CBJ",2009020353,14574,20092010,1,60,2,1,1,0,0,0,36,33,3,48,41,7,59,58,1,4,6,0,0
"16592","OTT","BOS",2009020368,14576,20092010,0,65,3,3,0,0,0,0,22,33,-11,25,45,-20,38,59,-21,4,5,0,0
"16593","OTT","S.J",2009020393,14579,20092010,0,60,2,5,-3,0,0,0,27,33,-6,37,48,-11,54,66,-12,5,3,0,0
"16594","OTT","L.A",2009020407,14581,20092010,0,60,3,6,-3,0,0,0,30,24,6,44,35,9,57,43,14,5,6,0,0
"16595","OTT","ANA",2009020428,14584,20092010,0,65,3,3,0,0,0,0,29,36,-7,40,46,-6,51,56,-5,5,3,0,0
"16596","OTT","MTL",2009020439,14586,20092010,1,60,1,4,-3,0,0,0,46,27,19,59,30,29,73,37,36,7,3,0,0
"16597","OTT","PHI",2009020453,14588,20092010,0,60,2,0,2,0,0,0,25,23,2,29,37,-8,46,62,-16,6,7,0,0
"16598","OTT","CAR",2009020467,14590,20092010,1,60,4,2,2,0,0,0,39,25,14,50,36,14,60,46,14,3,2,0,0
"16599","OTT","TOR",2009020481,14592,20092010,0,60,2,3,-1,0,0,0,24,24,0,38,37,1,53,54,-1,4,2,0,0
"16600","OTT","N.J",2009020511,14596,20092010,0,60,2,4,-2,0,0,0,29,22,7,41,27,14,51,34,17,7,4,0,0
"16601","OTT","MIN",2009020522,14597,20092010,1,60,4,1,3,0,0,0,24,23,1,33,33,0,46,45,1,3,6,0,0
"16602","OTT","BOS",2009020536,14599,20092010,1,60,0,2,-2,0,0,0,29,29,0,41,39,2,57,55,2,2,5,0,0
"16603","OTT","PIT",2009020548,14601,20092010,0,60,2,8,-6,0,0,0,47,36,11,61,55,6,77,68,9,7,9,0,0
"16604","OTT","MTL",2009020579,14606,20092010,1,60,4,2,2,0,0,0,28,31,-3,40,41,-1,50,54,-4,5,0,0,0
"16605","OTT","COL",2009020594,14608,20092010,1,60,3,4,-1,0,0,0,30,20,10,44,29,15,63,42,21,1,2,0,0
"16606","OTT","NYI",2009020599,14609,20092010,1,65,2,2,0,0,0,0,36,27,9,46,35,11,65,48,17,5,6,0,0
"16607","OTT","PHI",2009020624,14612,20092010,1,60,7,4,3,0,0,0,33,21,12,45,25,20,59,35,24,4,3,0,0
"16608","OTT","BOS",2009020632,14614,20092010,1,60,1,4,-3,0,0,0,28,35,-7,40,44,-4,54,58,-4,9,10,0,0
"16609","OTT","WSH",2009020646,14616,20092010,0,60,2,5,-3,0,0,0,28,38,-10,35,44,-9,53,55,-2,4,4,0,0
"16610","OTT","FLA",2009020664,14618,20092010,1,60,0,3,-3,0,0,0,24,19,5,38,26,12,59,36,23,4,7,0,0
"16611","OTT","CAR",2009020673,14619,20092010,0,60,1,4,-3,0,0,0,32,33,-1,41,48,-7,55,62,-7,3,3,0,0
"16612","OTT","ATL",2009020684,14621,20092010,0,60,1,6,-5,0,0,0,31,28,3,40,36,4,50,45,5,2,6,0,0
"16613","OTT","NYR",2009020694,14623,20092010,0,60,2,0,2,0,0,0,34,32,2,48,46,2,57,65,-8,2,3,0,0
"16614","OTT","MTL",2009020712,14625,20092010,0,60,4,2,2,0,0,0,28,32,-4,40,43,-3,54,67,-13,2,6,0,0
"16615","OTT","BOS",2009020723,14627,20092010,0,60,5,1,4,0,0,0,26,23,3,33,27,6,46,38,8,6,2,0,0
"16616","OTT","CHI",2009020737,14628,20092010,1,60,4,1,3,0,0,0,18,30,-12,23,38,-15,36,50,-14,6,5,0,0
"16617","OTT","STL",2009020745,14630,20092010,1,60,3,2,1,0,0,0,30,29,1,39,37,2,55,53,2,5,4,0,0
"16618","OTT","BOS",2009020760,14632,20092010,0,60,2,1,1,0,0,0,23,33,-10,28,43,-15,38,52,-14,1,1,0,0
"16619","OTT","N.J",2009020782,14635,20092010,1,60,3,0,3,0,0,0,18,24,-6,32,31,1,45,40,5,2,1,0,0
"16620","OTT","PIT",2009020794,14637,20092010,0,60,4,1,3,0,0,0,28,31,-3,45,39,6,60,55,5,3,3,0,0
"16621","OTT","MTL",2009020807,14639,20092010,1,63.55,3,2,1,0,0,0,37,29,8,47,40,7,59,59,0,4,4,0,0
"16622","OTT","VAN",2009020844,14644,20092010,1,60,3,1,2,0,0,0,21,30,-9,33,43,-10,44,61,-17,3,3,0,0
"16623","OTT","TOR",2009020859,14646,20092010,0,60,0,5,-5,0,0,0,30,37,-7,48,50,-2,60,69,-9,4,6,0,0
"16624","OTT","CGY",2009020879,14649,20092010,1,60,3,2,1,0,0,0,31,29,2,51,38,13,66,58,8,5,3,0,0
"16625","OTT","WSH",2009020891,14651,20092010,1,60,6,5,1,0,0,0,28,24,4,35,35,0,40,64,-24,2,2,0,0
"16626","OTT","DET",2009020910,14653,20092010,0,60,1,4,-3,0,0,0,30,40,-10,37,52,-15,49,63,-14,2,4,0,0
"16627","OTT","NYI",2009020919,14654,20092010,0,60,4,3,1,0,0,0,35,37,-2,44,50,-6,61,65,-4,2,5,0,0
"16628","OTT","NYR",2009020928,14670,20092010,1,60,1,4,-3,0,0,0,25,25,0,38,34,4,53,53,0,3,1,0,0
"16629","OTT","CAR",2009020944,14672,20092010,0,60,1,4,-3,0,0,0,26,21,5,44,29,15,63,38,25,2,3,0,0
"16630","OTT","TOR",2009020957,14674,20092010,1,65,1,1,0,0,0,0,23,31,-8,36,39,-3,49,56,-7,6,8,0,0
"16631","OTT","EDM",2009020983,14677,20092010,0,60,4,1,3,0,0,0,39,19,20,53,26,27,73,31,42,9,5,0,0
"16632","OTT","CGY",2009020998,14679,20092010,0,60,0,2,-2,0,0,0,33,25,8,45,36,9,75,46,29,6,3,0,0
"16633","OTT","VAN",2009021013,14681,20092010,0,60,1,5,-4,0,0,0,14,35,-21,16,49,-33,28,68,-40,3,7,0,0
"16634","OTT","TOR",2009021031,14684,20092010,1,60,1,4,-3,0,0,0,31,30,1,43,38,5,63,54,9,6,8,0,0
"16635","OTT","ATL",2009021045,14686,20092010,0,60,3,6,-3,0,0,0,39,27,12,52,39,13,68,53,15,5,7,0,0
"16636","OTT","DAL",2009021058,14688,20092010,0,60,4,5,-1,0,0,0,29,25,4,40,30,10,62,48,14,5,4,0,0
"16637","OTT","MTL",2009021078,14690,20092010,0,60,2,0,2,0,0,0,27,29,-2,37,44,-7,52,58,-6,2,5,0,0
"16638","OTT","PHI",2009021083,14691,20092010,1,60,2,0,2,0,0,0,26,26,0,40,40,0,58,52,6,7,7,0,0
"16639","OTT","FLA",2009021115,14695,20092010,1,60,3,2,1,0,0,0,25,22,3,37,34,3,55,49,6,4,4,0,0
"16640","OTT","WSH",2009021136,14698,20092010,0,64.6833333333333,5,4,1,0,0,0,31,21,10,42,36,6,50,64,-14,4,5,0,0
"16641","OTT","CAR",2009021153,14700,20092010,1,65,3,3,0,0,0,0,35,31,4,58,40,18,81,59,22,2,2,0,0
"16642","OTT","NYI",2009021165,14702,20092010,0,60,1,4,-3,0,0,0,29,33,-4,39,43,-4,51,56,-5,3,3,0,0
"16643","OTT","FLA",2009021188,14705,20092010,0,60,5,2,3,0,0,0,29,34,-5,40,43,-3,53,57,-4,3,3,0,0
"16644","OTT","T.B",2009021201,14707,20092010,0,65,3,3,0,0,0,0,38,29,9,55,42,13,68,52,16,12,8,0,0
"16645","OTT","PIT",2009030141,14713,20092010,0,60,5,4,1,0,0,0,26,21,5,33,35,-2,44,53,-9,4,6,0,0
"16646","OTT","PIT",2009030142,14715,20092010,0,60,1,2,-1,0,0,0,20,31,-11,24,53,-29,39,66,-27,3,3,0,0
"16647","OTT","PIT",2009030143,14717,20092010,1,60,2,4,-2,0,0,0,22,24,-2,34,32,2,52,49,3,6,7,0,0
"16648","OTT","PIT",2009030144,14719,20092010,1,60,4,7,-3,0,0,0,30,42,-12,45,50,-5,57,64,-7,8,12,0,0
"16649","OTT","PIT",2009030145,14721,20092010,0,80,3,3,0,0,0,0,34,48,-14,53,61,-8,64,93,-29,8,9,0,0
"16650","OTT","PIT",2009030146,14723,20092010,1,69.9333333333333,3,4,-1,0,0,0,31,43,-12,39,55,-16,49,76,-27,2,2,0,0
"16651","OTT","TOR",2010020014,14891,20102011,0,60,1,5,-4,2.35643679366058,5.4228861954932,-3.06644940183263,18,38,-20,27,50,-23,41,61,-20,4,5,0,0
"16652","OTT","WSH",2010020032,14893,20102011,0,64.4666666666667,2,3,-1,5.40884853095486,4.57674896792859,0.83209956302627,31,26,5,44,39,5,59,50,9,6,6,0,0
"16653","OTT","CAR",2010020043,14896,20102011,1,60,3,2,1,6.38324309294694,3.58858880069602,2.79465429225093,39,24,15,50,33,17,62,41,21,3,4,0,0
"16654","OTT","MTL",2010020055,14898,20102011,0,60,3,4,-1,2.02959808334708,4.76705877513713,-2.73746069179005,19,40,-21,23,51,-28,34,64,-30,4,7,0,0
"16655","OTT","PIT",2010020071,14900,20102011,0,60,2,5,-3,3.76725597388577,4.80319673568192,-1.03594076179616,34,29,5,41,44,-3,51,55,-4,5,7,0,0
"16656","OTT","MTL",2010020099,14905,20102011,1,60,0,3,-3,2.39488172443816,2.97246455710228,-0.57758283266412,19,34,-15,37,40,-3,48,56,-8,4,5,0,0
"16657","OTT","FLA",2010020132,14910,20102011,1,60,5,3,2,4.76443517175358,6.67407390702283,-1.90963873526925,28,31,-3,39,43,-4,49,60,-11,1,3,0,0
"16658","OTT","BOS",2010020145,14912,20102011,1,60,0,4,-4,6.52347460656893,3.80551742532407,2.71795718124486,29,25,4,43,38,5,70,48,22,3,4,0,0
"16659","OTT","TOR",2010020160,14915,20102011,0,60,3,2,1,3.75885054300255,4.58213875253023,-0.823288209527681,24,35,-11,38,54,-16,47,72,-25,5,5,0,0
"16660","OTT","NYI",2010020175,14917,20102011,1,60,4,1,3,5.17562678821196,6.06098680949981,-0.885360021287852,27,29,-2,37,36,1,52,53,-1,3,2,0,0
"16661","OTT","MTL",2010020190,14919,20102011,0,60,3,2,1,2.08243022970436,1.84826887505795,0.234161354646403,31,23,8,38,35,3,49,45,4,6,2,0,0
"16662","OTT","ATL",2010020207,14922,20102011,1,60,5,2,3,5.05243067190167,6.8558037392213,-1.80337306731963,29,37,-8,36,46,-10,49,52,-3,3,5,0,0
"16663","OTT","VAN",2010020223,14924,20102011,1,60,2,6,-4,6.79476498608915,4.80170117588568,1.99306381020347,35,33,2,48,43,5,63,51,12,6,4,0,0
"16664","OTT","BOS",2010020233,14926,20102011,0,60,2,0,2,3.35012793498226,5.21353778612429,-1.86340985114203,33,31,2,38,38,0,51,43,8,3,3,0,0
"16665","OTT","PHI",2010020250,14928,20102011,0,60,1,5,-4,7.94956307938628,8.61619810131378,-0.666635021927505,29,46,-17,40,56,-16,57,70,-13,1,5,0,0
"16666","OTT","CAR",2010020261,14930,20102011,0,60,1,7,-6,6.31508966023055,5.28351438755027,1.03157527268028,24,28,-4,42,43,-1,58,47,11,6,9,0,0
"16667","OTT","STL",2010020278,14932,20102011,0,60,2,5,-3,3.14704378276206,7.8864291376085,-4.73938535484644,20,33,-13,26,47,-21,34,62,-28,4,7,0,0
"16668","OTT","L.A",2010020303,14935,20102011,1,60,3,2,1,1.60381754340779,4.51681988206693,-2.91300233865915,19,30,-11,26,38,-12,41,48,-7,2,5,0,0
"16669","OTT","DAL",2010020312,14937,20102011,1,60,1,2,-1,2.46913148668165,3.8318116744922,-1.36268018781055,19,26,-7,30,38,-8,46,49,-3,3,5,0,0
"16670","OTT","PIT",2010020324,14939,20102011,0,60,1,2,-1,4.48787697358057,5.09093495966852,-0.603057986087954,44,40,4,53,53,0,68,69,-1,4,5,0,0
"16671","OTT","TOR",2010020337,14940,20102011,1,60,3,0,3,4.56625386838277,2.83953535032492,1.72671851805785,28,29,-1,39,42,-3,53,63,-10,1,3,0,0
"16672","OTT","EDM",2010020350,14942,20102011,1,60,1,4,-3,2.7118370591031,6.59696973385392,-3.88513267475083,23,25,-2,36,38,-2,57,54,3,3,5,0,0
"16673","OTT","S.J",2010020370,14945,20102011,1,60,0,4,-4,3.7148740634929,5.76334575072423,-2.04847168723133,28,33,-5,34,49,-15,44,63,-19,4,3,0,0
"16674","OTT","NYR",2010020392,14948,20102011,0,60,3,1,2,3.77718475840084,3.41212776326574,0.365056995135092,25,26,-1,40,41,-1,55,51,4,1,4,0,0
"16675","OTT","MTL",2010020402,14950,20102011,0,60,1,4,-3,3.57903235591948,6.50520163332112,-2.92616927740164,28,35,-7,35,51,-16,53,66,-13,4,5,0,0
"16676","OTT","NYR",2010020415,14952,20102011,1,60,3,5,-2,4.60649347025901,6.60749244329054,-2.00099897303153,27,28,-1,40,37,3,60,42,18,4,4,0,0
"16677","OTT","N.J",2010020420,14953,20102011,1,60,3,2,1,3.12871601448569,3.79245595022951,-0.66373993574382,29,31,-2,40,41,-1,49,61,-12,4,3,0,0
"16678","OTT","ATL",2010020442,14956,20102011,1,61.15,3,4,-1,5.18655676516937,3.97324569418561,1.21331107098376,30,24,6,51,42,9,75,57,18,2,0,0,0
"16679","OTT","MIN",2010020465,14959,20102011,0,60,3,1,2,5.49799577001249,3.21485954202944,2.28313622798305,25,24,1,44,35,9,55,48,7,2,3,0,0
"16680","OTT","COL",2010020472,14960,20102011,0,62.6,5,6,-1,5.35965835167917,5.42085173134595,-0.0611933796667739,29,25,4,35,36,-1,49,50,-1,5,3,0,0
"16681","OTT","WSH",2010020484,14962,20102011,1,60,2,3,-1,4.33760332097881,4.67610786012665,-0.338504539147834,26,34,-8,33,47,-14,47,61,-14,6,7,0,0
"16682","OTT","NSH",2010020514,14966,20102011,0,60,2,1,1,2.94110554290673,3.09006217366418,-0.148956630757455,30,26,4,37,36,1,44,49,-5,5,4,0,0
"16683","OTT","PIT",2010020519,14969,20102011,1,60,3,1,2,0,0,0,24,45,-21,31,56,-25,39,71,-32,8,7,0,0
"16684","OTT","CAR",2010020547,14972,20102011,1,60,0,4,-4,7.75540301975441,3.35666830014088,4.39873471961353,37,31,6,52,35,17,69,46,23,4,4,0,0
"16685","OTT","CBJ",2010020561,14974,20102011,0,62.1,3,4,-1,6.38336564773635,5.35364881587157,1.02971683186479,38,23,15,45,41,4,55,57,-2,4,5,0,0
"16686","OTT","TOR",2010020568,14975,20102011,1,60,1,5,-4,5.5866192689391,4.04682023509599,1.53979903384311,33,21,12,43,34,9,58,48,10,8,8,0,0
"16687","OTT","CHI",2010020607,14981,20102011,0,65,2,2,0,3.21893265275867,3.03971114594606,0.17922150681261,26,26,0,37,37,0,48,55,-7,1,0,0,0
"16688","OTT","T.B",2010020615,14982,20102011,1,60,1,2,-1,5.42447071534116,7.67221096743738,-2.24774025209622,32,27,5,44,43,1,59,52,7,4,6,0,0
"16689","OTT","BOS",2010020632,14985,20102011,0,60,0,6,-6,2.48312310469919,4.72369268723156,-2.24056958253237,31,39,-8,40,46,-6,47,55,-8,3,3,0,0
"16690","OTT","NYI",2010020648,14987,20102011,0,60,6,4,2,5.42197491638944,1.93372480242084,3.4882501139686,38,24,14,47,34,13,59,51,8,4,3,0,0
"16691","OTT","CGY",2010020656,14988,20102011,1,60,2,3,-1,5.33329052547924,3.73085131508014,1.6024392103991,35,26,9,44,34,10,59,43,16,7,7,0,0
"16692","OTT","WSH",2010020672,14990,20102011,0,60,1,3,-2,2.69701578599052,4.38194441760425,-1.68492863161373,23,26,-3,38,39,-1,53,60,-7,2,2,0,0
"16693","OTT","ANA",2010020687,14992,20102011,1,65,1,1,0,4.83294605305127,5.62729487246725,-0.794348819415973,40,27,13,57,40,17,76,49,27,2,0,0,0
"16694","OTT","PHI",2010020700,14994,20102011,0,60,2,6,-4,3.0116512614768,5.22625231517441,-2.21460105369761,27,23,4,37,31,6,53,38,15,6,7,0,0
"16695","OTT","MTL",2010020709,14995,20102011,1,60,1,7,-6,6.46084310958031,3.27286011040269,3.18798299917762,34,35,-1,42,43,-1,53,55,-2,4,4,0,0
"16696","OTT","N.J",2010020752,15006,20102011,0,60,1,2,-1,4.10974351218165,4.22361953908253,-0.113876026900882,16,33,-17,27,47,-20,35,52,-17,3,1,0,0
"16697","OTT","DET",2010020764,15007,20102011,1,60,5,7,-2,6.84639960994673,7.43993635648803,-0.593536746541304,34,38,-4,44,47,-3,54,60,-6,2,3,0,0
"16698","OTT","NYI",2010020786,15010,20102011,0,60,3,5,-2,3.10861329839906,5.96421492370428,-2.85560162530521,23,38,-15,34,47,-13,56,61,-5,4,7,0,0
"16699","OTT","VAN",2010020801,15012,20102011,0,60,2,4,-2,1.35638629526312,3.91323127591875,-2.55684498065563,33,30,3,45,38,7,57,53,4,5,3,0,0
"16700","OTT","CGY",2010020813,15014,20102011,0,60,2,5,-3,4.03464529720077,6.8464010124444,-2.81175571524363,26,35,-9,38,49,-11,50,71,-21,4,6,0,0
"16701","OTT","EDM",2010020830,15017,20102011,0,60,5,3,2,4.67074814781562,4.38947755336994,0.281270594445676,25,18,7,34,29,5,50,39,11,12,10,0,0
"16702","OTT","NYI",2010020850,15020,20102011,1,65,3,3,0,5.23737162340964,5.46496548787864,-0.227593864469,31,28,3,41,46,-5,60,53,7,5,4,0,0
"16703","OTT","BOS",2010020873,15023,20102011,1,60,2,4,-2,7.21022380530194,6.19301754565095,1.01720625965099,34,33,1,46,45,1,60,59,1,3,5,0,0
"16704","OTT","TOR",2010020878,15024,20102011,0,65,0,0,0,1.86452956709548,6.1742274948881,-4.30969792779262,22,47,-25,32,58,-26,44,74,-30,3,6,0,0
"16705","OTT","FLA",2010020903,15028,20102011,1,60,5,1,4,2.95122045297371,4.85685622833751,-1.9056357753638,34,24,10,43,41,2,58,56,2,6,5,0,0
"16706","OTT","PHI",2010020929,15031,20102011,1,60,4,1,3,4.63102062360291,5.25606887974,-0.625048256137092,29,31,-2,38,38,0,43,57,-14,5,6,0,0
"16707","OTT","BOS",2010020946,15034,20102011,1,60,0,1,-1,7.52670426751094,2.24865271692397,5.27805155058697,33,21,12,52,32,20,69,49,20,2,2,0,0
"16708","OTT","ATL",2010020962,15036,20102011,0,60,3,1,2,4.59694487252273,3.96353973267833,0.633405139844399,27,43,-16,40,54,-14,53,70,-17,2,2,0,0
"16709","OTT","NYR",2010020969,15037,20102011,1,60,1,4,-3,3.47591861723777,2.53448738726615,0.941431229971613,29,27,2,42,35,7,62,47,15,4,5,0,0
"16710","OTT","N.J",2010020992,15041,20102011,0,60,2,1,1,3.71296555255504,4.50758718190082,-0.79462162934578,21,32,-11,28,40,-12,38,51,-13,3,4,0,0
"16711","OTT","FLA",2010021010,15043,20102011,0,60,2,1,1,4.47015212532361,3.1524803872453,1.3176717380783,39,34,5,49,43,6,63,50,13,4,3,0,0
"16712","OTT","T.B",2010021020,15044,20102011,0,60,2,1,1,3.17072099350116,3.76044023829309,-0.589719244791922,22,35,-13,32,47,-15,45,71,-26,6,5,0,0
"16713","OTT","PIT",2010021046,15048,20102011,1,60,1,5,-4,3.59305742842116,5.34428303069581,-1.75122560227464,22,41,-19,32,54,-22,41,79,-38,4,5,0,0
"16714","OTT","N.J",2010021058,15050,20102011,1,60,3,1,2,6.37420816124705,4.33240068244814,2.04180747879891,25,34,-9,35,44,-9,46,68,-22,3,3,0,0
"16715","OTT","T.B",2010021073,15052,20102011,1,63.4666666666667,3,2,1,6.55468823069441,7.09474126383429,-0.540053033139884,34,37,-3,47,50,-3,70,64,6,2,3,0,0
"16716","OTT","CAR",2010021091,15055,20102011,0,60,3,4,-1,7.33341188248687,3.85023129512774,3.48318058735913,39,24,15,59,32,27,79,47,32,4,4,0,0
"16717","OTT","NYR",2010021104,15057,20102011,0,65,1,1,0,4.63091561745387,3.78350811549171,0.847407501962152,30,30,0,38,38,0,50,49,1,5,5,0,0
"16718","OTT","WSH",2010021113,15058,20102011,1,60,2,0,2,5.08065024318691,4.13620598536136,0.944444257825552,23,31,-8,33,44,-11,46,61,-15,4,4,0,0
"16719","OTT","ATL",2010021129,15060,20102011,0,65,4,4,0,5.30944911317366,4.81837792699812,0.491071186175532,28,47,-19,36,66,-30,46,82,-36,1,4,0,0
"16720","OTT","T.B",2010021140,15062,20102011,0,60,2,5,-3,5.32279796496791,5.00430486040489,0.318493104563025,33,31,2,51,45,6,62,51,11,2,4,0,0
"16721","OTT","FLA",2010021155,15064,20102011,0,60,4,1,3,3.11508584772272,4.48882310045883,-1.37373725273611,23,38,-15,32,55,-23,35,71,-36,2,4,0,0
"16722","OTT","TOR",2010021168,15066,20102011,1,60,2,4,-2,4.66112345681233,3.88775761811121,0.773365838701125,25,30,-5,39,41,-2,50,58,-8,3,2,0,0
"16723","OTT","PHI",2010021188,15069,20102011,1,60,5,2,3,5.14228468799894,5.7649320806629,-0.622647392663964,36,29,7,40,43,-3,52,62,-10,5,6,0,0
"16724","OTT","MTL",2010021202,15071,20102011,1,61.2666666666667,3,2,1,3.95956946225488,3.51585909875575,0.443710363499122,32,29,3,40,42,-2,50,57,-7,2,2,0,0
"16725","OTT","BOS",2010021216,15073,20102011,0,60,1,3,-2,4.76424594333679,3.15240922238445,1.61183672095234,32,29,3,37,37,0,47,57,-10,3,4,0,0
"16726","OTT","DET",2011020005,15254,20112012,0,60,3,5,-2,4.96355029587097,6.49609846977535,-1.53254817390438,32,39,-7,41,59,-18,56,67,-11,3,5,0,0
"16727","OTT","TOR",2011020011,15255,20112012,0,60,5,6,-1,5.72885885003456,4.28069484033079,1.44816400970377,32,35,-3,49,50,-1,65,58,7,9,9,0,0
"16728","OTT","MIN",2011020033,15258,20112012,1,65,3,3,0,4.74563653185032,3.89032800620771,0.855308525642613,44,27,17,59,34,25,80,48,32,5,3,0,0
"16729","OTT","COL",2011020041,15260,20112012,1,60,1,7,-6,2.02883237437345,5.19686229330841,-3.16802991893496,16,39,-23,28,45,-17,42,53,-11,4,6,0,0
"16730","OTT","WSH",2011020054,15262,20112012,0,60,1,2,-1,2.49315058792454,4.83962728222832,-2.34647669430378,34,26,8,46,38,8,56,55,1,1,3,0,0
"16731","OTT","PHI",2011020073,15265,20112012,1,60,2,7,-5,5.7910693277372,5.99304094878647,-0.201971621049267,23,30,-7,40,39,1,56,51,5,4,6,0,0
"16732","OTT","WPG",2011020083,15267,20112012,1,60,4,1,3,5.74922214820981,5.87108280745451,-0.121860659244703,30,36,-6,42,52,-10,59,64,-5,4,5,0,0
"16733","OTT","CBJ",2011020099,15269,20112012,1,60,4,3,1,6.21234717480728,5.02752659632824,1.18482057847904,27,21,6,36,28,8,48,39,9,2,4,0,0
"16734","OTT","CAR",2011020115,15272,20112012,0,65,2,2,0,5.65755760374418,6.76578490222164,-1.10822729847746,28,34,-6,48,50,-2,67,75,-8,1,4,0,0
"16735","OTT","FLA",2011020130,15274,20112012,1,60,4,3,1,5.44242702675547,3.82987267203407,1.6125543547214,38,25,13,50,36,14,68,50,18,3,5,0,0
"16736","OTT","NYR",2011020140,15276,20112012,0,65,4,4,0,5.74179030728545,6.61852025290224,-0.87672994561679,40,28,12,51,40,11,65,49,16,4,1,0,0
"16737","OTT","TOR",2011020154,15277,20112012,1,60,3,2,1,3.55096951088157,3.21768718372914,0.333282327152432,30,25,5,45,33,12,63,52,11,4,6,0,0
"16738","OTT","BOS",2011020160,15279,20112012,0,60,3,5,-2,2.89361885305436,6.63983914091638,-3.74622028786202,26,41,-15,33,49,-16,43,65,-22,4,8,0,0
"16739","OTT","MTL",2011020180,15282,20112012,1,60,1,2,-1,6.79284067358822,4.37983720898046,2.41300346460775,34,26,8,47,36,11,66,45,21,4,2,0,0
"16740","OTT","NYR",2011020211,15287,20112012,1,60,2,3,-1,6.42168744322674,4.23666197364219,2.18502546958456,31,19,12,45,29,16,68,37,31,2,1,0,0
"16741","OTT","TOR",2011020230,15290,20112012,0,60,5,2,3,6.37970025788526,5.93068879972878,0.449011458156477,24,33,-9,38,45,-7,47,74,-27,3,6,0,0
"16742","OTT","CGY",2011020255,15293,20112012,0,60,3,1,2,4.3536831696245,3.36994311459932,0.98374005502518,32,39,-7,51,47,4,62,61,1,4,6,0,0
"16743","OTT","EDM",2011020268,15295,20112012,0,60,5,2,3,2.91807711764704,2.57325566542568,0.344821452221368,16,24,-8,26,37,-11,37,56,-19,4,3,0,0
"16744","OTT","VAN",2011020289,15298,20112012,0,62.3,1,2,-1,3.00227333919611,5.41118952292928,-2.40891618373317,29,27,2,43,41,2,55,51,4,5,4,0,0
"16745","OTT","PIT",2011020319,15303,20112012,0,60,3,6,-3,5.88470292978582,6.80095238645936,-0.91624945667354,27,40,-13,36,62,-26,54,80,-26,5,6,0,0
"16746","OTT","CAR",2011020337,15305,20112012,1,60,4,3,1,5.14700162757587,4.30271723843543,0.844284389140435,25,37,-12,34,50,-16,47,63,-16,5,9,0,0
"16747","OTT","WPG",2011020349,15307,20112012,0,60,6,4,2,5.5957124545821,3.84264653583591,1.75306591874619,34,43,-9,50,55,-5,59,61,-2,5,6,0,0
"16748","OTT","DAL",2011020361,15309,20112012,0,60,2,3,-1,5.77854598150589,6.0943306730187,-0.315784691512818,35,32,3,41,47,-6,57,66,-9,1,3,0,0
"16749","OTT","WSH",2011020374,15311,20112012,0,60.2,2,3,-1,4.82149667524391,4.13285347132478,0.688643203919128,34,35,-1,44,47,-3,57,61,-4,1,4,0,0
"16750","OTT","T.B",2011020389,15313,20112012,1,60,4,2,2,4.47170041984828,4.01908787123466,0.452612548613615,31,33,-2,45,44,1,55,65,-10,3,3,0,0
"16751","OTT","WSH",2011020402,15315,20112012,1,60,3,5,-2,5.70392565212876,8.20661200607312,-2.50268635394436,34,44,-10,47,51,-4,66,58,8,7,5,0,0
"16752","OTT","N.J",2011020406,15316,20112012,0,65,4,4,0,0,0,0,29,31,-2,33,39,-6,39,45,-6,6,6,0,0
"16753","OTT","VAN",2011020423,15318,20112012,1,60,1,4,-3,3.65846471488476,3.66857133086887,-0.0101066159841139,25,28,-3,36,41,-5,56,45,11,7,7,0,0
"16754","OTT","BOS",2011020448,15322,20112012,1,60,2,5,-3,5.19059657248727,5.54483311991157,-0.354236547424307,49,29,20,64,39,25,82,52,30,3,1,0,0
"16755","OTT","FLA",2011020502,15330,20112012,1,62.0333333333333,4,3,1,5.45298334821014,5.16629857616499,0.286684772045152,26,35,-9,38,49,-11,53,66,-13,3,4,0,0
"16756","OTT","CAR",2011020512,15331,20112012,0,61.6,1,2,-1,4.66913407915854,8.31469846260734,-3.6455643834488,23,38,-15,40,59,-19,53,83,-30,1,3,0,0
"16757","OTT","MTL",2011020531,15335,20112012,1,60,2,6,-4,2.56221560892144,6.82836911431572,-4.26615350539428,35,28,7,42,38,4,56,52,4,5,6,0,0
"16758","OTT","CGY",2011020552,15338,20112012,1,63.5166666666667,4,3,1,10.998962102772,4.2228944100134,6.7760676927586,49,32,17,73,34,39,93,47,46,4,4,0,0
"16759","OTT","N.J",2011020570,15341,20112012,1,64,3,2,1,8.45172348927008,3.0806840985997,5.37103939067038,32,29,3,55,39,16,78,47,31,4,2,0,0
"16760","OTT","T.B",2011020588,15344,20112012,1,60,4,1,3,5.99996013590135,4.2357263492213,1.76423378668005,24,36,-12,36,56,-20,53,74,-21,2,3,0,0
"16761","OTT","PHI",2011020599,15346,20112012,0,64.9,2,3,-1,5.15063986895673,4.46088432623219,0.689755542724542,37,39,-2,51,55,-4,68,69,-1,5,8,0,0
"16762","OTT","PHI",2011020611,15347,20112012,1,60,6,4,2,8.10350959777134,5.87240430013446,2.23110529763688,38,37,1,47,49,-2,67,64,3,2,3,0,0
"16763","OTT","NYR",2011020633,15351,20112012,0,60,3,0,3,4.34924748245794,2.63942855188423,1.70981893057371,24,34,-10,33,41,-8,49,50,-1,2,4,0,0
"16764","OTT","MTL",2011020650,15353,20112012,0,65,2,2,0,4.22222314713235,5.53727346227074,-1.31505031513838,25,35,-10,40,42,-2,60,60,0,6,5,0,0
"16765","OTT","WPG",2011020666,15355,20112012,1,60,0,2,-2,5.95444591761229,4.85370564204641,1.10074027556588,25,35,-10,41,46,-5,64,61,3,3,4,0,0
"16766","OTT","TOR",2011020670,15356,20112012,0,60,3,2,1,3.09305248365854,8.1147108564046,-5.02165837274606,21,39,-18,34,64,-30,57,77,-20,1,2,0,0
"16767","OTT","S.J",2011020694,15358,20112012,0,60,4,1,3,4.56555218750259,4.00218197514187,0.563370212360724,21,37,-16,35,50,-15,48,65,-17,5,4,0,0
"16768","OTT","ANA",2011020705,15360,20112012,0,60,1,2,-1,3.81126500247046,4.25857930403436,-0.447314301563893,32,29,3,41,44,-3,63,54,9,2,3,0,0
"16769","OTT","L.A",2011020721,15362,20112012,0,60,1,4,-3,5.10268690528756,5.52512928431679,-0.422442379029235,28,34,-6,44,49,-5,54,59,-5,5,5,0,0
"16770","OTT","BOS",2011020736,15370,20112012,0,60,3,4,-1,5.46567198321827,3.28725125174969,2.17842073146858,33,30,3,49,37,12,65,48,17,0,4,0,0
"16771","OTT","NYI",2011020762,15373,20112012,1,62.5833333333333,1,2,-1,2.5376264306251,3.79459910726291,-1.25697267663782,24,32,-8,36,41,-5,63,56,7,2,2,0,0
"16772","OTT","TOR",2011020771,15374,20112012,1,60,0,5,-5,6.5162147041774,5.20867715783041,1.30753754634699,49,40,9,60,57,3,80,65,15,3,5,0,0
"16773","OTT","STL",2011020791,15377,20112012,1,60,1,3,-2,5.55905715271365,3.93053769360995,1.6285194591037,29,18,11,44,25,19,64,35,29,5,2,0,0
"16774","OTT","NSH",2011020807,15379,20112012,1,60,4,3,1,4.38058623081105,3.72474694333312,0.655839287477927,29,27,2,44,36,8,67,55,12,6,5,0,0
"16775","OTT","EDM",2011020820,15381,20112012,1,60.2833333333333,3,4,-1,6.18132239453832,4.10911154164933,2.07221085288899,42,40,2,56,47,9,73,63,10,2,2,0,0
"16776","OTT","T.B",2011020840,15384,20112012,0,60,4,0,4,5.76601501437835,5.61368148995098,0.152333524427377,27,28,-1,36,42,-6,48,51,-3,3,2,0,0
"16777","OTT","FLA",2011020848,15385,20112012,0,60,6,2,4,3.41588120304678,3.93528444352078,-0.519403240474002,31,44,-13,42,57,-15,61,67,-6,4,5,0,0
"16778","OTT","NYI",2011020883,15390,20112012,0,60,6,0,6,4.36297440585258,3.4679526550247,0.89502175082788,32,28,4,43,37,6,55,44,11,5,3,0,0
"16779","OTT","WSH",2011020896,15392,20112012,1,60,5,2,3,3.02920537549873,4.15337796217864,-1.12417258667991,26,35,-9,30,48,-18,46,63,-17,3,5,0,0
"16780","OTT","BOS",2011020919,15395,20112012,1,60,3,5,-2,9.80592677684035,5.77901426548488,4.02691251135548,30,38,-8,44,50,-6,61,61,0,2,2,0,0
"16781","OTT","NYI",2011020928,15396,20112012,1,60,5,2,3,6.54037299356423,3.04824410419678,3.49212888936745,24,30,-6,39,42,-3,57,50,7,3,1,0,0
"16782","OTT","BOS",2011020937,15398,20112012,0,60,1,0,1,4.33501667581731,5.15875501739981,-0.823738341582491,38,32,6,48,46,2,59,64,-5,3,4,0,0
"16783","OTT","CHI",2011020960,15401,20112012,1,60,1,2,-1,0,0,0,26,39,-13,38,50,-12,55,62,-7,2,4,0,0
"16784","OTT","FLA",2011020977,15403,20112012,0,60,2,4,-2,2.31669376999044,4.8945375578478,-2.57784378785735,25,28,-3,38,39,-1,63,46,17,2,4,0,0
"16785","OTT","T.B",2011020989,15405,20112012,0,60,7,3,4,5.70804552236223,4.18023163245516,1.52781388990707,35,28,7,46,36,10,55,44,11,3,3,0,0
"16786","OTT","NYR",2011021003,15407,20112012,1,60,4,1,3,3.92087117032401,4.81946979416534,-0.898598623841337,22,26,-4,34,38,-4,45,53,-8,3,5,0,0
"16787","OTT","MTL",2011021047,15413,20112012,0,65,2,2,0,5.93353368903627,3.30556191715486,2.6279717718814,37,26,11,49,41,8,71,61,10,5,4,0,0
"16788","OTT","MTL",2011021060,15415,20112012,1,63.1166666666667,2,1,1,6.78072972601285,1.51180069443123,5.26892903158162,33,14,19,54,17,37,79,28,51,10,5,0,0
"16789","OTT","TOR",2011021069,15416,20112012,1,60,1,3,-2,5.82477936777286,2.47597060205393,3.34880876571893,30,18,12,49,24,25,76,34,42,6,7,0,0
"16790","OTT","N.J",2011021092,15419,20112012,1,60,0,1,-1,5.06693506084796,3.4545178269544,1.61241723389356,34,34,0,41,46,-5,57,56,1,4,4,0,0
"16791","OTT","MTL",2011021114,15422,20112012,0,60,1,5,-4,8.54024301296454,6.32378237563466,2.21646063732987,38,32,6,52,39,13,67,48,19,6,11,0,0
"16792","OTT","WPG",2011021136,15425,20112012,0,60,6,4,2,4.44282219717792,6.55825865244941,-2.1154364552715,35,48,-13,46,64,-18,59,80,-21,2,5,0,0
"16793","OTT","PHI",2011021170,15430,20112012,0,65,3,3,0,3.6230078261984,7.03809201519471,-3.4150841889963,29,39,-10,45,52,-7,63,69,-6,5,6,0,0
"16794","OTT","NYI",2011021181,15431,20112012,0,60,5,1,4,2.65197274682305,3.40963430116481,-0.757661554341759,32,30,2,42,39,3,64,50,14,3,3,0,0
"16795","OTT","CAR",2011021193,15433,20112012,1,60,1,2,-1,4.99275795911663,4.14381278791552,0.848945171201104,39,31,8,52,37,15,69,44,25,6,4,0,0
"16796","OTT","BOS",2011021207,15435,20112012,1,60,1,3,-2,5.79684424638221,5.16667261984432,0.630171626537885,45,27,18,63,32,31,85,40,45,4,4,0,0
"16797","OTT","N.J",2011021217,15437,20112012,0,60,2,4,-2,4.11154013383202,4.95636440860471,-0.844824274772691,33,35,-2,35,41,-6,45,45,0,2,3,0,0
"16798","OTT","NYR",2011030111,15442,20112012,0,60,2,4,-2,3.23202323477017,4.85376933991347,-1.6217461051433,32,31,1,44,47,-3,64,59,5,4,5,0,0
"16799","OTT","NYR",2011030112,15444,20112012,0,61.2833333333333,3,2,1,5.14258497407683,3.20211542378064,1.94046955029619,32,29,3,49,39,10,74,49,25,3,4,0,0
"16800","OTT","NYR",2011030113,15446,20112012,1,60,0,1,-1,8.37882599157456,4.30697837596386,4.0718476156107,39,23,16,55,31,24,76,48,28,5,5,0,0
"16801","OTT","NYR",2011030114,15448,20112012,1,62.7,3,2,1,8.58690793942052,5.7999032586813,2.78700468073922,31,33,-2,55,41,14,85,49,36,5,7,0,0
"16802","OTT","NYR",2011030115,15451,20112012,0,60,2,0,2,4.59306243409038,5.96445762156642,-1.37139518747605,30,41,-11,42,50,-8,61,60,1,5,5,0,0
"16803","OTT","NYR",2011030116,15453,20112012,1,60,2,3,-1,5.21499961598863,3.84402678720653,1.3709728287821,27,22,5,36,35,1,53,50,3,5,7,0,0
"16804","OTT","NYR",2011030117,15456,20112012,0,60,1,2,-1,4.53352419580551,3.03016972279875,1.50335447300677,27,29,-2,40,43,-3,63,51,12,2,3,0,0
"16805","OTT","WPG",2012020002,15724,20122013,0,60,4,1,3,4.11623736466299,4.75077410705853,-0.634536742395539,37,28,9,51,44,7,61,58,3,3,7,0,0
"16806","OTT","FLA",2012020024,15726,20122013,1,60,4,0,4,4.82934358928292,3.92589914416914,0.903444445113776,37,31,6,44,37,7,62,50,12,4,3,0,0
"16807","OTT","FLA",2012020044,15729,20122013,0,60,3,1,2,5.60497611548635,2.62375677673845,2.98121933874791,37,26,11,45,35,10,64,50,14,4,5,0,0
"16808","OTT","T.B",2012020053,15730,20122013,0,60,4,6,-2,4.87316918131251,7.20943619325226,-2.33626701193975,36,31,5,50,45,5,69,59,10,6,7,0,0
"16809","OTT","WSH",2012020082,15734,20122013,1,60,3,2,1,5.82502478103561,4.3522039426025,1.47282083843311,27,33,-6,40,39,1,52,48,4,6,4,0,0
"16810","OTT","MTL",2012020088,15735,20122013,1,60,5,1,4,4.46608849651511,3.70831437118678,0.757774125328332,27,32,-5,36,44,-8,51,63,-12,8,9,0,0
"16811","OTT","CAR",2012020102,15737,20122013,0,60,0,1,-1,5.43852333803557,3.27902877944276,2.15949455859281,33,35,-2,48,44,4,67,55,12,3,4,0,0
"16812","OTT","MTL",2012020120,15739,20122013,0,60,1,2,-1,5.5600803568534,4.1274768175208,1.4326035393326,33,32,1,43,48,-5,68,60,8,4,6,0,0
"16813","OTT","CAR",2012020147,15743,20122013,1,62.3166666666667,2,3,-1,6.21144056803314,4.47679429607524,1.7346462719579,47,26,21,64,37,27,88,54,34,3,2,0,0
"16814","OTT","WPG",2012020157,15745,20122013,1,60,0,1,-1,8.91887440952996,3.85386791739768,5.06500649213228,33,37,-4,56,48,8,78,55,23,3,1,0,0
"16815","OTT","TOR",2012020205,15752,20122013,0,60,0,3,-3,3.95474151366198,6.76183912614943,-2.80709761248744,34,29,5,49,40,9,68,50,18,4,2,0,0
"16816","OTT","N.J",2012020219,15754,20122013,0,65,1,1,0,4.38218970883967,4.02284787578547,0.359341833054195,30,31,-1,39,41,-2,43,49,-6,6,7,0,0
"16817","OTT","NYI",2012020228,15755,20122013,1,60,3,1,2,4.7741970710631,7.34637063994887,-2.57217356888577,26,38,-12,41,51,-10,54,66,-12,5,4,0,0
"16818","OTT","NYR",2012020242,15757,20122013,1,65,2,2,0,7.34276037944887,8.09167363488814,-0.748913255439271,37,34,3,48,50,-2,65,70,-5,2,4,0,0
"16819","OTT","TOR",2012020256,15759,20122013,1,60,3,2,1,5.16956896390184,3.80473492279998,1.36483404110186,35,28,7,43,38,5,65,56,9,1,2,0,0
"16820","OTT","MTL",2012020271,15761,20122013,1,65,1,1,0,3.98333313316726,4.72663412816473,-0.743300994997478,24,45,-21,33,56,-23,42,68,-26,1,4,0,0
"16821","OTT","BOS",2012020288,15764,20122013,0,63.6333333333333,1,2,-1,5.39477505320834,3.40254501573338,1.99223003747496,31,46,-15,45,57,-12,60,71,-11,5,3,0,0
"16822","OTT","PHI",2012020302,15766,20122013,0,60,1,2,-1,5.37269992443489,4.10832223574049,1.2643776886944,34,41,-7,51,54,-3,66,75,-9,4,5,0,0
"16823","OTT","NYI",2012020312,15767,20122013,0,65,2,2,0,4.36488193221157,5.93707900051959,-1.57219706830801,31,35,-4,44,50,-6,60,74,-14,3,5,0,0
"16824","OTT","TOR",2012020335,15770,20122013,0,60,4,5,-1,7.51168240206619,2.07599265612589,5.43568974594029,43,28,15,71,40,31,97,52,45,1,2,0,0
"16825","OTT","NYR",2012020350,15772,20122013,0,60,3,2,1,6.23485110254842,3.12004424049519,3.11480686205323,39,35,4,54,47,7,77,58,19,4,3,0,0
"16826","OTT","BOS",2012020375,15775,20122013,1,65,2,2,0,5.30511795167877,4.9922452022717,0.312872749407063,32,35,-3,38,52,-14,49,64,-15,3,4,0,0
"16827","OTT","MTL",2012020388,15777,20122013,0,65,3,3,0,4.31430288463525,5.84649345441721,-1.53219056978196,32,45,-13,42,58,-16,64,80,-16,5,7,0,0
"16828","OTT","WPG",2012020419,15781,20122013,1,60,4,1,3,4.65662844036706,5.56258341479406,-0.905954974427004,42,26,16,55,37,18,64,46,18,4,3,0,0
"16829","OTT","NYI",2012020430,15783,20122013,0,60,5,3,2,4.7358664742954,4.33081194170518,0.405054532590219,23,29,-6,33,37,-4,48,49,-1,1,6,0,0
"16830","OTT","BOS",2012020447,15785,20122013,1,60,1,2,-1,6.90797275450313,6.14433416805696,0.763638586446177,28,29,-1,39,42,-3,56,57,-1,1,3,0,0
"16831","OTT","T.B",2012020456,15787,20122013,1,60,5,3,2,0,0,0,32,32,0,42,38,4,55,56,-1,3,5,0,0
"16832","OTT","N.J",2012020473,15789,20122013,1,65,2,2,0,2.87211500182093,5.88703367277049,-3.01491867094956,14,34,-20,21,52,-31,34,67,-33,1,1,0,0
"16833","OTT","NYR",2012020495,15792,20122013,1,60,3,0,3,3.26929256817725,2.38594438888282,0.883348179294432,29,24,5,39,37,2,55,55,0,2,4,0,0
"16834","OTT","TOR",2012020513,15794,20122013,1,60,0,4,-4,6.64644040738222,4.09670250751248,2.54973789986973,31,23,8,45,30,15,63,43,20,6,6,0,0
"16835","OTT","BOS",2012020531,15797,20122013,0,60,2,3,-1,5.50132014748855,6.28101150242173,-0.779691354933186,47,50,-3,55,64,-9,72,72,0,3,3,0,0
"16836","OTT","FLA",2012020571,15802,20122013,0,60,1,2,-1,3.85174675824237,2.06152622401714,1.79022053422523,41,17,24,55,25,30,74,32,42,5,1,0,0
"16837","OTT","T.B",2012020586,15804,20122013,0,60,2,3,-1,6.32423892711682,3.11077827445843,3.2134606526584,33,24,9,50,33,17,72,38,34,6,9,0,0
"16838","OTT","PHI",2012020598,15806,20122013,0,60,3,1,2,6.84178951801732,2.44387171901945,4.39791779899787,34,25,9,53,28,25,72,45,27,5,2,0,0
"16839","OTT","N.J",2012020605,15807,20122013,0,60,2,0,2,3.00962720911048,4.5508097095917,-1.54118250048123,11,33,-22,16,48,-32,25,58,-33,2,4,0,0
"16840","OTT","BOS",2012020624,15823,20122013,0,60,4,2,2,4.083869139115,7.6716243197734,-3.5877551806584,22,36,-14,31,52,-21,45,63,-18,3,3,0,0
"16841","OTT","CAR",2012020634,15811,20122013,1,60,3,2,1,5.04499909393809,3.90024483801972,1.14475425591837,34,34,0,41,41,0,51,60,-9,4,4,0,0
"16842","OTT","WSH",2012020647,15813,20122013,1,60,3,1,2,9.22558861538278,3.73019696539268,5.4953916499901,38,19,19,52,30,22,68,40,28,3,3,0,0
"16843","OTT","TOR",2012020663,15815,20122013,1,60,1,4,-3,8.09851027667355,3.82709682955488,4.27141344711868,50,22,28,63,29,34,90,38,52,3,4,0,0
"16844","OTT","WSH",2012020695,15820,20122013,0,60.7833333333333,2,1,1,9.5107226433247,5.20812002867901,4.30260261464569,41,20,21,52,32,20,68,43,25,6,2,0,0
"16845","OTT","PHI",2012020709,15822,20122013,1,60,1,2,-1,7.14550873808252,3.79515265027544,3.35035608780708,44,25,19,56,35,21,74,44,30,5,2,0,0
"16846","OTT","MTL",2012030121,15827,20122013,0,60,4,2,2,4.34217949251297,9.68971631592296,-5.34753682340999,31,50,-19,36,61,-25,57,80,-23,3,4,0,0
"16847","OTT","MTL",2012030122,15828,20122013,0,60,1,3,-2,3.50120171828894,4.20625871515018,-0.705056996861244,30,34,-4,37,47,-10,71,59,12,6,4,0,0
"16848","OTT","MTL",2012030123,15830,20122013,1,60,6,1,5,4.27815945310142,5.3959196124405,-1.11776015933908,30,34,-4,48,43,5,59,54,5,17,11,0,0
"16849","OTT","MTL",2012030124,15832,20122013,1,62.5333333333333,3,2,1,7.48680245107971,6.97629779548879,0.510504655590921,34,28,6,49,40,9,63,61,2,3,1,0,0
"16850","OTT","MTL",2012030125,15834,20122013,0,60,6,1,5,7.23164172056568,3.82436125930246,3.40728046126321,29,34,-5,42,48,-6,60,59,1,6,6,0,0
"16851","OTT","PIT",2012030211,15839,20122013,0,60,1,4,-3,4.67552915350063,4.42744954422437,0.24807960927626,36,30,6,50,42,8,68,48,20,9,8,0,0
"16852","OTT","PIT",2012030212,15842,20122013,0,60,3,4,-1,4.15480993730475,6.89331186289201,-2.73850192558726,22,42,-20,28,54,-26,48,62,-14,3,7,0,0
"16853","OTT","PIT",2012030213,15844,20122013,1,80,1,1,0,9.80500149071086,5.98139318125504,3.82360830945582,42,45,-3,62,57,5,89,78,11,3,6,0,0
"16854","OTT","PIT",2012030214,15847,20122013,1,60,3,7,-4,6.41248729754443,4.2058576354757,2.20662966206874,33,42,-9,47,52,-5,63,63,0,4,5,0,0
"16855","OTT","PIT",2012030215,15849,20122013,0,60,2,6,-4,5.36171708640177,5.92850773967803,-0.566790653276257,31,33,-2,43,45,-2,56,55,1,7,6,0,0
"16856","OTT","TOR",2013020022,15983,20132014,0,65,4,4,0,4.39645216417827,5.24879071481701,-0.852338550638734,36,42,-6,51,61,-10,68,80,-12,2,7,0,0
"16857","OTT","L.A",2013020047,15987,20132014,0,60.4666666666667,3,4,-1,4.87993051798003,6.13811155659027,-1.25818103861025,25,32,-7,39,52,-13,52,66,-14,5,7,0,0
"16858","OTT","S.J",2013020074,15990,20132014,0,60,2,3,-1,3.10314514616039,8.39471424639896,-5.29156910023858,23,50,-27,32,72,-40,48,87,-39,4,5,0,0
"16859","OTT","ANA",2013020078,15991,20132014,0,60,1,4,-3,5.14711912854995,5.86293110250699,-0.715811973957038,31,56,-25,47,77,-30,65,88,-23,1,6,0,0
"16860","OTT","ARI",2013020093,15993,20132014,0,62.8,4,3,1,4.5857654241466,5.02266899405222,-0.436903569905629,32,37,-5,48,50,-2,60,60,0,3,4,0,0
"16861","OTT","N.J",2013020101,15995,20132014,1,60,5,2,3,6.30121148948691,4.12596286868211,2.1752486208048,23,42,-19,31,52,-21,37,62,-25,5,7,0,0
"16862","OTT","EDM",2013020111,15997,20132014,1,60,1,3,-2,5.00712351074753,2.28327417519029,2.72384933555725,36,21,15,55,24,31,71,29,42,6,7,0,0
"16863","OTT","DET",2013020137,16001,20132014,0,60,6,1,5,3.55432746204315,5.20867753610946,-1.65435007406631,28,32,-4,41,42,-1,52,53,-1,3,3,0,0
"16864","OTT","ANA",2013020151,16003,20132014,1,60,1,2,-1,3.67070850327424,3.84974342577902,-0.179034922504784,27,28,-1,40,42,-2,58,54,4,4,5,0,0
"16865","OTT","S.J",2013020166,16005,20132014,1,60,2,5,-3,5.98424718953007,4.22878679360292,1.75546039592714,40,29,11,53,41,12,69,53,16,3,3,0,0
"16866","OTT","CHI",2013020180,16007,20132014,0,60,5,6,-1,7.069558269759,4.36438582003843,2.70517244972057,37,40,-3,49,51,-2,59,62,-3,2,3,0,0
"16867","OTT","NYI",2013020194,16010,20132014,1,65,4,4,0,5.19996391638489,10.1520836641794,-4.95211974779448,31,57,-26,37,78,-41,59,90,-31,3,5,0,0
"16868","OTT","DAL",2013020212,16012,20132014,1,65,3,3,0,5.34993067926067,4.80470999896806,0.545220680292601,36,39,-3,47,50,-3,62,61,1,4,4,0,0
"16869","OTT","CBJ",2013020219,16014,20132014,0,60,4,1,3,3.31447759067123,4.2290069540586,-0.914529363387373,24,33,-9,39,48,-9,51,60,-9,4,4,0,0
"16870","OTT","MTL",2013020231,16016,20132014,1,60,4,1,3,4.60862390651891,2.32423700993641,2.2843868965825,24,34,-10,32,50,-18,54,68,-14,7,7,0,0
"16871","OTT","FLA",2013020246,16018,20132014,1,60,3,2,1,5.59686018325381,3.86824021082336,1.72861997243045,32,28,4,43,45,-2,54,58,-4,4,6,0,0
"16872","OTT","PHI",2013020269,16021,20132014,1,60,0,5,-5,5.31440180905338,5.46023927733768,-0.145837468284299,24,31,-7,36,40,-4,49,52,-3,1,3,0,0
"16873","OTT","BOS",2013020289,16024,20132014,1,60,4,2,2,7.04305475215733,6.8928238264416,0.150230925715732,31,32,-1,43,44,-1,56,56,0,2,1,0,0
"16874","OTT","CBJ",2013020303,16026,20132014,1,60,1,4,-3,5.28750629918068,4.9546275796686,0.332878719512081,30,22,8,43,34,9,65,46,19,7,4,0,0
"16875","OTT","PHI",2013020314,16028,20132014,0,60,2,5,-3,7.00002755171464,7.34957061242963,-0.349543060714986,34,42,-8,39,53,-14,53,71,-18,8,5,0,0
"16876","OTT","MIN",2013020322,16029,20132014,1,60,3,4,-1,5.79849710425781,5.29769821089576,0.500798893362054,37,25,12,45,36,9,66,42,24,3,4,0,0
"16877","OTT","DET",2013020345,16032,20132014,0,60,4,2,2,2.97971101902658,4.78230842079211,-1.80259740176552,29,36,-7,39,49,-10,48,59,-11,8,9,0,0
"16878","OTT","CAR",2013020354,16033,20132014,0,60,1,4,-3,6.98675775929587,7.33687604045554,-0.350118281159666,36,37,-1,53,55,-2,67,76,-9,2,4,0,0
"16879","OTT","WSH",2013020368,16036,20132014,0,60,6,4,2,6.23841256619198,3.66834328841651,2.57006927777547,41,33,8,58,41,17,67,51,16,9,7,0,0
"16880","OTT","VAN",2013020378,16037,20132014,1,60,2,5,-3,7.95938880642416,5.12395729556283,2.83543151086133,39,28,11,49,37,12,68,49,19,4,4,0,0
"16881","OTT","DET",2013020404,16040,20132014,1,60,2,4,-2,4.17311153973671,4.33477853694811,-0.161666997211402,32,23,9,46,27,19,67,39,28,4,1,0,0
"16882","OTT","FLA",2013020414,16042,20132014,0,60,4,2,2,4.5158163036408,4.9966479425384,-0.480831638897598,45,32,13,55,41,14,71,52,19,8,4,0,0
"16883","OTT","T.B",2013020426,16044,20132014,0,60,1,3,-2,5.76830700000028,2.43514837532712,3.33315862467316,34,22,12,49,32,17,65,39,26,5,4,0,0
"16884","OTT","TOR",2013020440,16046,20132014,1,65,3,3,0,9.32042230261697,3.2988883946673,6.02153390794967,50,31,19,72,43,29,90,51,39,8,6,0,0
"16885","OTT","PHI",2013020454,16048,20132014,1,65,4,4,0,7.65663799873437,6.74880916450638,0.907828834227985,34,29,5,52,38,14,70,54,16,3,2,0,0
"16886","OTT","L.A",2013020488,16053,20132014,1,60,2,5,-3,6.08494737397996,3.18296320811271,2.90198416586725,39,26,13,51,34,17,65,48,17,5,4,0,0
"16887","OTT","STL",2013020507,16055,20132014,1,63.9833333333333,3,2,1,9.54719089774881,5.2417395505181,4.3054513472307,32,32,0,49,39,10,66,51,15,4,3,0,0
"16888","OTT","N.J",2013020521,16057,20132014,0,60,2,5,-3,2.51698713171253,3.51816863498675,-1.00118150327422,25,33,-8,32,38,-6,38,43,-5,4,5,0,0
"16889","OTT","FLA",2013020527,16058,20132014,1,60,2,4,-2,4.42098624646314,6.11790862272365,-1.6969223762605,34,35,-1,49,47,2,59,64,-5,4,4,0,0
"16890","OTT","ARI",2013020539,16060,20132014,1,62.3833333333333,3,4,-1,5.42988327901347,4.61443632826707,0.815446950746398,40,38,2,53,49,4,66,63,3,11,10,0,0
"16891","OTT","BOS",2013020567,16066,20132014,0,60,0,5,-5,5.3238444416996,7.67526062908857,-2.35141618738897,33,42,-9,43,51,-8,57,67,-10,4,3,0,0
"16892","OTT","BOS",2013020577,16067,20132014,1,60,4,3,1,3.67034495150074,5.11191846744623,-1.44157351594549,30,32,-2,41,53,-12,63,61,2,2,4,0,0
"16893","OTT","WSH",2013020595,16069,20132014,1,60,3,1,2,7.57856569950809,3.99373802472257,3.58482767478552,38,35,3,49,50,-1,60,65,-5,4,2,0,0
"16894","OTT","WPG",2013020615,16072,20132014,1,60,4,3,1,5.45775169038097,4.67855150172545,0.779200188655523,29,35,-6,38,48,-10,56,62,-6,3,1,0,0
"16895","OTT","MTL",2013020630,16074,20132014,0,60.9666666666667,4,3,1,5.7798947384581,2.28369695844594,3.49619778001215,34,29,5,42,40,2,61,53,8,4,5,0,0
"16896","OTT","COL",2013020659,16078,20132014,0,60.55,3,4,-1,4.56193337051903,4.92497334981454,-0.363039979295507,32,31,1,47,45,2,64,57,7,3,1,0,0
"16897","OTT","NSH",2013020678,16081,20132014,0,65,1,1,0,5.33298356566229,5.32892797962815,0.00405558603414136,21,33,-12,38,49,-11,55,61,-6,2,3,0,0
"16898","OTT","MIN",2013020705,16084,20132014,0,60,3,0,3,2.76100409928767,5.19712875498226,-2.43612465569458,32,27,5,40,35,5,51,48,3,5,3,0,0
"16899","OTT","MTL",2013020712,16086,20132014,1,60.3833333333333,4,5,-1,3.98348530488392,3.32241272361716,0.661072581266759,44,23,21,53,33,20,67,41,26,1,1,0,0
"16900","OTT","NYR",2013020723,16088,20132014,1,60,1,4,-3,4.21938270284939,4.28597523255372,-0.0665925297043355,30,31,-1,44,44,0,55,62,-7,3,5,0,0
"16901","OTT","WSH",2013020750,16091,20132014,0,60,2,0,2,3.94523031799418,2.15419623896186,1.79103407903232,26,34,-8,42,43,-1,54,53,1,5,5,0,0
"16902","OTT","T.B",2013020762,16093,20132014,0,65,3,3,0,6.65545987093719,3.15094401789247,3.50451585304472,36,38,-2,54,45,9,80,49,31,3,2,0,0
"16903","OTT","CAR",2013020770,16095,20132014,0,60,3,6,-3,6.20284711373036,6.73150997989183,-0.528662866161469,26,32,-6,45,44,1,59,51,8,3,4,0,0
"16904","OTT","CBJ",2013020798,16098,20132014,0,60,3,2,1,2.53261177925742,5.24701280620008,-2.71440102694265,28,36,-8,37,48,-11,62,60,2,6,7,0,0
"16905","OTT","T.B",2013020812,16100,20132014,1,60,5,3,2,8.06533336635201,6.60946815108036,1.45586521527164,28,38,-10,40,50,-10,56,63,-7,2,2,0,0
"16906","OTT","TOR",2013020828,16102,20132014,0,60,3,6,-3,4.24715473598438,5.40442089973476,-1.15726616375038,26,36,-10,43,45,-2,60,59,1,3,6,0,0
"16907","OTT","STL",2013020850,16105,20132014,0,65,4,4,0,4.57112663774489,6.63062630867353,-2.05949967092864,31,50,-19,39,64,-25,50,76,-26,3,9,0,0
"16908","OTT","BOS",2013020874,16109,20132014,0,60,2,7,-5,4.3953901504579,6.39030506238578,-1.99491491192788,28,42,-14,37,60,-23,43,69,-26,3,4,0,0
"16909","OTT","DET",2013020891,16128,20132014,1,60,1,6,-5,4.02620948031836,2.78696140274405,1.2392480775743,38,26,12,53,30,23,66,37,29,7,5,0,0
"16910","OTT","VAN",2013020915,16131,20132014,0,60,4,2,2,0,0,0,28,31,-3,39,40,-1,47,52,-5,6,6,0,0
"16911","OTT","EDM",2013020932,16133,20132014,0,60,2,3,-1,4.53985679517064,4.75472126493696,-0.214864469766326,36,30,6,53,38,15,73,47,26,3,3,0,0
"16912","OTT","CGY",2013020936,16134,20132014,0,60,1,4,-3,4.49710029109022,3.89759080522163,0.599509485868595,31,28,3,43,39,4,60,43,17,7,9,0,0
"16913","OTT","WPG",2013020953,16137,20132014,0,60,5,3,2,5.75187573694575,5.29856255382765,0.453313183118098,32,49,-17,40,64,-24,47,76,-29,6,9,0,0
"16914","OTT","NSH",2013020969,16139,20132014,1,63.8166666666667,3,4,-1,11.3315407255432,6.02837259991202,5.30316812563115,37,42,-5,48,58,-10,65,70,-5,1,3,0,0
"16915","OTT","MTL",2013021006,16144,20132014,0,61.4333333333333,4,5,-1,5.81918801912241,6.11372774840856,-0.294539729286157,34,48,-14,47,61,-14,61,86,-25,4,8,0,0
"16916","OTT","COL",2013021017,16145,20132014,1,60,1,3,-2,4.68993600493246,5.53112102138766,-0.841185016455199,39,22,17,57,30,27,76,38,38,2,1,0,0
"16917","OTT","NYR",2013021031,16147,20132014,1,60,4,8,-4,4.45514770442969,7.04133450242807,-2.58618679799838,39,39,0,52,52,0,72,65,7,2,3,0,0
"16918","OTT","T.B",2013021045,16149,20132014,1,60,4,5,-1,5.21538324111316,3.78562000324018,1.42976323787298,31,28,3,45,30,15,61,37,24,6,7,0,0
"16919","OTT","DAL",2013021058,16151,20132014,0,60,1,3,-2,3.27673926022474,4.17613832827692,-0.899399068052183,27,44,-17,46,54,-8,60,70,-10,9,9,0,0
"16920","OTT","T.B",2013021076,16153,20132014,0,65,3,3,0,4.25162499929866,7.72891028947197,-3.47728529017331,32,38,-6,46,55,-9,67,62,5,5,9,0,0
"16921","OTT","FLA",2013021084,16154,20132014,0,65,2,2,0,4.62318344464029,6.66007580367784,-2.03689235903755,39,41,-2,56,60,-4,65,70,-5,2,2,0,0
"16922","OTT","CHI",2013021104,16157,20132014,1,60,5,3,2,3.4882271392853,6.12054738905499,-2.63232024976969,29,49,-20,39,57,-18,56,73,-17,2,7,0,0
"16923","OTT","CGY",2013021119,16159,20132014,1,60,6,3,3,5.16790774854599,6.32148488190294,-1.15357713335696,37,40,-3,51,50,1,68,62,6,2,3,0,0
"16924","OTT","CAR",2013021125,16160,20132014,1,65,1,1,0,9.60228536358521,4.32891085801285,5.27337450557236,29,31,-2,52,48,4,70,57,13,3,4,0,0
"16925","OTT","NYI",2013021140,16162,20132014,1,60,1,2,-1,7.1239233227353,3.0341777273527,4.0897455953826,36,27,9,61,40,21,86,52,34,5,4,0,0
"16926","OTT","MTL",2013021153,16164,20132014,1,60,4,7,-3,6.55616085218123,3.97745385677266,2.57870699540857,43,23,20,64,27,37,78,30,48,7,6,0,0
"16927","OTT","NYR",2013021166,16165,20132014,0,60,3,2,1,4.70603712805314,8.00955334390457,-3.30351621585143,34,43,-9,44,57,-13,57,78,-21,3,4,0,0
"16928","OTT","NYI",2013021181,16168,20132014,0,60,4,1,3,3.71245120494885,3.65585910232782,0.0565921026210301,32,46,-14,48,58,-10,56,64,-8,7,5,0,0
"16929","OTT","N.J",2013021197,16170,20132014,1,65,1,1,0,2.72195292903291,6.38933151913746,-3.66737859010455,32,39,-7,46,46,0,62,60,2,4,2,0,0
"16930","OTT","TOR",2013021215,16172,20132014,1,60,1,0,1,5.63262389582553,5.78536764636374,-0.152743750538205,37,28,9,49,41,8,74,49,25,3,4,0,0
"16931","OTT","NSH",2014020012,16352,20142015,0,60,2,3,-1,4.84562897478463,5.75664662952886,-0.911017654744228,20,37,-17,31,52,-21,43,62,-19,5,4,0,0
"16932","OTT","T.B",2014020021,16354,20142015,0,65,2,2,0,4.24076648952905,4.13945337964021,0.10131310988884,34,40,-6,44,53,-9,59,63,-4,4,4,0,0
"16933","OTT","FLA",2014020037,16356,20142015,0,60,1,0,1,4.04030327728469,3.26771988945848,0.772583387826216,23,30,-7,33,42,-9,42,55,-13,6,4,0,0
"16934","OTT","COL",2014020054,16359,20142015,1,60,5,3,2,4.50488419091562,4.91700374808502,-0.412119557169397,28,31,-3,38,42,-4,58,54,4,8,6,0,0
"16935","OTT","CBJ",2014020065,16361,20142015,1,60,3,2,1,5.95448143051135,4.36094820812286,1.59353322238849,35,40,-5,45,54,-9,56,68,-12,5,5,0,0
"16936","OTT","TOR",2014020089,16383,20142015,1,60,3,5,-2,4.60925634261912,3.96844215994382,0.6408141826753,41,30,11,54,44,10,71,50,21,4,3,0,0
"16937","OTT","N.J",2014020109,16368,20142015,1,63.65,2,3,-1,3.82958301377948,6.2843874651735,-2.45480445139401,35,29,6,42,41,1,63,53,10,5,6,0,0
"16938","OTT","CHI",2014020119,16369,20142015,0,60,1,2,-1,5.98291504717162,6.54429135105759,-0.561376303885964,33,45,-12,47,50,-3,60,63,-3,5,9,0,0
"16939","OTT","CBJ",2014020128,16371,20142015,0,60,5,2,3,5.58387738412148,5.69456365844235,-0.110686274320869,34,38,-4,46,54,-8,58,63,-5,3,4,0,0
"16940","OTT","CHI",2014020141,16373,20142015,1,65,4,4,0,7.94402647754481,6.0406289042471,1.90339757329771,32,39,-7,53,53,0,68,70,-2,7,6,0,0
"16941","OTT","BOS",2014020153,16375,20142015,0,60,2,4,-2,5.56544577485314,8.75986297619238,-3.19441720133924,29,30,-1,35,45,-10,45,62,-17,1,3,0,0
"16942","OTT","DET",2014020178,16378,20142015,1,60,3,1,2,3.96182071868793,5.91268781041435,-1.95086709172642,32,32,0,43,49,-6,57,62,-5,4,3,0,0
"16943","OTT","MIN",2014020189,16380,20142015,1,60,3,0,3,1.93756858730922,5.49439017745561,-3.5568215901464,17,35,-18,28,41,-13,40,54,-14,7,5,0,0
"16944","OTT","WPG",2014020206,16382,20142015,1,65,1,1,0,6.81500422010413,5.90884352959622,0.906160690507907,38,37,1,51,47,4,69,63,6,3,3,0,0
"16945","OTT","VAN",2014020230,16385,20142015,0,64.0833333333333,3,4,-1,5.15815105401634,8.4371474186355,-3.27899636461916,24,37,-13,29,47,-18,42,57,-15,1,2,0,0
"16946","OTT","EDM",2014020240,16387,20142015,0,62.65,4,3,1,2.31266460274834,3.92440516034549,-1.61174055759714,30,37,-7,39,49,-10,49,55,-6,5,5,0,0
"16947","OTT","CGY",2014020259,16389,20142015,0,60,2,4,-2,2.18293503684981,2.65384165629803,-0.470906619448215,25,25,0,36,35,1,51,45,6,6,2,0,0
"16948","OTT","NSH",2014020283,16394,20142015,1,60,3,2,1,2.80298474943265,5.89179604898527,-3.08881129955262,19,35,-16,34,50,-16,47,59,-12,4,3,0,0
"16949","OTT","STL",2014020295,16396,20142015,1,60,2,3,-1,4.65719818198704,2.324465849719,2.33273233226805,26,33,-7,40,44,-4,57,55,2,5,5,0,0
"16950","OTT","DET",2014020314,16398,20142015,0,60,3,4,-1,5.43745861267263,6.31088973009446,-0.873431117421831,26,43,-17,36,54,-18,52,62,-10,4,6,0,0
"16951","OTT","STL",2014020317,16399,20142015,0,65,2,2,0,5.5169427517283,5.54745284051276,-0.0305100887844603,33,29,4,49,41,8,74,47,27,5,8,0,0
"16952","OTT","FLA",2014020341,16402,20142015,0,60,2,3,-1,3.40284638051526,3.13814253939927,0.264703841115988,24,46,-22,30,57,-27,39,72,-33,3,3,0,0
"16953","OTT","T.B",2014020346,16403,20142015,0,60,1,4,-3,5.86791919596555,4.81196102176909,1.05595817419646,27,32,-5,39,42,-3,50,59,-9,2,3,0,0
"16954","OTT","NYI",2014020363,16406,20142015,0,63.1,2,3,-1,4.75141305621946,4.52843563398346,0.222977422235999,18,28,-10,33,41,-8,47,58,-11,1,2,0,0
"16955","OTT","NYI",2014020379,16408,20142015,1,60,1,2,-1,6.40696130361175,3.86024487874238,2.54671642486937,21,25,-4,41,36,5,63,48,15,3,3,0,0
"16956","OTT","VAN",2014020404,16411,20142015,1,61.35,4,3,1,7.0719069209589,3.71969721045753,3.35220971050137,45,33,12,64,37,27,89,48,41,7,3,0,0
"16957","OTT","L.A",2014020425,16415,20142015,1,60,3,5,-2,5.75547189424833,7.95577076182235,-2.20029886757402,35,36,-1,47,49,-2,68,65,3,2,4,0,0
"16958","OTT","BOS",2014020435,16417,20142015,0,65,2,2,0,4.1674134156201,6.47747121971571,-2.31005780409561,31,31,0,39,47,-8,57,61,-4,3,1,0,0
"16959","OTT","N.J",2014020464,16421,20142015,0,60,2,0,2,3.76539628510363,3.3468883332971,0.418507951806532,16,34,-18,20,44,-24,25,58,-33,2,5,0,0
"16960","OTT","ANA",2014020475,16423,20142015,1,60,6,2,4,3.29534355996293,5.39230450652394,-2.09696094656101,31,34,-3,39,45,-6,51,66,-15,2,3,0,0
"16961","OTT","MTL",2014020482,16424,20142015,0,60,1,4,-3,2.28519357213046,4.17960353265516,-1.89440996052471,25,29,-4,38,36,2,61,54,7,3,4,0,0
"16962","OTT","WSH",2014020497,16426,20142015,0,60,1,2,-1,3.53943656401248,4.51970446284903,-0.980267898836559,39,23,16,49,40,9,67,59,8,3,4,0,0
"16963","OTT","DET",2014020515,16431,20142015,1,64.2,2,3,-1,4.0775809159386,3.54944898222311,0.528131933715486,33,27,6,48,40,8,68,47,21,6,4,0,0
"16964","OTT","BOS",2014020566,16438,20142015,0,60.7333333333333,3,2,1,4.4851003845688,4.2576987411594,0.227401643409394,26,28,-2,36,41,-5,44,57,-13,5,3,0,0
"16965","OTT","T.B",2014020578,16439,20142015,1,60,2,4,-2,1.44146642386268,4.47082812207584,-3.02936169821316,22,30,-8,30,40,-10,42,60,-18,4,9,0,0
"16966","OTT","PHI",2014020585,16441,20142015,0,65,1,1,0,7.48068957415795,6.02944199341488,1.45124758074306,42,34,8,57,47,10,84,60,24,4,4,0,0
"16967","OTT","COL",2014020604,16443,20142015,0,60,2,5,-3,3.32530379127925,1.62659981900288,1.69870397227638,38,21,17,48,25,23,73,29,44,4,2,0,0
"16968","OTT","ARI",2014020619,16445,20142015,0,60,5,1,4,3.57230945536867,5.18114726975909,-1.60883781439043,33,32,1,42,39,3,56,50,6,5,5,0,0
"16969","OTT","DAL",2014020638,16448,20142015,0,60,4,5,-1,8.0287128444761,5.26344170517632,2.76527113929978,41,29,12,52,42,10,73,54,19,3,3,0,0
"16970","OTT","MTL",2014020647,16450,20142015,1,60,4,1,3,4.04235129389053,4.81942808918834,-0.777076795297802,35,26,9,47,42,5,65,61,4,4,4,0,0
"16971","OTT","CAR",2014020663,16452,20142015,1,60,2,3,-1,4.08437608588554,6.05546843488212,-1.97109234899659,32,28,4,48,43,5,68,53,15,2,4,0,0
"16972","OTT","NYR",2014020683,16455,20142015,0,62.9166666666667,2,3,-1,5.4577018803684,7.59298422788311,-2.1352823475147,35,35,0,42,46,-4,58,60,-2,2,3,0,0
"16973","OTT","TOR",2014020691,16456,20142015,1,60,4,3,1,4.65110116325447,4.89124169794442,-0.240140534689949,26,40,-14,36,54,-18,49,66,-17,3,4,0,0
"16974","OTT","DAL",2014020715,16464,20142015,1,60,3,6,-3,3.72464791790139,5.7047191275295,-1.98007120962811,28,41,-13,35,56,-21,54,65,-11,6,4,0,0
"16975","OTT","ARI",2014020729,16466,20142015,1,60,7,2,5,4.14690217858879,5.59101224463666,-1.44411006604787,31,37,-6,47,44,3,63,60,3,6,4,0,0
"16976","OTT","N.J",2014020745,16469,20142015,0,60,1,2,-1,2.42794154177034,2.13074558367884,0.297195958091502,20,19,1,27,27,0,39,28,11,1,3,0,0
"16977","OTT","WSH",2014020761,16471,20142015,1,60,1,2,-1,3.38205967690078,3.57914049733404,-0.197080820433257,26,29,-3,37,41,-4,50,59,-9,6,3,0,0
"16978","OTT","CBJ",2014020779,16473,20142015,1,60,1,4,-3,2.9511611078342,4.62126580922755,-1.67010470139336,35,33,2,50,39,11,65,51,14,3,1,0,0
"16979","OTT","EDM",2014020823,16480,20142015,1,60,7,2,5,7.19973955219393,6.2270655373438,0.972674014850135,42,27,15,53,38,15,66,49,17,2,2,0,0
"16980","OTT","CAR",2014020839,16482,20142015,1,60,3,6,-3,4.28171950438263,4.60662178971688,-0.324902285334251,32,36,-4,49,43,6,66,56,10,3,5,0,0
"16981","OTT","MTL",2014020853,16484,20142015,1,60,4,2,2,7.46633731648035,8.02713672752716,-0.560799411046816,39,44,-5,51,52,-1,69,63,6,3,2,0,0
"16982","OTT","ANA",2014020907,16491,20142015,0,60,3,0,3,5.16803955830624,3.18122334681729,1.98681621148895,34,25,9,45,40,5,57,56,1,4,2,0,0
"16983","OTT","L.A",2014020915,16492,20142015,0,60,1,0,1,2.84176673711045,7.28530129627325,-4.4435345591628,28,35,-7,38,56,-18,48,70,-22,3,4,0,0
"16984","OTT","S.J",2014020932,16494,20142015,0,60,4,2,2,3.9760237622977,3.24452571122674,0.731498051070957,31,30,1,45,43,2,66,60,6,4,3,0,0
"16985","OTT","MIN",2014020947,16497,20142015,0,65,2,2,0,7.70615648754866,6.17156456372672,1.53459192382194,33,38,-5,46,47,-1,63,58,5,4,3,0,0
"16986","OTT","WPG",2014020952,16498,20142015,0,60,3,1,2,3.22700094898227,6.03755602258025,-2.81055507359798,20,36,-16,29,48,-19,37,69,-32,2,3,0,0
"16987","OTT","CGY",2014020983,16502,20142015,1,65,4,4,0,9.11689711332275,7.69406206971739,1.42283504360536,42,46,-4,53,55,-2,73,71,2,2,2,0,0
"16988","OTT","BOS",2014020995,16504,20142015,1,60,1,3,-2,5.59994586765889,4.18798724460186,1.41195862305703,40,22,18,53,35,18,74,43,31,4,4,0,0
"16989","OTT","MTL",2014021005,16506,20142015,0,60,5,2,3,5.56364037332128,5.19798841048032,0.36565196284096,28,29,-1,41,45,-4,62,60,2,3,3,0,0
"16990","OTT","NYI",2014021013,16507,20142015,0,60,2,1,1,2.62931727627711,4.19134552849573,-1.56202825221862,28,35,-7,38,45,-7,58,64,-6,1,3,0,0
"16991","OTT","PHI",2014021033,16509,20142015,1,65,1,1,0,4.1940279842532,2.66685820516432,1.52716977908888,28,28,0,42,32,10,59,51,8,4,4,0,0
"16992","OTT","CAR",2014021043,16511,20142015,0,64.7666666666667,2,1,1,5.50221075562877,6.14194278931245,-0.639732033683686,33,36,-3,48,52,-4,64,67,-3,5,4,0,0
"16993","OTT","BOS",2014021055,16513,20142015,1,60,6,4,2,5.14475838110548,7.07298800790817,-1.92822962680269,32,35,-3,49,44,5,65,58,7,3,3,0,0
"16994","OTT","TOR",2014021070,16515,20142015,1,60,5,3,2,0,0,0,41,25,16,48,32,16,59,43,16,5,1,0,0
"16995","OTT","S.J",2014021086,16517,20142015,1,60,5,2,3,7.62641877576243,5.85871789252269,1.76770088323974,37,31,6,45,41,4,56,59,-3,1,1,0,0
"16996","OTT","NYR",2014021107,16520,20142015,1,60,1,5,-4,5.27455150824971,4.25270571492136,1.02184579332835,24,32,-8,39,42,-3,53,53,0,7,1,0,0
"16997","OTT","TOR",2014021121,16522,20142015,0,63.2833333333333,3,4,-1,3.4385739700313,6.87376308521198,-3.43518911518068,25,31,-6,39,50,-11,52,67,-15,1,4,0,0
"16998","OTT","DET",2014021146,16525,20142015,0,65,1,1,0,5.32801427850791,3.09808456871576,2.22992970979215,34,17,17,51,26,25,67,33,34,7,5,0,0
"16999","OTT","T.B",2014021155,16527,20142015,1,64.7166666666667,2,1,1,6.31068895802309,3.40141987246079,2.9092690855623,34,29,5,45,44,1,64,56,8,6,5,0,0
"17000","OTT","WSH",2014021171,16529,20142015,1,63.2333333333333,4,3,1,5.03939020048347,9.85926393751288,-4.81987373702941,28,32,-4,40,52,-12,54,65,-11,4,2,0,0
"17001","OTT","TOR",2014021182,16530,20142015,0,65,2,2,0,9.05964712772038,4.26709677776876,4.79255034995163,45,38,7,69,47,22,87,58,29,6,3,0,0
"17002","OTT","NYR",2014021203,16534,20142015,0,60,3,0,3,6.5693987124401,3.55472903593909,3.01466967650101,27,26,1,40,37,3,45,55,-10,2,2,0,0
"17003","OTT","PHI",2014021216,16536,20142015,0,60,3,1,2,4.86341335395912,8.3341780104807,-3.47076465652158,22,35,-13,31,46,-15,51,56,-5,4,2,0,0
"17004","OTT","TOR",2015020019,16718,20152016,0,65,4,4,0,4.44279576849658,4.5820106611076,-0.139214892611018,33,41,-8,46,58,-12,62,77,-15,7,5,0,0
"17005","OTT","MTL",2015020031,16719,20152016,1,60,1,3,-2,5.12232950470283,6.00009783778682,-0.877768333083983,21,34,-13,38,48,-10,55,71,-16,6,9,0,0
"17006","OTT","CBJ",2015020046,16722,20152016,0,60,7,3,4,3.60355533599795,5.58485141309211,-1.98129607709416,27,41,-14,38,53,-15,46,66,-20,4,5,0,0
"17007","OTT","NSH",2015020066,16725,20152016,1,65,3,3,0,4.55659100520496,2.30285998112231,2.25373102408265,41,25,16,53,35,18,74,50,24,5,9,0,0
"17008","OTT","N.J",2015020094,16730,20152016,1,65,4,4,0,5.45245429047282,5.44255952111784,0.00989476935497535,39,32,7,53,42,11,70,53,17,4,5,0,0
"17009","OTT","ARI",2015020109,16732,20152016,1,60,1,4,-3,6.68662658720655,4.34067201227253,2.34595457493401,36,26,10,55,34,21,68,44,24,3,2,0,0
"17010","OTT","CGY",2015020134,16736,20152016,1,65,4,4,0,3.63279535492111,7.24129160799203,-3.60849625307091,23,38,-15,33,52,-19,55,66,-11,4,4,0,0
"17011","OTT","DET",2015020149,16738,20152016,0,60,3,1,2,6.03395704255643,3.82208794882553,2.2118690937309,35,30,5,43,45,-2,49,58,-9,4,5,0,0
"17012","OTT","DET",2015020158,16739,20152016,1,60,3,5,-2,5.71602643687811,5.6655689324087,0.0504575044694135,36,28,8,50,43,7,73,51,22,5,5,0,0
"17013","OTT","MTL",2015020175,16742,20152016,0,60.5666666666667,2,1,1,3.75585524376947,4.17291779950756,-0.417062555738084,27,37,-10,34,48,-14,42,71,-29,1,3,0,0
"17014","OTT","WPG",2015020188,16744,20152016,1,65,2,2,0,2.94231037731515,5.41246605596825,-2.4701556786531,31,40,-9,39,55,-16,56,70,-14,2,2,0,0
"17015","OTT","CAR",2015020204,16746,20152016,0,62.85,2,3,-1,5.28267382055902,5.98259134809632,-0.6999175275373,21,46,-25,32,67,-35,44,85,-41,2,3,0,0
"17016","OTT","NSH",2015020223,16749,20152016,0,60,5,7,-2,3.58457687993359,5.29036570199276,-1.70578882205916,26,38,-12,32,55,-23,49,69,-20,3,3,0,0
"17017","OTT","VAN",2015020234,16751,20152016,1,60,3,2,1,3.23906571319078,4.56954584565304,-1.33048013246226,25,35,-10,36,47,-11,46,68,-22,4,3,0,0
"17018","OTT","NYR",2015020246,16753,20152016,1,65,1,1,0,4.06833143867698,6.12509426640463,-2.05676282772765,23,34,-11,39,38,1,56,53,3,4,3,0,0
"17019","OTT","DET",2015020264,16755,20152016,1,62.0666666666667,3,4,-1,5.63985479653275,7.39163013399229,-1.75177533745955,25,37,-12,39,50,-11,57,65,-8,2,2,0,0
"17020","OTT","CBJ",2015020283,16758,20152016,1,60,3,0,3,5.38937772344798,4.13331529387376,1.25606242957422,29,25,4,43,38,5,62,55,7,7,6,0,0
"17021","OTT","PHI",2015020294,16760,20152016,1,60,4,0,4,2.7805512693958,5.82660952457172,-3.04605825517592,31,36,-5,40,52,-12,52,81,-29,4,5,0,0
"17022","OTT","DAL",2015020315,16763,20152016,0,60,7,4,3,3.99149750493234,6.29404339672055,-2.30254589178821,20,37,-17,35,50,-15,49,65,-16,3,2,0,0
"17023","OTT","COL",2015020328,16764,20152016,0,60,5,3,2,4.56448931640125,4.85488243093769,-0.290393114536442,29,43,-14,37,62,-25,43,83,-40,1,6,0,0
"17024","OTT","ARI",2015020351,16767,20152016,0,60,3,4,-1,2.77066318464495,3.56124843965517,-0.790585255010228,38,19,19,56,29,27,70,36,34,3,2,0,0
"17025","OTT","PHI",2015020361,16770,20152016,1,60,2,4,-2,3.99083976141297,5.28305148298386,-1.29221172157089,25,33,-8,30,47,-17,50,60,-10,2,4,0,0
"17026","OTT","CHI",2015020376,16772,20152016,1,60.5,4,3,1,3.87317611882463,4.32029636601222,-0.447120247187587,27,38,-11,33,50,-17,41,68,-27,4,4,0,0
"17027","OTT","NYI",2015020390,16774,20152016,1,63.5666666666667,3,2,1,6.75135867563949,4.11371118828538,2.63764748735412,29,31,-2,48,48,0,65,66,-1,3,1,0,0
"17028","OTT","NYR",2015020401,16775,20152016,0,60,1,4,-3,2.3527496009192,4.96490120669114,-2.61215160577194,24,31,-7,37,47,-10,61,57,4,2,2,0,0
"17029","OTT","T.B",2015020422,16779,20152016,0,60,1,4,-3,2.59191091312096,6.20208460362186,-3.61017369050091,31,30,1,45,38,7,58,48,10,4,4,0,0
"17030","OTT","MTL",2015020437,16781,20152016,0,60,1,3,-2,2.47152901894879,5.39040929562179,-2.91888027667301,26,42,-16,34,52,-18,53,69,-16,2,4,0,0
"17031","OTT","L.A",2015020451,16783,20152016,1,60,5,3,2,2.32944673680777,4.15358719845972,-1.82414046165195,21,36,-15,29,51,-22,41,60,-19,4,3,0,0
"17032","OTT","WSH",2015020464,16785,20152016,0,60,1,2,-1,3.01518105974537,2.86154328979319,0.153637769952184,27,25,2,39,40,-1,54,49,5,2,3,0,0
"17033","OTT","S.J",2015020480,16787,20152016,1,60,4,2,2,6.77293704925847,7.33389682393328,-0.560959774674806,35,33,2,45,49,-4,60,67,-7,3,4,0,0
"17034","OTT","T.B",2015020495,16789,20152016,0,60,2,5,-3,3.5382399373193,5.14701411289343,-1.60877417557413,25,35,-10,29,44,-15,40,60,-20,6,2,0,0
"17035","OTT","BOS",2015020526,16796,20152016,1,60,3,1,2,5.39390077759865,6.75534223535215,-1.36144145775349,22,39,-17,30,55,-25,43,65,-22,2,2,0,0
"17036","OTT","BOS",2015020541,16798,20152016,0,60,3,7,-4,4.62287455878572,4.15162067499935,0.471253883786376,32,37,-5,47,46,1,66,63,3,6,9,0,0
"17037","OTT","N.J",2015020553,16799,20152016,1,60,0,3,-3,4.90308387217295,3.11649392625276,1.78658994592019,36,21,15,52,28,24,76,32,44,4,4,0,0
"17038","OTT","CHI",2015020581,16803,20152016,0,60,0,3,-3,4.72686247830279,5.35148658947219,-0.624624111169396,26,30,-4,41,40,1,65,56,9,2,1,0,0
"17039","OTT","BOS",2015020617,16809,20152016,1,64.3666666666667,2,1,1,6.54129562989692,6.99003246227949,-0.448736832382565,40,34,6,51,45,6,74,64,10,3,2,0,0
"17040","OTT","WSH",2015020625,16810,20152016,0,60,1,7,-6,5.31756823539035,5.36356565272183,-0.0459974173314777,33,36,-3,43,48,-5,54,60,-6,5,4,0,0
"17041","OTT","ANA",2015020645,16813,20152016,0,60,1,4,-3,2.86485626172825,6.95614190001652,-4.09128563828827,25,38,-13,31,52,-21,45,65,-20,2,3,0,0
"17042","OTT","L.A",2015020661,16816,20152016,0,60,5,3,2,5.87497264373815,6.74568248978176,-0.87070984604361,23,33,-10,37,46,-9,51,66,-15,3,3,0,0
"17043","OTT","S.J",2015020681,16818,20152016,0,65,3,3,0,2.09267467925383,7.05321515774995,-4.96054047849611,17,35,-18,27,61,-34,40,86,-46,2,2,0,0
"17044","OTT","N.J",2015020694,16821,20152016,0,60,3,6,-3,7.82914602970413,4.92607892720343,2.9030671025007,32,20,12,40,29,11,48,35,13,4,2,0,0
"17045","OTT","NYI",2015020706,16822,20152016,1,60,2,5,-3,1.74064526524183,3.79542494076304,-2.05477967552121,30,34,-4,37,47,-10,51,70,-19,2,4,0,0
"17046","OTT","NYR",2015020721,16824,20152016,1,60,3,0,3,5.86733652808471,6.29493765742518,-0.427601129340474,33,35,-2,47,50,-3,74,64,10,2,3,0,0
"17047","OTT","PIT",2015020748,16833,20152016,0,60,5,6,-1,3.25412838999182,5.04833023506217,-1.79420184507035,23,44,-21,28,58,-30,39,69,-30,3,6,0,0
"17048","OTT","EDM",2015020763,16835,20152016,1,60,2,7,-5,7.1181439391803,5.47033072862541,1.64781321055489,38,28,10,49,35,14,76,53,23,4,3,0,0
"17049","OTT","TOR",2015020780,16837,20152016,1,60,6,1,5,0,0,0,25,27,-2,31,38,-7,42,54,-12,5,6,0,0
"17050","OTT","T.B",2015020792,16839,20152016,1,60,5,1,4,4.2377948918147,5.15515005699066,-0.917355165175962,29,32,-3,38,42,-4,49,59,-10,7,4,0,0
"17051","OTT","DET",2015020806,16841,20152016,0,60,1,3,-2,1.88113791501382,2.67092003717005,-0.789782122156225,23,29,-6,34,35,-1,45,42,3,7,2,0,0
"17052","OTT","COL",2015020812,16842,20152016,1,60,3,4,-1,3.98741222080025,5.85159742583869,-1.86418520503844,29,27,2,47,38,9,65,44,21,4,3,0,0
"17053","OTT","CBJ",2015020829,16844,20152016,0,60,2,4,-2,4.01878411079724,7.61451868936895,-3.59573457857171,35,40,-5,46,55,-9,67,70,-3,5,4,0,0
"17054","OTT","CAR",2015020861,16849,20152016,1,60,4,2,2,8.1370346340118,4.47501387400553,3.66202076000627,22,32,-10,33,40,-7,44,61,-17,4,2,0,0
"17055","OTT","DET",2015020876,16851,20152016,1,65,2,2,0,6.4580736110961,5.52242099077557,0.935652620320525,27,31,-4,31,42,-11,42,50,-8,3,3,0,0
"17056","OTT","EDM",2015020900,16854,20152016,0,60,4,1,3,3.50460037664844,3.63733518573281,-0.132734809084369,25,32,-7,39,47,-8,58,62,-4,3,4,0,0
"17057","OTT","VAN",2015020914,16856,20152016,0,60,3,5,-2,4.8813249130651,4.29521381758877,0.586111095476326,30,36,-6,38,41,-3,50,49,1,5,5,0,0
"17058","OTT","CGY",2015020928,16858,20152016,0,60,6,4,2,4.89313716234112,4.54510406886357,0.348033093477554,26,38,-12,40,48,-8,54,58,-4,3,3,0,0
"17059","OTT","T.B",2015020959,16863,20152016,1,60,1,4,-3,5.89705316371601,5.20524509620736,0.691808067508646,34,29,5,51,39,12,71,54,17,5,2,0,0
"17060","OTT","TOR",2015020974,16865,20152016,0,60,3,2,1,5.2261034627445,4.30737559668734,0.918727866057168,31,43,-12,43,59,-16,57,81,-24,1,3,0,0
"17061","OTT","DAL",2015020980,16866,20152016,1,60,1,2,-1,3.16635760224017,5.54347328887025,-2.37711568663008,24,25,-1,33,35,-2,56,47,9,3,2,0,0
"17062","OTT","CAR",2015020995,16868,20152016,0,65,3,3,0,3.89947297569597,5.93840996840299,-2.03893699270702,24,37,-13,46,53,-7,57,73,-16,3,4,0,0
"17063","OTT","TOR",2015021022,16872,20152016,1,60,4,0,4,6.03434526912179,4.87072671691922,1.16361855220256,17,29,-12,26,44,-18,36,66,-30,3,5,0,0
"17064","OTT","MIN",2015021044,16875,20152016,1,64.4833333333333,3,2,1,4.46927415360551,4.90518673078623,-0.435912577180716,20,25,-5,36,33,3,61,45,16,3,3,0,0
"17065","OTT","MTL",2015021071,16879,20152016,1,60,5,0,5,7.97823523313855,4.95252001011977,3.02571522301878,44,30,14,52,43,9,68,66,2,3,5,0,0
"17066","OTT","WSH",2015021092,16882,20152016,1,60,2,4,-2,5.10221946676802,5.08365441695787,0.0185650498101495,30,22,8,44,32,12,62,43,19,4,2,0,0
"17067","OTT","NYI",2015021099,16883,20152016,0,60,1,3,-2,2.06374799166355,3.05224292131606,-0.988494929652518,23,23,0,26,34,-8,39,48,-9,1,3,0,0
"17068","OTT","ANA",2015021121,16886,20152016,1,62.6333333333333,3,4,-1,1.90565913696548,6.43258046312258,-4.52692132615709,33,39,-6,40,53,-13,48,65,-17,5,3,0,0
"17069","OTT","WPG",2015021149,16890,20152016,0,60,2,1,1,2.89574722508996,5.40691458561923,-2.51116736052927,19,21,-2,30,34,-4,47,51,-4,4,4,0,0
"17070","OTT","MIN",2015021158,16891,20152016,0,60,3,2,1,6.18050837400369,2.44682958708668,3.73367878691701,22,25,-3,32,38,-6,44,47,-3,1,2,0,0
"17071","OTT","PHI",2015021168,16893,20152016,0,60,2,3,-1,4.46038445888553,6.33992970082909,-1.87954524194356,35,36,-1,45,47,-2,59,65,-6,3,6,0,0
"17072","OTT","PIT",2015021193,16896,20152016,1,60,3,5,-2,4.35247906137079,3.45366572478088,0.89881333658991,30,28,2,40,35,5,56,45,11,4,2,0,0
"17073","OTT","BOS",2015021216,16900,20152016,0,60,6,1,5,6.06435561092803,4.93881919543492,1.12553641549312,36,40,-4,39,61,-22,42,76,-34,1,5,0,0
"17074","OTT","TOR",2016020001,17086,20162017,1,60.6166666666667,5,4,1,4.32090159566227,6.09789219486993,-1.77699059920766,30,38,-8,42,56,-14,51,81,-30,3,5,0,0
"17075","OTT","MTL",2016020018,17089,20162017,1,65,3,3,0,5.88209632108919,3.50656319456175,2.37553312652744,38,24,14,52,33,19,63,48,15,5,5,0,0
"17076","OTT","DET",2016020035,17091,20162017,0,60,1,5,-4,6.20076772806351,2.84934634877573,3.35142137928779,32,25,7,44,31,13,59,41,18,5,6,0,0
"17077","OTT","ARI",2016020041,17092,20162017,1,60,7,4,3,0,0,0,42,35,7,52,47,5,61,70,-9,4,7,0,0
"17078","OTT","T.B",2016020066,17096,20162017,1,60,1,4,-3,4.10216384955129,4.38957074974314,-0.287406900191854,28,35,-7,34,44,-10,51,59,-8,3,4,0,0
"17079","OTT","VAN",2016020091,17099,20162017,0,60,3,0,3,4.74629028152352,3.06331485425471,1.6829754272688,28,22,6,40,32,8,49,47,2,1,1,0,0
"17080","OTT","CGY",2016020110,17102,20162017,0,60,2,5,-3,5.73183214780071,3.45009154910804,2.28174059869268,33,19,14,50,32,18,70,50,20,4,2,0,0
"17081","OTT","EDM",2016020129,17104,20162017,0,60,2,0,2,3.83667488417996,7.66238505328362,-3.82571016910366,22,37,-15,33,42,-9,47,65,-18,2,4,0,0
"17082","OTT","CAR",2016020135,17106,20162017,1,63.15,2,1,1,7.76813234086148,3.89237793524489,3.87575440561659,32,33,-1,39,51,-12,48,63,-15,4,5,0,0
"17083","OTT","VAN",2016020150,17108,20162017,1,60,1,0,1,4.56996116475784,5.85274163808559,-1.28278047332775,24,27,-3,32,39,-7,43,64,-21,6,5,0,0
"17084","OTT","MIN",2016020225,17118,20162017,1,63.95,1,2,-1,6.82740047555808,8.80317427571299,-1.97577380015491,36,42,-6,54,49,5,65,67,-2,4,3,0,0
"17085","OTT","PHI",2016020230,17120,20162017,0,65,2,2,0,4.49540870403552,4.29526842807358,0.20014027596194,26,35,-9,41,50,-9,59,71,-12,2,4,0,0
"17086","OTT","MTL",2016020285,17127,20162017,0,60,4,3,1,4.13471731962636,5.67174206278287,-1.53702474315651,23,39,-16,29,52,-23,42,79,-37,6,10,0,0
"17087","OTT","NYR",2016020326,17132,20162017,0,60,2,0,2,5.23635699012084,6.11554343727767,-0.879186447156826,20,33,-13,30,48,-18,51,71,-20,3,5,0,0
"17088","OTT","PHI",2016020349,17136,20162017,1,60.6666666666667,2,3,-1,4.01192771694669,7.41092750099779,-3.39899978405109,21,32,-11,32,54,-22,51,79,-28,4,6,0,0
"17089","OTT","PIT",2016020379,17140,20162017,0,60,5,8,-3,5.37438003832983,4.88217977492604,0.492200263403788,34,46,-12,45,55,-10,62,72,-10,5,6,0,0
"17090","OTT","ANA",2016020421,17146,20162017,0,60,1,5,-4,2.51461071010999,3.30285385402931,-0.788243143919317,22,32,-10,34,50,-16,49,58,-9,5,5,0,0
"17091","OTT","N.J",2016020463,17152,20162017,1,60,3,1,2,5.5369281986641,2.75043357082177,2.78649462784233,31,30,1,42,37,5,53,55,-2,2,2,0,0
"17092","OTT","NYI",2016020473,17153,20162017,0,60,6,2,4,5.07250062222715,3.49870313212159,1.57379749010556,34,31,3,48,44,4,56,70,-14,2,4,0,0
"17093","OTT","ANA",2016020499,17157,20162017,1,64.05,2,1,1,4.21061508895491,2.53482001536759,1.67579507358732,18,25,-7,25,38,-13,37,55,-18,3,4,0,0
"17094","OTT","NYR",2016020519,17162,20162017,0,60,3,4,-1,5.76799546176335,5.05542578469758,0.712569677065765,36,25,11,46,37,9,60,48,12,7,7,0,0
"17095","OTT","EDM",2016020606,17174,20162017,1,60,5,3,2,3.58687265612389,6.02751024857107,-2.44063759244718,18,38,-20,29,56,-27,37,73,-36,2,2,0,0
"17096","OTT","PIT",2016020625,17178,20162017,1,60,4,1,3,3.66705544334462,3.67142401946217,-0.00436857611754959,33,30,3,44,41,3,57,56,1,6,3,0,0
"17097","OTT","TOR",2016020643,17180,20162017,1,60,2,4,-2,8.10727778408909,4.38095151860034,3.72632626548875,37,27,10,56,39,17,77,54,23,2,2,0,0
"17098","OTT","TOR",2016020693,17187,20162017,0,65,2,2,0,5.19443830583259,5.78615937626455,-0.591721070431959,27,33,-6,46,58,-12,65,72,-7,4,3,0,0
"17099","OTT","T.B",2016020760,17199,20162017,0,60,5,2,3,4.3951491190237,4.90150683058891,-0.506357711565215,30,21,9,43,34,9,63,50,13,5,3,0,0
"17100","OTT","DAL",2016020809,17206,20162017,1,60,3,2,1,3.63113811738873,6.22201403772488,-2.59087592033614,27,33,-6,35,45,-10,51,64,-13,3,6,0,0
"17101","OTT","NYI",2016020816,17208,20162017,1,60,3,0,3,4.42649935549707,5.28069738551029,-0.854198030013215,24,33,-9,33,49,-16,50,68,-18,3,2,0,0
"17102","OTT","N.J",2016020848,17213,20162017,0,60,3,0,3,4.09172506094441,3.90521477693983,0.186510284004584,35,21,14,46,32,14,62,40,22,2,1,0,0
"17103","OTT","TOR",2016020861,17215,20162017,0,60,6,3,3,9.54973836462334,5.91691631858686,3.63282204603648,42,37,5,54,53,1,65,71,-6,5,5,0,0
"17104","OTT","WPG",2016020871,17216,20162017,1,60,2,3,-1,7.3768115027342,4.81186253351373,2.56494896922047,34,20,14,47,31,16,56,54,2,4,1,0,0
"17105","OTT","N.J",2016020882,17218,20162017,0,60,2,1,1,3.37089183195167,3.6693594030221,-0.298467571070432,23,30,-7,34,46,-12,40,68,-28,2,1,0,0
"17106","OTT","T.B",2016020920,17224,20162017,0,60,1,5,-4,5.15562204501856,4.14862444496248,1.00699760005608,40,34,6,43,49,-6,54,58,-4,9,7,0,0
"17107","OTT","COL",2016020942,17227,20162017,1,60,2,1,1,3.54855627036886,5.32328822459294,-1.77473195422408,42,23,19,51,40,11,66,65,1,4,2,0,0
"17108","OTT","DAL",2016020983,17233,20162017,0,60,5,2,3,2.41353722815984,6.84053620533086,-4.42699897717102,23,37,-14,31,64,-33,42,86,-44,5,6,0,0
"17109","OTT","ARI",2016020991,17234,20162017,0,60.6666666666667,3,2,1,3.70000419320286,5.1496269589461,-1.44962276574324,31,41,-10,48,59,-11,61,76,-15,3,4,0,0
"17110","OTT","COL",2016021006,17236,20162017,0,60,4,2,2,2.37778112965908,2.14276916610834,0.235011963550747,31,16,15,40,26,14,56,39,17,4,5,0,0
"17111","OTT","T.B",2016021028,17239,20162017,1,64.1,1,2,-1,4.69190518473488,6.80569218005985,-2.11378699532497,32,37,-5,45,51,-6,64,75,-11,2,1,0,0
"17112","OTT","MTL",2016021056,17243,20162017,1,65,3,3,0,7.45474581238523,5.09633654725621,2.35840926512901,31,32,-1,45,38,7,66,54,12,4,2,0,0
"17113","OTT","MTL",2016021068,17244,20162017,0,60,1,4,-3,6.0738577236621,5.66652937990616,0.407328343755944,31,37,-6,39,47,-8,52,63,-11,6,7,0,0
"17114","OTT","PIT",2016021093,17248,20162017,1,65,1,1,0,5.99514146714421,6.71388675144408,-0.718745284299871,30,35,-5,39,47,-8,53,65,-12,4,4,0,0
"17115","OTT","MTL",2016021108,17250,20162017,0,60,1,3,-2,3.05874700799356,2.64412761597709,0.414619392016476,32,24,8,43,37,6,64,51,13,7,7,0,0
"17116","OTT","PHI",2016021128,17253,20162017,0,65,2,2,0,4.0895534859241,7.42599556042774,-3.33644207450364,28,35,-7,42,53,-11,62,70,-8,3,4,0,0
"17117","OTT","MIN",2016021147,17255,20162017,0,60,1,5,-4,2.52056407294003,4.38358029926894,-1.86301622632891,19,26,-7,33,37,-4,40,51,-11,4,2,0,0
"17118","OTT","WPG",2016021163,17257,20162017,0,60,2,4,-2,4.76272283666185,8.21526613015158,-3.45254329348973,31,28,3,41,46,-5,51,62,-11,2,2,0,0
"17119","OTT","NYR",2016021207,17264,20162017,1,60,3,1,2,3.75129918038147,3.96931417065207,-0.218014990270603,33,19,14,45,31,14,56,43,13,4,3,0,0
"17120","OTT","NYI",2016021223,17265,20162017,0,60,2,4,-2,4.03676370088942,4.17064944381127,-0.133885742921848,34,21,13,54,29,25,67,41,26,3,0,0,0
"17121","OTT","NYR",2016030211,17283,20162017,1,60,2,1,1,6.0297796443695,6.54295077714869,-0.513171132779192,43,35,8,52,48,4,69,64,5,4,4,0,0
"17122","OTT","NYR",2016030212,17285,20162017,1,80,5,5,0,6.66045033161333,5.12293386365127,1.53751646796206,32,47,-15,53,62,-9,77,81,-4,5,5,0,0
"17123","OTT","NYR",2016030213,17288,20162017,0,60,1,4,-3,4.16546391884913,3.15800570969168,1.00745820915745,27,30,-3,35,45,-10,54,56,-2,4,4,0,0
"17124","OTT","NYR",2016030214,17290,20162017,0,60,1,4,-3,5.91554630127393,6.05856588498681,-0.143019583712872,23,30,-7,35,46,-11,57,58,-1,8,13,0,0
"17125","OTT","NYR",2016030215,17292,20162017,1,66.4666666666667,5,4,1,6.74935198325358,8.28830766771137,-1.5389556844578,37,33,4,52,43,9,79,54,25,5,5,0,0
"17126","OTT","NYR",2016030216,17295,20162017,0,60,4,2,2,3.57018666813725,4.35705055071422,-0.786863882576962,26,39,-13,35,52,-17,42,72,-30,2,3,0,0
"17127","OTT","PIT",2016030311,17299,20162017,0,64.9833333333333,2,1,1,5.44454089608123,2.36869340918929,3.07584748689194,35,28,7,46,34,12,60,56,4,2,5,0,0
"17128","OTT","PIT",2016030312,17301,20162017,0,60,0,1,-1,3.2964589100593,3.77684561477508,-0.480386704715784,23,29,-6,28,39,-11,35,57,-22,5,5,0,0
"17129","OTT","PIT",2016030313,17303,20162017,1,60,5,1,4,0,0,0,29,26,3,40,45,-5,52,62,-10,6,6,0,0
"17130","OTT","PIT",2016030314,17305,20162017,1,60,2,3,-1,4.84550985009979,3.85649097562026,0.989018874479526,26,35,-9,39,41,-2,52,50,2,4,2,0,0
"17131","OTT","PIT",2016030315,17307,20162017,0,60,0,7,-7,1.96850939227807,2.10195086500565,-0.133441472727589,25,36,-11,28,44,-16,47,56,-9,5,4,0,0
"17132","OTT","PIT",2016030316,17309,20162017,1,60,2,1,1,4.10459998236516,5.80443498509703,-1.69983500273187,30,46,-16,38,58,-20,46,75,-29,5,5,0,0
"17133","OTT","PIT",2016030317,17311,20162017,0,80,2,2,0,2.66902054827551,4.97875549804303,-2.30973494976752,27,41,-14,38,54,-16,57,70,-13,2,1,0,0
"17134","OTT","EDM",2017020073,17453,20172018,0,60,6,1,5,3.83053392509464,6.9732447543865,-3.14271082929185,31,36,-5,43,59,-16,52,86,-34,6,4,0,0
"17135","OTT","N.J",2017020099,17458,20172018,1,61.3333333333333,4,5,-1,4.7724485227758,6.15134955654048,-1.37890103376468,33,46,-13,40,61,-21,51,70,-19,7,5,0,0
"17136","OTT","TOR",2017020113,17460,20172018,1,60,6,3,3,5.93904357141582,6.46912020900527,-0.53007663758945,35,31,4,47,43,4,58,66,-8,2,2,0,0
"17137","OTT","PHI",2017020143,17465,20172018,1,60,5,4,1,4.75779662157584,5.57400173731855,-0.816205115742719,28,40,-12,33,49,-16,46,70,-24,2,4,0,0
"17138","OTT","N.J",2017020150,17466,20172018,0,65,4,4,0,4.11198720390621,6.10562030563641,-1.9936331017302,27,25,2,40,40,0,54,53,1,2,3,0,0
"17139","OTT","MTL",2017020173,17469,20172018,1,60,3,8,-5,5.39630389937355,2.69816836223526,2.69813553713828,28,29,-1,42,40,2,61,57,4,8,7,0,0
"17140","OTT","VGK",2017020200,17474,20172018,1,60,4,5,-1,5.32333986668746,3.14839901294272,2.17494085374474,28,34,-6,45,47,-2,63,58,5,3,6,0,0
"17141","OTT","COL",2017020247,17480,20172018,0,60.9833333333333,4,3,1,6.28929431839788,2.89956922826605,3.38972509013183,32,19,13,51,38,13,68,51,17,2,3,0,0
"17142","OTT","COL",2017020252,17481,20172018,1,60,4,3,1,6.08763324352913,3.81561536081063,2.2720178827185,40,18,22,51,26,25,71,41,30,7,5,0,0
"17143","OTT","PIT",2017020281,17486,20172018,1,60,1,3,-2,4.5124490999151,5.49928284646012,-0.986833746545017,22,29,-7,34,36,-2,48,49,-1,3,2,0,0
"17144","OTT","ARI",2017020293,17488,20172018,1,61.3833333333333,2,3,-1,5.01699591948043,5.43398368714179,-0.416987767661356,32,28,4,47,38,9,63,53,10,5,3,0,0
"17145","OTT","NYR",2017020307,17489,20172018,0,60,0,3,-3,4.24963495184757,4.19928207757675,0.0503528742708115,20,27,-7,33,40,-7,60,57,3,2,3,0,0
"17146","OTT","NYI",2017020350,17495,20172018,1,60,1,2,-1,3.78677353428668,3.46806648808456,0.318707046202124,32,24,8,45,35,10,58,47,11,6,5,0,0
"17147","OTT","MTL",2017020378,17499,20172018,0,60,1,2,-1,4.55304080815404,4.4103326305136,0.142708177640436,28,31,-3,38,45,-7,65,61,4,3,3,0,0
"17148","OTT","NYI",2017020389,17501,20172018,0,60,6,5,1,6.76053827074543,4.05805272647454,2.70248554427089,35,37,-2,48,44,4,60,57,3,3,3,0,0
"17149","OTT","WPG",2017020409,17503,20172018,0,60,0,5,-5,2.9183341737953,6.60293166430056,-3.68459749050526,21,49,-28,32,61,-29,50,77,-27,3,5,0,0
"17150","OTT","ANA",2017020429,17506,20172018,0,60,0,3,-3,6.88282524392707,3.10433148597986,3.77849375794722,29,22,7,44,28,16,55,39,16,3,2,0,0
"17151","OTT","NYR",2017020475,17513,20172018,1,60,3,2,1,6.51079331245273,4.31621500819256,2.19457830426018,30,29,1,39,39,0,48,53,-5,2,1,0,0
"17152","OTT","MTL",2017020498,17516,20172018,1,60,3,0,3,8.71165229273,4.55473296484679,4.15691932788322,38,28,10,48,34,14,67,53,14,3,1,0,0
"17153","OTT","MIN",2017020520,17519,20172018,1,60,4,6,-2,4.50253812439814,5.2309085176239,-0.728370393225759,32,40,-8,47,48,-1,65,60,5,4,4,0,0
"17154","OTT","T.B",2017020533,17521,20172018,0,65,3,3,0,2.80290325256647,4.5645921434043,-1.76168889083783,21,38,-17,25,57,-32,28,77,-49,4,4,0,0
"17155","OTT","T.B",2017020638,17537,20172018,1,60,6,3,3,4.80015783375711,7.29416923306723,-2.49401139931012,33,48,-15,43,71,-28,55,93,-38,5,7,0,0
"17156","OTT","TOR",2017020660,17541,20172018,0,60,4,3,1,4.82641983996102,7.59848850831622,-2.7720686683552,32,48,-16,42,73,-31,50,93,-43,1,3,0,0
"17157","OTT","TOR",2017020713,17551,20172018,1,60,3,4,-1,3.07133682363098,3.26316634292016,-0.191829519289179,18,33,-15,28,41,-13,53,57,-4,3,4,0,0
"17158","OTT","MIN",2017020728,17553,20172018,0,60,1,3,-2,6.68211922543214,5.91627013028483,0.765849095147312,38,36,2,51,52,-1,64,68,-4,2,2,0,0
"17159","OTT","ANA",2017020781,17563,20172018,1,60.5333333333333,2,1,1,0,0,0,32,31,1,39,49,-10,47,68,-21,5,3,0,0
"17160","OTT","PHI",2017020793,17565,20172018,0,65,3,3,0,3.06508551098523,5.26259215762548,-2.19750664664025,29,36,-7,36,55,-19,44,79,-35,5,6,0,0
"17161","OTT","MTL",2017020806,17566,20172018,0,60,1,4,-3,6.34365352758323,7.4266969083983,-1.08304338081507,26,35,-9,34,45,-11,54,70,-16,2,3,0,0
"17162","OTT","N.J",2017020816,17568,20172018,1,60,5,3,2,6.64284283061236,5.4067579748662,1.23608485574616,32,33,-1,55,57,-2,67,77,-10,4,5,0,0
"17163","OTT","TOR",2017020844,17572,20172018,0,60,3,6,-3,2.6707442396073,4.86391910715611,-2.19317486754881,25,41,-16,35,57,-22,48,74,-26,2,5,0,0
"17164","OTT","PIT",2017020868,17575,20172018,0,60,3,6,-3,1.88982473877695,4.50682406779379,-2.61699932901683,33,28,5,42,39,3,63,59,4,2,1,0,0
"17165","OTT","NYR",2017020895,17579,20172018,1,60,6,3,3,3.43903389258776,6.56548079507775,-3.12644690248999,33,38,-5,42,53,-11,57,71,-14,2,2,0,0
"17166","OTT","T.B",2017020934,17584,20172018,1,60,3,4,-1,7.14923305631521,1.71431139463154,5.43492166168367,36,24,12,48,34,14,76,48,28,5,3,0,0
"17167","OTT","PHI",2017020946,17586,20172018,1,60,3,5,-2,5.3114957133555,6.57517481052297,-1.26367909716747,28,39,-11,45,49,-4,64,61,3,4,3,0,0
"17168","OTT","VGK",2017020998,17592,20172018,0,60,5,4,1,6.06532818769762,5.68745068483986,0.377877502857757,38,29,9,47,36,11,60,58,2,5,2,0,0
"17169","OTT","ARI",2017021006,17593,20172018,0,60,1,2,-1,5.42025357829698,4.80602767021628,0.614225908080698,24,27,-3,39,40,-1,54,57,-3,2,3,0,0
"17170","OTT","DAL",2017021017,17595,20172018,0,62.6833333333333,3,2,1,5.39509357373026,3.53766276780516,1.85743080592511,30,33,-3,48,44,4,71,65,6,2,4,0,0
"17171","OTT","T.B",2017021073,17603,20172018,0,60,7,4,3,4.80434728773253,4.68036979865428,0.123977489078243,33,46,-13,38,60,-22,47,76,-29,2,4,0,0
"17172","OTT","DAL",2017021093,17606,20172018,1,63.4333333333333,3,2,1,3.12845922660199,4.13580334981089,-1.0073441232089,25,25,0,40,40,0,52,53,-1,3,1,0,0
"17173","OTT","EDM",2017021140,17612,20172018,1,60,2,6,-4,4.90235952840567,5.68042733405309,-0.778067805647424,35,38,-3,42,46,-4,57,61,-4,2,5,0,0
"17174","OTT","NYI",2017021178,17617,20172018,1,60,3,4,-1,4.08481846007236,4.44194935238193,-0.357130892309563,36,31,5,51,39,12,74,54,20,4,2,0,0
"17175","OTT","WPG",2017021224,17623,20172018,1,60,5,6,-1,4.93714903589702,5.57097568287994,-0.633826646982918,37,40,-3,54,53,1,73,66,7,7,5,0,0
"17176","OTT","PIT",2017021253,17627,20172018,0,60,0,4,-4,2.82249292087607,3.95709032691229,-1.13459740603622,35,23,12,42,35,7,63,43,20,4,5,0,0
"17177","OTT","TOR",2018020018,17810,20182019,0,60,5,3,2,2.73859265362262,4.0979571011776,-1.35936444755498,24,37,-13,32,53,-21,40,80,-40,2,3,0,0
"17178","OTT","PHI",2018020042,17814,20182019,1,60,4,7,-3,6.15296942351065,8.43264569187038,-2.27967626835973,35,45,-10,48,59,-11,64,71,-7,12,12,0,0
"17179","OTT","DAL",2018020076,17819,20182019,1,60,4,1,3,3.4546004374409,3.69308062965865,-0.23848019221775,24,38,-14,35,53,-18,47,68,-21,2,4,0,0
"17180","OTT","MTL",2018020107,17824,20182019,1,62.5,4,3,1,3.31660772413521,3.79614251283774,-0.479534788702535,34,27,7,41,37,4,52,57,-5,4,3,0,0
"17181","OTT","COL",2018020147,17830,20182019,0,60,3,6,-3,1.95029125643042,4.13148254571415,-2.18119128928372,24,37,-13,31,54,-23,42,73,-31,2,3,0,0
"17182","OTT","VGK",2018020163,17832,20182019,0,62.4,3,4,-1,3.31911035526551,8.18906412515472,-4.86995376988921,22,53,-31,29,68,-39,39,97,-58,3,5,0,0
"17183","OTT","ARI",2018020175,17834,20182019,0,60,1,5,-4,6.68436610717561,4.90234048589173,1.78202562128388,26,35,-9,48,45,3,60,59,1,5,3,0,0
"17184","OTT","T.B",2018020207,17839,20182019,1,60.2333333333333,3,4,-1,4.8176096456009,6.14474750298541,-1.32713785738451,25,45,-20,33,61,-28,54,85,-31,3,3,0,0
"17185","OTT","N.J",2018020218,17841,20182019,1,60,7,3,4,7.05792085357825,5.42975187653842,1.62816897703983,42,39,3,62,48,14,76,63,13,4,2,0,0
"17186","OTT","VGK",2018020231,17843,20182019,1,60,3,5,-2,4.33881944789027,4.37750307635457,-0.0386836284642982,30,42,-12,45,57,-12,58,81,-23,2,2,0,0
"17187","OTT","T.B",2018020247,17845,20182019,0,60,6,4,2,3.20777087475881,4.90793077203853,-1.70015989727972,34,28,6,45,41,4,54,61,-7,4,3,0,0
"17188","OTT","PIT",2018020295,17852,20182019,1,60,6,4,2,4.92476279891562,7.50860891670163,-2.58384611778601,25,35,-10,37,51,-14,43,67,-24,4,5,0,0
"17189","OTT","MIN",2018020327,17856,20182019,0,60,4,6,-2,4.57864813425113,5.28647031871014,-0.707822184459019,27,34,-7,35,47,-12,60,61,-1,5,4,0,0
"17190","OTT","DAL",2018020344,17858,20182019,0,60,4,6,-2,3.19522585271886,10.1064305819201,-6.91120472920124,33,54,-21,36,69,-33,54,90,-36,4,5,0,0
"17191","OTT","NYR",2018020365,17861,20182019,0,60,2,4,-2,3.48828253895329,4.27851463621114,-0.790232097257848,31,33,-2,39,41,-2,49,62,-13,3,5,0,0
"17192","OTT","PHI",2018020368,17862,20182019,0,60,4,3,1,5.16002371453214,5.72452399336479,-0.56450027883265,24,37,-13,28,56,-28,41,70,-29,3,0,0,0
"17193","OTT","NYR",2018020384,17864,20182019,1,60,3,0,3,5.84874734299228,4.22191477190063,1.62683257109165,34,27,7,49,38,11,58,50,8,1,0,0,0
"17194","OTT","MTL",2018020421,17869,20182019,0,60,2,5,-3,6.42608244890611,8.55737600848079,-2.13129355957468,30,41,-11,39,58,-19,49,84,-35,5,4,0,0
"17195","OTT","MTL",2018020433,17871,20182019,1,60,2,5,-3,1.58866584381832,6.09965068509337,-4.51098484127504,21,43,-22,26,56,-30,38,72,-34,1,3,0,0
"17196","OTT","PIT",2018020447,17873,20182019,1,61.3333333333333,2,1,1,4.29878904201225,4.71564200811554,-0.416852966103287,29,36,-7,36,58,-22,43,85,-42,6,3,0,0
"17197","OTT","MTL",2018020496,17880,20182019,0,60,2,5,-3,2.20648429589346,7.01555259980159,-4.80906830390813,18,47,-29,23,58,-35,32,83,-51,4,6,0,0
"17198","OTT","N.J",2018020542,17886,20182019,0,60,2,5,-3,2.88830189587316,4.44870633598669,-1.56040444011354,27,32,-5,40,42,-2,50,46,4,6,4,0,0
"17199","OTT","NYI",2018020581,17893,20182019,0,60,3,6,-3,2.09791963088901,9.71120238152798,-7.61328275063897,27,39,-12,36,47,-11,50,65,-15,3,3,0,0
"17200","OTT","MIN",2018020637,17901,20182019,1,60,3,4,-1,4.95205598446773,6.45569902141142,-1.50364303694369,27,26,1,42,42,0,60,58,2,2,3,0,0
"17201","OTT","ANA",2018020670,17905,20182019,0,61.5666666666667,2,1,1,3.94852733916923,4.45729095411662,-0.508763614947384,30,33,-3,48,54,-6,57,72,-15,0,3,0,0
"17202","OTT","COL",2018020721,17912,20182019,1,60,5,2,3,5.05761822703062,4.060998978938,0.996619248092617,31,32,-1,41,45,-4,48,69,-21,3,3,0,0
"17203","OTT","ARI",2018020761,17918,20182019,1,60,2,3,-1,5.44643634327076,5.3936442839331,0.0527920593376621,27,33,-6,41,42,-1,63,59,4,2,1,0,0
"17204","OTT","PIT",2018020784,17928,20182019,0,60,3,5,-2,5.53025069863625,4.62712838583684,0.903122312799411,40,40,0,45,60,-15,58,76,-18,2,2,0,0
"17205","OTT","TOR",2018020821,17933,20182019,0,60,4,5,-1,7.87391586398007,3.75352840356004,4.12038746042003,44,30,14,56,42,14,69,63,6,1,1,0,0
"17206","OTT","ANA",2018020829,17934,20182019,1,60,4,0,4,6.41061911486577,7.32352514611557,-0.912906031249804,35,45,-10,45,60,-15,59,86,-27,1,3,0,0
"17207","OTT","WPG",2018020843,17936,20182019,1,60,5,2,3,3.55391824322203,6.51042057553423,-2.9565023323122,32,46,-14,48,66,-18,60,86,-26,1,3,0,0
"17208","OTT","WPG",2018020897,17943,20182019,0,63.7333333333333,4,3,1,4.31720377527381,3.54800172367662,0.769202051597189,41,26,15,55,35,20,71,48,23,5,2,0,0
"17209","OTT","N.J",2018020931,17948,20182019,0,60,0,4,-4,4.2974824688572,3.39094275733937,0.906539711517825,30,31,-1,42,47,-5,60,55,5,4,2,0,0
"17210","OTT","EDM",2018020987,17955,20182019,1,60,2,4,-2,7.61506505693251,4.19801873258257,3.41704632434994,37,26,11,58,32,26,77,48,29,1,3,0,0
"17211","OTT","T.B",2018021004,17957,20182019,0,60,1,5,-4,2.21321122794423,5.66655205578263,-3.4533408278384,37,34,3,42,52,-10,57,67,-10,5,4,0,0
"17212","OTT","NYI",2018021021,17960,20182019,0,65,4,4,0,5.35587338966077,6.10682878014632,-0.750955390485543,27,38,-11,40,48,-8,54,60,-6,0,3,0,0
"17213","OTT","NYI",2018021035,17962,20182019,1,60,2,4,-2,4.56287493550553,4.06278788797988,0.500087047525653,37,31,6,48,42,6,73,64,9,4,4,0,0
"17214","OTT","PHI",2018021067,17966,20182019,0,60,2,3,-1,3.49704563512933,5.02214038474631,-1.52509474961698,22,36,-14,30,48,-18,46,65,-19,2,4,0,0
"17215","OTT","TOR",2018021104,17971,20182019,1,60,6,2,4,6.31409832653544,7.69368705585657,-1.37958872932114,44,37,7,54,51,3,66,73,-7,4,3,0,0
"17216","OTT","EDM",2018021153,17978,20182019,0,62.15,4,3,1,4.88608497917869,5.03410073147459,-0.148015752295898,35,29,6,47,43,4,59,61,-2,3,2,0,0
"17217","OTT","TOR",2018021205,17985,20182019,1,60,4,2,2,4.14749147789712,4.63369433966986,-0.486202861772739,22,44,-22,30,57,-27,43,80,-37,3,3,0,0
"17218","OTT","T.B",2018021224,17987,20182019,1,60,2,5,-3,3.90058861534635,4.676082840655,-0.775494225308648,24,26,-2,32,36,-4,42,56,-14,4,3,0,0
"17219","OTT","NYR",2018021239,17989,20182019,0,60,4,1,3,4.47953112944379,4.78512713141155,-0.305596001967761,31,28,3,37,44,-7,46,54,-8,6,2,0,0
"17220","PHI","NYR",2008020019,14163,20082009,1,60,3,4,-1,0,0,0,28,27,1,41,38,3,50,50,0,7,7,0,0
"17221","PHI","MTL",2008020035,14165,20082009,1,60,3,5,-2,0,0,0,32,27,5,44,39,5,59,54,5,8,5,0,0
"17222","PHI","PIT",2008020039,14166,20082009,0,64.8166666666667,2,3,-1,0,0,0,30,28,2,40,39,1,54,62,-8,6,6,0,0
"17223","PHI","COL",2008020055,14168,20082009,0,60,2,5,-3,0,0,0,18,34,-16,24,42,-18,37,50,-13,9,12,0,0
"17224","PHI","S.J",2008020075,14170,20082009,0,61.4166666666667,4,5,-1,0,0,0,17,45,-28,29,62,-33,40,81,-41,6,11,0,0
"17225","PHI","S.J",2008020089,14174,20082009,1,65,6,6,0,0,0,0,29,35,-6,39,43,-4,50,62,-12,5,7,0,0
"17226","PHI","N.J",2008020100,14176,20082009,0,60,6,3,3,0,0,0,28,26,2,39,33,6,41,42,-1,2,3,0,0
"17227","PHI","N.J",2008020110,14177,20082009,1,63.7333333333333,3,2,1,0,0,0,33,31,2,50,35,15,60,48,12,5,6,0,0
"17228","PHI","ATL",2008020127,14180,20082009,0,60,7,0,7,0,0,0,31,24,7,42,30,12,51,40,11,8,6,0,0
"17229","PHI","NYI",2008020138,14182,20082009,1,64.6166666666667,3,2,1,0,0,0,28,36,-8,40,49,-9,50,66,-16,6,5,0,0
"17230","PHI","EDM",2008020162,14185,20082009,1,60,4,5,-1,0,0,0,26,28,-2,33,39,-6,48,53,-5,6,7,0,0
"17231","PHI","OTT",2008020185,14189,20082009,0,60,1,4,-3,0,0,0,18,25,-7,29,35,-6,44,51,-7,3,0,0,0
"17232","PHI","T.B",2008020199,14191,20082009,1,60,1,2,-1,0,0,0,36,22,14,48,31,17,60,46,14,5,6,0,0
"17233","PHI","NYI",2008020215,14194,20082009,0,60,3,1,2,0,0,0,32,36,-4,42,50,-8,59,73,-14,4,8,0,0
"17234","PHI","PIT",2008020230,14196,20082009,0,65,4,4,0,0,0,0,35,31,4,44,39,5,61,59,2,4,7,0,0
"17235","PHI","MTL",2008020242,14198,20082009,0,60,2,1,1,0,0,0,31,25,6,46,38,8,67,63,4,2,4,0,0
"17236","PHI","ATL",2008020254,14199,20082009,1,60,4,3,1,0,0,0,32,32,0,44,43,1,54,57,-3,4,3,0,0
"17237","PHI","BUF",2008020282,14204,20082009,0,60,3,0,3,0,0,0,25,40,-15,36,53,-17,48,61,-13,4,6,0,0
"17238","PHI","ARI",2008020290,14205,20082009,1,61.5833333333333,4,3,1,0,0,0,34,28,6,46,41,5,59,62,-3,3,8,0,0
"17239","PHI","DAL",2008020300,14207,20082009,1,60,4,3,1,0,0,0,25,25,0,31,41,-10,41,58,-17,1,5,0,0
"17240","PHI","CAR",2008020312,14209,20082009,0,60,3,1,2,0,0,0,27,28,-1,36,43,-7,52,62,-10,4,6,0,0
"17241","PHI","CAR",2008020324,14211,20082009,1,63.8833333333333,2,3,-1,0,0,0,26,30,-4,42,46,-4,54,57,-3,4,4,0,0
"17242","PHI","TOR",2008020337,14212,20082009,0,60,2,4,-2,0,0,0,30,27,3,52,46,6,71,57,14,4,4,0,0
"17243","PHI","T.B",2008020355,14215,20082009,1,62.0833333333333,4,3,1,0,0,0,32,38,-6,42,49,-7,55,62,-7,7,6,0,0
"17244","PHI","N.J",2008020367,14217,20082009,1,62.7666666666667,2,3,-1,0,0,0,31,31,0,42,46,-4,63,63,0,7,5,0,0
"17245","PHI","CAR",2008020384,14219,20082009,0,63.5666666666667,2,1,1,0,0,0,31,36,-5,44,50,-6,65,73,-8,5,8,0,0
"17246","PHI","NYI",2008020402,14222,20082009,1,60,4,3,1,0,0,0,25,27,-2,33,44,-11,52,60,-8,4,4,0,0
"17247","PHI","CAR",2008020414,14224,20082009,1,65,5,5,0,0,0,0,37,31,6,57,47,10,66,57,9,7,8,0,0
"17248","PHI","PIT",2008020429,14226,20082009,1,60,6,3,3,0,0,0,27,26,1,39,38,1,59,48,11,7,5,0,0
"17249","PHI","COL",2008020447,14229,20082009,1,60,5,2,3,0,0,0,24,31,-7,35,41,-6,51,55,-4,5,5,0,0
"17250","PHI","MTL",2008020464,14231,20082009,0,60,2,5,-3,0,0,0,31,31,0,47,44,3,67,57,10,3,7,0,0
"17251","PHI","WSH",2008020475,14233,20082009,1,60,7,1,6,0,0,0,28,48,-20,32,65,-33,47,80,-33,7,7,0,0
"17252","PHI","N.J",2008020489,14234,20082009,0,65,2,2,0,0,0,0,29,26,3,36,40,-4,42,51,-9,1,5,0,0
"17253","PHI","OTT",2008020497,14236,20082009,1,60,6,4,2,0,0,0,32,21,11,52,28,24,66,44,22,2,2,0,0
"17254","PHI","CHI",2008020513,14239,20082009,0,60,1,5,-4,0,0,0,18,38,-20,21,50,-29,29,67,-38,2,8,0,0
"17255","PHI","CBJ",2008020519,14240,20082009,0,60,0,3,-3,0,0,0,20,33,-13,25,46,-21,35,61,-26,5,8,0,0
"17256","PHI","VAN",2008020546,14243,20082009,0,60,3,2,1,0,0,0,29,31,-2,36,46,-10,51,54,-3,1,3,0,0
"17257","PHI","ANA",2008020564,14246,20082009,0,65,4,4,0,0,0,0,32,27,5,46,42,4,55,47,8,6,5,0,0
"17258","PHI","L.A",2008020574,14247,20082009,0,65,1,1,0,0,0,0,32,31,1,45,50,-5,54,73,-19,3,6,0,0
"17259","PHI","WSH",2008020587,14250,20082009,0,65,1,1,0,0,0,0,34,34,0,39,53,-14,57,77,-20,4,4,0,0
"17260","PHI","MIN",2008020600,14252,20082009,1,60,3,1,2,0,0,0,23,28,-5,26,42,-16,36,54,-18,3,10,0,0
"17261","PHI","TOR",2008020618,14254,20082009,1,60,4,1,3,0,0,0,30,42,-12,37,49,-12,50,68,-18,4,4,0,0
"17262","PHI","PIT",2008020633,14257,20082009,1,60,2,4,-2,0,0,0,29,26,3,42,40,2,52,50,2,2,5,0,0
"17263","PHI","T.B",2008020649,14259,20082009,0,60,1,4,-3,0,0,0,32,44,-12,39,55,-16,49,64,-15,4,5,0,0
"17264","PHI","FLA",2008020659,14260,20082009,0,65,2,2,0,0,0,0,26,34,-8,40,44,-4,49,59,-10,3,6,0,0
"17265","PHI","ATL",2008020694,14265,20082009,1,60,5,3,2,0,0,0,33,31,2,43,42,1,63,53,10,7,7,0,0
"17266","PHI","FLA",2008020706,14271,20082009,0,60,2,3,-1,0,0,0,35,27,8,46,36,10,60,46,14,5,7,0,0
"17267","PHI","T.B",2008020727,14274,20082009,0,60,6,1,5,0,0,0,32,42,-10,41,54,-13,50,68,-18,8,12,0,0
"17268","PHI","STL",2008020738,14275,20082009,0,60,0,4,-4,0,0,0,36,35,1,56,45,11,77,53,24,12,10,0,0
"17269","PHI","BOS",2008020759,14279,20082009,1,60,1,3,-2,0,0,0,26,33,-7,35,47,-12,47,65,-18,2,5,0,0
"17270","PHI","BOS",2008020777,14282,20082009,0,63,4,3,1,0,0,0,30,37,-7,40,52,-12,59,62,-3,6,3,0,0
"17271","PHI","ATL",2008020790,14283,20082009,0,60,3,2,1,0,0,0,23,31,-8,29,48,-19,36,64,-28,5,7,0,0
"17272","PHI","OTT",2008020811,14287,20082009,1,60,2,5,-3,0,0,0,36,23,13,51,33,18,70,46,24,3,2,0,0
"17273","PHI","NYI",2008020825,14289,20082009,1,60,5,1,4,0,0,0,34,39,-5,45,48,-3,61,66,-5,1,2,0,0
"17274","PHI","NYR",2008020835,14290,20082009,0,60,5,2,3,0,0,0,20,37,-17,31,52,-21,42,70,-28,4,5,0,0
"17275","PHI","BUF",2008020860,14294,20082009,1,60,6,3,3,0,0,0,36,42,-6,53,57,-4,76,77,-1,2,4,0,0
"17276","PHI","PIT",2008020874,14296,20082009,1,60,4,5,-1,0,0,0,27,27,0,44,40,4,57,49,8,5,5,0,0
"17277","PHI","WSH",2008020895,14299,20082009,0,60,4,2,2,0,0,0,37,35,2,51,57,-6,66,69,-3,9,8,0,0
"17278","PHI","L.A",2008020904,14300,20082009,1,60,2,0,2,0,0,0,20,34,-14,37,46,-9,46,77,-31,3,5,0,0
"17279","PHI","MTL",2008020918,14302,20082009,1,63.35,3,4,-1,0,0,0,38,36,2,57,46,11,78,65,13,9,6,0,0
"17280","PHI","N.J",2008020934,14304,20082009,0,60,0,3,-3,0,0,0,27,42,-15,30,48,-18,45,60,-15,3,5,0,0
"17281","PHI","BOS",2008020941,14306,20082009,0,60,4,2,2,0,0,0,26,24,2,33,34,-1,46,45,1,6,6,0,0
"17282","PHI","CGY",2008020957,14308,20082009,1,60,1,5,-4,0,0,0,36,41,-5,52,56,-4,67,65,2,6,4,0,0
"17283","PHI","NSH",2008020974,14310,20082009,1,60,4,1,3,0,0,0,26,32,-6,41,46,-5,60,57,3,6,5,0,0
"17284","PHI","BUF",2008020990,14313,20082009,1,60,5,2,3,0,0,0,33,29,4,46,39,7,64,54,10,8,5,0,0
"17285","PHI","WSH",2008021006,14315,20082009,1,60,1,2,-1,0,0,0,36,30,6,53,46,7,68,59,9,4,2,0,0
"17286","PHI","NYR",2008021019,14317,20082009,1,60,4,2,2,0,0,0,29,41,-12,36,57,-21,53,73,-20,3,4,0,0
"17287","PHI","NYR",2008021031,14318,20082009,0,60,1,4,-3,0,0,0,25,39,-14,35,56,-21,47,74,-27,6,7,0,0
"17288","PHI","DET",2008021046,14320,20082009,0,60,2,3,-1,0,0,0,26,48,-22,33,60,-27,37,83,-46,3,6,0,0
"17289","PHI","BUF",2008021065,14323,20082009,0,60,6,4,2,0,0,0,31,43,-12,38,60,-22,49,77,-28,6,10,0,0
"17290","PHI","PIT",2008021079,14325,20082009,0,60,3,1,2,0,0,0,20,28,-8,32,40,-8,50,63,-13,8,5,0,0
"17291","PHI","N.J",2008021085,14326,20082009,1,60,4,2,2,0,0,0,25,34,-9,35,54,-19,49,80,-31,6,10,0,0
"17292","PHI","FLA",2008021102,14329,20082009,1,60,2,4,-2,0,0,0,42,28,14,56,37,19,79,44,35,5,6,0,0
"17293","PHI","NYI",2008021120,14331,20082009,0,65,3,3,0,0,0,0,36,33,3,46,47,-1,60,65,-5,4,5,0,0
"17294","PHI","BOS",2008021130,14332,20082009,1,60,3,4,-1,0,0,0,48,31,17,59,45,14,75,66,9,3,3,0,0
"17295","PHI","TOR",2008021146,14335,20082009,0,60,2,3,-1,0,0,0,34,38,-4,51,51,0,70,61,9,4,4,0,0
"17296","PHI","TOR",2008021159,14337,20082009,1,60,8,5,3,0,0,0,35,32,3,47,52,-5,62,76,-14,5,3,0,0
"17297","PHI","OTT",2008021167,14338,20082009,0,65,3,3,0,0,0,0,34,38,-4,41,46,-5,53,63,-10,3,3,0,0
"17298","PHI","FLA",2008021186,14341,20082009,1,60,2,1,1,0,0,0,30,30,0,46,43,3,61,61,0,2,3,0,0
"17299","PHI","NYR",2008021200,14343,20082009,0,60,1,2,-1,0,0,0,38,31,7,46,41,5,67,54,13,5,3,0,0
"17300","PHI","NYI",2008021215,14345,20082009,0,60,3,2,1,0,0,0,27,32,-5,35,45,-10,40,56,-16,3,3,0,0
"17301","PHI","NYR",2008021229,14346,20082009,1,60,3,4,-1,0,0,0,31,31,0,41,38,3,56,47,9,5,7,0,0
"17302","PHI","PIT",2008030141,14349,20082009,0,60,1,4,-3,0,0,0,27,33,-6,41,40,1,60,57,3,5,10,0,0
"17303","PHI","PIT",2008030142,14351,20082009,0,78.4833333333333,2,3,-1,0,0,0,40,49,-9,54,64,-10,72,79,-7,4,5,0,0
"17304","PHI","PIT",2008030143,14353,20082009,1,60,6,3,3,0,0,0,30,29,1,39,40,-1,55,59,-4,9,9,0,0
"17305","PHI","PIT",2008030144,14355,20082009,1,60,1,3,-2,0,0,0,46,26,20,59,32,27,79,42,37,8,5,0,0
"17306","PHI","PIT",2008030145,14357,20082009,0,60,3,0,3,0,0,0,26,28,-2,39,34,5,48,51,-3,5,4,0,0
"17307","PHI","PIT",2008030146,14359,20082009,1,60,3,5,-2,0,0,0,25,35,-10,37,50,-13,51,69,-18,4,4,0,0
"17308","PHI","CAR",2009020005,14519,20092010,0,60,2,0,2,0,0,0,27,28,-1,41,48,-7,49,65,-16,6,10,0,0
"17309","PHI","N.J",2009020012,14520,20092010,0,60,5,2,3,0,0,0,27,26,1,32,32,0,41,38,3,3,5,0,0
"17310","PHI","WSH",2009020027,14523,20092010,1,63.8666666666667,6,5,1,0,0,0,41,36,5,60,46,14,74,58,16,9,6,0,0
"17311","PHI","PIT",2009020038,14525,20092010,1,60,4,5,-1,0,0,0,34,26,8,48,33,15,72,44,28,10,8,0,0
"17312","PHI","ANA",2009020052,14527,20092010,1,65,2,2,0,0,0,0,35,33,2,52,43,9,71,61,10,8,5,0,0
"17313","PHI","FLA",2009020089,14533,20092010,0,60,2,4,-2,0,0,0,27,28,-1,46,40,6,54,58,-4,2,3,0,0
"17314","PHI","BOS",2009020120,14539,20092010,1,65,3,3,0,0,0,0,39,26,13,56,37,19,72,59,13,2,2,0,0
"17315","PHI","FLA",2009020133,14541,20092010,1,60,5,1,4,0,0,0,38,18,20,53,28,25,81,46,35,5,4,0,0
"17316","PHI","S.J",2009020145,14542,20092010,1,60,1,4,-3,0,0,0,38,28,10,46,36,10,67,48,19,6,6,0,0
"17317","PHI","WSH",2009020152,14544,20092010,0,60,2,4,-2,0,0,0,43,36,7,62,45,17,82,58,24,5,4,0,0
"17318","PHI","CAR",2009020181,14548,20092010,1,60,6,1,5,0,0,0,28,40,-12,38,50,-12,47,73,-26,9,10,0,0
"17319","PHI","T.B",2009020196,14550,20092010,1,60,6,2,4,0,0,0,31,28,3,42,35,7,54,46,8,6,4,0,0
"17320","PHI","BUF",2009020221,14554,20092010,0,60,5,2,3,0,0,0,37,30,7,46,45,1,55,56,-1,5,7,0,0
"17321","PHI","STL",2009020231,14555,20092010,1,65,1,1,0,0,0,0,36,31,5,54,44,10,72,71,1,7,6,0,0
"17322","PHI","OTT",2009020255,14560,20092010,1,60,5,1,4,0,0,0,27,23,4,35,35,0,53,46,7,4,1,0,0
"17323","PHI","BUF",2009020271,14562,20092010,1,60,2,3,-1,0,0,0,31,25,6,52,34,18,68,48,20,6,9,0,0
"17324","PHI","N.J",2009020284,14564,20092010,1,60,3,2,1,0,0,0,35,35,0,48,47,1,62,73,-11,3,6,0,0
"17325","PHI","L.A",2009020298,14566,20092010,0,60,3,2,1,0,0,0,20,39,-19,36,53,-17,46,67,-21,3,5,0,0
"17326","PHI","S.J",2009020312,14568,20092010,0,60,3,6,-3,0,0,0,29,29,0,36,41,-5,49,60,-11,6,8,0,0
"17327","PHI","ARI",2009020323,14569,20092010,0,60,1,3,-2,0,0,0,24,21,3,31,31,0,47,48,-1,5,5,0,0
"17328","PHI","COL",2009020335,14571,20092010,0,60,4,5,-1,0,0,0,34,31,3,46,36,10,59,44,15,3,7,0,0
"17329","PHI","NYI",2009020340,14573,20092010,0,60,2,1,1,0,0,0,28,29,-1,41,43,-2,50,66,-16,1,5,0,0
"17330","PHI","BUF",2009020356,14575,20092010,1,60,2,4,-2,0,0,0,33,25,8,45,33,12,57,41,16,5,5,0,0
"17331","PHI","ATL",2009020371,14576,20092010,0,60,0,1,-1,0,0,0,34,18,16,43,27,16,56,41,15,4,6,0,0
"17332","PHI","VAN",2009020399,14581,20092010,1,60,0,3,-3,0,0,0,38,29,9,57,38,19,73,54,19,6,5,0,0
"17333","PHI","WSH",2009020419,14583,20092010,1,60,2,8,-6,0,0,0,36,30,6,46,42,4,65,58,7,2,4,0,0
"17334","PHI","MTL",2009020431,14585,20092010,0,60,1,3,-2,0,0,0,15,13,2,21,21,0,48,32,16,4,3,0,0
"17335","PHI","NYI",2009020438,14586,20092010,1,60,6,2,4,0,0,0,37,24,13,47,41,6,58,52,6,6,9,0,0
"17336","PHI","OTT",2009020453,14588,20092010,1,60,0,2,-2,0,0,0,23,25,-2,37,29,8,62,46,16,7,6,0,0
"17337","PHI","N.J",2009020468,14590,20092010,0,60,1,4,-3,0,0,0,23,28,-5,31,32,-1,40,37,3,2,6,0,0
"17338","PHI","BOS",2009020480,14592,20092010,0,60,3,1,2,0,0,0,38,27,11,50,36,14,58,48,10,5,4,0,0
"17339","PHI","PIT",2009020488,14593,20092010,0,60,1,6,-5,0,0,0,27,35,-8,41,44,-3,54,55,-1,6,4,0,0
"17340","PHI","PIT",2009020504,14595,20092010,1,65,2,2,0,0,0,0,33,30,3,47,41,6,66,55,11,5,7,0,0
"17341","PHI","NYR",2009020517,14597,20092010,1,60,1,2,-1,0,0,0,37,24,13,47,38,9,59,50,9,5,2,0,0
"17342","PHI","FLA",2009020533,14599,20092010,1,60,1,4,-3,0,0,0,31,30,1,40,41,-1,58,51,7,8,6,0,0
"17343","PHI","T.B",2009020552,14601,20092010,0,60,5,2,3,0,0,0,36,33,3,44,53,-9,59,66,-7,5,5,0,0
"17344","PHI","CAR",2009020561,14604,20092010,0,65,3,3,0,0,0,0,36,40,-4,47,58,-11,53,80,-27,3,5,0,0
"17345","PHI","NYI",2009020570,14605,20092010,0,60,2,1,1,0,0,0,30,29,1,47,38,9,67,56,11,5,5,0,0
"17346","PHI","NYR",2009020592,14608,20092010,0,60,6,0,6,0,0,0,31,22,9,38,38,0,49,57,-8,2,4,0,0
"17347","PHI","BOS",2009020609,14610,20092010,0,61.95,1,2,-1,0,0,0,25,26,-1,34,40,-6,46,60,-14,3,4,0,0
"17348","PHI","OTT",2009020624,14612,20092010,0,60,4,7,-3,0,0,0,21,33,-12,25,45,-20,35,59,-24,3,4,0,0
"17349","PHI","TOR",2009020641,14615,20092010,1,60,6,2,4,0,0,0,32,32,0,37,41,-4,54,64,-10,6,4,0,0
"17350","PHI","PIT",2009020649,14616,20092010,0,60,7,4,3,0,0,0,31,39,-8,40,55,-15,47,73,-26,3,4,0,0
"17351","PHI","T.B",2009020665,14618,20092010,1,60,4,1,3,0,0,0,31,18,13,41,28,13,48,42,6,5,5,0,0
"17352","PHI","DAL",2009020683,14621,20092010,1,60,6,3,3,0,0,0,28,30,-2,34,41,-7,43,59,-16,4,5,0,0
"17353","PHI","TOR",2009020693,14623,20092010,0,60,0,4,-4,0,0,0,38,35,3,49,51,-2,67,67,0,5,5,0,0
"17354","PHI","WSH",2009020719,14626,20092010,0,60,3,5,-2,0,0,0,33,22,11,53,29,24,71,46,25,6,2,0,0
"17355","PHI","CBJ",2009020734,14628,20092010,1,60,5,3,2,0,0,0,37,28,9,53,38,15,62,53,9,4,3,0,0
"17356","PHI","NYR",2009020747,14630,20092010,1,60,2,0,2,0,0,0,27,24,3,43,35,8,61,47,14,4,3,0,0
"17357","PHI","CAR",2009020761,14632,20092010,1,60,4,2,2,0,0,0,30,35,-5,41,46,-5,52,58,-6,4,6,0,0
"17358","PHI","PIT",2009020772,14633,20092010,1,60,1,2,-1,0,0,0,28,22,6,46,31,15,62,50,12,12,9,0,0
"17359","PHI","ATL",2009020793,14637,20092010,1,60,3,4,-1,0,0,0,37,28,9,47,40,7,60,51,9,4,5,0,0
"17360","PHI","NYI",2009020810,14639,20092010,1,60,2,1,1,0,0,0,32,32,0,39,42,-3,58,61,-3,7,6,0,0
"17361","PHI","CGY",2009020825,14641,20092010,0,60,3,0,3,0,0,0,27,18,9,40,38,2,48,53,-5,4,2,0,0
"17362","PHI","EDM",2009020839,14643,20092010,0,60,0,1,-1,0,0,0,33,27,6,54,38,16,70,53,17,4,4,0,0
"17363","PHI","MIN",2009020867,14646,20092010,0,60,1,2,-1,0,0,0,39,30,9,49,45,4,64,53,11,5,5,0,0
"17364","PHI","N.J",2009020872,14648,20092010,1,60,3,2,1,0,0,0,37,30,7,46,39,7,57,53,4,4,7,0,0
"17365","PHI","N.J",2009020883,14650,20092010,0,63.45,3,2,1,0,0,0,15,23,-8,24,37,-13,40,50,-10,4,3,0,0
"17366","PHI","MTL",2009020899,14652,20092010,1,60,3,2,1,0,0,0,33,25,8,45,37,8,63,66,-3,8,3,0,0
"17367","PHI","MTL",2009020907,14653,20092010,0,60,6,2,4,0,0,0,26,28,-2,29,41,-12,37,56,-19,5,7,0,0
"17368","PHI","T.B",2009020930,14670,20092010,0,60,7,2,5,0,0,0,34,38,-4,40,48,-8,54,60,-6,9,7,0,0
"17369","PHI","FLA",2009020936,14671,20092010,0,60,4,7,-3,0,0,0,42,43,-1,55,49,6,66,60,6,5,8,0,0
"17370","PHI","BUF",2009020950,14673,20092010,0,62.5166666666667,2,3,-1,0,0,0,29,35,-6,38,44,-6,56,53,3,1,2,0,0
"17371","PHI","TOR",2009020970,14675,20092010,1,60,3,1,2,0,0,0,25,28,-3,46,41,5,61,55,6,9,7,0,0
"17372","PHI","NYI",2009020977,14677,20092010,1,60,3,2,1,0,0,0,35,25,10,47,34,13,70,50,20,4,1,0,0
"17373","PHI","BOS",2009020992,14679,20092010,1,60,1,5,-4,0,0,0,32,37,-5,40,41,-1,54,62,-8,2,2,0,0
"17374","PHI","CHI",2009021006,14681,20092010,1,60,3,2,1,0,0,0,34,41,-7,50,56,-6,67,82,-15,4,5,0,0
"17375","PHI","NYR",2009021015,14682,20092010,0,60,1,3,-2,0,0,0,18,21,-3,30,37,-7,45,55,-10,5,6,0,0
"17376","PHI","NSH",2009021035,14684,20092010,0,65,3,3,0,0,0,0,45,30,15,55,43,12,75,52,23,2,0,0,0
"17377","PHI","DAL",2009021050,14686,20092010,0,60,3,2,1,0,0,0,31,29,2,39,45,-6,57,63,-6,2,4,0,0
"17378","PHI","ATL",2009021061,14688,20092010,0,60,2,5,-3,0,0,0,27,28,-1,39,37,2,60,47,13,5,4,0,0
"17379","PHI","ATL",2009021073,14689,20092010,1,60,1,3,-2,0,0,0,45,31,14,63,34,29,85,42,43,3,3,0,0
"17380","PHI","OTT",2009021083,14691,20092010,0,60,0,2,-2,0,0,0,26,26,0,40,40,0,52,58,-6,7,7,0,0
"17381","PHI","MIN",2009021099,14693,20092010,1,62.55,3,4,-1,0,0,0,35,21,14,51,35,16,69,46,23,5,4,0,0
"17382","PHI","PIT",2009021111,14695,20092010,0,60,1,4,-3,0,0,0,27,31,-4,41,44,-3,46,59,-13,5,6,0,0
"17383","PHI","N.J",2009021125,14696,20092010,1,60,5,1,4,0,0,0,25,33,-8,35,45,-10,45,71,-26,6,7,0,0
"17384","PHI","NYI",2009021151,14700,20092010,0,60,4,6,-2,0,0,0,35,28,7,43,32,11,65,47,18,3,3,0,0
"17385","PHI","MTL",2009021158,14701,20092010,1,60,0,1,-1,0,0,0,35,23,12,53,34,19,73,49,24,3,3,0,0
"17386","PHI","DET",2009021175,14703,20092010,1,60,4,3,1,0,0,0,25,34,-9,35,44,-9,45,63,-18,5,6,0,0
"17387","PHI","TOR",2009021183,14705,20092010,0,60,2,0,2,0,0,0,23,23,0,41,40,1,54,58,-4,8,9,0,0
"17388","PHI","NYR",2009021207,14708,20092010,0,60,3,4,-1,0,0,0,27,25,2,47,44,3,60,60,0,2,3,0,0
"17389","PHI","NYR",2009021223,14710,20092010,1,65,1,1,0,0,0,0,47,25,22,64,35,29,78,47,31,5,3,0,0
"17390","PHI","N.J",2009030121,14713,20092010,0,60,2,1,1,0,0,0,14,24,-10,20,40,-20,24,54,-30,3,4,0,0
"17391","PHI","N.J",2009030122,14715,20092010,0,60,3,5,-2,0,0,0,29,33,-4,43,45,-2,56,55,1,9,5,0,0
"17392","PHI","N.J",2009030123,14717,20092010,1,63.5833333333333,3,2,1,0,0,0,34,19,15,44,39,5,65,60,5,6,9,0,0
"17393","PHI","N.J",2009030124,14719,20092010,1,60,4,1,3,0,0,0,28,31,-3,38,49,-11,51,74,-23,8,8,0,0
"17394","PHI","N.J",2009030125,14721,20092010,0,60,3,0,3,0,0,0,21,28,-7,28,40,-12,33,55,-22,9,11,0,0
"17395","PHI","BOS",2009030221,14730,20092010,0,73.8666666666667,4,5,-1,0,0,0,36,46,-10,40,60,-20,56,79,-23,7,5,0,0
"17396","PHI","BOS",2009030222,14732,20092010,0,60,2,3,-1,0,0,0,26,27,-1,30,35,-5,42,48,-6,4,5,0,0
"17397","PHI","BOS",2009030223,14734,20092010,1,60,1,4,-3,0,0,0,35,20,15,50,23,27,71,31,40,4,2,0,0
"17398","PHI","BOS",2009030224,14736,20092010,1,74.6666666666667,5,4,1,0,0,0,34,37,-3,50,46,4,77,61,16,3,5,0,0
"17399","PHI","BOS",2009030225,14739,20092010,0,60,4,0,4,0,0,0,31,23,8,39,35,4,60,41,19,10,4,0,0
"17400","PHI","BOS",2009030226,14741,20092010,1,60,2,1,1,0,0,0,27,31,-4,33,49,-16,43,79,-36,5,4,0,0
"17401","PHI","BOS",2009030227,14743,20092010,0,60,4,3,1,0,0,0,27,25,2,34,39,-5,46,57,-11,3,3,0,0
"17402","PHI","MTL",2009030311,14745,20092010,1,60,6,0,6,0,0,0,25,28,-3,35,42,-7,55,58,-3,6,4,0,0
"17403","PHI","MTL",2009030312,14747,20092010,1,60,3,0,3,0,0,0,23,30,-7,29,36,-7,44,52,-8,4,4,0,0
"17404","PHI","MTL",2009030313,14749,20092010,0,60,1,5,-4,0,0,0,26,38,-12,35,52,-17,48,68,-20,7,10,0,0
"17405","PHI","MTL",2009030314,14751,20092010,0,60,3,0,3,0,0,0,25,17,8,38,27,11,52,54,-2,4,4,0,0
"17406","PHI","MTL",2009030315,14753,20092010,1,60,4,2,2,0,0,0,26,27,-1,35,37,-2,57,56,1,6,5,0,0
"17407","PHI","CHI",2009030411,14758,20092010,0,60,5,6,-1,0,0,0,32,32,0,44,39,5,55,46,9,4,0,0,0
"17408","PHI","CHI",2009030412,14760,20092010,0,60,1,2,-1,0,0,0,33,26,7,43,37,6,61,52,9,4,4,0,0
"17409","PHI","CHI",2009030413,14762,20092010,1,65.9833333333333,4,3,1,0,0,0,32,27,5,44,42,2,67,62,5,3,3,0,0
"17410","PHI","CHI",2009030414,14764,20092010,1,60,5,3,2,0,0,0,31,34,-3,43,49,-6,54,77,-23,7,4,0,0
"17411","PHI","CHI",2009030415,14766,20092010,0,60,4,7,-3,0,0,0,27,28,-1,36,42,-6,44,62,-18,3,4,0,0
"17412","PHI","CHI",2009030416,14769,20092010,1,64.1666666666667,3,4,-1,0,0,0,24,41,-17,41,51,-10,63,71,-8,4,5,0,0
"17413","PHI","PIT",2010020002,14889,20102011,0,60,3,2,1,3.8312359048947,3.79241424504858,0.0388216598461213,27,31,-4,37,49,-12,51,65,-14,5,6,0,0
"17414","PHI","STL",2010020019,14891,20102011,0,61.7833333333333,1,2,-1,0,0,0,30,25,5,44,44,0,59,59,0,9,13,0,0
"17415","PHI","COL",2010020031,14893,20102011,1,60,4,2,2,8.48372588087659,4.29721841531136,4.18650746556523,38,27,11,49,34,15,60,44,16,5,4,0,0
"17416","PHI","T.B",2010020042,14896,20102011,1,60,2,3,-1,4.45825861583262,5.50129675188509,-1.04303813605247,26,24,2,40,37,3,59,53,6,4,6,0,0
"17417","PHI","PIT",2010020058,14898,20102011,1,60,1,5,-4,4.52998392073101,4.16914821116349,0.360835709567522,30,32,-2,49,42,7,64,59,5,6,9,0,0
"17418","PHI","ANA",2010020084,14903,20102011,1,60,2,3,-1,7.90505528939181,2.47169672137147,5.43335856802034,42,22,20,61,32,29,89,40,49,5,4,0,0
"17419","PHI","TOR",2010020101,14905,20102011,1,60,5,2,3,4.64289635126534,2.69517156560323,1.9477247856621,40,14,26,55,22,33,68,40,28,6,5,0,0
"17420","PHI","CBJ",2010020114,14907,20102011,0,60,1,2,-1,0,0,0,29,25,4,36,38,-2,48,52,-4,3,6,0,0
"17421","PHI","BUF",2010020118,14908,20102011,1,60,6,3,3,7.14700755112975,4.52980978726055,2.6171977638692,34,35,-1,52,48,4,66,65,1,5,3,0,0
"17422","PHI","PIT",2010020139,14911,20102011,0,60,3,2,1,2.83818699678341,3.95846775732934,-1.12028076054594,24,28,-4,29,40,-11,44,56,-12,5,7,0,0
"17423","PHI","NYI",2010020146,14912,20102011,1,60,6,1,5,6.14038699370595,2.73144727274421,3.40893972096174,29,31,-2,48,40,8,63,52,11,9,7,0,0
"17424","PHI","CAR",2010020158,14914,20102011,1,60,3,2,1,5.5274879657328,4.5115055176575,1.01598244807531,37,28,9,51,44,7,67,67,0,5,3,0,0
"17425","PHI","NYR",2010020173,14917,20102011,1,60,4,1,3,3.45397900129319,3.92786124622216,-0.473882244928973,21,21,0,27,34,-7,42,54,-12,5,4,0,0
"17426","PHI","NYI",2010020191,14919,20102011,0,60,2,1,1,4.36163310871596,3.51105981513917,0.85057329357679,26,32,-6,43,49,-6,52,75,-23,2,6,0,0
"17427","PHI","WSH",2010020199,14920,20102011,0,60.4833333333333,2,3,-1,2.2951802026364,5.04981272012009,-2.75463251748369,25,39,-14,35,51,-16,49,74,-25,2,5,0,0
"17428","PHI","CAR",2010020220,14924,20102011,0,60,8,1,7,4.45771642611561,6.07476066073286,-1.61704423461725,26,36,-10,41,55,-14,50,77,-27,2,4,0,0
"17429","PHI","FLA",2010020237,14926,20102011,1,60,5,2,3,5.65495668397384,7.68704224530521,-2.03208556133137,42,36,6,59,46,13,78,67,11,4,2,0,0
"17430","PHI","OTT",2010020250,14928,20102011,1,60,5,1,4,8.61619810131378,7.94956307938628,0.666635021927505,46,29,17,56,40,16,70,57,13,5,1,0,0
"17431","PHI","MTL",2010020255,14929,20102011,0,60,0,3,-3,3.37809277984044,3.57165460352288,-0.193561823682439,41,28,13,50,40,10,65,49,16,8,10,0,0
"17432","PHI","T.B",2010020271,14931,20102011,1,60,7,8,-1,4.01468907556372,6.62530524726026,-2.61061617169654,32,33,-1,45,39,6,69,52,17,5,8,0,0
"17433","PHI","WSH",2010020287,14933,20102011,0,65,4,4,0,4.76284070569091,4.24035006549093,0.522490640199976,35,37,-2,44,55,-11,59,76,-17,9,7,0,0
"17434","PHI","MTL",2010020301,14935,20102011,1,60,3,2,1,8.12897172355861,4.11675282289798,4.01221890066063,45,31,14,57,43,14,75,58,17,3,4,0,0
"17435","PHI","MIN",2010020317,14937,20102011,0,60,6,1,5,4.00099837862945,4.34543989529865,-0.344441516669207,28,16,12,36,33,3,50,46,4,3,3,0,0
"17436","PHI","CGY",2010020323,14939,20102011,1,65,2,2,0,7.28033228060758,4.40204152734077,2.87829075326681,36,30,6,52,40,12,73,57,16,6,3,0,0
"17437","PHI","N.J",2010020334,14940,20102011,0,65,1,1,0,7.78073807121837,4.64701274796244,3.13372532325593,41,25,16,49,33,16,58,44,14,2,2,0,0
"17438","PHI","BOS",2010020359,14944,20102011,1,60,0,3,-3,7.25303800654365,5.18053145868308,2.07250654786057,41,32,9,61,43,18,75,54,21,6,3,0,0
"17439","PHI","N.J",2010020379,14947,20102011,1,60,5,3,2,10.0440470996109,4.63889482314698,5.40515227646392,34,26,8,46,35,11,64,49,15,5,5,0,0
"17440","PHI","NYI",2010020391,14948,20102011,0,60,3,2,1,3.72932909437632,4.05925049465208,-0.329921400275763,27,30,-3,45,41,4,63,64,-1,4,4,0,0
"17441","PHI","S.J",2010020406,14951,20102011,1,65,4,4,0,6.95226328101126,6.56478905668955,0.387474224321707,35,33,2,48,47,1,65,68,-3,4,5,0,0
"17442","PHI","TOR",2010020413,14952,20102011,0,60,4,1,3,6.17061332054436,5.6854131425124,0.485200178031963,28,32,-4,36,49,-13,54,71,-17,4,4,0,0
"17443","PHI","BOS",2010020425,14954,20102011,0,64.95,2,1,1,6.43429184397282,4.428675623603,2.00561622036982,33,36,-3,43,49,-6,60,70,-10,1,1,0,0
"17444","PHI","PIT",2010020447,14957,20102011,1,60,3,2,1,4.74457810758031,5.47676779968816,-0.732189692107847,37,23,14,49,40,9,54,52,2,7,5,0,0
"17445","PHI","MTL",2010020454,14958,20102011,0,60,5,3,2,0,0,0,30,41,-11,37,62,-25,49,84,-35,3,2,0,0
"17446","PHI","NYR",2010020473,14961,20102011,1,60,4,1,3,3.98194413298012,2.86573476911872,1.1162093638614,39,25,14,52,37,15,64,52,12,4,4,0,0
"17447","PHI","FLA",2010020490,14963,20102011,1,60,0,5,-5,3.66099222860616,6.87653568608221,-3.21554345747604,26,34,-8,43,47,-4,57,60,-3,1,4,0,0
"17448","PHI","VAN",2010020544,14971,20102011,0,60,2,6,-4,4.71728106759201,5.43016162951062,-0.71288056191861,37,49,-12,45,63,-18,56,79,-23,7,4,0,0
"17449","PHI","L.A",2010020556,14973,20102011,0,60,7,4,3,4.31444530459301,6.23516069935067,-1.92071539475766,28,36,-8,38,52,-14,52,71,-19,5,7,0,0
"17450","PHI","ANA",2010020563,14974,20102011,0,60,2,5,-3,3.39151696083718,4.14008002754417,-0.748563066706993,37,27,10,51,36,15,65,48,17,2,2,0,0
"17451","PHI","DET",2010020575,14976,20102011,0,60,3,2,1,0,0,0,32,27,5,39,41,-2,48,51,-3,2,3,0,0
"17452","PHI","N.J",2010020599,14980,20102011,0,60,4,2,2,3.64233268014505,1.7954326488547,1.84690003129035,20,20,0,34,32,2,43,37,6,4,1,0,0
"17453","PHI","N.J",2010020612,14982,20102011,1,60,2,1,1,2.30930616753176,3.69866037439471,-1.38935420686295,29,35,-6,40,47,-7,52,64,-12,5,4,0,0
"17454","PHI","BUF",2010020633,14985,20102011,0,60,5,2,3,4.93507286021486,4.19302589481231,0.742046965402551,33,40,-7,41,45,-4,46,60,-14,3,3,0,0
"17455","PHI","BOS",2010020646,14987,20102011,0,60,5,7,-2,3.93967899487162,6.79941197574954,-2.85973298087792,35,37,-2,42,47,-5,51,63,-12,1,5,0,0
"17456","PHI","ATL",2010020657,14988,20102011,0,60,5,2,3,4.934262099443,3.50999651463428,1.42426558480872,36,29,7,46,42,4,63,57,6,3,3,0,0
"17457","PHI","NYR",2010020674,14990,20102011,0,60,3,2,1,2.74938452047354,7.19095618469169,-4.44157166421815,27,36,-9,36,49,-13,46,73,-27,6,5,0,0
"17458","PHI","WSH",2010020684,14992,20102011,1,61.1166666666667,3,2,1,5.65711891837418,7.86398230746272,-2.20686338908854,30,25,5,43,38,5,52,52,0,1,0,0,0
"17459","PHI","OTT",2010020700,14994,20102011,1,60,6,2,4,5.22625231517441,3.0116512614768,2.21460105369761,23,27,-4,31,37,-6,38,53,-15,7,6,0,0
"17460","PHI","N.J",2010020712,14996,20102011,1,60,1,3,-2,6.26602772926708,4.19966078756261,2.06636694170447,27,22,5,41,38,3,61,53,8,3,4,0,0
"17461","PHI","CHI",2010020725,14997,20102011,0,60,4,1,3,6.44053487834753,3.87191595127751,2.56861892707002,34,31,3,37,38,-1,48,56,-8,2,3,0,0
"17462","PHI","MTL",2010020735,14999,20102011,1,60,5,2,3,5.54622229604301,6.44838524556933,-0.902162949526321,35,31,4,46,53,-7,54,84,-30,7,9,0,0
"17463","PHI","T.B",2010020758,15006,20102011,0,60,0,4,-4,4.31478433170416,3.84923541408513,0.465548917619026,38,22,16,51,32,19,67,43,24,4,2,0,0
"17464","PHI","NSH",2010020773,15008,20102011,1,60,3,2,1,5.50276547759557,4.38697342549676,1.11579205209881,29,28,1,38,38,0,53,49,4,2,2,0,0
"17465","PHI","DAL",2010020787,15010,20102011,1,60,3,1,2,4.14720103096114,3.08728425372101,1.05991677724013,32,31,1,42,37,5,57,61,-4,3,3,0,0
"17466","PHI","CAR",2010020817,15015,20102011,1,60,2,1,1,5.79207158366255,5.63756159199932,0.154509991663231,25,32,-7,35,46,-11,51,63,-12,6,5,0,0
"17467","PHI","L.A",2010020843,15018,20102011,1,60,0,1,-1,4.95401926787372,4.25224318586048,0.701776082013244,40,25,15,50,33,17,65,41,24,4,2,0,0
"17468","PHI","T.B",2010020851,15020,20102011,0,65,3,3,0,2.99295836015334,2.37435546184133,0.618602898312009,29,27,2,42,37,5,56,54,2,5,5,0,0
"17469","PHI","FLA",2010020858,15021,20102011,0,60,4,2,2,0,0,0,35,35,0,45,46,-1,53,66,-13,4,3,0,0
"17470","PHI","CAR",2010020871,15023,20102011,0,60,2,3,-1,4.48016694206726,4.29293556741322,0.187231374654033,23,29,-6,42,41,1,69,58,11,3,7,0,0
"17471","PHI","NYR",2010020887,15025,20102011,0,60,4,2,2,4.1568032848736,5.47017561113575,-1.31337232626214,24,39,-15,33,53,-20,50,74,-24,3,0,0,0
"17472","PHI","ARI",2010020895,15027,20102011,1,62.6833333333333,2,3,-1,5.22210494747446,6.02354697627015,-0.801442028795691,39,29,10,55,44,11,71,57,14,5,4,0,0
"17473","PHI","NYI",2010020909,15029,20102011,1,64.7,4,3,1,6.13015815175459,5.24530100169773,0.88485715005686,43,35,8,57,43,14,79,66,13,1,1,0,0
"17474","PHI","OTT",2010020929,15031,20102011,0,60,1,4,-3,5.25606887974,4.63102062360291,0.625048256137092,31,29,2,38,38,0,57,43,14,6,5,0,0
"17475","PHI","TOR",2010020959,15036,20102011,1,60,2,3,-1,4.25341167759513,4.25933563055878,-0.00592395296365389,30,33,-3,43,42,1,60,60,0,3,8,0,0
"17476","PHI","BUF",2010020974,15038,20102011,1,60,3,5,-2,6.12455400821437,6.94002743886085,-0.815473430646482,36,35,1,54,42,12,83,57,26,5,5,0,0
"17477","PHI","NYR",2010020984,15039,20102011,0,60,0,7,-7,5.14477998191433,4.72355685777876,0.42122312413557,24,36,-12,39,45,-6,59,56,3,6,6,0,0
"17478","PHI","EDM",2010020994,15041,20102011,1,60,4,1,3,5.50696710873673,3.57278843445238,1.93417867428435,27,25,2,39,38,1,57,52,5,2,3,0,0
"17479","PHI","TOR",2010021009,15043,20102011,0,60,3,2,1,6.00234882594668,4.31454765758826,1.68780116835842,33,29,4,49,44,5,62,61,1,4,6,0,0
"17480","PHI","ATL",2010021026,15045,20102011,1,61.2833333333333,4,5,-1,4.0285014793852,6.26716928387759,-2.23866780449239,24,41,-17,31,56,-25,49,73,-24,3,4,0,0
"17481","PHI","FLA",2010021047,15048,20102011,0,60,3,2,1,3.7368234051099,4.64096358255892,-0.904140177449015,31,22,9,40,35,5,49,57,-8,5,3,0,0
"17482","PHI","ATL",2010021055,15050,20102011,0,65,3,3,0,2.73272036573926,4.57827636367324,-1.84555599793398,24,25,-1,31,40,-9,41,58,-17,3,4,0,0
"17483","PHI","DAL",2010021076,15052,20102011,0,65,2,2,0,2.84354311092271,6.13188677519793,-3.28834366427522,30,30,0,39,50,-11,51,73,-22,2,5,0,0
"17484","PHI","WSH",2010021090,15055,20102011,1,65,4,4,0,4.35811280385678,3.43604737887654,0.922065424980246,33,23,10,49,37,12,70,51,19,2,2,0,0
"17485","PHI","PIT",2010021105,15057,20102011,1,65,1,1,0,4.64309958276863,6.22817712319443,-1.5850775404258,20,31,-11,27,43,-16,41,61,-20,3,2,0,0
"17486","PHI","NYI",2010021120,15059,20102011,0,60,4,1,3,2.92473164077542,6.5629245499149,-3.63819290913948,22,37,-15,33,51,-18,41,67,-26,1,4,0,0
"17487","PHI","BOS",2010021131,15060,20102011,1,60,1,2,-1,6.80909186153713,8.0380147773626,-1.22892291582548,28,36,-8,37,50,-13,50,70,-20,1,3,0,0
"17488","PHI","PIT",2010021136,15062,20102011,0,60,5,2,3,2.37290060655818,3.89519529190147,-1.5222946853433,24,27,-3,27,40,-13,40,54,-14,4,4,0,0
"17489","PHI","ATL",2010021152,15064,20102011,1,60,0,1,-1,3.30461728405769,4.04676402243786,-0.742146738380164,43,22,21,52,31,21,71,44,27,6,7,0,0
"17490","PHI","N.J",2010021160,15065,20102011,0,60,2,4,-2,2.95584538811818,2.14128063687531,0.81456475124287,36,24,12,44,38,6,48,42,6,1,1,0,0
"17491","PHI","NYR",2010021175,15067,20102011,1,65,2,2,0,7.42487172130495,5.20111924941906,2.22375247188589,34,34,0,48,47,1,71,63,8,5,4,0,0
"17492","PHI","OTT",2010021188,15069,20102011,0,60,2,5,-3,5.7649320806629,5.14228468799894,0.622647392663964,29,36,-7,43,40,3,62,52,10,6,5,0,0
"17493","PHI","BUF",2010021207,15072,20102011,0,61.2666666666667,3,4,-1,3.9837383178791,6.15119474192124,-2.16745642404214,27,29,-2,37,39,-2,54,46,8,2,3,0,0
"17494","PHI","NYI",2010021218,15073,20102011,1,60,7,4,3,6.76513387328237,9.22677906946875,-2.46164519618638,39,36,3,51,54,-3,69,68,1,6,7,0,0
"17495","PHI","BUF",2010030121,15078,20102011,1,60,0,1,-1,4.75119270123537,5.91685829048166,-1.16566558924629,35,25,10,58,32,26,74,36,38,6,2,0,0
"17496","PHI","BUF",2010030122,15080,20102011,1,60,5,4,1,4.24377378396238,4.17051202115696,0.0732617628054175,34,28,6,46,39,7,62,57,5,12,10,0,0
"17497","PHI","BUF",2010030123,15082,20102011,0,60,4,2,2,2.92203330868688,4.32037081400267,-1.39833750531579,26,37,-11,36,47,-11,45,64,-19,5,8,0,0
"17498","PHI","BUF",2010030124,15084,20102011,0,60,0,1,-1,4.35599669439421,3.94671738643862,0.409279307955585,32,29,3,51,37,14,65,52,13,6,6,0,0
"17499","PHI","BUF",2010030125,15086,20102011,1,65.5166666666667,3,4,-1,5.97858336893842,8.68010545699074,-2.70152208805232,39,32,7,58,42,16,87,50,37,6,4,0,0
"17500","PHI","BUF",2010030126,15088,20102011,0,64.7166666666667,5,4,1,7.31719844054896,5.33206325175809,1.98513518879088,49,33,16,64,49,15,80,66,14,6,6,0,0
"17501","PHI","BUF",2010030127,15090,20102011,1,60,5,2,3,5.59163964479963,6.79289452894591,-1.20125488414628,36,28,8,51,44,7,70,72,-2,6,6,0,0
"17502","PHI","BOS",2010030221,15094,20102011,1,60,3,7,-4,5.00879266260723,4.20132869273948,0.807463969867751,34,33,1,41,41,0,57,66,-9,7,7,0,0
"17503","PHI","BOS",2010030222,15096,20102011,1,74,2,3,-1,9.37952385627318,6.92225131737376,2.45727253889942,54,41,13,66,60,6,89,82,7,5,3,0,0
"17504","PHI","BOS",2010030223,15098,20102011,0,60,1,5,-4,5.44475290825345,2.82938065057056,2.61537225768289,38,28,10,45,39,6,56,45,11,2,4,0,0
"17505","PHI","BOS",2010030224,15100,20102011,0,60,1,5,-4,2.68716775687062,6.22120511102366,-3.53403735415304,23,27,-4,30,40,-10,42,55,-13,6,8,0,0
"17506","PHI","BOS",2011020001,15253,20112012,0,60,2,1,1,3.60456262211871,1.97205546550686,1.63250715661186,29,23,6,38,35,3,47,52,-5,5,7,0,0
"17507","PHI","N.J",2011020012,15255,20112012,0,60,3,0,3,3.51561046206803,1.48775807888286,2.02785238318517,29,20,9,36,25,11,47,31,16,8,5,0,0
"17508","PHI","VAN",2011020035,15259,20112012,1,60,5,4,1,2.92668271747781,6.49346386488976,-3.56678114741194,27,40,-13,34,52,-18,43,79,-36,5,7,0,0
"17509","PHI","L.A",2011020052,15262,20112012,1,61.65,2,3,-1,4.15108016147133,4.91211057279725,-0.761030411325919,34,26,8,45,34,11,67,52,15,9,8,0,0
"17510","PHI","OTT",2011020073,15265,20112012,0,60,7,2,5,5.99304094878647,5.7910693277372,0.201971621049267,30,23,7,39,40,-1,51,56,-5,6,4,0,0
"17511","PHI","WSH",2011020081,15267,20112012,1,60,2,5,-3,4.43146202069573,3.77303880261024,0.658423218085485,42,28,14,49,41,8,61,64,-3,4,6,0,0
"17512","PHI","STL",2011020100,15269,20112012,1,60,2,4,-2,3.36980941571557,3.32876858597551,0.0410408297400551,36,25,11,41,34,7,58,45,13,4,3,0,0
"17513","PHI","TOR",2011020110,15271,20112012,1,60,4,2,2,2.85065248553872,5.74332914262777,-2.89267665708906,30,26,4,41,33,8,54,43,11,5,4,0,0
"17514","PHI","MTL",2011020122,15273,20112012,0,60,1,5,-4,4.37208338858909,6.74779465025229,-2.3757112616632,22,28,-6,38,42,-4,57,57,0,5,6,0,0
"17515","PHI","WPG",2011020128,15274,20112012,1,60,8,9,-1,6.36543000518319,3.82897172954489,2.5364582756383,48,25,23,65,32,33,84,43,41,6,6,0,0
"17516","PHI","CAR",2011020145,15276,20112012,1,60,5,1,4,4.8269089744968,3.83009648101033,0.996812493486473,34,25,9,44,46,-2,52,58,-6,5,3,0,0
"17517","PHI","BUF",2011020165,15280,20112012,0,60,3,2,1,4.64076780588198,5.70102993550245,-1.06026212962047,26,31,-5,31,41,-10,38,59,-21,6,8,0,0
"17518","PHI","N.J",2011020170,15281,20112012,1,65,3,3,0,3.87379670021481,4.622918048266,-0.749121348051187,23,39,-16,32,49,-17,51,77,-26,7,4,0,0
"17519","PHI","CBJ",2011020189,15283,20112012,1,60,9,2,7,6.16662605125748,7.44568624571548,-1.279060194458,33,35,-2,49,47,2,60,61,-1,6,4,0,0
"17520","PHI","T.B",2011020212,15287,20112012,0,62.5,1,2,-1,3.2846016600775,5.49909317654874,-2.21449151647124,15,24,-9,34,44,-10,45,59,-14,5,7,0,0
"17521","PHI","FLA",2011020240,15291,20112012,0,60,3,2,1,3.69692043726536,3.93201999634473,-0.235099559079366,35,33,2,44,48,-4,56,66,-10,6,6,0,0
"17522","PHI","CAR",2011020244,15292,20112012,0,60,5,3,2,3.23642775848225,2.3561709985961,0.880256759886151,28,20,8,36,35,1,48,56,-8,8,7,0,0
"17523","PHI","ARI",2011020262,15295,20112012,1,60,2,1,1,8.77471323473401,5.36234169559225,3.41237153914176,42,31,11,55,44,11,72,54,18,3,3,0,0
"17524","PHI","WPG",2011020274,15297,20112012,0,60,4,6,-2,3.31132035019073,5.97266682317262,-2.66134647298189,31,40,-9,41,50,-9,55,60,-5,9,9,0,0
"17525","PHI","CAR",2011020290,15299,20112012,1,60,2,4,-2,5.68964822937414,3.92511669838859,1.76453153098555,32,31,1,45,39,6,65,50,15,5,5,0,0
"17526","PHI","NYI",2011020302,15301,20112012,0,62.5666666666667,4,3,1,4.83082905708579,5.06934270425546,-0.238513647169668,33,32,1,48,42,6,73,57,16,5,5,0,0
"17527","PHI","MTL",2011020315,15303,20112012,1,60,3,1,2,5.20322913046468,5.60766108650387,-0.40443195603919,36,24,12,43,41,2,61,53,8,4,5,0,0
"17528","PHI","NYR",2011020327,15304,20112012,0,60,0,2,-2,2.96164482147135,2.98095820437811,-0.0193133829067573,29,32,-3,38,41,-3,59,55,4,4,4,0,0
"17529","PHI","ANA",2011020371,15310,20112012,0,63.4833333333333,4,3,1,5.56369895195887,2.00114233664817,3.5625566153107,47,22,25,57,33,24,76,42,34,11,5,0,0
"17530","PHI","ARI",2011020380,15311,20112012,0,60,4,2,2,4.71945477007699,5.53241994931599,-0.812965179239001,30,38,-8,44,60,-16,51,82,-31,7,8,0,0
"17531","PHI","BUF",2011020403,15315,20112012,0,62.6166666666667,5,4,1,8.09435603767633,2.57541765875067,5.51893837892567,34,24,10,49,33,16,59,44,15,2,5,0,0
"17532","PHI","T.B",2011020425,15318,20112012,1,60,5,2,3,5.75748841448932,3.87012756860349,1.88736084588583,32,19,13,41,27,14,67,43,24,5,4,0,0
"17533","PHI","WSH",2011020441,15321,20112012,0,60,5,1,4,5.25732646077711,4.44833863075473,0.808987830022375,33,32,1,43,48,-5,56,67,-11,1,3,0,0
"17534","PHI","MTL",2011020454,15323,20112012,0,60,4,3,1,2.76807856466621,5.56534769606034,-2.79726913139412,25,31,-6,30,42,-12,49,60,-11,6,9,0,0
"17535","PHI","BOS",2011020466,15325,20112012,1,60,0,6,-6,4.837499254264,4.90804615676461,-0.0705469025006096,31,37,-6,42,51,-9,59,63,-4,6,9,0,0
"17536","PHI","COL",2011020484,15327,20112012,0,65,2,2,0,5.3477948144573,4.0591214340493,1.288673380408,33,27,6,53,32,21,66,51,15,4,3,0,0
"17537","PHI","DAL",2011020496,15329,20112012,0,60,4,1,3,3.5678466626144,4.70935675737832,-1.14151009476392,30,31,-1,43,51,-8,57,71,-14,6,4,0,0
"17538","PHI","NYR",2011020511,15331,20112012,0,60,2,4,-2,3.41239944193512,3.05134301027283,0.361056431662291,30,24,6,46,38,8,62,53,9,4,4,0,0
"17539","PHI","T.B",2011020532,15335,20112012,0,60,1,5,-4,4.16976723080597,2.35937341977842,1.81039381102755,32,16,16,51,25,26,73,32,41,5,6,0,0
"17540","PHI","NYR",2011020569,15341,20112012,1,60,2,3,-1,5.37815279886127,5.09189859192702,0.286254206934245,36,33,3,50,41,9,70,49,21,4,3,0,0
"17541","PHI","CHI",2011020587,15344,20112012,1,60,5,4,1,9.17337365534331,7.25630695398286,1.91706670136045,46,34,12,60,46,14,75,62,13,3,0,0,0
"17542","PHI","OTT",2011020599,15346,20112012,1,64.9,3,2,1,4.46088432623219,5.15063986895673,-0.689755542724542,39,37,2,55,51,4,69,68,1,8,5,0,0
"17543","PHI","OTT",2011020611,15347,20112012,0,60,4,6,-2,5.87240430013446,8.10350959777134,-2.23110529763688,37,38,-1,49,47,2,64,67,-3,3,2,0,0
"17544","PHI","CAR",2011020621,15349,20112012,0,60,2,1,1,5.91368536934351,4.71625088338056,1.19743448596295,37,36,1,51,51,0,62,68,-6,5,4,0,0
"17545","PHI","NYI",2011020632,15351,20112012,0,60,3,2,1,5.65212559072097,4.36121808276221,1.29090750795876,22,35,-13,32,45,-13,44,64,-20,3,4,0,0
"17546","PHI","NSH",2011020656,15353,20112012,0,60,2,4,-2,3.44715128957523,2.78340989269782,0.663741396877413,38,25,13,48,34,14,66,42,24,2,3,0,0
"17547","PHI","MIN",2011020673,15356,20112012,1,60,5,1,4,5.68716031360179,5.01587059766098,0.671289715940816,34,26,8,44,36,8,57,50,7,6,1,0,0
"17548","PHI","NYI",2011020688,15358,20112012,1,60,1,4,-3,5.2155760056994,5.59062265763828,-0.375046651938874,41,27,14,55,34,21,80,42,38,6,5,0,0
"17549","PHI","N.J",2011020700,15360,20112012,0,60,4,1,3,3.2894721469311,5.53353004144652,-2.24405789451541,20,31,-11,28,38,-10,32,47,-15,6,7,0,0
"17550","PHI","BOS",2011020713,15361,20112012,1,65,5,5,0,8.24206144154078,4.92494477843866,3.31711666310213,38,37,1,56,51,5,74,70,4,11,8,0,0
"17551","PHI","FLA",2011020727,15363,20112012,0,65,2,2,0,6.78485227009924,2.92395800167026,3.86089426842898,37,25,12,45,32,13,54,45,9,3,2,0,0
"17552","PHI","WPG",2011020738,15370,20112012,1,65,1,1,0,5.38820970873348,5.38633573098923,0.00187397774425335,28,24,4,42,39,3,64,53,11,1,3,0,0
"17553","PHI","NSH",2011020756,15372,20112012,1,60,4,1,3,4.95858639001381,4.0900912584366,0.868495131577204,28,27,1,45,40,5,57,55,2,5,6,0,0
"17554","PHI","N.J",2011020768,15374,20112012,1,60,4,6,-2,6.41903314199089,3.62750232903454,2.79153081295635,41,31,10,58,39,19,82,43,39,10,10,0,0
"17555","PHI","NYR",2011020781,15375,20112012,0,60,2,5,-3,4.34690542507451,4.44045193891725,-0.0935465138427389,23,38,-15,35,47,-12,60,57,3,6,5,0,0
"17556","PHI","NYI",2011020787,15377,20112012,1,65,0,0,0,5.43249222016391,3.84956784837414,1.58292437178977,45,18,27,62,33,29,86,52,34,3,3,0,0
"17557","PHI","TOR",2011020804,15379,20112012,1,60,4,3,1,4.77784061903094,5.0295870307018,-0.251746411670865,39,27,12,46,38,8,73,57,16,4,4,0,0
"17558","PHI","NYR",2011020819,15381,20112012,1,60,2,5,-3,3.75827705041198,4.209175641984,-0.450898591572024,33,26,7,48,40,8,64,52,12,6,9,0,0
"17559","PHI","DET",2011020829,15382,20112012,0,60,3,4,-1,3.4955500112843,4.57761937915348,-1.08206936786917,29,25,4,44,39,5,54,48,6,3,6,0,0
"17560","PHI","BUF",2011020852,15386,20112012,1,60,7,2,5,7.34254160450917,5.904719352955,1.43782225155417,35,29,6,42,41,1,49,58,-9,4,7,0,0
"17561","PHI","WPG",2011020892,15391,20112012,0,64.2666666666667,5,4,1,8.13404322335555,1.89445099269506,6.23959223066049,55,26,29,66,33,33,80,43,37,4,4,0,0
"17562","PHI","EDM",2011020907,15393,20112012,0,60,0,2,-2,3.1640235803934,3.89560034845999,-0.731576768066589,35,30,5,46,42,4,60,50,10,4,4,0,0
"17563","PHI","CGY",2011020924,15395,20112012,0,65,4,4,0,8.29549687680948,4.48420389214199,3.81129298466749,45,21,24,63,34,29,82,54,28,7,4,0,0
"17564","PHI","S.J",2011020945,15398,20112012,0,60,0,1,-1,3.81113695450409,4.03987257019207,-0.228735615687981,26,23,3,37,34,3,55,52,3,2,1,0,0
"17565","PHI","NYI",2011020952,15400,20112012,1,60,6,3,3,6.07422167406185,2.81944320062757,3.25477847343427,30,24,6,44,32,12,68,48,20,1,2,0,0
"17566","PHI","WSH",2011020979,15403,20112012,0,60,1,0,1,3.0285430261938,4.21353715532314,-1.18499412912934,23,34,-11,33,45,-12,41,60,-19,1,0,0,0
"17567","PHI","DET",2011020986,15405,20112012,1,60,3,2,1,2.620160017583,6.1726810812433,-3.55252106366029,23,39,-16,37,54,-17,47,78,-31,2,4,0,0
"17568","PHI","FLA",2011021000,15407,20112012,1,60,5,0,5,5.65134235373113,4.18525908698211,1.46608326674902,35,28,7,53,42,11,59,60,-1,6,6,0,0
"17569","PHI","TOR",2011021016,15409,20112012,0,65,0,0,0,3.82758844530053,3.40119285637047,0.426395588930063,27,29,-2,43,48,-5,52,71,-19,1,4,0,0
"17570","PHI","N.J",2011021029,15410,20112012,0,60,1,4,-3,1.55931773313029,3.27547055279138,-1.71615281966109,19,31,-12,24,43,-19,27,46,-19,3,5,0,0
"17571","PHI","N.J",2011021039,15412,20112012,1,60,3,0,3,3.46740246517584,1.22677993093483,2.24062253424101,29,17,12,39,26,13,48,41,7,7,6,0,0
"17572","PHI","NYI",2011021053,15414,20112012,0,60,3,2,1,4.28499950064361,2.81980209960602,1.46519740103759,22,31,-9,32,35,-3,46,54,-8,0,2,0,0
"17573","PHI","BOS",2011021065,15416,20112012,0,65,2,2,0,5.45077229340313,5.01632963872331,0.434442654679828,29,33,-4,39,46,-7,55,64,-9,4,2,0,0
"17574","PHI","FLA",2011021089,15419,20112012,1,60,1,2,-1,5.38197105911968,2.91397647513804,2.46799458398164,36,13,23,50,30,20,68,41,27,4,2,0,0
"17575","PHI","WSH",2011021102,15421,20112012,1,65,1,1,0,6.88110872270227,4.00380932614235,2.87729939655992,28,31,-3,44,40,4,60,50,10,1,3,0,0
"17576","PHI","MTL",2011021121,15423,20112012,1,60,4,1,3,4.65260876372076,6.68372819869546,-2.0311194349747,33,24,9,47,37,10,68,46,22,6,6,0,0
"17577","PHI","T.B",2011021134,15425,20112012,1,60,3,5,-2,5.07309612551944,3.68100415490215,1.39209197061729,38,15,23,56,22,34,81,29,52,6,3,0,0
"17578","PHI","TOR",2011021155,15428,20112012,0,60,7,1,6,5.5743448963907,1.79906586408583,3.77527903230487,30,17,13,46,29,17,56,45,11,6,6,0,0
"17579","PHI","OTT",2011021170,15430,20112012,1,65,3,3,0,7.03809201519471,3.6230078261984,3.4150841889963,39,29,10,52,45,7,69,63,6,6,5,0,0
"17580","PHI","NYR",2011021192,15433,20112012,1,60,3,5,-2,7.62027986630892,4.27575131705822,3.3445285492507,40,24,16,62,29,33,82,38,44,9,6,0,0
"17581","PHI","BUF",2011021203,15435,20112012,1,60,2,1,1,4.28831716835134,7.39549569017254,-3.1071785218212,35,26,9,46,37,9,65,53,12,2,3,0,0
"17582","PHI","PIT",2011030141,15441,20112012,0,62.3833333333333,4,3,1,4.4163593975488,4.31932757484645,0.0970318227023483,26,28,-2,34,43,-9,53,59,-6,1,3,0,0
"17583","PHI","PIT",2011030142,15443,20112012,0,60,8,5,3,5.40276358520615,8.34916266426444,-2.9463990790583,31,28,3,39,46,-7,44,58,-14,3,5,0,0
"17584","PHI","PIT",2011030143,15445,20112012,1,60,8,4,4,6.62471499260255,8.1652387677459,-1.54052377514336,34,35,-1,46,52,-6,58,72,-14,12,12,0,0
"17585","PHI","PIT",2011030144,15448,20112012,1,60,3,10,-7,3.86144677236776,6.84080177109293,-2.97935499872517,25,36,-11,30,45,-15,43,63,-20,8,12,0,0
"17586","PHI","PIT",2011030145,15450,20112012,0,60,2,3,-1,3.92117172388205,5.4260178369077,-1.50484611302565,26,23,3,40,31,9,58,41,17,5,3,0,0
"17587","PHI","PIT",2011030146,15452,20112012,1,60,5,1,4,4.16161394300002,3.76758920955763,0.394024733442393,23,31,-8,33,48,-15,47,88,-41,3,5,0,0
"17588","PHI","N.J",2011030221,15459,20112012,1,64.6,4,3,1,7.25539358978858,1.35739091500707,5.89800267478152,36,26,10,54,34,20,71,47,24,6,3,0,0
"17589","PHI","N.J",2011030222,15461,20112012,1,60,1,4,-3,3.02010527207312,4.80351292203475,-1.78340764996162,20,35,-15,25,47,-22,37,70,-33,6,6,0,0
"17590","PHI","N.J",2011030223,15463,20112012,0,77.35,3,4,-1,3.49411510606296,3.42098549544805,0.0731296106149131,28,31,-3,34,44,-10,46,59,-13,5,2,0,0
"17591","PHI","N.J",2011030224,15466,20112012,0,60,2,4,-2,4.16321670093207,4.37443804611394,-0.211221345181864,22,43,-21,27,54,-27,33,64,-31,2,5,0,0
"17592","PHI","N.J",2011030225,15468,20112012,1,60,1,3,-2,2.27576763297947,5.02897305048224,-2.75320541750277,28,30,-2,37,44,-7,55,60,-5,1,4,0,0
"17593","PHI","BUF",2012020014,15725,20122013,0,60,2,5,-3,2.27021999453427,5.94876880179238,-3.6785488072581,29,41,-12,35,47,-12,44,61,-17,8,10,0,0
"17594","PHI","N.J",2012020030,15727,20122013,0,60,0,3,-3,2.46280969875113,4.42626415609081,-1.96345445733968,24,26,-2,30,33,-3,46,41,5,12,14,0,0
"17595","PHI","NYR",2012020041,15729,20122013,1,60,2,1,1,6.57251457948092,4.50127017765772,2.0712444018232,33,19,14,49,28,21,64,48,16,4,4,0,0
"17596","PHI","FLA",2012020060,15731,20122013,0,60,7,1,6,3.20671617169864,5.36344481588458,-2.15672864418593,26,31,-5,37,50,-13,51,60,-9,8,5,0,0
"17597","PHI","T.B",2012020068,15732,20122013,0,60,1,5,-4,3.89910427542259,1.95120769213918,1.94789658328341,25,26,-1,41,32,9,67,40,27,7,6,0,0
"17598","PHI","NYR",2012020080,15734,20122013,0,60,1,2,-1,3.60792690682138,3.50515355984317,0.102773346978211,27,28,-1,36,35,1,49,51,-2,7,3,0,0
"17599","PHI","WSH",2012020101,15737,20122013,0,60,2,3,-1,4.01550046377815,1.89213918260066,2.12336128117749,31,26,5,43,33,10,66,44,22,3,5,0,0
"17600","PHI","CAR",2012020112,15738,20122013,1,60,5,3,2,2.45018828638638,6.87464733480873,-4.42445904842235,24,42,-18,34,59,-25,41,91,-50,4,7,0,0
"17601","PHI","T.B",2012020133,15741,20122013,1,60,2,1,1,2.7086391676421,3.41781572700711,-0.709176559365005,24,22,2,36,35,1,58,53,5,3,5,0,0
"17602","PHI","FLA",2012020144,15743,20122013,1,65,2,2,0,2.2791468691139,1.87087506311309,0.408271806000812,32,24,8,40,34,6,59,46,13,4,4,0,0
"17603","PHI","CAR",2012020156,15745,20122013,1,61.7833333333333,4,3,1,4.3029844200646,5.31227248450887,-1.00928806444426,32,33,-1,51,45,6,62,65,-3,3,5,0,0
"17604","PHI","TOR",2012020172,15747,20122013,0,60,2,5,-3,4.60316236643063,3.54816130525433,1.0550010611763,46,24,22,55,38,17,74,56,18,3,6,0,0
"17605","PHI","WPG",2012020183,15748,20122013,0,60,3,2,1,3.954312452213,3.02203633670442,0.932276115508586,23,26,-3,28,42,-14,42,54,-12,4,3,0,0
"17606","PHI","N.J",2012020198,15751,20122013,0,60,3,5,-2,4.5132333424699,3.50101368414471,1.01221965832519,28,19,9,38,31,7,46,41,5,1,1,0,0
"17607","PHI","MTL",2012020206,15752,20122013,0,60,1,4,-3,2.25548073939657,3.57729566817386,-1.32181492877729,19,29,-10,31,39,-8,42,56,-14,5,5,0,0
"17608","PHI","NYI",2012020220,15754,20122013,0,60,7,0,7,3.04975160576942,2.21812089370519,0.831630712064225,25,19,6,35,29,6,43,52,-9,4,5,0,0
"17609","PHI","FLA",2012020238,15757,20122013,1,60,2,5,-3,4.9493497862918,6.66829231317388,-1.71894252688207,34,26,8,50,35,15,73,47,26,2,4,0,0
"17610","PHI","WPG",2012020251,15759,20122013,1,60,5,3,2,0,0,0,39,37,2,49,49,0,62,66,-4,8,6,0,0
"17611","PHI","TOR",2012020270,15761,20122013,1,60,2,4,-2,4.55306249088608,4.36430144169776,0.188761049188315,25,22,3,39,35,4,51,51,0,6,3,0,0
"17612","PHI","WSH",2012020285,15763,20122013,1,60,4,1,3,5.3531058212393,2.81959351635315,2.53351230488614,32,24,8,46,31,15,67,52,15,4,3,0,0
"17613","PHI","OTT",2012020302,15766,20122013,1,60,2,1,1,4.10832223574049,5.37269992443489,-1.2643776886944,41,34,7,54,51,3,75,66,9,5,4,0,0
"17614","PHI","NYR",2012020329,15769,20122013,0,60,2,4,-2,2.30042132141534,3.26908489975904,-0.968663578343694,25,20,5,33,34,-1,52,47,5,3,4,0,0
"17615","PHI","BOS",2012020355,15773,20122013,0,60,0,3,-3,4.98337197092249,3.19373556075152,1.78963641017097,23,28,-5,37,44,-7,55,69,-14,3,2,0,0
"17616","PHI","BUF",2012020371,15774,20122013,1,60,3,2,1,2.41763047072336,2.96133591998949,-0.543705449266135,28,20,8,38,26,12,55,41,14,7,4,0,0
"17617","PHI","N.J",2012020389,15777,20122013,0,60,2,5,-3,2.9124277574104,3.51212940090045,-0.599701643490044,25,32,-7,27,42,-15,35,57,-22,5,7,0,0
"17618","PHI","N.J",2012020402,15779,20122013,1,65,1,1,0,4.16911196243018,3.69249129664995,0.476620665780224,22,28,-6,32,44,-12,42,60,-18,4,5,0,0
"17619","PHI","T.B",2012020423,15782,20122013,0,60,2,4,-2,3.81340452981772,4.92775591550162,-1.1143513856839,30,27,3,45,43,2,58,56,2,4,4,0,0
"17620","PHI","NYR",2012020483,15790,20122013,1,60,2,5,-3,5.00675106906336,4.28802744770292,0.718723621360448,34,31,3,43,43,0,63,61,2,1,3,0,0
"17621","PHI","NYI",2012020493,15792,20122013,1,65,3,3,0,4.97788391914219,6.01511859170569,-1.0372346725635,36,36,0,48,52,-4,61,78,-17,3,5,0,0
"17622","PHI","BOS",2012020506,15794,20122013,1,60,3,1,2,4.54566946047772,6.2684565136442,-1.72278705316647,22,34,-12,30,47,-17,43,67,-24,3,4,0,0
"17623","PHI","WSH",2012020521,15795,20122013,1,61.5666666666667,5,4,1,5.04381267519511,4.86537952486497,0.178433150330143,34,29,5,50,49,1,71,67,4,5,8,0,0
"17624","PHI","MTL",2012020539,15798,20122013,1,60,5,3,2,3.39332864957808,1.80847639540298,1.58485225417511,34,17,17,38,29,9,48,42,6,4,4,0,0
"17625","PHI","TOR",2012020544,15799,20122013,0,60,5,3,2,6.68915250175633,7.5387751366361,-0.849622634879779,31,28,3,45,46,-1,58,64,-6,4,2,0,0
"17626","PHI","WPG",2012020559,15801,20122013,0,60,1,4,-3,1.71383683557647,4.40817833401979,-2.69434149844332,31,25,6,42,40,2,55,58,-3,3,3,0,0
"17627","PHI","NYI",2012020582,15804,20122013,0,60,1,4,-3,3.26946231728652,4.05673848961305,-0.787276172326528,27,32,-5,40,42,-2,52,58,-6,2,1,0,0
"17628","PHI","OTT",2012020598,15806,20122013,1,60,1,3,-2,2.44387171901945,6.84178951801732,-4.39791779899787,25,34,-9,28,53,-25,45,72,-27,2,5,0,0
"17629","PHI","BUF",2012020610,15808,20122013,0,60,0,1,-1,5.55356365034822,3.72904316772474,1.82452048262348,29,21,8,40,31,9,52,40,12,4,2,0,0
"17630","PHI","MTL",2012020626,15810,20122013,0,60,7,3,4,4.97126836335572,4.81247333557522,0.158795027780503,33,28,5,40,44,-4,47,62,-15,7,10,0,0
"17631","PHI","NYR",2012020635,15811,20122013,1,60,4,2,2,3.29875741423123,8.97585466135024,-5.67709724711901,22,40,-18,33,52,-19,47,71,-24,2,5,0,0
"17632","PHI","N.J",2012020648,15813,20122013,1,60,0,3,-3,4.64769690769026,5.32877077563717,-0.681073867946907,23,31,-8,29,44,-15,42,61,-19,3,5,0,0
"17633","PHI","CAR",2012020665,15815,20122013,0,60,5,3,2,5.59075530959217,4.24492083285077,1.3458344767414,38,29,9,58,47,11,68,58,10,4,3,0,0
"17634","PHI","BOS",2012020684,15818,20122013,1,60,5,2,3,4.18225553978533,7.74104994896584,-3.55879440918051,30,41,-11,40,50,-10,53,70,-17,3,3,0,0
"17635","PHI","NYI",2012020694,15820,20122013,1,60,2,1,1,4.74814497608168,2.75109352975142,1.99705144633026,30,22,8,44,34,10,56,50,6,4,2,0,0
"17636","PHI","OTT",2012020709,15822,20122013,0,60,2,1,1,3.79515265027544,7.14550873808252,-3.35035608780708,25,44,-19,35,56,-21,44,74,-30,2,5,0,0
"17637","PHI","TOR",2013020004,15980,20132014,1,60,1,3,-2,4.98511971722473,3.81429470159674,1.170825015628,32,25,7,53,31,22,73,42,31,9,3,0,0
"17638","PHI","MTL",2013020023,15983,20132014,0,60,1,4,-3,2.78190767798523,5.52349878801033,-2.7415911100251,23,34,-11,36,51,-15,48,75,-27,7,11,0,0
"17639","PHI","CAR",2013020032,15984,20132014,0,60,1,2,-1,4.47296923449903,4.42503704797855,0.0479321865204838,18,34,-16,30,46,-16,41,60,-19,2,4,0,0
"17640","PHI","FLA",2013020039,15986,20132014,1,60,2,1,1,4.03259904043091,4.61625689381526,-0.583657853384352,30,34,-4,41,48,-7,57,68,-11,6,7,0,0
"17641","PHI","ARI",2013020058,15989,20132014,1,60,1,2,-1,5.18468659476028,3.3077720367063,1.87691455805398,37,31,6,59,46,13,70,63,7,5,7,0,0
"17642","PHI","DET",2013020065,15990,20132014,0,60,2,5,-3,4.55712644508458,8.56742845408735,-4.01030200900277,34,30,4,40,39,1,55,47,8,4,7,0,0
"17643","PHI","VAN",2013020084,15993,20132014,1,60,2,3,-1,3.88579412491526,3.87077452731319,0.0150195976020768,22,25,-3,36,37,-1,54,54,0,2,1,0,0
"17644","PHI","NYR",2013020141,16002,20132014,1,60,2,1,1,6.37405875592958,6.02963666131687,0.344422094612714,27,31,-4,38,44,-6,50,61,-11,3,2,0,0
"17645","PHI","NYI",2013020160,16004,20132014,0,60,5,2,3,7.55049696110655,3.59570538104163,3.95479158006492,32,28,4,52,40,12,65,58,7,4,4,0,0
"17646","PHI","ANA",2013020177,16007,20132014,1,60,2,3,-1,5.02712136925395,8.91369771934114,-3.8865763500872,28,37,-9,39,49,-10,50,64,-14,3,2,0,0
"17647","PHI","WSH",2013020191,16010,20132014,1,60,0,7,-7,4.15778645641353,5.95414505535695,-1.79635859894343,30,32,-2,44,44,0,59,55,4,5,7,0,0
"17648","PHI","N.J",2013020203,16011,20132014,0,60,1,0,1,1.76509138918482,1.23291151336161,0.532179875823203,21,14,7,28,20,8,34,27,7,5,5,0,0
"17649","PHI","CAR",2013020222,16014,20132014,0,62.6666666666667,1,2,-1,3.15788719884949,7.26661481534097,-4.10872761649148,29,38,-9,40,55,-15,63,74,-11,5,5,0,0
"17650","PHI","N.J",2013020232,16016,20132014,1,60,0,3,-3,3.56167182422781,4.98463954069302,-1.42296771646522,22,25,-3,31,32,-1,46,40,6,3,3,0,0
"17651","PHI","EDM",2013020245,16018,20132014,1,60,4,2,2,5.89176759149996,3.36322186843609,2.52854572306387,34,26,8,56,31,25,73,45,28,3,6,0,0
"17652","PHI","OTT",2013020269,16021,20132014,0,60,5,0,5,5.46023927733768,5.31440180905338,0.145837468284299,31,24,7,40,36,4,52,49,3,3,1,0,0
"17653","PHI","WPG",2013020292,16024,20132014,0,65,2,2,0,6.01406440102743,5.504706636013,0.509357765014428,34,38,-4,42,53,-11,53,66,-13,3,4,0,0
"17654","PHI","OTT",2013020314,16028,20132014,1,60,5,2,3,7.34957061242963,7.00002755171464,0.349543060714986,42,34,8,53,39,14,71,53,18,5,8,0,0
"17655","PHI","BUF",2013020328,16030,20132014,1,60,4,1,3,7.10003206597837,5.71014342889457,1.3898886370838,46,30,16,60,41,19,74,56,18,8,5,0,0
"17656","PHI","NYI",2013020346,16032,20132014,1,60,5,2,3,5.65856044681188,8.42533784624845,-2.76677739943658,30,38,-8,50,48,2,71,66,5,3,3,0,0
"17657","PHI","FLA",2013020359,16034,20132014,0,60,1,3,-2,4.96806613286026,4.56328715901225,0.404778973848003,39,31,8,49,38,11,66,49,17,4,2,0,0
"17658","PHI","T.B",2013020371,16036,20132014,0,60,2,4,-2,3.3321143467109,7.31426067158463,-3.98214632487374,21,35,-14,31,48,-17,43,58,-15,5,6,0,0
"17659","PHI","WPG",2013020383,16038,20132014,1,60,2,1,1,4.99044967126611,3.50323193211343,1.48721773915268,34,26,8,45,36,9,62,55,7,5,7,0,0
"17660","PHI","NSH",2013020398,16039,20132014,0,65,2,2,0,3.40798088978806,4.50209488722612,-1.09411399743806,24,36,-12,38,46,-8,49,59,-10,3,5,0,0
"17661","PHI","MIN",2013020408,16041,20132014,0,60,0,2,-2,4.3721160304267,4.63153991855506,-0.259423888128367,21,21,0,37,29,8,53,37,16,2,2,0,0
"17662","PHI","DET",2013020420,16043,20132014,0,60,6,3,3,6.1901928730794,4.67784485276206,1.51234802031734,34,35,-1,44,42,2,56,47,9,4,10,0,0
"17663","PHI","DAL",2013020446,16046,20132014,0,60,1,5,-4,2.50579839010458,6.53049982537868,-4.0247014352741,28,34,-6,41,45,-4,65,54,11,5,5,0,0
"17664","PHI","OTT",2013020454,16048,20132014,0,65,4,4,0,6.74880916450638,7.65663799873437,-0.907828834227985,29,34,-5,38,52,-14,54,70,-16,2,3,0,0
"17665","PHI","CHI",2013020471,16050,20132014,0,60,2,7,-5,4.18138486577108,3.55163299581977,0.629751869951306,30,23,7,40,31,9,52,46,6,5,7,0,0
"17666","PHI","MTL",2013020474,16051,20132014,1,60,2,1,1,3.54587792836537,4.58107727711504,-1.03519934874966,27,21,6,41,28,13,65,43,22,5,3,0,0
"17667","PHI","WSH",2013020499,16054,20132014,0,65,4,4,0,0,0,0,28,33,-5,39,40,-1,55,50,5,4,5,0,0
"17668","PHI","WSH",2013020515,16056,20132014,1,60,5,2,3,4.67228930233368,3.03435588581488,1.63793341651881,35,26,9,45,32,13,65,51,14,5,4,0,0
"17669","PHI","CBJ",2013020525,16058,20132014,1,60,5,4,1,7.24635754997446,3.90380405348917,3.34255349648529,39,29,10,55,37,18,75,46,29,4,2,0,0
"17670","PHI","CBJ",2013020547,16060,20132014,0,60,3,6,-3,6.42630060572064,4.80186879725077,1.62443180846988,36,29,7,42,38,4,54,49,5,5,4,0,0
"17671","PHI","MIN",2013020560,16062,20132014,1,60,4,1,3,3.97284671432863,5.23230197015528,-1.25945525582665,31,27,4,39,43,-4,61,53,8,4,5,0,0
"17672","PHI","EDM",2013020584,16067,20132014,0,65,3,3,0,4.56478419719497,5.23527845018543,-0.670494252990466,38,16,22,57,27,30,74,34,40,5,5,0,0
"17673","PHI","VAN",2013020598,16069,20132014,0,65,3,3,0,2.86180463484847,3.39893222405226,-0.537127589203785,27,44,-17,34,55,-21,49,70,-21,3,5,0,0
"17674","PHI","CGY",2013020608,16070,20132014,0,60,4,1,3,2.59612442360958,2.02381949359551,0.57230493001407,21,24,-3,30,38,-8,37,60,-23,1,2,0,0
"17675","PHI","COL",2013020619,16072,20132014,0,60,1,2,-1,3.43388894462805,4.95489033940248,-1.52100139477443,30,31,-1,44,40,4,56,54,2,3,2,0,0
"17676","PHI","ARI",2013020636,16074,20132014,0,60,5,3,2,5.30872111869514,6.1735765778576,-0.864855459162466,28,29,-1,43,41,2,54,56,-2,3,4,0,0
"17677","PHI","N.J",2013020649,16077,20132014,0,61.8333333333333,3,2,1,5.46271287628412,3.75220050978533,1.71051236649879,28,33,-5,40,43,-3,48,47,1,5,3,0,0
"17678","PHI","MTL",2013020657,16078,20132014,1,60,3,1,2,2.99485311823082,5.57150315381256,-2.57665003558174,27,20,7,39,31,8,50,52,-2,4,4,0,0
"17679","PHI","T.B",2013020675,16081,20132014,1,60,3,6,-3,6.23058329438616,4.07758829388058,2.15299500050558,38,25,13,58,34,24,77,41,36,6,5,0,0
"17680","PHI","NYR",2013020688,16082,20132014,0,60,1,4,-3,2.26648210618984,6.31000322797697,-4.04352112178713,38,35,3,45,51,-6,59,69,-10,3,6,0,0
"17681","PHI","BUF",2013020699,16084,20132014,0,60,4,3,1,3.06938201963949,4.12977087728086,-1.06038885764137,33,19,14,45,28,17,61,36,25,6,4,0,0
"17682","PHI","NSH",2013020711,16086,20132014,1,65,3,3,0,3.44887075662336,5.76689409831777,-2.31802334169441,30,37,-7,39,45,-6,59,60,-1,4,4,0,0
"17683","PHI","NYI",2013020729,16088,20132014,1,60,6,4,2,9.81851755035032,4.58407131904627,5.23444623130405,32,29,3,42,37,5,61,52,9,3,4,0,0
"17684","PHI","NYI",2013020740,16090,20132014,0,65,3,3,0,2.01298008361027,3.86142159736607,-1.8484415137558,29,43,-14,38,54,-16,50,76,-26,4,7,0,0
"17685","PHI","CAR",2013020749,16092,20132014,1,60,2,3,-1,3.72766167574446,6.18555079793798,-2.45788912219352,24,32,-8,36,46,-10,48,65,-17,3,3,0,0
"17686","PHI","CBJ",2013020761,16093,20132014,0,60,2,5,-3,2.67182772987871,5.64705454300256,-2.97522681312385,28,39,-11,33,54,-21,42,65,-23,6,7,0,0
"17687","PHI","BOS",2013020776,16095,20132014,1,60,1,6,-5,3.06361310080683,4.09413334286077,-1.03052024205394,26,33,-7,33,43,-10,51,62,-11,2,4,0,0
"17688","PHI","DET",2013020797,16098,20132014,1,60,5,0,5,4.62627961605273,4.71828489508516,-0.0920052790324348,28,33,-5,37,45,-8,46,65,-19,4,6,0,0
"17689","PHI","ANA",2013020817,16100,20132014,0,60,3,5,-2,4.95147126813086,5.89190435639466,-0.940433088263799,30,28,2,45,44,1,66,53,13,4,1,0,0
"17690","PHI","L.A",2013020827,16102,20132014,0,60,2,0,2,1.6973893652621,4.44928328677634,-2.75189392151424,13,35,-22,19,49,-30,27,69,-42,2,3,0,0
"17691","PHI","S.J",2013020843,16104,20132014,0,60,5,2,3,4.80851921813713,1.71759491570992,3.0909243024272,28,22,6,41,29,12,61,46,15,2,5,0,0
"17692","PHI","COL",2013020858,16107,20132014,1,60,3,1,2,4.30167765537044,4.63721139772382,-0.335533742353382,35,39,-4,49,48,1,60,74,-14,3,4,0,0
"17693","PHI","CGY",2013020872,16109,20132014,1,60,2,1,1,3.82158849887492,5.03640733164775,-1.21481883277283,23,33,-10,31,51,-20,43,69,-26,3,3,0,0
"17694","PHI","S.J",2013020889,16128,20132014,1,60,3,7,-4,2.53746877449805,4.09298037618493,-1.55551160168688,30,29,1,40,47,-7,51,57,-6,5,5,0,0
"17695","PHI","NYR",2013020904,16130,20132014,1,60,4,2,2,6.68739620700944,7.17443387239473,-0.487037665385287,31,35,-4,45,54,-9,67,78,-11,5,4,0,0
"17696","PHI","WSH",2013020912,16131,20132014,0,62.75,5,4,1,3.56484146258381,3.01451237726724,0.550329085316577,36,29,7,54,40,14,76,52,24,5,8,0,0
"17697","PHI","WSH",2013020935,16134,20132014,1,60,6,4,2,5.87695424505195,4.29691483383067,1.58003941122128,30,25,5,41,35,6,60,51,9,4,6,0,0
"17698","PHI","TOR",2013020955,16137,20132014,0,62.35,3,4,-1,6.51814084813951,2.88923576378147,3.62890508435804,31,36,-5,55,46,9,85,58,27,2,3,0,0
"17699","PHI","N.J",2013020977,16140,20132014,1,60,1,2,-1,4.74974215926844,1.73001110475523,3.0197310545132,31,26,5,49,32,17,67,46,21,6,3,0,0
"17700","PHI","CHI",2013021033,16147,20132014,1,64.9166666666667,3,2,1,6.50735962067847,4.39927924379589,2.10808037688258,37,25,12,57,37,20,71,49,22,6,4,0,0
"17701","PHI","DAL",2013021043,16149,20132014,1,60,4,2,2,5.57653270463925,5.9668377324578,-0.390305027818556,29,35,-6,42,45,-3,65,69,-4,2,3,0,0
"17702","PHI","STL",2013021055,16151,20132014,1,60,4,1,3,3.04089807397395,2.91242996370815,0.128468110265796,19,33,-14,31,50,-19,55,71,-16,8,10,0,0
"17703","PHI","L.A",2013021074,16153,20132014,1,60,2,3,-1,7.75252157683585,5.68905763675113,2.06346394008471,32,41,-9,47,52,-5,68,65,3,5,5,0,0
"17704","PHI","NYR",2013021090,16155,20132014,0,60,1,3,-2,4.62390968041291,2.75005928028258,1.87385040013032,31,29,2,39,41,-2,60,55,5,5,5,0,0
"17705","PHI","TOR",2013021102,16157,20132014,1,60,4,2,2,3.71990396654232,4.08070353974472,-0.360799573202395,29,34,-5,46,38,8,65,55,10,7,6,0,0
"17706","PHI","BOS",2013021121,16159,20132014,1,65,3,3,0,7.90052259475851,4.07945595059846,3.82106664416006,52,30,22,61,35,26,71,49,22,4,2,0,0
"17707","PHI","STL",2013021136,16161,20132014,0,65,0,0,0,3.12591787258862,2.14430772438936,0.981610148199252,31,28,3,37,49,-12,49,66,-17,3,4,0,0
"17708","PHI","CBJ",2013021145,16163,20132014,1,60,0,2,-2,4.00146555064682,4.75711737339795,-0.75565182275113,37,27,10,46,44,2,68,64,4,4,4,0,0
"17709","PHI","BOS",2013021160,16165,20132014,0,60,2,5,-3,2.51143625343684,6.46429416257942,-3.95285790914258,26,42,-16,36,56,-20,47,71,-24,3,1,0,0
"17710","PHI","BUF",2013021173,16166,20132014,1,60,5,2,3,7.24649578764037,4.53804955862483,2.70844622901554,37,19,18,54,31,23,74,45,29,4,4,0,0
"17711","PHI","FLA",2013021185,16168,20132014,0,60,5,2,3,5.13716046046466,3.79941924125887,1.33774121920578,27,40,-13,38,47,-9,49,59,-10,2,1,0,0
"17712","PHI","T.B",2013021198,16170,20132014,0,60,2,4,-2,5.05859971260452,3.61337098605873,1.44522872654579,36,30,6,46,39,7,62,48,14,3,3,0,0
"17713","PHI","CAR",2013021222,16173,20132014,1,65,5,5,0,9.2900727981731,6.60376725941023,2.68630553876287,44,38,6,59,47,12,76,66,10,3,2,0,0
"17714","PHI","NYR",2013030141,16177,20132014,0,60,1,4,-3,2.44707730298978,5.2298259631425,-2.78274866015272,15,36,-21,26,47,-21,42,69,-27,2,6,0,0
"17715","PHI","NYR",2013030142,16180,20132014,0,60,4,2,2,2.88467783361193,3.55848028482433,-0.673802451212396,25,33,-8,31,43,-12,44,65,-21,6,9,0,0
"17716","PHI","NYR",2013030143,16182,20132014,1,60,1,4,-3,6.23353209575635,4.62560828381902,1.60792381193733,32,23,9,52,38,14,80,49,31,6,5,0,0
"17717","PHI","NYR",2013030144,16185,20132014,1,60,2,1,1,3.36236287517386,3.24662025026009,0.115742624913764,25,38,-13,40,58,-18,61,72,-11,3,5,0,0
"17718","PHI","NYR",2013030145,16187,20132014,0,60,2,4,-2,4.76759630331071,3.80352266817681,0.9640736351339,26,22,4,38,31,7,50,41,9,5,3,0,0
"17719","PHI","NYR",2013030146,16189,20132014,1,60,5,2,3,5.01301082399201,8.72975240502827,-3.71674158103626,29,36,-7,41,55,-14,55,79,-24,4,6,0,0
"17720","PHI","NYR",2013030147,16190,20132014,0,60,1,2,-1,5.73193865187932,4.53535312632295,1.19658552555636,27,33,-6,37,44,-7,59,57,2,2,1,0,0
"17721","PHI","BOS",2014020002,16351,20142015,0,60,1,2,-1,1.92548416436473,2.61099573737488,-0.685511573010153,20,33,-13,29,43,-14,44,58,-14,5,3,0,0
"17722","PHI","N.J",2014020006,16352,20142015,1,60,4,6,-2,6.54974558906213,3.29089820355875,3.25884738550337,39,26,13,54,39,15,68,53,15,5,3,0,0
"17723","PHI","MTL",2014020024,16354,20142015,1,65,3,3,0,5.24371038173411,5.76901263780792,-0.525302256073805,32,38,-6,42,59,-17,66,91,-25,6,4,0,0
"17724","PHI","ANA",2014020039,16357,20142015,1,65,3,3,0,6.42724051725531,2.5686707507266,3.85856976652872,42,28,14,56,34,22,79,46,33,4,2,0,0
"17725","PHI","DAL",2014020070,16361,20142015,0,62.8166666666667,6,5,1,7.10666955879424,3.43261913987953,3.6740504189147,37,23,14,58,38,20,83,47,36,5,3,0,0
"17726","PHI","CHI",2014020085,16364,20142015,0,60,0,4,-4,3.60631276556524,7.2971861451806,-3.69087337961537,32,43,-11,40,56,-16,55,71,-16,2,4,0,0
"17727","PHI","DET",2014020111,16368,20142015,1,60,4,2,2,4.79784866096452,5.41527788032811,-0.617429219363586,17,37,-20,27,44,-17,42,75,-33,6,4,0,0
"17728","PHI","L.A",2014020126,16371,20142015,1,62.6,3,2,1,6.72860492627751,6.6087541783017,0.119850747975814,43,40,3,54,60,-6,67,78,-11,2,2,0,0
"17729","PHI","T.B",2014020142,16373,20142015,0,60,3,4,-1,2.20063674001653,2.03337674079921,0.167259999217322,27,32,-5,38,39,-1,48,53,-5,4,7,0,0
"17730","PHI","FLA",2014020156,16375,20142015,0,60,1,2,-1,3.33120936338105,1.89119636871615,1.4400129946649,37,30,7,43,37,6,55,40,15,7,5,0,0
"17731","PHI","EDM",2014020174,16378,20142015,1,60,4,1,3,3.49273643704305,7.6499677570464,-4.15723132000335,25,36,-11,37,54,-17,55,73,-18,0,4,0,0
"17732","PHI","FLA",2014020188,16380,20142015,1,60,4,1,3,2.87544074404059,7.31346888415283,-4.43802814011224,30,35,-5,39,47,-8,53,65,-12,4,6,0,0
"17733","PHI","COL",2014020207,16382,20142015,1,60,4,3,1,3.85397506881122,4.77600753739978,-0.922032468588554,27,39,-12,37,49,-12,54,62,-8,3,4,0,0
"17734","PHI","CBJ",2014020242,16388,20142015,1,60,3,4,-1,3.29758043815673,7.34278410160914,-4.04520366345241,27,38,-11,35,51,-16,51,67,-16,3,4,0,0
"17735","PHI","MTL",2014020252,16389,20142015,0,60,3,6,-3,5.69557227491168,4.68955796912633,1.00601430578536,29,28,1,44,38,6,67,49,18,5,3,0,0
"17736","PHI","NYR",2014020278,16393,20142015,0,60,0,2,-2,3.33251898712479,3.86947570802295,-0.536956720898161,31,34,-3,41,40,1,47,48,-1,4,4,0,0
"17737","PHI","MIN",2014020280,16394,20142015,1,60,2,3,-1,4.11015605469304,6.41587116126902,-2.30571510657599,39,29,10,48,37,11,72,43,29,5,7,0,0
"17738","PHI","CBJ",2014020300,16396,20142015,1,60,4,2,2,7.13164674254949,6.9419529621955,0.189693780353991,37,22,15,46,30,16,60,47,13,5,4,0,0
"17739","PHI","NYI",2014020313,16398,20142015,0,65,0,0,0,1.96347867800984,6.70566249757394,-4.7421838195641,21,46,-25,29,63,-34,39,75,-36,2,3,0,0
"17740","PHI","DET",2014020325,16400,20142015,0,60,2,5,-3,5.64046346023679,4.40497494159354,1.23548851864325,24,25,-1,36,31,5,47,40,7,4,3,0,0
"17741","PHI","NYR",2014020333,16402,20142015,1,60,0,3,-3,3.21874949598472,2.31175968201842,0.906989813966297,26,24,2,38,33,5,57,50,7,5,6,0,0
"17742","PHI","NYR",2014020348,16403,20142015,0,60,2,5,-3,2.96787686307115,3.41662682080641,-0.448749957735266,23,35,-12,32,45,-13,46,58,-12,1,3,0,0
"17743","PHI","S.J",2014020370,16406,20142015,0,60,1,2,-1,3.00109477539081,6.43024060816425,-3.42914583277344,29,27,2,37,42,-5,49,49,0,2,1,0,0
"17744","PHI","ANA",2014020375,16407,20142015,0,65,4,4,0,5.61953318450833,4.04746183138482,1.5720713531235,35,33,2,49,56,-7,56,76,-20,3,6,0,0
"17745","PHI","L.A",2014020391,16410,20142015,0,60,2,1,1,3.40798730688402,6.57902315876464,-3.17103585188062,16,38,-22,26,47,-21,29,69,-40,5,5,0,0
"17746","PHI","CBJ",2014020411,16413,20142015,0,61.9666666666667,2,3,-1,3.15912199264492,3.71192811935907,-0.552806126714152,21,24,-3,34,33,1,46,48,-2,4,4,0,0
"17747","PHI","N.J",2014020423,16415,20142015,1,60,4,1,3,6.50897848908789,5.43234155897323,1.07663693011466,36,18,18,44,25,19,55,46,9,5,2,0,0
"17748","PHI","CAR",2014020436,16417,20142015,1,60,5,1,4,4.05605471132003,6.47807587007992,-2.42202115875989,23,26,-3,36,42,-6,48,66,-18,2,4,0,0
"17749","PHI","T.B",2014020453,16420,20142015,1,60,1,3,-2,5.49578810831758,4.66998474788852,0.825803360429057,24,23,1,36,33,3,52,40,12,3,4,0,0
"17750","PHI","FLA",2014020467,16422,20142015,1,65,1,1,0,3.92196330660954,4.8129503183518,-0.890987011742254,26,32,-6,36,44,-8,51,62,-11,2,3,0,0
"17751","PHI","TOR",2014020481,16424,20142015,0,60,7,4,3,4.86396740403211,4.21389242290331,0.650074981128796,42,25,17,57,38,19,69,48,21,3,4,0,0
"17752","PHI","WPG",2014020496,16425,20142015,0,60.1666666666667,4,3,1,3.80332974628254,2.70883554840111,1.09449419788143,23,28,-5,31,34,-3,52,45,7,5,2,0,0
"17753","PHI","MIN",2014020507,16427,20142015,0,60,5,2,3,4.72561709077854,3.97731818712782,0.748298903650721,30,24,6,36,35,1,47,50,-3,2,6,0,0
"17754","PHI","NSH",2014020522,16431,20142015,0,60,1,4,-3,2.49734793684911,6.37406267447656,-3.87671473762745,27,38,-11,32,46,-14,45,57,-12,5,6,0,0
"17755","PHI","ARI",2014020540,16433,20142015,0,60,2,4,-2,5.67340256439638,4.52469944246695,1.14870312192943,32,25,7,51,36,15,66,45,21,2,2,0,0
"17756","PHI","COL",2014020554,16435,20142015,0,64.6666666666667,3,4,-1,4.32507213686326,6.16513245082149,-1.84006031395823,29,33,-4,41,39,2,55,57,-2,6,5,0,0
"17757","PHI","CAR",2014020561,16437,20142015,0,60,1,2,-1,2.80531872506253,1.68212856369883,1.12319016136371,24,26,-2,40,39,1,50,50,0,3,2,0,0
"17758","PHI","N.J",2014020568,16438,20142015,0,60,2,5,-3,4.54890458920272,1.93181888830441,2.61708570089831,20,18,2,26,26,0,39,38,1,2,3,0,0
"17759","PHI","OTT",2014020585,16441,20142015,1,65,1,1,0,6.02944199341488,7.48068957415795,-1.45124758074306,34,42,-8,47,57,-10,60,84,-24,4,4,0,0
"17760","PHI","WSH",2014020599,16443,20142015,1,61.4666666666667,3,2,1,7.00891763421123,3.38211740021147,3.62680023399976,33,28,5,49,37,12,71,57,14,4,3,0,0
"17761","PHI","BOS",2014020613,16445,20142015,1,60,1,3,-2,4.49610607558861,2.80132316056307,1.69478291502554,25,18,7,43,27,16,57,40,17,6,4,0,0
"17762","PHI","T.B",2014020627,16447,20142015,1,60,7,3,4,4.37241411197465,6.81636733002961,-2.44395321805496,25,24,1,31,41,-10,44,50,-6,3,3,0,0
"17763","PHI","WSH",2014020641,16449,20142015,0,60,0,1,-1,4.31449933780823,4.35585290595009,-0.041353568141858,21,26,-5,32,40,-8,55,54,1,3,2,0,0
"17764","PHI","VAN",2014020646,16450,20142015,1,60,0,4,-4,4.68634894301067,4.75010220401751,-0.063753261006835,30,22,8,41,38,3,63,50,13,4,4,0,0
"17765","PHI","BUF",2014020661,16452,20142015,0,60,4,3,1,7.33859985597288,3.24357092258288,4.09502893339,32,27,5,48,36,12,63,44,19,4,4,0,0
"17766","PHI","NYI",2014020676,16454,20142015,0,60,4,7,-3,3.44928870007425,6.35182229564452,-2.90253359557028,29,41,-12,37,49,-12,52,61,-9,3,4,0,0
"17767","PHI","ARI",2014020698,16462,20142015,1,65,3,3,0,6.1864714861731,4.42128855441115,1.76518293176196,42,27,15,60,41,19,79,48,31,2,1,0,0
"17768","PHI","WPG",2014020713,16464,20142015,1,60,5,2,3,0,0,0,32,38,-6,38,53,-15,46,66,-20,4,7,0,0
"17769","PHI","TOR",2014020733,16466,20142015,1,60,1,0,1,4.63688089500647,6.39285549237684,-1.75597459737037,18,30,-12,29,39,-10,42,60,-18,2,1,0,0
"17770","PHI","NYI",2014020760,16471,20142015,1,65,2,2,0,2.66505049949046,3.773073808763,-1.10802330927254,18,30,-12,30,44,-14,50,64,-14,1,1,0,0
"17771","PHI","WSH",2014020786,16474,20142015,0,60,3,1,2,3.8205991819365,4.94605272205081,-1.12545354011431,25,14,11,35,35,0,49,51,-2,2,7,0,0
"17772","PHI","MTL",2014020801,16476,20142015,0,63.45,1,2,-1,2.28736908581777,9.71071424628099,-7.42334516046321,24,41,-17,30,65,-35,44,90,-46,1,3,0,0
"17773","PHI","CBJ",2014020818,16479,20142015,0,62.2833333333333,3,4,-1,4.9862750605389,7.03472328117578,-2.04844822063687,25,33,-8,35,45,-10,47,65,-18,3,1,0,0
"17774","PHI","BUF",2014020835,16481,20142015,0,60,2,1,1,3.73204636897748,4.93495908460994,-1.20291271563246,30,22,8,43,34,9,62,42,20,2,3,0,0
"17775","PHI","CBJ",2014020847,16483,20142015,1,60,2,5,-3,6.99600825746893,5.87784012750468,1.11816812996425,44,25,19,63,33,30,85,38,47,2,1,0,0
"17776","PHI","BUF",2014020861,16485,20142015,1,65,2,2,0,6.7105699024832,5.11035979517328,1.60021010730992,38,32,6,60,42,18,84,53,31,5,4,0,0
"17777","PHI","NSH",2014020874,16487,20142015,1,65,2,2,0,3.28648935182719,3.21105384916882,0.0754355026583653,33,22,11,43,30,13,58,45,13,2,2,0,0
"17778","PHI","WSH",2014020884,16488,20142015,1,60,3,2,1,1.89104912172507,5.26482931871324,-3.37378019698818,28,23,5,39,35,4,54,54,0,4,5,0,0
"17779","PHI","CAR",2014020897,16490,20142015,0,60,1,4,-3,3.42807965996076,7.99300395185128,-4.56492429189052,24,35,-11,37,51,-14,52,69,-17,2,4,0,0
"17780","PHI","TOR",2014020911,16492,20142015,0,60,2,3,-1,6.93019464423691,1.47419600377907,5.45599864045784,49,17,32,70,27,43,89,37,52,7,5,0,0
"17781","PHI","NYR",2014020929,16494,20142015,1,60,4,2,2,6.1985236041146,5.62862627626332,0.56989732785128,34,36,-2,46,45,1,66,66,0,3,3,0,0
"17782","PHI","CGY",2014020943,16497,20142015,1,61.3833333333333,2,3,-1,6.26273600982802,4.5431816301425,1.71955437968552,37,26,11,53,41,12,86,53,33,2,2,0,0
"17783","PHI","STL",2014020957,16499,20142015,1,60,3,1,2,5.45630161842928,2.16952207915347,3.28677953927581,31,29,2,45,36,9,60,57,3,2,1,0,0
"17784","PHI","BOS",2014020970,16501,20142015,0,63.8666666666667,2,3,-1,5.55082899317495,3.97878235963641,1.57204663353854,31,37,-6,41,50,-9,48,75,-27,2,4,0,0
"17785","PHI","N.J",2014020981,16502,20142015,0,60,2,5,-3,4.17727199778892,3.88059542791359,0.296676569875331,27,21,6,33,31,2,47,42,5,4,5,0,0
"17786","PHI","DAL",2014020992,16504,20142015,1,60,1,2,-1,3.95058796204535,5.13407472465597,-1.18348676261062,26,39,-13,40,49,-9,57,63,-6,3,3,0,0
"17787","PHI","STL",2014021008,16506,20142015,0,65,0,0,0,2.95710135567481,6.12182103568921,-3.1647196800144,28,35,-7,40,50,-10,63,66,-3,4,2,0,0
"17788","PHI","DET",2014021018,16508,20142015,1,60,7,2,5,3.02997609528409,4.31701551257133,-1.28703941728724,36,33,3,45,42,3,67,60,7,4,3,0,0
"17789","PHI","OTT",2014021033,16509,20142015,0,65,1,1,0,2.66685820516432,4.1940279842532,-1.52716977908888,28,28,0,32,42,-10,51,59,-8,4,4,0,0
"17790","PHI","VAN",2014021049,16511,20142015,0,60,1,4,-3,4.25085724580237,6.69365026305354,-2.44279301725118,28,35,-7,43,47,-4,59,53,6,3,2,0,0
"17791","PHI","CGY",2014021060,16513,20142015,0,60,1,4,-3,4.21476166032153,5.00038994028,-0.785628279958473,27,26,1,39,38,1,59,57,2,3,5,0,0
"17792","PHI","EDM",2014021078,16515,20142015,0,62.7666666666667,4,5,-1,3.80385815034494,8.95085932364146,-5.14700117329652,31,34,-3,40,50,-10,57,69,-12,4,4,0,0
"17793","PHI","CHI",2014021098,16519,20142015,1,60,4,1,3,6.79656249808613,4.02878760021849,2.76777489786764,33,35,-2,48,47,1,62,63,-1,2,2,0,0
"17794","PHI","S.J",2014021118,16522,20142015,1,65,2,2,0,3.58112117748533,10.0465995129634,-6.46547833547811,18,44,-26,26,58,-32,47,83,-36,3,4,0,0
"17795","PHI","CAR",2014021167,16529,20142015,0,65,2,2,0,3.78213281498756,2.90422050047709,0.877912314510468,23,26,-3,35,37,-2,51,55,-4,2,3,0,0
"17796","PHI","NYI",2014021191,16532,20142015,1,60,5,4,1,6.90481548728712,6.40809447308263,0.496721014204494,27,40,-13,43,48,-5,60,68,-8,3,5,0,0
"17797","PHI","CAR",2014021204,16534,20142015,1,60,1,3,-2,3.19357157003424,6.2116297488966,-3.01805817886236,28,27,1,41,41,0,53,56,-3,2,5,0,0
"17798","PHI","OTT",2014021216,16536,20142015,1,60,1,3,-2,8.3341780104807,4.86341335395912,3.47076465652158,35,22,13,46,31,15,56,51,5,2,4,0,0
"17799","PHI","T.B",2015020007,16716,20152016,0,62.2833333333333,2,3,-1,3.11363595425202,5.78601300620176,-2.67237705194974,25,32,-7,37,44,-7,51,50,1,5,3,0,0
"17800","PHI","FLA",2015020020,16718,20152016,0,60,1,7,-6,3.62886203044036,4.58101378664755,-0.952151756207186,39,30,9,46,35,11,56,45,11,6,8,0,0
"17801","PHI","FLA",2015020035,16720,20152016,1,60,1,0,1,5.46708643867378,5.75074891466647,-0.283662475992692,33,31,2,45,49,-4,59,66,-7,6,8,0,0
"17802","PHI","CHI",2015020047,16722,20152016,1,60,3,0,3,4.71915385380845,5.78486125963923,-1.06570740583078,29,30,-1,43,45,-2,57,62,-5,6,5,0,0
"17803","PHI","DAL",2015020082,16728,20152016,1,60,1,2,-1,4.83769122455851,3.75361424785695,1.08407697670156,35,32,3,47,45,2,59,62,-3,7,5,0,0
"17804","PHI","BOS",2015020089,16729,20152016,0,62.15,5,4,1,5.20964156976507,2.14004887738065,3.06959269238442,37,30,7,47,37,10,53,54,-1,2,3,0,0
"17805","PHI","NYR",2015020110,16732,20152016,1,65,2,2,0,9.95289195178107,5.90124382663635,4.05164812514473,48,39,9,61,54,7,77,70,7,2,3,0,0
"17806","PHI","BUF",2015020126,16735,20152016,1,62.4833333333333,3,4,-1,4.49611693588758,8.55007461793139,-4.0539576820438,33,40,-7,43,54,-11,62,75,-13,2,2,0,0
"17807","PHI","N.J",2015020138,16737,20152016,1,60,1,4,-3,4.09130798394569,3.80882845170072,0.282479532244972,28,33,-5,47,48,-1,68,59,9,2,5,0,0
"17808","PHI","BUF",2015020145,16738,20152016,0,60,1,3,-2,5.42905124090612,4.4157978441508,1.01325339675532,28,36,-8,36,48,-12,58,59,-1,5,8,0,0
"17809","PHI","VAN",2015020171,16741,20152016,0,60,1,4,-3,3.02636889694259,4.00890824908856,-0.982539352145977,28,34,-6,34,41,-7,49,47,2,3,2,0,0
"17810","PHI","EDM",2015020179,16742,20152016,0,60,2,4,-2,4.37552769911417,6.91371303958101,-2.53818534046684,22,49,-27,33,61,-28,41,87,-46,2,5,0,0
"17811","PHI","CGY",2015020190,16744,20152016,0,60.5833333333333,1,2,-1,4.41841098861187,4.05864937288516,0.359761615726711,27,30,-3,41,33,8,63,42,21,2,2,0,0
"17812","PHI","WPG",2015020205,16746,20152016,0,60,3,0,3,4.5384278538404,3.07114628883168,1.46728156500873,23,28,-5,34,44,-10,43,63,-20,6,6,0,0
"17813","PHI","COL",2015020218,16749,20152016,1,60,0,4,-4,5.14496939931269,7.55375052755699,-2.4087811282443,25,40,-15,38,47,-9,54,57,-3,1,2,0,0
"17814","PHI","WSH",2015020232,16751,20152016,1,60,2,5,-3,3.10859069452868,3.36425185730521,-0.25566116277653,20,32,-12,34,40,-6,49,55,-6,4,3,0,0
"17815","PHI","CAR",2015020253,16753,20152016,0,60.6166666666667,3,2,1,8.08888280028123,3.46474953798679,4.62413326229444,19,21,-2,43,32,11,65,45,20,2,4,0,0
"17816","PHI","L.A",2015020269,16756,20152016,1,65,2,2,0,3.93944089047,7.83358164259698,-3.89414075212699,38,40,-2,50,51,-1,62,65,-3,5,2,0,0
"17817","PHI","S.J",2015020279,16758,20152016,1,63.75,0,1,-1,0,0,0,34,21,13,45,34,11,67,49,18,2,4,0,0
"17818","PHI","OTT",2015020294,16760,20152016,0,60,0,4,-4,5.82660952457172,2.7805512693958,3.04605825517592,36,31,5,52,40,12,81,52,29,5,4,0,0
"17819","PHI","CAR",2015020310,16762,20152016,1,60.4,3,2,1,3.66072004105126,7.03935170173645,-3.37863166068519,36,33,3,48,43,5,64,64,0,5,5,0,0
"17820","PHI","NYI",2015020319,16764,20152016,0,60,1,3,-2,2.81241896852241,5.91581606180129,-3.10339709327888,18,36,-18,27,43,-16,48,65,-17,5,2,0,0
"17821","PHI","NSH",2015020331,16766,20152016,1,64.1333333333333,3,2,1,4.40544263039192,5.59826547585705,-1.19282284546513,36,35,1,43,46,-3,59,60,-1,2,2,0,0
"17822","PHI","NYR",2015020342,16767,20152016,0,60,3,0,3,4.03512915790902,2.69996491627535,1.33516424163368,34,24,10,41,35,6,54,52,2,2,2,0,0
"17823","PHI","OTT",2015020361,16770,20152016,0,60,4,2,2,5.28305148298386,3.99083976141297,1.29221172157089,33,25,8,47,30,17,60,50,10,4,2,0,0
"17824","PHI","N.J",2015020382,16773,20152016,0,63.4,4,3,1,3.94806079278966,2.94144996331306,1.0066108294766,25,18,7,36,24,12,44,32,12,5,6,0,0
"17825","PHI","CBJ",2015020394,16774,20152016,1,60,1,4,-3,3.43112821463205,3.45355240273057,-0.0224241880985119,28,34,-6,35,47,-12,50,64,-14,2,3,0,0
"17826","PHI","NYI",2015020408,16777,20152016,1,65,3,3,0,5.8277150164231,7.7620680280852,-1.9343530116621,46,26,20,65,36,29,89,51,38,3,2,0,0
"17827","PHI","STL",2015020424,16779,20152016,0,60,4,2,2,4.43950405549286,4.94515925571613,-0.505655200223273,29,37,-8,40,40,0,54,55,-1,2,3,0,0
"17828","PHI","DAL",2015020431,16780,20152016,0,60,1,3,-2,3.88793604809325,9.87425223307218,-5.98631618497893,20,44,-24,32,62,-30,46,86,-40,2,6,0,0
"17829","PHI","CAR",2015020456,16784,20152016,1,61.7,4,3,1,3.78032398177311,4.48658783818246,-0.70626385640935,31,32,-1,41,46,-5,59,62,-3,3,5,0,0
"17830","PHI","VAN",2015020468,16786,20152016,1,60,2,0,2,5.15446193271782,5.44139244452617,-0.28693051180835,31,36,-5,47,46,1,61,65,-4,6,5,0,0
"17831","PHI","CBJ",2015020488,16788,20152016,0,65,2,2,0,5.54240410780039,6.58138160072414,-1.03897749292375,32,37,-5,45,50,-5,67,59,8,4,7,0,0
"17832","PHI","STL",2015020500,16790,20152016,1,60,4,3,1,4.92746523800709,4.76728061951469,0.160184618492397,31,29,2,43,40,3,63,55,8,4,3,0,0
"17833","PHI","ANA",2015020533,16796,20152016,0,60,2,4,-2,4.04262132925214,5.70073806977598,-1.65811674052384,26,37,-11,31,49,-18,40,59,-19,6,4,0,0
"17834","PHI","S.J",2015020555,16799,20152016,0,60,2,4,-2,4.32235750183463,3.844790548319,0.477566953515634,19,33,-14,31,41,-10,50,51,-1,5,8,0,0
"17835","PHI","L.A",2015020569,16802,20152016,0,60,1,2,-1,3.90920971065064,4.05368787624016,-0.144478165589521,30,32,-2,41,42,-1,56,55,1,4,3,0,0
"17836","PHI","MTL",2015020591,16805,20152016,1,60,4,3,1,4.2264387733303,6.83327136873862,-2.60683259540832,31,24,7,40,40,0,47,65,-18,3,4,0,0
"17837","PHI","MIN",2015020603,16807,20152016,0,64.3833333333333,4,3,1,5.52019281993853,4.06465167928945,1.45554114064907,36,34,2,58,43,15,65,53,12,3,2,0,0
"17838","PHI","NYI",2015020615,16809,20152016,1,60,4,0,4,4.89775301014015,3.42554453545745,1.4722084746827,31,20,11,48,30,18,66,45,21,5,3,0,0
"17839","PHI","BOS",2015020643,16813,20152016,1,60,3,2,1,3.17136163118994,6.20483443208815,-3.03347280089821,21,32,-11,38,44,-6,58,55,3,3,2,0,0
"17840","PHI","NYR",2015020660,16816,20152016,1,65,2,2,0,8.45082452442148,4.80006053659599,3.65076398782548,36,31,5,49,43,6,79,57,22,4,5,0,0
"17841","PHI","DET",2015020675,16817,20152016,0,65,1,1,0,4.31868895296233,3.15691276328289,1.16177618967944,31,30,1,40,53,-13,49,69,-20,6,4,0,0
"17842","PHI","TOR",2015020684,16819,20152016,1,60,2,3,-1,5.17001884091167,4.0373280881322,1.13269075277947,33,35,-2,50,46,4,67,64,3,4,4,0,0
"17843","PHI","PIT",2015020695,16821,20152016,0,60,3,4,-1,0,0,0,32,45,-13,42,55,-13,56,75,-19,6,4,0,0
"17844","PHI","NYI",2015020716,16901,20152016,0,60,5,2,3,5.4334531440788,1.70910946710501,3.72434367697379,27,17,10,36,22,14,47,33,14,4,4,0,0
"17845","PHI","BOS",2015020727,16825,20152016,1,60,2,3,-1,5.37030723237456,7.16090991214514,-1.79060267977059,36,31,5,48,44,4,74,63,11,5,4,0,0
"17846","PHI","WSH",2015020741,16827,20152016,0,60.6333333333333,4,3,1,6.10319715496157,4.42450337700115,1.67869377796042,32,30,2,44,41,3,66,62,4,6,3,0,0
"17847","PHI","MTL",2015020747,16833,20152016,1,60,4,2,2,6.87085403700816,6.23731910535464,0.633534931653521,36,32,4,50,41,9,67,59,8,6,5,0,0
"17848","PHI","NSH",2015020766,16835,20152016,0,60,6,3,3,2.70928345365974,4.57482836849522,-1.86554491483548,19,40,-21,24,46,-22,30,60,-30,2,6,0,0
"17849","PHI","NYR",2015020776,16837,20152016,1,65,2,2,0,5.80825886392267,4.38244035137177,1.4258185125509,28,28,0,46,38,8,64,54,10,7,2,0,0
"17850","PHI","WSH",2015020787,16838,20152016,0,60,2,3,-1,6.34312241841243,3.52301176969128,2.82011064872115,35,30,5,53,39,14,68,57,11,5,2,0,0
"17851","PHI","ANA",2015020797,16840,20152016,1,60,1,4,-3,4.97130287189556,3.00468299362363,1.96661987827193,29,26,3,38,41,-3,63,52,11,8,8,0,0
"17852","PHI","BUF",2015020810,16842,20152016,1,60,5,1,4,3.82787163135855,7.92441498772662,-4.09654335636807,28,42,-14,29,58,-29,42,90,-48,4,5,0,0
"17853","PHI","N.J",2015020825,16844,20152016,1,62.9666666666667,1,2,-1,5.30110500229057,5.84921216023213,-0.548107157941558,32,24,8,41,39,2,54,55,-1,4,4,0,0
"17854","PHI","NYR",2015020839,16845,20152016,0,60,1,3,-2,6.13027434183459,4.78097197480713,1.34930236702746,22,30,-8,50,37,13,70,51,19,6,6,0,0
"17855","PHI","N.J",2015020847,16847,20152016,0,60,6,3,3,4.84661607243083,3.33204122846061,1.51457484397023,26,24,2,32,37,-5,38,44,-6,6,7,0,0
"17856","PHI","MTL",2015020872,16850,20152016,0,65,2,2,0,4.67930595701346,3.83249245137984,0.846813505633627,37,31,6,47,40,7,66,62,4,3,4,0,0
"17857","PHI","TOR",2015020875,16851,20152016,0,60.4833333333333,5,4,1,3.42775844783361,3.11910500581143,0.308653442022177,28,24,4,41,33,8,51,50,1,1,2,0,0
"17858","PHI","CAR",2015020894,16854,20152016,0,60,1,3,-2,6.77964262220485,2.4081779245656,4.37146469763924,37,18,19,56,27,29,66,37,29,3,3,0,0
"17859","PHI","MIN",2015020906,16856,20152016,1,60,3,2,1,8.67460386644422,4.9412942424533,3.73330962399092,31,26,5,41,33,8,57,50,7,1,3,0,0
"17860","PHI","ARI",2015020921,16858,20152016,1,60,4,2,2,4.44845445400279,4.01995061460184,0.428503839400946,33,31,2,42,41,1,54,73,-19,4,4,0,0
"17861","PHI","CGY",2015020938,16860,20152016,1,60,5,3,2,6.58946091287751,6.03032938051729,0.559131532360219,29,32,-3,41,50,-9,64,71,-7,4,5,0,0
"17862","PHI","EDM",2015020956,16863,20152016,1,60,0,4,-4,5.22203248168807,3.95898239428425,1.26305008740383,35,31,4,55,37,18,83,49,34,9,4,0,0
"17863","PHI","CBJ",2015020976,16865,20152016,1,60,6,0,6,4.97296206120518,1.79446052813,3.17850153307518,36,19,17,47,27,20,65,44,21,7,4,0,0
"17864","PHI","T.B",2015020986,16867,20152016,1,60,4,2,2,7.44714297307655,3.56414216442499,3.88300080865156,40,18,22,58,33,25,90,44,46,5,2,0,0
"17865","PHI","T.B",2015021014,16871,20152016,0,60,3,1,2,2.42868182662642,1.61485276393068,0.813829062695731,23,19,4,33,30,3,41,50,-9,4,2,0,0
"17866","PHI","FLA",2015021023,16872,20152016,0,65,4,4,0,5.34316265113307,2.97253098686493,2.37063166426814,26,29,-3,39,38,1,53,45,8,5,3,0,0
"17867","PHI","DET",2015021039,16875,20152016,1,60,4,3,1,4.56444173310259,5.47523923734384,-0.910797504241252,46,37,9,59,48,11,77,69,8,6,2,0,0
"17868","PHI","CHI",2015021048,16876,20152016,0,60,3,2,1,2.98834823811957,2.34969412888267,0.638654109236899,29,26,3,37,37,0,47,60,-13,2,3,0,0
"17869","PHI","PIT",2015021067,16879,20152016,1,60,1,4,-3,3.30964580451837,7.65336223091522,-4.34371642639685,17,35,-18,28,52,-24,45,71,-26,3,3,0,0
"17870","PHI","NYI",2015021085,16881,20152016,0,60,4,1,3,2.84344026085455,3.68273379173006,-0.839293530875514,27,24,3,33,36,-3,48,54,-6,4,3,0,0
"17871","PHI","CBJ",2015021090,16882,20152016,0,65,2,2,0,5.82979893946619,7.76365927316496,-1.93386033369877,33,53,-20,48,64,-16,64,82,-18,4,5,0,0
"17872","PHI","COL",2015021109,16884,20152016,0,60,4,2,2,9.7468821365037,3.43756523890235,6.30931689760135,45,34,11,57,44,13,77,62,15,3,2,0,0
"17873","PHI","ARI",2015021127,16886,20152016,0,60,1,2,-1,7.48043178307125,1.96735175451613,5.51308002855512,35,17,18,51,25,26,62,41,21,4,4,0,0
"17874","PHI","WPG",2015021132,16888,20152016,1,64.7666666666667,3,2,1,9.20303017855622,5.95723363583602,3.2457965427202,32,28,4,54,44,10,77,63,14,3,1,0,0
"17875","PHI","WSH",2015021150,16890,20152016,1,65,1,1,0,4.17786892929917,7.98857261350713,-3.81070368420797,34,30,4,44,45,-1,69,68,1,6,6,0,0
"17876","PHI","OTT",2015021168,16893,20152016,1,60,3,2,1,6.33992970082909,4.46038445888553,1.87954524194356,36,35,1,47,45,2,65,59,6,6,3,0,0
"17877","PHI","PIT",2015021179,16894,20152016,0,60,2,6,-4,3.18905751063721,5.71408711833647,-2.52502960769925,30,39,-9,40,50,-10,59,74,-15,2,2,0,0
"17878","PHI","DET",2015021200,16897,20152016,0,60,0,3,-3,5.52675040803172,4.26525782824501,1.2614925797867,30,26,4,38,34,4,59,44,15,7,7,0,0
"17879","PHI","TOR",2015021205,16898,20152016,1,62.85,3,4,-1,10.0295122645584,4.32320211806729,5.70631014649114,44,26,18,64,31,33,86,43,43,3,2,0,0
"17880","PHI","PIT",2015021218,16900,20152016,1,60,3,1,2,7.16472375870217,2.25202229700517,4.912701461697,36,19,17,50,24,26,70,39,31,4,3,0,0
"17881","PHI","WSH",2015030131,16905,20152016,0,60,0,2,-2,1.17690229026357,3.46391123266039,-2.28700894239682,19,31,-12,26,48,-22,49,69,-20,8,10,0,0
"17882","PHI","WSH",2015030132,16907,20152016,0,60,1,4,-3,6.57479329244961,3.62430431519169,2.95048897725792,42,23,19,55,39,16,81,48,33,6,4,0,0
"17883","PHI","WSH",2015030133,16909,20152016,1,60,1,6,-5,6.36820163148423,5.93715804081876,0.431043590665467,32,27,5,50,42,8,63,68,-5,7,9,0,0
"17884","PHI","WSH",2015030134,16911,20152016,1,60,2,1,1,4.45998268826224,5.19259591103764,-0.732613222775399,25,32,-7,35,47,-12,47,76,-29,2,2,0,0
"17885","PHI","WSH",2015030135,16913,20152016,0,60,2,0,2,3.19312879338395,3.34497211360401,-0.151843320220057,11,44,-33,21,63,-42,27,82,-55,7,4,0,0
"17886","PHI","WSH",2015030136,16915,20152016,1,60,0,1,-1,4.24967040574503,3.76717119215755,0.482499213587484,26,29,-3,37,44,-7,53,65,-12,2,5,0,0
"17887","PHI","L.A",2016020016,17088,20162017,0,60,4,2,2,2.5017236328506,2.64590183915425,-0.14417820630365,30,25,5,36,37,-1,49,53,-4,3,3,0,0
"17888","PHI","ARI",2016020028,17089,20162017,0,63.2,3,4,-1,3.06636924292252,5.80488978115753,-2.73852053823501,30,35,-5,46,50,-4,62,61,1,4,7,0,0
"17889","PHI","CHI",2016020045,17092,20162017,0,60,4,7,-3,4.40717266608044,5.43711221638659,-1.02993955030615,27,28,-1,35,32,3,44,43,1,4,3,0,0
"17890","PHI","ANA",2016020052,17094,20162017,1,60,2,3,-1,4.64319329103455,5.30187857785495,-0.658685286820401,22,26,-4,30,30,0,48,46,2,8,3,0,0
"17891","PHI","CAR",2016020070,17096,20162017,1,60,6,3,3,4.30232125176661,5.33893491068739,-1.03661365892077,27,30,-3,42,42,0,52,65,-13,5,6,0,0
"17892","PHI","MTL",2016020081,17098,20162017,0,60,1,3,-2,5.0965573442,6.18774441687856,-1.09118707267856,32,33,-1,45,38,7,61,51,10,1,4,0,0
"17893","PHI","BUF",2016020085,17099,20162017,1,65,3,3,0,9.2401949713385,7.0769470456944,2.1632479256441,41,25,16,61,42,19,79,56,23,4,4,0,0
"17894","PHI","ARI",2016020099,17101,20162017,1,60,4,5,-1,6.80121987058487,3.09559950304123,3.70562036754364,32,25,7,55,33,22,75,49,26,8,3,0,0
"17895","PHI","PIT",2016020117,17103,20162017,1,60,4,5,-1,5.63128797996103,4.07739821114197,1.55388976881906,42,27,15,67,41,26,92,53,39,5,3,0,0
"17896","PHI","CAR",2016020125,17104,20162017,0,60,4,3,1,4.19608447884366,6.38629499768285,-2.19021051883919,28,29,-1,46,45,1,55,63,-8,3,2,0,0
"17897","PHI","DET",2016020144,17107,20162017,1,61.6833333333333,4,3,1,6.91845907730749,6.3740206103224,0.544438466985085,40,25,15,54,38,16,69,57,12,2,2,0,0
"17898","PHI","NYI",2016020147,17108,20162017,0,65,2,2,0,5.35353729862254,5.7027146242771,-0.349177325654563,42,27,15,61,34,27,79,43,36,6,4,0,0
"17899","PHI","MTL",2016020164,17110,20162017,0,60,4,5,-1,4.91611877883111,3.54782884979977,1.36828992903133,38,17,21,48,25,23,70,45,25,4,3,0,0
"17900","PHI","DET",2016020185,17113,20162017,1,65,2,2,0,4.46197935682721,6.55545619512122,-2.09347683829401,25,35,-10,43,51,-8,60,70,-10,2,3,0,0
"17901","PHI","TOR",2016020207,17116,20162017,0,60,3,6,-3,5.73362527950729,6.23158108891221,-0.497955809404914,33,23,10,47,42,5,60,66,-6,2,5,0,0
"17902","PHI","MIN",2016020216,17117,20162017,1,60,3,2,1,5.0403187936754,2.66074868579744,2.37957010787795,36,27,9,46,39,7,60,58,2,3,2,0,0
"17903","PHI","OTT",2016020230,17120,20162017,1,65,2,2,0,4.29526842807358,4.49540870403552,-0.20014027596194,35,26,9,50,41,9,71,59,12,4,2,0,0
"17904","PHI","WPG",2016020246,17122,20162017,1,60,5,2,3,5.0478816194227,3.65929523526938,1.38858638415331,22,32,-10,31,49,-18,52,69,-17,1,1,0,0
"17905","PHI","T.B",2016020260,17124,20162017,1,60,0,3,-3,3.96767137981553,1.45345143789018,2.51421994192535,32,18,14,49,23,26,70,29,41,6,3,0,0
"17906","PHI","FLA",2016020286,17127,20162017,0,60,3,1,2,2.14626461710208,2.84997915416898,-0.703714537066901,28,39,-11,32,45,-13,36,57,-21,3,5,0,0
"17907","PHI","T.B",2016020294,17128,20162017,0,60,2,4,-2,6.42122784377058,4.42021291358571,2.00101493018487,31,29,2,43,43,0,56,64,-8,4,7,0,0
"17908","PHI","NYR",2016020302,17130,20162017,1,60,2,3,-1,3.4075585914145,3.43927517614793,-0.0317165847334309,42,23,19,51,28,23,78,39,39,1,2,0,0
"17909","PHI","CGY",2016020327,17132,20162017,1,60,5,3,2,5.42945631663315,5.27930787416356,0.150148442469586,43,32,11,61,41,20,77,57,20,7,2,0,0
"17910","PHI","BOS",2016020331,17134,20162017,1,65,2,2,0,4.47768009174615,6.35373149797488,-1.87605140622873,21,47,-26,35,61,-26,44,80,-36,8,6,0,0
"17911","PHI","OTT",2016020349,17136,20162017,0,60.6666666666667,3,2,1,7.41092750099779,4.01192771694669,3.39899978405109,32,21,11,54,32,22,79,51,28,6,4,0,0
"17912","PHI","CHI",2016020361,17138,20162017,1,60,3,1,2,5.33649322351266,2.94254412477299,2.39394909873967,30,27,3,46,36,10,63,49,14,3,1,0,0
"17913","PHI","NSH",2016020373,17139,20162017,0,60,4,2,2,5.11236248171303,4.99305372685194,0.119308754861095,28,32,-4,45,43,2,55,58,-3,4,2,0,0
"17914","PHI","FLA",2016020385,17141,20162017,1,64.85,3,2,1,2.78695801523281,7.71342554975126,-4.92646753451845,25,44,-19,35,65,-30,51,85,-34,5,3,0,0
"17915","PHI","EDM",2016020397,17143,20162017,1,60,6,5,1,4.29084940011442,4.79392271918901,-0.503073319074585,31,33,-2,44,46,-2,63,64,-1,5,4,0,0
"17916","PHI","DAL",2016020411,17145,20162017,1,60,4,2,2,4.61210123085493,4.23296733789418,0.379133892960752,22,23,-1,37,33,4,49,49,0,6,4,0,0
"17917","PHI","DET",2016020422,17146,20162017,0,62.7333333333333,1,0,1,4.66725715761487,3.08886484200048,1.57839231561439,36,28,8,48,37,11,60,53,7,4,5,0,0
"17918","PHI","COL",2016020444,17149,20162017,0,60,4,3,1,5.19912108187418,6.21387711673742,-1.01475603486324,25,29,-4,36,42,-6,46,54,-8,3,3,0,0
"17919","PHI","DAL",2016020460,17152,20162017,0,60,1,3,-2,4.36303461300849,6.22729233586142,-1.86425772285293,32,28,4,51,47,4,66,64,2,1,1,0,0
"17920","PHI","NSH",2016020476,17154,20162017,1,65,1,1,0,5.66116055192759,3.93255173470243,1.72860881722517,32,31,1,46,41,5,60,64,-4,3,1,0,0
"17921","PHI","WSH",2016020493,17156,20162017,1,65,2,2,0,6.03938215239032,6.88672914934341,-0.847346996953092,38,38,0,50,47,3,64,67,-3,3,2,0,0
"17922","PHI","N.J",2016020496,17157,20162017,0,60,0,4,-4,1.95027913611375,3.91169088840252,-1.96141175228877,16,22,-6,23,29,-6,35,32,3,6,10,0,0
"17923","PHI","STL",2016020530,17163,20162017,0,60,3,6,-3,2.47535955491185,4.73697027950789,-2.26161072459604,20,25,-5,23,35,-12,44,45,-1,5,5,0,0
"17924","PHI","S.J",2016020547,17165,20162017,0,60,0,2,-2,4.0361448074366,4.16648175683804,-0.130336949401439,21,34,-13,31,44,-13,49,55,-6,2,3,0,0
"17925","PHI","ANA",2016020561,17167,20162017,0,65,3,3,0,6.73814451362705,5.21734032427111,1.52080418935594,55,25,30,68,40,28,85,54,31,6,4,0,0
"17926","PHI","NYR",2016020573,17170,20162017,1,60,2,5,-3,4.80460005979694,8.66682141484387,-3.86222135504693,32,28,4,41,44,-3,63,54,9,3,2,0,0
"17927","PHI","T.B",2016020592,17173,20162017,1,60,4,2,2,3.38905340418341,4.76405043661362,-1.3749970324302,44,26,18,54,34,20,67,50,17,3,3,0,0
"17928","PHI","CBJ",2016020605,17174,20162017,0,62.55,1,2,-1,6.64613593025749,4.74938491458306,1.89675101567443,26,25,1,42,33,9,59,55,4,1,2,0,0
"17929","PHI","BUF",2016020613,17176,20162017,0,60,1,4,-3,8.37620741769354,2.2120881669689,6.16411925072464,40,27,13,62,34,28,81,45,36,2,2,0,0
"17930","PHI","VAN",2016020624,17178,20162017,1,65,4,4,0,6.13313240098023,3.23066862216771,2.90246377881252,35,38,-3,51,54,-3,57,72,-15,4,6,0,0
"17931","PHI","BOS",2016020640,17180,20162017,0,60,3,6,-3,5.03184476933765,6.3339460220347,-1.30210125269704,24,39,-15,37,53,-16,51,67,-16,5,5,0,0
"17932","PHI","WSH",2016020652,17181,20162017,0,60,0,5,-5,4.69989271845486,3.59141275093022,1.10847996752464,24,22,2,40,30,10,56,48,8,5,2,0,0
"17933","PHI","N.J",2016020696,17187,20162017,1,60,1,4,-3,5.76500324485824,2.24232603943701,3.52267720542122,36,29,7,53,37,16,85,48,37,6,7,0,0
"17934","PHI","NYI",2016020705,17188,20162017,0,63.3333333333333,3,2,1,6.8334925553936,2.31935624231119,4.51413631308242,47,38,9,68,48,20,83,66,17,3,2,0,0
"17935","PHI","NYR",2016020725,17191,20162017,0,60,2,0,2,4.13416836591205,4.83971050346756,-0.705542137555511,26,34,-8,40,53,-13,48,69,-21,3,3,0,0
"17936","PHI","TOR",2016020731,17192,20162017,1,60,2,1,1,6.04624395734845,3.21193994727946,2.83430401006899,34,28,6,48,41,7,66,62,4,1,2,0,0
"17937","PHI","CAR",2016020744,17197,20162017,0,60,1,5,-4,2.77223807265182,5.14502236258704,-2.37278428993523,16,28,-12,28,44,-16,37,64,-27,5,7,0,0
"17938","PHI","MTL",2016020759,17199,20162017,1,60,3,1,2,3.97721386083867,4.94283253190224,-0.965618671063567,24,16,8,34,30,4,60,44,16,3,1,0,0
"17939","PHI","L.A",2016020772,17201,20162017,1,62.5833333333333,0,1,-1,1.85022466904411,3.72525103716907,-1.87502636812496,17,28,-11,25,39,-14,44,68,-24,2,2,0,0
"17940","PHI","STL",2016020789,17203,20162017,1,60,0,2,-2,3.61117449175799,1.06421139300801,2.54696309874998,26,16,10,38,23,15,60,39,21,6,3,0,0
"17941","PHI","NYI",2016020805,17206,20162017,1,60,1,3,-2,5.24658056999033,4.12718860141467,1.11939196857566,35,30,5,48,37,11,80,57,23,4,3,0,0
"17942","PHI","S.J",2016020817,17208,20162017,1,61.0666666666667,2,1,1,5.4548048934812,5.8010405851528,-0.346235691671609,35,24,11,59,39,20,75,56,19,4,4,0,0
"17943","PHI","CGY",2016020845,17212,20162017,0,60,1,3,-2,3.06143791013164,4.35684933859602,-1.29541142846438,34,23,11,45,34,11,70,50,20,3,4,0,0
"17944","PHI","EDM",2016020853,17213,20162017,0,60,3,6,-3,7.1806122706621,4.41462487616684,2.76598739449526,36,25,11,45,33,12,66,51,15,4,1,0,0
"17945","PHI","VAN",2016020879,17216,20162017,0,60,3,2,1,2.58066172898543,2.94087495381245,-0.360213224827021,28,20,8,37,32,5,55,56,-1,3,4,0,0
"17946","PHI","WSH",2016020892,17219,20162017,1,60,1,4,-3,6.55336963085574,3.40394389629364,3.1494257345621,34,29,5,46,38,8,69,50,19,5,5,0,0
"17947","PHI","PIT",2016020908,17222,20162017,0,60,2,4,-2,4.28712558371831,3.50493840156986,0.782187182148448,38,29,9,43,35,8,55,51,4,5,6,0,0
"17948","PHI","COL",2016020925,17225,20162017,1,60,4,0,4,3.52254583557738,5.13954777031904,-1.61700193474167,26,33,-7,38,50,-12,53,66,-13,3,5,0,0
"17949","PHI","FLA",2016020938,17227,20162017,1,65,1,1,0,10.2906054575869,6.32078693158913,3.9698185259978,49,40,9,74,51,23,89,63,26,6,4,0,0
"17950","PHI","WSH",2016020957,17229,20162017,0,63.4166666666667,1,2,-1,2.89858202953474,3.33934110494122,-0.440759075406486,31,24,7,41,32,9,58,52,6,7,5,0,0
"17951","PHI","BUF",2016020973,17232,20162017,0,60,6,3,3,0,0,0,30,34,-4,39,44,-5,56,55,1,3,4,0,0
"17952","PHI","TOR",2016020986,17234,20162017,0,60,2,4,-2,3.97506341926055,3.7678603769873,0.20720304227325,38,33,5,50,45,5,68,59,9,3,2,0,0
"17953","PHI","BOS",2016021000,17236,20162017,0,60,1,2,-1,3.29349867520796,5.14108928712085,-1.84759061191289,27,27,0,41,40,1,54,56,-2,2,3,0,0
"17954","PHI","CBJ",2016021018,17238,20162017,1,60,3,5,-2,4.04278117761714,5.07649899197202,-1.03371781435487,26,29,-3,41,35,6,61,46,15,9,4,0,0
"17955","PHI","PIT",2016021033,17240,20162017,1,60,4,0,4,4.11718582069823,2.5280506317421,1.58913518895613,28,23,5,37,35,2,57,53,4,4,2,0,0
"17956","PHI","N.J",2016021037,17241,20162017,0,60,2,6,-4,1.94928712944966,3.01110195426736,-1.0618148248177,19,29,-10,24,40,-16,30,51,-21,4,4,0,0
"17957","PHI","CAR",2016021066,17244,20162017,1,60.6333333333333,4,3,1,8.07211054011714,4.42363964579999,3.64847089431714,44,22,22,53,32,21,69,44,25,3,2,0,0
"17958","PHI","WPG",2016021083,17246,20162017,0,60,2,3,-1,3.58354106094376,3.31929085010819,0.264250210835566,26,33,-7,34,50,-16,45,70,-25,6,8,0,0
"17959","PHI","MIN",2016021097,17248,20162017,0,60,3,1,2,6.38854258935316,4.23939629008601,2.14914629926716,27,25,2,37,35,2,48,49,-1,1,2,0,0
"17960","PHI","CBJ",2016021105,17250,20162017,0,60,0,1,-1,3.69751619671297,2.86716230980528,0.830353886907687,36,21,15,44,28,16,58,42,16,5,4,0,0
"17961","PHI","PIT",2016021117,17251,20162017,0,60,6,2,4,5.1323197568366,5.55659555624754,-0.424275799410946,33,27,6,43,33,10,56,51,5,1,2,0,0
"17962","PHI","OTT",2016021128,17253,20162017,1,65,2,2,0,7.42599556042774,4.0895534859241,3.33644207450364,35,28,7,53,42,11,70,62,8,4,3,0,0
"17963","PHI","NYI",2016021142,17255,20162017,1,60,6,3,3,4.13815809326479,6.79920489490905,-2.66104680164426,30,41,-11,34,53,-19,46,80,-34,3,4,0,0
"17964","PHI","N.J",2016021161,17257,20162017,1,60,3,0,3,3.43018001773248,3.40667046900489,0.0235095487275885,41,32,9,54,44,10,64,59,5,6,5,0,0
"17965","PHI","NYR",2016021173,17258,20162017,0,60,3,4,-1,2.59218603319641,3.74615758865806,-1.15397155546165,23,24,-1,30,36,-6,45,41,4,3,4,0,0
"17966","PHI","N.J",2016021180,17260,20162017,0,60.9833333333333,0,1,-1,3.9202096833904,3.24405840830877,0.67615127508163,35,27,8,44,32,12,54,40,14,4,5,0,0
"17967","PHI","CBJ",2016021208,17264,20162017,1,60,4,2,2,4.02694785047788,1.76686955842888,2.260078292049,24,22,2,34,29,5,49,54,-5,4,3,0,0
"17968","PHI","CAR",2016021227,17265,20162017,1,65,3,3,0,4.63752247032152,8.55334273027256,-3.91582025995104,44,35,9,56,46,10,77,61,16,1,3,0,0
"17969","PHI","S.J",2017020004,17443,20172018,0,60,5,3,2,5.42552158837235,5.58420802804693,-0.158686439674582,31,35,-4,43,47,-4,60,64,-4,5,6,0,0
"17970","PHI","L.A",2017020012,17444,20172018,0,60,0,2,-2,2.59674058687247,2.75600802816916,-0.159267441296691,35,27,8,52,43,9,63,56,7,5,4,0,0
"17971","PHI","ANA",2017020029,17446,20172018,0,60.7333333333333,3,2,1,3.35122015124025,3.61995590757635,-0.268735756336105,37,23,14,43,37,6,58,49,9,6,3,0,0
"17972","PHI","NSH",2017020042,17449,20172018,0,60,5,6,-1,2.75227739487309,4.81208350444285,-2.05980610956976,30,31,-1,35,48,-13,48,62,-14,6,5,0,0
"17973","PHI","WSH",2017020066,17453,20172018,1,60,8,2,6,5.31965058804097,3.90733364626067,1.4123169417803,37,23,14,47,36,11,57,52,5,2,2,0,0
"17974","PHI","FLA",2017020083,17456,20172018,1,60,5,1,4,6.49337382835302,5.05269985124244,1.44067397711059,39,41,-2,53,54,-1,63,76,-13,4,6,0,0
"17975","PHI","NSH",2017020097,17458,20172018,1,60,0,1,-1,2.28562791259901,6.00664043048164,-3.72101251788263,28,24,4,41,37,4,58,54,4,5,2,0,0
"17976","PHI","EDM",2017020111,17460,20172018,1,60,2,1,1,3.05526128373526,2.21289640680698,0.842364876928286,24,24,0,33,38,-5,55,59,-4,3,3,0,0
"17977","PHI","ANA",2017020127,17463,20172018,1,60,2,6,-4,3.21726626620898,2.6338721079519,0.583394158257079,33,25,8,46,32,14,57,51,6,8,6,0,0
"17978","PHI","OTT",2017020143,17465,20172018,0,60,4,5,-1,5.57400173731855,4.75779662157584,0.816205115742719,40,28,12,49,33,16,70,46,24,4,2,0,0
"17979","PHI","TOR",2017020157,17467,20172018,0,60,4,2,2,4.71731273148921,3.53955506032798,1.17775767116122,30,30,0,40,50,-10,48,65,-17,1,3,0,0
"17980","PHI","ARI",2017020171,17469,20172018,1,64.75,3,4,-1,7.15038127686569,3.64272825024091,3.50765302662478,31,34,-3,48,43,5,60,59,1,3,4,0,0
"17981","PHI","CHI",2017020181,17471,20172018,0,60,0,3,-3,7.51179965236224,4.51057711336773,3.00122253899451,35,35,0,45,40,5,65,51,14,3,4,0,0
"17982","PHI","STL",2017020191,17472,20172018,0,60,2,0,2,4.57829755343846,4.2387386681221,0.339558885316364,23,33,-10,35,48,-13,39,68,-29,3,3,0,0
"17983","PHI","COL",2017020204,17474,20172018,1,65,4,4,0,7.51847515100962,4.77597273754154,2.74250241346808,37,27,10,58,42,16,79,53,26,6,3,0,0
"17984","PHI","CHI",2017020236,17479,20172018,1,60,3,1,2,4.13447483066813,7.12164130230667,-2.98716647163855,31,39,-8,42,53,-11,52,69,-17,3,5,0,0
"17985","PHI","MIN",2017020255,17481,20172018,1,60,0,1,-1,2.29774402398493,2.84511454624044,-0.547370522255505,32,27,5,43,34,9,61,46,15,3,3,0,0
"17986","PHI","MIN",2017020271,17484,20172018,0,60,0,3,-3,6.34446903230855,4.36479536537081,1.97967366693774,30,20,10,41,27,14,57,35,22,2,1,0,0
"17987","PHI","WPG",2017020284,17486,20172018,0,65,2,2,0,4.08622561070643,3.64490959237446,0.441316018331968,32,33,-1,44,41,3,59,48,11,6,5,0,0
"17988","PHI","CGY",2017020292,17488,20172018,1,61.3,4,5,-1,2.94399451689856,2.85879635141464,0.0851981654839165,39,31,8,46,42,4,62,59,3,4,6,0,0
"17989","PHI","VAN",2017020316,17491,20172018,1,60,2,5,-3,5.12646298073128,6.02180149912223,-0.89533851839095,38,36,2,52,43,9,79,54,25,2,3,0,0
"17990","PHI","NYI",2017020323,17492,20172018,0,60.5333333333333,3,4,-1,4.17355409256243,5.48731412321709,-1.31376003065467,38,39,-1,47,52,-5,57,72,-15,2,5,0,0
"17991","PHI","NYI",2017020335,17494,20172018,1,62.7333333333333,4,5,-1,5.01262107778166,7.92387584476228,-2.91125476698062,30,37,-7,47,51,-4,65,67,-2,3,4,0,0
"17992","PHI","PIT",2017020363,17497,20172018,0,61.8,4,5,-1,1.65079746451556,6.93662763056727,-5.28583016605171,32,52,-20,41,72,-31,58,82,-24,4,5,0,0
"17993","PHI","S.J",2017020370,17498,20172018,1,60,1,3,-2,3.15539879906708,7.70933433619211,-4.55393553712504,23,34,-11,30,47,-17,45,69,-24,3,6,0,0
"17994","PHI","BOS",2017020396,17502,20172018,1,60,0,3,-3,3.47406945400871,2.66638969722499,0.807679756783727,28,27,1,36,39,-3,57,52,5,6,2,0,0
"17995","PHI","CGY",2017020415,17504,20172018,0,60,5,2,3,3.01076744706675,4.87234007900461,-1.86157263193786,21,45,-24,31,61,-30,39,80,-41,2,2,0,0
"17996","PHI","EDM",2017020428,17506,20172018,0,60,4,2,2,5.12972102373897,5.82620742894511,-0.696486405206144,33,26,7,42,39,3,60,52,8,4,2,0,0
"17997","PHI","VAN",2017020436,17507,20172018,0,60,4,1,3,3.32221993344137,3.30470236922247,0.0175175642189078,26,37,-11,36,45,-9,41,63,-22,6,2,0,0
"17998","PHI","TOR",2017020468,17512,20172018,1,60,4,2,2,6.9929675150197,5.57019688142464,1.42277063359506,39,22,17,48,34,14,60,45,15,1,1,0,0
"17999","PHI","BUF",2017020480,17514,20172018,1,60,2,1,1,3.09206483922753,3.23331335172497,-0.141248512497441,27,20,7,43,29,14,55,48,7,2,1,0,0
"18000","PHI","DAL",2017020500,17516,20172018,1,63.8333333333333,2,1,1,4.34600116388901,5.79051269167034,-1.44451152778133,30,28,2,41,40,1,62,54,8,7,3,0,0
"18001","PHI","L.A",2017020513,17518,20172018,1,60,1,4,-3,5.99661298167582,3.99711376852151,1.99949921315432,37,25,12,51,36,15,56,46,10,7,3,0,0
"18002","PHI","DET",2017020527,17520,20172018,1,60,4,3,1,3.49294162009028,2.76926162255404,0.723679997536237,31,28,3,39,35,4,65,50,15,2,3,0,0
"18003","PHI","BUF",2017020539,17522,20172018,0,60,2,4,-2,3.32951365050006,5.09368758873188,-1.76417393823182,35,37,-2,44,48,-4,58,58,0,5,2,0,0
"18004","PHI","CBJ",2017020551,17523,20172018,0,65,1,1,0,5.62254784417843,3.86645676265352,1.75609108152491,31,36,-5,46,50,-4,61,64,-3,3,3,0,0
"18005","PHI","FLA",2017020571,17528,20172018,0,60,2,3,-1,5.04187812330201,5.08689944155049,-0.0450213182484731,31,27,4,43,40,3,53,58,-5,5,5,0,0
"18006","PHI","T.B",2017020579,17529,20172018,0,60,5,3,2,4.20358460490115,3.39591629744973,0.807668307451422,38,27,11,49,38,11,61,59,2,6,3,0,0
"18007","PHI","PIT",2017020604,17533,20172018,1,60,1,5,-4,5.59516911269748,3.90755912150325,1.68760999119422,28,25,3,40,36,4,62,50,12,4,2,0,0
"18008","PHI","NYI",2017020618,17535,20172018,1,60,6,4,2,4.0081604746083,5.1138165879529,-1.10565611334459,32,31,1,49,42,7,66,59,7,5,2,0,0
"18009","PHI","STL",2017020633,17537,20172018,1,60,6,3,3,4.7986469473326,7.78705833640432,-2.98841138907172,39,31,8,48,48,0,68,57,11,4,1,0,0
"18010","PHI","BUF",2017020643,17538,20172018,1,60,4,1,3,7.32683475976228,4.81073063763324,2.51610412212904,29,31,-2,42,39,3,53,50,3,4,4,0,0
"18011","PHI","N.J",2017020673,17544,20172018,0,60,5,3,2,2.32595438847539,3.6398375670542,-1.31388317857881,25,29,-4,30,44,-14,37,51,-14,2,7,0,0
"18012","PHI","NYR",2017020689,17547,20172018,0,60,1,5,-4,6.09178633798001,3.90634483715985,2.18544150082016,26,29,-3,38,34,4,51,40,11,3,2,0,0
"18013","PHI","TOR",2017020698,17549,20172018,1,60.3,3,2,1,5.44363770301124,2.4556273411219,2.98801036188934,37,31,6,51,39,12,66,58,8,2,2,0,0
"18014","PHI","N.J",2017020709,17551,20172018,1,60,3,1,2,3.77009041571312,3.27210738551841,0.497983030194705,31,29,2,44,38,6,61,55,6,4,5,0,0
"18015","PHI","WSH",2017020721,17552,20172018,0,60.45,2,1,1,2.00210613106174,5.73567055616877,-3.73356442510703,23,28,-5,38,46,-8,42,65,-23,4,4,0,0
"18016","PHI","DET",2017020735,17554,20172018,0,60.45,3,2,1,5.21272951595824,3.92824843908602,1.28448107687223,31,21,10,46,35,11,53,52,1,2,2,0,0
"18017","PHI","T.B",2017020747,17556,20172018,1,60,1,5,-4,3.60988089529565,3.61392203314344,-0.0040411378477927,37,22,15,48,31,17,68,43,25,4,1,0,0
"18018","PHI","WSH",2017020775,17562,20172018,0,60,3,5,-2,4.50323146293522,3.68489464684797,0.818336816087253,30,25,5,40,37,3,49,52,-3,1,3,0,0
"18019","PHI","N.J",2017020778,17563,20172018,0,60,3,4,-1,3.33509137776677,4.15673686380615,-0.821645486039373,25,22,3,38,33,5,47,43,4,4,5,0,0
"18020","PHI","OTT",2017020793,17565,20172018,1,65,3,3,0,5.26259215762548,3.06508551098523,2.19750664664025,36,29,7,55,36,19,79,44,35,6,5,0,0
"18021","PHI","CAR",2017020814,17568,20172018,0,64.9333333333333,2,1,1,3.56076161821693,5.58842061860412,-2.02765900038719,30,28,2,41,44,-3,54,72,-18,5,3,0,0
"18022","PHI","MTL",2017020828,17570,20172018,1,60,5,3,2,5.08063381658576,3.61676784635478,1.46386597023098,28,28,0,35,42,-7,43,58,-15,5,4,0,0
"18023","PHI","ARI",2017020850,17572,20172018,0,65,3,3,0,4.99713584715209,2.59150258940645,2.40563325774565,43,27,16,57,37,20,68,54,14,5,3,0,0
"18024","PHI","VGK",2017020859,17573,20172018,0,60,4,1,3,3.78858893111572,6.69603817164898,-2.90744924053326,18,39,-21,26,54,-28,34,64,-30,0,1,0,0
"18025","PHI","N.J",2017020867,17575,20172018,1,65,4,4,0,7.96167285574106,8.4838640486653,-0.522191192924244,35,36,-1,52,54,-2,65,68,-3,6,4,0,0
"18026","PHI","CBJ",2017020890,17578,20172018,0,61.8666666666667,2,1,1,3.46592803874228,4.43717708601616,-0.971249047273886,25,36,-11,30,49,-19,47,68,-21,2,1,0,0
"18027","PHI","NYR",2017020905,17580,20172018,0,60,7,4,3,4.2610782803531,5.02941932682563,-0.768341046472525,37,40,-3,45,45,0,61,54,7,1,0,0,0
"18028","PHI","MTL",2017020920,17582,20172018,1,61.4333333333333,3,2,1,4.2922881556151,4.9835586930284,-0.691270537413304,33,27,6,52,39,13,79,55,24,3,0,0,0
"18029","PHI","CBJ",2017020932,17584,20172018,1,60,2,1,1,2.9590527794935,1.38294978837826,1.57610299111525,20,20,0,31,31,0,42,45,-3,5,2,0,0
"18030","PHI","OTT",2017020946,17586,20172018,0,60,5,3,2,6.57517481052297,5.3114957133555,1.26367909716747,39,28,11,49,45,4,61,64,-3,3,4,0,0
"18031","PHI","MTL",2017020965,17588,20172018,0,65,0,0,0,6.10695560323074,5.93828494497575,0.168670658254996,33,28,5,49,40,9,66,56,10,5,3,0,0
"18032","PHI","CAR",2017020984,17591,20172018,1,60,1,4,-3,2.29908852674998,4.81856800183596,-2.51947947508597,22,35,-13,33,42,-9,43,53,-10,3,2,0,0
"18033","PHI","T.B",2017021000,17593,20172018,0,65,6,6,0,4.68808679664653,4.21479421350887,0.473292583137663,43,35,8,51,43,8,62,54,8,6,2,0,0
"18034","PHI","FLA",2017021008,17594,20172018,0,60,1,4,-3,8.57721299112773,3.72577743569309,4.85143555543464,40,26,14,51,38,13,67,52,15,3,6,0,0
"18035","PHI","PIT",2017021030,17597,20172018,1,60,2,5,-3,3.93268808838911,4.55758327158711,-0.624895183197992,28,28,0,38,44,-6,55,57,-2,6,5,0,0
"18036","PHI","BOS",2017021032,17598,20172018,0,60,2,3,-1,3.6798666677141,2.8235127814547,0.856353886259408,33,27,6,46,43,3,61,51,10,4,3,0,0
"18037","PHI","WPG",2017021051,17600,20172018,1,60,2,1,1,4.70705833392458,2.4097967944806,2.29726153944398,35,28,7,45,37,8,56,53,3,2,4,0,0
"18038","PHI","VGK",2017021064,17602,20172018,1,60,2,3,-1,4.40107061419985,3.86654104630642,0.534529567893433,40,29,11,58,40,18,74,51,23,4,2,0,0
"18039","PHI","CBJ",2017021085,17605,20172018,1,60,3,5,-2,5.30291108973324,6.32744657287995,-1.02453548314671,30,29,1,49,43,6,70,65,5,3,1,0,0
"18040","PHI","CAR",2017021103,17607,20172018,0,60,4,2,2,5.13671782816527,4.73972621539751,0.396991612767765,27,25,2,38,40,-2,55,64,-9,2,2,0,0
"18041","PHI","WSH",2017021112,17608,20172018,1,60,6,3,3,5.39102146411005,4.36605181972845,1.0249696443816,35,28,7,51,42,9,66,53,13,4,4,0,0
"18042","PHI","DET",2017021126,17610,20172018,0,65,4,4,0,0,0,0,31,31,0,46,40,6,71,52,19,4,1,0,0
"18043","PHI","NYR",2017021137,17612,20172018,1,60,4,3,1,5.96123148565675,5.2217229564759,0.739508529180853,36,36,0,48,52,-4,58,73,-15,3,3,0,0
"18044","PHI","PIT",2017021163,17615,20172018,0,62.4166666666667,4,5,-1,4.84170516434824,4.04655579233258,0.795149372015658,45,32,13,50,42,8,59,52,7,3,2,0,0
"18045","PHI","DAL",2017021183,17617,20172018,0,60.6666666666667,2,3,-1,4.47010777576361,3.88879551843274,0.581312257330865,33,23,10,53,34,19,67,49,18,3,3,0,0
"18046","PHI","COL",2017021188,17618,20172018,0,60,2,1,1,5.42553356749113,2.60433259239653,2.8212009750946,33,28,5,46,45,1,61,78,-17,2,3,0,0
"18047","PHI","BOS",2017021218,17622,20172018,1,63.65,4,3,1,3.30940602913161,6.60778833355289,-3.29838230442128,24,39,-15,33,54,-21,53,70,-17,2,3,0,0
"18048","PHI","NYI",2017021230,17624,20172018,0,60,4,5,-1,4.44718392909272,3.1193267951603,1.32785713393241,31,37,-6,46,46,0,59,62,-3,4,6,0,0
"18049","PHI","CAR",2017021243,17626,20172018,1,60,4,3,1,2.39405411076586,5.69133831148793,-3.29728420072206,34,22,12,44,39,5,56,57,-1,2,3,0,0
"18050","PHI","NYR",2017021257,17628,20172018,1,60,5,0,5,5.79842472403618,2.16413391253445,3.63429081150173,40,17,23,47,31,16,61,49,12,3,2,0,0
"18051","PHI","PIT",2017030141,17632,20172018,0,60,0,7,-7,1.66451573735702,2.21768936199398,-0.553173624636955,24,33,-9,35,39,-4,59,52,7,4,4,0,0
"18052","PHI","PIT",2017030142,17634,20172018,0,60,5,1,4,3.11955560764613,5.4444731199612,-2.32491751231506,20,35,-15,26,48,-22,30,59,-29,5,6,0,0
"18053","PHI","PIT",2017030143,17636,20172018,1,60,1,5,-4,4.42403676503712,6.04259543180478,-1.61855866676766,27,26,1,38,39,-1,55,55,0,7,8,0,0
"18054","PHI","PIT",2017030144,17639,20172018,1,60,0,5,-5,2.79630106859212,2.72335324325331,0.0729478253388103,26,30,-4,36,39,-3,52,51,1,3,4,0,0
"18055","PHI","PIT",2017030145,17641,20172018,0,60,4,2,2,4.09243867213958,4.59276108264748,-0.500322410507906,25,32,-7,37,46,-9,48,60,-12,3,7,0,0
"18056","PHI","PIT",2017030146,17643,20172018,1,60,5,8,-3,2.89127814640233,5.68069241155172,-2.78941426514939,26,28,-2,37,37,0,59,51,8,5,3,0,0
"18057","PHI","VGK",2018020014,17808,20182019,0,60,5,2,3,4.83838565915357,2.97540891907568,1.8629767400779,25,25,0,31,40,-9,41,52,-11,5,4,0,0
"18058","PHI","COL",2018020026,17810,20182019,0,60,2,5,-3,4.49996047415513,3.16316021710264,1.33680025705249,37,35,2,47,43,4,64,66,-2,5,6,0,0
"18059","PHI","S.J",2018020036,17813,20182019,1,60,2,8,-6,6.09047030261595,8.40032348256452,-2.30985317994857,33,48,-15,51,62,-11,59,70,-11,6,5,0,0
"18060","PHI","OTT",2018020042,17814,20182019,0,60,7,4,3,8.43264569187038,6.15296942351065,2.27967626835973,45,35,10,59,48,11,71,64,7,12,12,0,0
"18061","PHI","VGK",2018020058,17817,20182019,1,60,0,1,-1,2.65889571429864,3.21771587169496,-0.558820157396326,26,21,5,38,35,3,55,52,3,2,3,0,0
"18062","PHI","FLA",2018020080,17820,20182019,1,65,5,5,0,2.21022619175578,6.92243734265503,-4.71221115089925,26,26,0,36,40,-4,50,53,-3,3,4,0,0
"18063","PHI","CBJ",2018020092,17822,20182019,0,60,3,6,-3,5.69225777202519,3.34863578600925,2.34362198601593,35,28,7,45,42,3,56,49,7,2,2,0,0
"18064","PHI","N.J",2018020102,17824,20182019,1,60,5,2,3,5.08385566835932,2.20514669647407,2.87870897188525,21,21,0,42,34,8,69,45,24,6,4,0,0
"18065","PHI","COL",2018020118,17826,20182019,1,60,1,4,-3,8.04057966918862,7.33415842818385,0.706421241004771,38,33,5,54,38,16,76,48,28,3,2,0,0
"18066","PHI","BOS",2018020134,17829,20182019,0,60,0,3,-3,4.27760470673698,3.40445392019592,0.873150786541061,26,25,1,38,34,4,51,48,3,6,8,0,0
"18067","PHI","NYI",2018020149,17831,20182019,1,60,1,6,-5,3.1041470067007,3.05556556990854,0.048581436792162,23,22,1,32,32,0,52,47,5,3,3,0,0
"18068","PHI","ANA",2018020176,17834,20182019,0,60,3,2,1,4.42774148590979,2.8714183802878,1.55632310562199,36,25,11,46,42,4,62,67,-5,4,3,0,0
"18069","PHI","L.A",2018020190,17836,20182019,0,60,5,2,3,5.04292322266701,6.64677080611204,-1.60384758344503,31,27,4,45,44,1,53,55,-2,1,5,0,0
"18070","PHI","S.J",2018020206,17838,20182019,0,60.2166666666667,3,4,-1,3.19470073550474,3.8424601010872,-0.64775936558246,25,35,-10,36,46,-10,42,62,-20,3,3,0,0
"18071","PHI","ARI",2018020214,17840,20182019,0,60,5,2,3,4.47719104827236,4.52736353001092,-0.0501724817385547,34,36,-2,38,53,-15,55,76,-21,8,8,0,0
"18072","PHI","ARI",2018020229,17843,20182019,1,61.0166666666667,5,4,1,6.79969818735117,5.12256381788757,1.6771343694636,31,34,-3,47,38,9,67,49,18,4,2,0,0
"18073","PHI","CHI",2018020243,17845,20182019,1,60,4,0,4,4.71810883311264,4.11308920904412,0.605019624068518,25,33,-8,42,48,-6,54,69,-15,3,4,0,0
"18074","PHI","FLA",2018020267,17848,20182019,1,60,1,2,-1,7.42662852503145,2.05837979432957,5.36824873070187,31,30,1,53,37,16,74,52,22,1,3,0,0
"18075","PHI","N.J",2018020278,17850,20182019,1,60,0,3,-3,4.99023153992289,6.21597711697359,-1.2257455770507,29,27,2,54,33,21,68,47,21,5,3,0,0
"18076","PHI","T.B",2018020293,17852,20182019,1,61.7833333333333,5,6,-1,3.85954927130184,5.74369916424621,-1.88414989294436,45,26,19,55,42,13,75,61,14,6,5,0,0
"18077","PHI","BUF",2018020318,17856,20182019,0,60,2,5,-3,2.97904884386662,5.74939294892829,-2.77034410506167,25,21,4,35,29,6,44,39,5,1,3,0,0
"18078","PHI","NYR",2018020332,17858,20182019,1,60,4,0,4,6.48719986296745,6.55339494203413,-0.0661950790666825,46,31,15,58,39,19,77,49,28,1,3,0,0
"18079","PHI","TOR",2018020348,17859,20182019,0,60,0,6,-6,7.13433718233136,4.75028326759639,2.38405391473498,34,41,-7,48,51,-3,58,68,-10,0,0,0,0
"18080","PHI","OTT",2018020368,17862,20182019,1,60,3,4,-1,5.72452399336479,5.16002371453214,0.56450027883265,37,24,13,56,28,28,70,41,29,0,3,0,0
"18081","PHI","PIT",2018020402,17866,20182019,0,60,4,2,2,4.39459622372651,5.73183938384408,-1.33724316011757,26,32,-6,32,40,-8,47,56,-9,4,2,0,0
"18082","PHI","CBJ",2018020431,17871,20182019,1,60.1666666666667,3,4,-1,4.50434465636499,3.49131250074272,1.01303215562227,26,30,-4,39,37,2,57,48,9,3,5,0,0
"18083","PHI","BUF",2018020444,17873,20182019,0,60,6,2,4,4.30968948715919,2.94181571061228,1.36787377654691,41,30,11,48,42,6,59,52,7,3,2,0,0
"18084","PHI","WPG",2018020455,17874,20182019,0,60,1,7,-6,4.17981815322746,5.75980401597917,-1.57998586275171,37,35,2,49,43,6,66,53,13,3,4,0,0
"18085","PHI","CGY",2018020477,17877,20182019,0,60.5833333333333,5,6,-1,2.47442451882398,4.76451419730438,-2.2900896784804,19,41,-22,25,53,-28,37,71,-34,4,7,0,0
"18086","PHI","EDM",2018020494,17879,20182019,0,60,1,4,-3,3.31776433762502,3.8038919447572,-0.486127607132175,32,22,10,43,29,14,59,39,20,4,2,0,0
"18087","PHI","VAN",2018020504,17880,20182019,0,60,1,5,-4,3.1863546366767,3.26293640790055,-0.0765817712238572,32,24,8,41,33,8,54,43,11,4,2,0,0
"18088","PHI","DET",2018020520,17883,20182019,1,60,3,2,1,5.65425015714573,3.68817624845542,1.9660739086903,33,22,11,46,33,13,59,51,8,2,3,0,0
"18089","PHI","NSH",2018020532,17885,20182019,1,60,2,1,1,2.99340351481214,3.87162953880761,-0.878226023995467,31,32,-1,41,41,0,47,65,-18,4,6,0,0
"18090","PHI","CBJ",2018020546,17887,20182019,1,60,3,4,-1,4.69296703330696,2.51967594073483,2.17329109257213,37,19,18,50,23,27,67,30,37,5,3,0,0
"18091","PHI","NYR",2018020561,17888,20182019,0,65,2,2,0,4.33874837881021,2.68016131892409,1.65858705988612,31,34,-3,45,43,2,63,53,10,2,2,0,0
"18092","PHI","T.B",2018020571,17892,20182019,0,60.3,5,6,-1,4.60900892829522,4.02002633116759,0.588982597127631,33,37,-4,46,46,0,65,56,9,3,4,0,0
"18093","PHI","FLA",2018020591,17894,20182019,0,60,1,2,-1,7.13019841624191,2.68554010027572,4.44465831596619,35,36,-1,50,46,4,58,67,-9,2,3,0,0
"18094","PHI","CAR",2018020602,17896,20182019,0,60,1,3,-2,2.74878688069962,4.80550234905331,-2.05671546835369,23,33,-10,37,48,-11,58,65,-7,2,2,0,0
"18095","PHI","NSH",2018020613,17897,20182019,0,60,0,4,-4,5.6804288677522,5.35026145982556,0.330167407926638,32,30,2,44,42,2,62,58,4,2,2,0,0
"18096","PHI","CAR",2018020625,17899,20182019,1,60,3,5,-2,4.40206227080462,2.59938299592944,1.80267927487517,37,28,9,54,34,20,74,44,30,6,5,0,0
"18097","PHI","CGY",2018020636,17901,20182019,1,61.9833333333333,2,3,-1,3.77232357022149,6.72651412579717,-2.95419055557568,34,32,2,51,46,5,66,63,3,5,3,0,0
"18098","PHI","STL",2018020653,17903,20182019,1,60,0,3,-3,4.33418364142562,3.67024006621796,0.663943575207668,25,37,-12,34,45,-11,49,56,-7,1,2,0,0
"18099","PHI","WSH",2018020661,17904,20182019,0,60,3,5,-2,5.3864736764667,6.1276385391393,-0.741164862672601,40,25,15,46,39,7,65,53,12,5,4,0,0
"18100","PHI","DAL",2018020674,17906,20182019,1,60,2,1,1,2.74251202218403,4.31556269427529,-1.57305067209126,22,38,-16,35,49,-14,51,67,-16,3,3,0,0
"18101","PHI","N.J",2018020687,17908,20182019,0,60,2,3,-1,4.93994379503373,2.51348195704208,2.42646183799165,34,26,8,54,37,17,68,51,17,5,7,0,0
"18102","PHI","MIN",2018020708,17910,20182019,1,60,7,4,3,6.31781315894381,4.48955389008011,1.8282592688637,27,38,-11,41,49,-8,50,69,-19,6,4,0,0
"18103","PHI","BOS",2018020722,17912,20182019,1,60,4,3,1,2.25162582600024,5.16678934409829,-2.91516351809805,19,42,-23,26,54,-28,34,84,-50,3,3,0,0
"18104","PHI","MTL",2018020743,17915,20182019,0,60,5,2,3,4.11780781717971,2.64991684716826,1.46789097001145,24,35,-11,33,47,-14,51,70,-19,2,1,0,0
"18105","PHI","WPG",2018020771,17924,20182019,1,60,3,1,2,4.15863076070178,3.47637582971781,0.682254930983975,31,32,-1,45,43,2,58,64,-6,2,3,0,0
"18106","PHI","NYR",2018020774,17925,20182019,0,60,1,0,1,4.47000494075473,5.81037608610632,-1.34037114535158,19,38,-19,23,47,-24,30,66,-36,2,2,0,0
"18107","PHI","BOS",2018020778,17927,20182019,0,62.9333333333333,3,2,1,4.34761061280005,6.17080829452553,-1.82319768172547,41,25,16,47,38,9,67,56,11,3,1,0,0
"18108","PHI","EDM",2018020789,17929,20182019,1,62.0166666666667,5,4,1,5.25270738761174,6.26085864293786,-1.00815125532613,39,44,-5,51,54,-3,67,69,-2,6,4,0,0
"18109","PHI","VAN",2018020807,17931,20182019,1,60,2,1,1,4.49633264108815,5.37670571958055,-0.880373078492396,30,42,-12,40,53,-13,50,83,-33,3,3,0,0
"18110","PHI","L.A",2018020826,17934,20182019,1,65,2,2,0,3.75276579678757,4.43108547407019,-0.678319677282616,32,39,-7,46,52,-6,62,62,0,2,0,0,0
"18111","PHI","ANA",2018020842,17936,20182019,1,60,6,2,4,5.69724808373576,3.91947446321137,1.77777362052439,40,32,8,53,43,10,68,62,6,6,5,0,0
"18112","PHI","PIT",2018020860,17938,20182019,1,60,1,4,-3,7.24661880303029,5.95448127764394,1.29213752538635,51,28,23,66,35,31,82,50,32,4,2,0,0
"18113","PHI","MIN",2018020871,17939,20182019,0,60,5,4,1,6.5644891370199,5.64517411520582,0.919315021814087,26,39,-13,36,54,-18,40,74,-34,4,5,0,0
"18114","PHI","DET",2018020892,17943,20182019,1,61.45,6,5,1,2.7309104136358,4.37550382827877,-1.64459341464297,32,38,-6,41,44,-3,59,60,-1,3,2,0,0
"18115","PHI","DET",2018020907,17944,20182019,0,60,3,1,2,4.8679235074087,3.30632283563318,1.56160067177552,23,38,-15,32,54,-22,48,74,-26,1,2,0,0
"18116","PHI","T.B",2018020918,17946,20182019,1,60,2,5,-3,3.93116597528569,5.57082369507407,-1.63965771978837,30,33,-3,41,46,-5,60,61,-1,4,5,0,0
"18117","PHI","MTL",2018020934,17948,20182019,0,60,1,5,-4,5.4999470042078,7.58233830815941,-2.08239130395161,30,40,-10,42,48,-6,58,64,-6,4,1,0,0
"18118","PHI","PIT",2018020953,17950,20182019,1,61.9833333333333,4,3,1,8.85433271579677,5.19721201858376,3.65712069721301,37,43,-6,50,55,-5,69,67,2,5,3,0,0
"18119","PHI","BUF",2018020970,17953,20182019,1,60,5,2,3,5.07859836367703,4.15172164669548,0.926876716981553,45,36,9,54,45,9,70,62,8,5,6,0,0
"18120","PHI","CBJ",2018020986,17955,20182019,0,64.45,3,4,-1,5.90744793326303,6.54664496549685,-0.639197032233824,31,40,-9,45,49,-4,57,69,-12,2,3,0,0
"18121","PHI","N.J",2018020992,17956,20182019,0,60,6,3,3,3.36881656941,3.41929680030741,-0.0504802308974046,24,33,-9,29,47,-18,37,58,-21,4,3,0,0
"18122","PHI","NYI",2018021010,17958,20182019,0,60,4,1,3,3.23494672900415,4.14069482305786,-0.905748094053706,26,30,-4,33,43,-10,45,62,-17,1,2,0,0
"18123","PHI","WSH",2018021029,17961,20182019,1,60,3,5,-2,4.21341585169564,4.79442958545405,-0.581013733758414,30,35,-5,44,49,-5,54,64,-10,2,4,0,0
"18124","PHI","NYI",2018021052,17964,20182019,0,60,5,2,3,3.33582658896921,4.39576058187356,-1.05993399290435,25,27,-2,33,43,-10,47,59,-12,4,3,0,0
"18125","PHI","OTT",2018021067,17966,20182019,1,60,3,2,1,5.02214038474631,3.49704563512933,1.52509474961698,36,22,14,48,30,18,65,46,19,4,2,0,0
"18126","PHI","WSH",2018021085,17969,20182019,1,60,2,5,-3,4.24483285151655,5.46551022867698,-1.22067737716043,24,32,-8,34,43,-9,55,53,2,4,3,0,0
"18127","PHI","TOR",2018021093,17970,20182019,0,60,6,7,-1,2.42662878634292,5.75413238537226,-3.32750359902934,29,51,-22,41,70,-29,49,96,-47,3,5,0,0
"18128","PHI","PIT",2018021115,17972,20182019,0,64.9333333333333,2,1,1,6.33317899839839,3.63041109102132,2.70276790737707,38,42,-4,45,55,-10,57,68,-11,3,4,0,0
"18129","PHI","MTL",2018021125,17974,20182019,1,60,1,3,-2,5.88076548858953,5.08156207208458,0.799203416504952,33,36,-3,51,42,9,68,64,4,2,2,0,0
"18130","PHI","CHI",2018021142,17976,20182019,0,60,3,1,2,3.14691240022148,6.12144125223131,-2.97452885200983,28,41,-13,33,54,-21,44,72,-28,1,2,0,0
"18131","PHI","NYI",2018021151,17978,20182019,1,60,2,4,-2,3.67092103057075,9.34999342309311,-5.67907239252236,24,40,-16,37,61,-24,54,78,-24,3,4,0,0
"18132","PHI","WSH",2018021164,17979,20182019,0,60,1,3,-2,4.82420899059031,3.1915391411848,1.63266984940551,36,30,6,56,39,17,74,47,27,4,2,0,0
"18133","PHI","TOR",2018021185,17982,20182019,1,65,4,4,0,9.02195244125323,9.23721669660881,-0.215264255355578,44,42,2,56,61,-5,65,78,-13,1,2,0,0
"18134","PHI","CAR",2018021203,17985,20182019,0,60,2,5,-3,5.03690162950352,5.99180493406493,-0.954903304561412,32,32,0,44,52,-8,58,66,-8,3,2,0,0
"18135","PHI","NYR",2018021215,17986,20182019,1,60,0,3,-3,2.34293446553056,2.19387604578895,0.149058419741612,29,25,4,38,34,4,60,46,14,4,2,0,0
"18136","PHI","DAL",2018021235,17988,20182019,0,60,2,6,-4,4.31584108172427,3.84777674470013,0.468064337024146,34,30,4,43,42,1,55,58,-3,4,6,0,0
"18137","PHI","STL",2018021248,17990,20182019,0,60,3,7,-4,1.13512282594456,3.58845024013499,-2.45332741419043,29,35,-6,39,42,-3,42,54,-12,5,5,0,0
"18138","PHI","CAR",2018021263,17992,20182019,1,60,3,4,-1,2.50384684983629,3.11474209353537,-0.610895243699076,31,28,3,40,36,4,57,52,5,2,2,0,0
"18139","PIT","OTT",2008020002,14156,20082009,0,64.5833333333333,4,3,1,0,0,0,30,35,-5,43,47,-4,64,58,6,7,6,0,0
"18140","PIT","OTT",2008020004,14157,20082009,1,60,1,3,-2,0,0,0,31,27,4,37,41,-4,51,56,-5,8,5,0,0
"18141","PIT","N.J",2008020022,14163,20082009,1,64.3666666666667,1,2,-1,0,0,0,15,49,-34,27,61,-34,38,88,-50,5,5,0,0
"18142","PIT","PHI",2008020039,14166,20082009,1,64.8166666666667,3,2,1,0,0,0,28,30,-2,39,40,-1,62,54,8,6,6,0,0
"18143","PIT","WSH",2008020050,14168,20082009,1,60,3,4,-1,0,0,0,26,30,-4,36,40,-4,48,66,-18,6,4,0,0
"18144","PIT","TOR",2008020066,14170,20082009,1,60,4,1,3,0,0,0,25,27,-2,36,40,-4,51,59,-8,4,6,0,0
"18145","PIT","BOS",2008020078,14172,20082009,0,65,1,1,0,0,0,0,32,36,-4,36,48,-12,45,64,-19,4,6,0,0
"18146","PIT","CAR",2008020094,14175,20082009,1,60,4,1,3,0,0,0,35,25,10,43,33,10,55,50,5,3,2,0,0
"18147","PIT","NYR",2008020109,14177,20082009,0,65,2,2,0,0,0,0,29,44,-15,45,53,-8,54,68,-14,2,5,0,0
"18148","PIT","S.J",2008020132,14180,20082009,0,60,1,2,-1,0,0,0,11,34,-23,19,50,-31,27,66,-39,2,6,0,0
"18149","PIT","ARI",2008020145,14182,20082009,0,60,1,4,-3,0,0,0,28,30,-2,41,41,0,56,56,0,5,4,0,0
"18150","PIT","STL",2008020159,14184,20082009,0,60,6,3,3,0,0,0,28,22,6,44,35,9,49,51,-2,6,4,0,0
"18151","PIT","EDM",2008020186,14189,20082009,1,60,5,4,1,0,0,0,34,31,3,50,42,8,72,54,18,7,6,0,0
"18152","PIT","NYI",2008020198,14191,20082009,0,65,3,3,0,0,0,0,32,22,10,45,28,17,74,42,32,4,3,0,0
"18153","PIT","DET",2008020216,14194,20082009,0,63.8166666666667,7,6,1,0,0,0,34,34,0,47,43,4,58,53,5,5,5,0,0
"18154","PIT","PHI",2008020230,14196,20082009,1,65,4,4,0,0,0,0,31,35,-4,39,44,-5,59,61,-2,7,4,0,0
"18155","PIT","BUF",2008020247,14198,20082009,1,60,5,2,3,0,0,0,25,23,2,36,31,5,61,46,15,6,5,0,0
"18156","PIT","MIN",2008020262,14201,20082009,1,65,1,1,0,0,0,0,25,25,0,40,36,4,53,58,-5,4,2,0,0
"18157","PIT","ATL",2008020272,14203,20082009,0,60,3,2,1,0,0,0,31,23,8,43,29,14,53,36,17,4,4,0,0
"18158","PIT","VAN",2008020285,14205,20082009,1,60,1,3,-2,0,0,0,19,19,0,32,25,7,48,37,11,8,6,0,0
"18159","PIT","NYI",2008020310,14209,20082009,0,60,5,3,2,0,0,0,30,25,5,39,34,5,59,44,15,3,4,0,0
"18160","PIT","BUF",2008020329,14211,20082009,0,60,3,4,-1,0,0,0,30,32,-2,42,46,-4,56,62,-6,8,5,0,0
"18161","PIT","N.J",2008020341,14212,20082009,1,60,4,1,3,0,0,0,35,30,5,49,46,3,61,68,-7,7,6,0,0
"18162","PIT","NYR",2008020362,14216,20082009,0,65,2,2,0,0,0,0,31,27,4,48,43,5,69,61,8,4,3,0,0
"18163","PIT","CAR",2008020369,14217,20082009,0,60,5,2,3,0,0,0,22,36,-14,31,58,-27,43,82,-39,3,5,0,0
"18164","PIT","OTT",2008020382,14219,20082009,0,60,2,3,-1,0,0,0,19,31,-12,34,39,-5,45,59,-14,3,2,0,0
"18165","PIT","BUF",2008020400,14221,20082009,1,60,3,4,-1,0,0,0,32,29,3,44,41,3,54,60,-6,9,4,0,0
"18166","PIT","N.J",2008020406,14223,20082009,0,60,1,4,-3,0,0,0,27,32,-5,38,38,0,43,55,-12,6,7,0,0
"18167","PIT","NYI",2008020417,14224,20082009,1,60,9,2,7,0,0,0,38,26,12,53,36,17,62,50,12,12,6,0,0
"18168","PIT","PHI",2008020429,14226,20082009,0,60,3,6,-3,0,0,0,26,27,-1,38,39,-1,48,59,-11,5,7,0,0
"18169","PIT","ATL",2008020463,14231,20082009,0,60,6,3,3,0,0,0,20,31,-11,24,42,-18,29,57,-28,4,6,0,0
"18170","PIT","TOR",2008020478,14233,20082009,1,60,3,7,-4,0,0,0,23,40,-17,35,57,-22,43,72,-29,5,8,0,0
"18171","PIT","BUF",2008020490,14235,20082009,0,60.7166666666667,4,3,1,0,0,0,22,35,-13,35,44,-9,46,58,-12,1,6,0,0
"18172","PIT","T.B",2008020500,14236,20082009,1,60,0,2,-2,0,0,0,15,29,-14,25,44,-19,35,62,-27,5,6,0,0
"18173","PIT","N.J",2008020507,14239,20082009,0,60,1,0,1,0,0,0,18,37,-19,24,50,-26,29,59,-30,6,5,0,0
"18174","PIT","MTL",2008020517,14240,20082009,1,60,2,3,-1,0,0,0,34,19,15,48,30,18,72,41,31,5,1,0,0
"18175","PIT","BOS",2008020541,14243,20082009,1,60,2,5,-3,0,0,0,34,40,-6,37,54,-17,43,76,-33,4,9,0,0
"18176","PIT","BOS",2008020555,14245,20082009,0,60,2,4,-2,0,0,0,32,26,6,45,36,9,62,52,10,5,6,0,0
"18177","PIT","FLA",2008020566,14247,20082009,1,60,1,6,-5,0,0,0,30,24,6,38,36,2,47,51,-4,5,8,0,0
"18178","PIT","NYR",2008020583,14249,20082009,0,60,0,4,-4,0,0,0,27,26,1,49,40,9,55,47,8,8,8,0,0
"18179","PIT","ATL",2008020590,14250,20082009,1,60,3,1,2,0,0,0,29,28,1,40,38,2,51,57,-6,6,3,0,0
"18180","PIT","NSH",2008020604,14252,20082009,0,60,3,5,-2,0,0,0,25,35,-10,30,48,-18,37,66,-29,3,3,0,0
"18181","PIT","COL",2008020615,14254,20082009,0,60,3,5,-2,0,0,0,24,32,-8,36,39,-3,49,54,-5,1,1,0,0
"18182","PIT","PHI",2008020633,14257,20082009,0,60,4,2,2,0,0,0,26,29,-3,40,42,-2,50,52,-2,5,2,0,0
"18183","PIT","WSH",2008020642,14258,20082009,1,60,3,6,-3,0,0,0,29,42,-13,43,60,-17,57,81,-24,5,6,0,0
"18184","PIT","ANA",2008020657,14260,20082009,1,60,3,1,2,0,0,0,24,22,2,32,35,-3,42,49,-7,4,5,0,0
"18185","PIT","NYR",2008020673,14262,20082009,1,60,3,0,3,0,0,0,23,33,-10,32,45,-13,41,54,-13,6,3,0,0
"18186","PIT","CAR",2008020687,14264,20082009,1,60,1,2,-1,0,0,0,33,40,-7,41,52,-11,55,66,-11,5,5,0,0
"18187","PIT","NYR",2008020712,14272,20082009,1,60,6,2,4,0,0,0,33,34,-1,45,47,-2,57,70,-13,6,5,0,0
"18188","PIT","N.J",2008020725,14274,20082009,0,64,3,4,-1,0,0,0,16,43,-27,19,54,-35,22,65,-43,3,6,0,0
"18189","PIT","TOR",2008020734,14275,20082009,0,60,4,5,-1,0,0,0,26,26,0,38,36,2,49,46,3,4,5,0,0
"18190","PIT","MTL",2008020753,14278,20082009,0,60,2,4,-2,0,0,0,25,35,-10,30,48,-18,53,64,-11,6,3,0,0
"18191","PIT","T.B",2008020761,14279,20082009,1,64.7333333333333,4,3,1,0,0,0,35,24,11,48,33,15,60,44,16,7,2,0,0
"18192","PIT","CBJ",2008020773,14281,20082009,1,60,4,1,3,0,0,0,25,34,-9,34,47,-13,47,62,-15,1,5,0,0
"18193","PIT","DET",2008020789,14283,20082009,1,60,0,3,-3,0,0,0,25,29,-4,32,46,-14,48,64,-16,5,4,0,0
"18194","PIT","S.J",2008020806,14286,20082009,1,65,1,1,0,0,0,0,36,37,-1,53,50,3,64,68,-4,3,1,0,0
"18195","PIT","TOR",2008020827,14289,20082009,0,60,2,6,-4,0,0,0,27,41,-14,37,62,-25,49,84,-35,3,5,0,0
"18196","PIT","NYI",2008020841,14291,20082009,0,65,2,2,0,0,0,0,37,30,7,51,44,7,70,63,7,4,2,0,0
"18197","PIT","MTL",2008020861,14294,20082009,1,60,5,4,1,0,0,0,28,27,1,39,40,-1,44,54,-10,1,4,0,0
"18198","PIT","PHI",2008020874,14296,20082009,0,60,5,4,1,0,0,0,27,27,0,40,44,-4,49,57,-8,5,5,0,0
"18199","PIT","WSH",2008020887,14297,20082009,0,60,2,5,-3,0,0,0,33,34,-1,47,52,-5,64,64,0,9,4,0,0
"18200","PIT","NYI",2008020906,14300,20082009,1,60,1,0,1,0,0,0,28,21,7,48,32,16,64,50,14,3,3,0,0
"18201","PIT","CHI",2008020920,14302,20082009,0,61.6,5,4,1,0,0,0,28,45,-17,30,54,-24,43,70,-27,6,9,0,0
"18202","PIT","DAL",2008020937,14304,20082009,0,60,4,1,3,0,0,0,23,21,2,30,29,1,43,40,3,6,6,0,0
"18203","PIT","T.B",2008020947,14306,20082009,0,60,3,1,2,0,0,0,33,33,0,44,50,-6,55,60,-5,4,2,0,0
"18204","PIT","FLA",2008020960,14308,20082009,0,60,4,1,3,0,0,0,47,32,15,66,45,21,83,58,25,4,2,0,0
"18205","PIT","WSH",2008020981,14311,20082009,0,65,3,3,0,0,0,0,22,32,-10,32,42,-10,41,63,-22,8,8,0,0
"18206","PIT","FLA",2008020994,14313,20082009,1,65,3,3,0,0,0,0,50,21,29,62,29,33,85,42,43,6,2,0,0
"18207","PIT","CBJ",2008021007,14315,20082009,0,65,3,3,0,0,0,0,41,28,13,53,38,15,65,48,17,4,6,0,0
"18208","PIT","OTT",2008021021,14317,20082009,1,65,3,3,0,0,0,0,30,39,-9,40,47,-7,52,61,-9,5,8,0,0
"18209","PIT","BOS",2008021032,14318,20082009,1,60,6,4,2,0,0,0,34,25,9,46,38,8,61,50,11,8,5,0,0
"18210","PIT","ATL",2008021043,14320,20082009,1,60,6,2,4,0,0,0,31,20,11,50,27,23,60,45,15,8,8,0,0
"18211","PIT","L.A",2008021066,14323,20082009,1,60,4,1,3,0,0,0,26,25,1,37,41,-4,49,57,-8,6,10,0,0
"18212","PIT","PHI",2008021079,14325,20082009,1,60,1,3,-2,0,0,0,28,20,8,40,32,8,63,50,13,5,8,0,0
"18213","PIT","CGY",2008021099,14328,20082009,1,60,2,0,2,0,0,0,28,31,-3,37,46,-9,55,64,-9,3,5,0,0
"18214","PIT","NYR",2008021116,14331,20082009,1,60,4,3,1,0,0,0,28,29,-1,38,36,2,56,55,1,8,5,0,0
"18215","PIT","N.J",2008021147,14335,20082009,1,60,6,1,5,0,0,0,37,25,12,48,30,18,60,42,18,6,4,0,0
"18216","PIT","CAR",2008021169,14338,20082009,0,61.1833333333333,2,3,-1,0,0,0,35,30,5,46,42,4,58,60,-2,4,4,0,0
"18217","PIT","FLA",2008021176,14339,20082009,0,60,2,4,-2,0,0,0,43,26,17,53,35,18,66,51,15,3,4,0,0
"18218","PIT","T.B",2008021190,14341,20082009,0,60,6,4,2,0,0,0,31,37,-6,41,46,-5,49,57,-8,5,7,0,0
"18219","PIT","NYI",2008021204,14343,20082009,1,60,6,1,5,0,0,0,37,29,8,46,41,5,59,58,1,2,7,0,0
"18220","PIT","MTL",2008021221,14345,20082009,0,60,3,1,2,0,0,0,41,30,11,56,40,16,72,59,13,5,3,0,0
"18221","PIT","PHI",2008030141,14349,20082009,1,60,4,1,3,0,0,0,33,27,6,40,41,-1,57,60,-3,10,5,0,0
"18222","PIT","PHI",2008030142,14351,20082009,1,78.4833333333333,3,2,1,0,0,0,49,40,9,64,54,10,79,72,7,5,4,0,0
"18223","PIT","PHI",2008030143,14353,20082009,0,60,3,6,-3,0,0,0,29,30,-1,40,39,1,59,55,4,9,9,0,0
"18224","PIT","PHI",2008030144,14355,20082009,0,60,3,1,2,0,0,0,26,46,-20,32,59,-27,42,79,-37,5,8,0,0
"18225","PIT","PHI",2008030145,14357,20082009,1,60,0,3,-3,0,0,0,28,26,2,34,39,-5,51,48,3,4,5,0,0
"18226","PIT","PHI",2008030146,14359,20082009,0,60,5,3,2,0,0,0,35,25,10,50,37,13,69,51,18,4,4,0,0
"18227","PIT","WSH",2008030221,14366,20082009,0,60,2,3,-1,0,0,0,36,26,10,50,39,11,67,59,8,5,2,0,0
"18228","PIT","WSH",2008030222,14368,20082009,0,60,3,4,-1,0,0,0,36,33,3,53,43,10,76,60,16,7,7,0,0
"18229","PIT","WSH",2008030223,14370,20082009,1,71.3833333333333,3,2,1,0,0,0,42,23,19,61,32,29,76,43,33,7,2,0,0
"18230","PIT","WSH",2008030224,14372,20082009,1,60,5,3,2,0,0,0,28,22,6,40,34,6,49,51,-2,6,4,0,0
"18231","PIT","WSH",2008030225,14373,20082009,0,63.4666666666667,4,3,1,0,0,0,42,31,11,54,45,9,71,69,2,4,4,0,0
"18232","PIT","WSH",2008030226,14375,20082009,1,66.3666666666667,4,5,-1,0,0,0,42,24,18,52,35,17,59,54,5,5,4,0,0
"18233","PIT","WSH",2008030227,14377,20082009,0,60,6,2,4,0,0,0,30,21,9,41,32,9,54,51,3,4,0,0,0
"18234","PIT","CAR",2008030312,14385,20082009,1,60,7,4,3,0,0,0,42,28,14,53,36,17,63,47,16,6,6,0,0
"18235","PIT","CAR",2008030313,14387,20082009,0,60,6,2,4,0,0,0,40,34,6,50,53,-3,64,75,-11,5,4,0,0
"18236","PIT","CAR",2008030314,14390,20082009,0,60,4,1,3,0,0,0,25,31,-6,34,47,-13,46,68,-22,5,4,0,0
"18237","PIT","DET",2008030411,14394,20082009,0,60,1,3,-2,0,0,0,32,30,2,43,48,-5,54,62,-8,2,1,0,0
"18238","PIT","DET",2008030412,14395,20082009,0,60,1,3,-2,0,0,0,32,26,6,39,35,4,49,45,4,1,3,0,0
"18239","PIT","DET",2008030413,14397,20082009,1,60,4,2,2,0,0,0,21,29,-8,34,39,-5,39,57,-18,3,2,0,0
"18240","PIT","DET",2008030414,14399,20082009,1,60,4,2,2,0,0,0,31,39,-8,34,54,-20,43,69,-26,4,5,0,0
"18241","PIT","DET",2008030415,14401,20082009,0,60,0,5,-5,0,0,0,22,29,-7,29,39,-10,35,51,-16,2,9,0,0
"18242","PIT","DET",2008030416,14404,20082009,1,60,2,1,1,0,0,0,31,26,5,38,43,-5,50,63,-13,2,2,0,0
"18243","PIT","DET",2008030417,14407,20082009,0,60,2,1,1,0,0,0,18,24,-6,24,41,-17,27,61,-34,2,3,0,0
"18244","PIT","NYR",2009020006,14519,20092010,1,60,3,2,1,0,0,0,31,27,4,42,40,2,60,62,-2,2,4,0,0
"18245","PIT","NYI",2009020013,14520,20092010,0,65,3,3,0,0,0,0,42,28,14,60,42,18,89,60,29,3,6,0,0
"18246","PIT","ARI",2009020033,14524,20092010,1,60,0,3,-3,0,0,0,24,25,-1,30,37,-7,39,54,-15,7,10,0,0
"18247","PIT","PHI",2009020038,14525,20092010,0,60,5,4,1,0,0,0,26,34,-8,33,48,-15,44,72,-28,8,10,0,0
"18248","PIT","TOR",2009020050,14527,20092010,0,60,5,2,3,0,0,0,33,20,13,47,33,14,58,51,7,6,3,0,0
"18249","PIT","OTT",2009020068,14529,20092010,0,60,4,1,3,0,0,0,28,31,-3,38,46,-8,49,60,-11,7,8,0,0
"18250","PIT","T.B",2009020101,14534,20092010,1,60,4,1,3,0,0,0,33,23,10,48,31,17,59,50,9,7,7,0,0
"18251","PIT","STL",2009020109,14537,20092010,1,60,5,1,4,0,0,0,43,23,20,53,32,21,67,50,17,5,3,0,0
"18252","PIT","FLA",2009020127,14540,20092010,1,65,2,2,0,0,0,0,43,29,14,61,40,21,75,64,11,7,5,0,0
"18253","PIT","N.J",2009020136,14541,20092010,1,60,1,4,-3,0,0,0,33,26,7,42,35,7,53,41,12,5,2,0,0
"18254","PIT","MTL",2009020159,14545,20092010,1,60,6,1,5,0,0,0,37,24,13,48,40,8,57,55,2,6,4,0,0
"18255","PIT","CBJ",2009020173,14547,20092010,0,65,3,3,0,0,0,0,32,32,0,38,39,-1,52,55,-3,6,8,0,0
"18256","PIT","MIN",2009020186,14548,20092010,1,60,1,2,-1,0,0,0,35,15,20,49,19,30,60,34,26,6,4,0,0
"18257","PIT","ANA",2009020202,14551,20092010,0,60,4,3,1,0,0,0,27,29,-2,40,47,-7,58,67,-9,7,3,0,0
"18258","PIT","L.A",2009020218,14553,20092010,0,60,2,5,-3,0,0,0,23,32,-9,39,50,-11,45,61,-16,4,4,0,0
"18259","PIT","S.J",2009020237,14555,20092010,0,60,0,5,-5,0,0,0,27,35,-8,47,46,1,60,65,-5,6,8,0,0
"18260","PIT","BOS",2009020241,14558,20092010,0,60,0,3,-3,0,0,0,27,29,-2,38,33,5,60,44,16,2,1,0,0
"18261","PIT","N.J",2009020256,14560,20092010,1,60,1,4,-3,0,0,0,26,25,1,36,39,-3,59,52,7,3,4,0,0
"18262","PIT","BOS",2009020274,14562,20092010,1,61.4,6,5,1,0,0,0,33,33,0,46,51,-5,57,73,-16,3,3,0,0
"18263","PIT","ANA",2009020286,14564,20092010,1,60,5,2,3,0,0,0,26,25,1,41,35,6,51,50,1,7,3,0,0
"18264","PIT","OTT",2009020301,14567,20092010,0,60,2,6,-4,0,0,0,27,31,-4,42,49,-7,64,60,4,5,3,0,0
"18265","PIT","ATL",2009020319,14569,20092010,0,60,3,2,1,0,0,0,34,33,1,47,40,7,60,52,8,3,3,0,0
"18266","PIT","FLA",2009020332,14571,20092010,0,63.1166666666667,3,2,1,0,0,0,45,21,24,59,33,26,71,44,27,4,4,0,0
"18267","PIT","MTL",2009020343,14573,20092010,1,60,3,1,2,0,0,0,30,19,11,45,30,15,63,39,24,2,1,0,0
"18268","PIT","NYI",2009020357,14575,20092010,0,60,2,3,-1,0,0,0,21,37,-16,34,58,-24,48,73,-25,6,5,0,0
"18269","PIT","NYR",2009020373,14576,20092010,1,60,8,3,5,0,0,0,33,25,8,46,30,16,59,41,18,6,3,0,0
"18270","PIT","NYR",2009020383,14578,20092010,0,60,5,2,3,0,0,0,33,31,2,45,47,-2,55,66,-11,5,3,0,0
"18271","PIT","COL",2009020403,14581,20092010,1,60,4,1,3,0,0,0,33,16,17,49,30,19,54,46,8,4,3,0,0
"18272","PIT","CHI",2009020422,14583,20092010,1,62.6333333333333,1,2,-1,0,0,0,33,31,2,48,51,-3,69,71,-2,3,5,0,0
"18273","PIT","CAR",2009020432,14585,20092010,1,60,2,3,-1,0,0,0,32,21,11,47,33,14,64,37,27,3,5,0,0
"18274","PIT","MTL",2009020454,14588,20092010,0,60,3,2,1,0,0,0,41,21,20,54,35,19,80,46,34,6,4,0,0
"18275","PIT","FLA",2009020473,14590,20092010,1,60.6166666666667,3,2,1,0,0,0,40,31,9,54,40,14,65,61,4,7,5,0,0
"18276","PIT","PHI",2009020488,14593,20092010,1,60,6,1,5,0,0,0,35,27,8,44,41,3,55,54,1,4,6,0,0
"18277","PIT","PHI",2009020504,14595,20092010,0,65,2,2,0,0,0,0,30,33,-3,41,47,-6,55,66,-11,7,5,0,0
"18278","PIT","BUF",2009020520,14597,20092010,0,65,1,1,0,0,0,0,24,32,-8,43,49,-6,63,65,-2,5,8,0,0
"18279","PIT","N.J",2009020537,14599,20092010,1,60,0,4,-4,0,0,0,35,30,5,52,40,12,64,55,9,6,4,0,0
"18280","PIT","OTT",2009020548,14601,20092010,1,60,8,2,6,0,0,0,36,47,-11,55,61,-6,68,77,-9,9,7,0,0
"18281","PIT","TOR",2009020573,14605,20092010,1,60,3,4,-1,0,0,0,24,27,-3,37,34,3,53,53,0,2,4,0,0
"18282","PIT","BUF",2009020584,14607,20092010,0,60,3,4,-1,0,0,0,38,24,14,54,34,20,67,46,21,3,5,0,0
"18283","PIT","N.J",2009020591,14608,20092010,0,60,0,2,-2,0,0,0,32,33,-1,36,41,-5,48,58,-10,2,5,0,0
"18284","PIT","T.B",2009020613,14611,20092010,0,60,1,3,-2,0,0,0,26,37,-11,40,49,-9,52,61,-9,5,5,0,0
"18285","PIT","FLA",2009020625,14612,20092010,0,60,2,6,-4,0,0,0,48,35,13,59,49,10,75,59,16,3,1,0,0
"18286","PIT","ATL",2009020633,14614,20092010,1,60,5,2,3,0,0,0,37,33,4,47,45,2,56,57,-1,4,2,0,0
"18287","PIT","PHI",2009020649,14616,20092010,1,60,4,7,-3,0,0,0,39,31,8,55,40,15,73,47,26,4,3,0,0
"18288","PIT","TOR",2009020662,14618,20092010,0,60,4,1,3,0,0,0,39,43,-4,51,61,-10,58,95,-37,3,4,0,0
"18289","PIT","MIN",2009020676,14620,20092010,0,60,3,4,-1,0,0,0,38,24,14,49,37,12,60,48,12,7,3,0,0
"18290","PIT","CGY",2009020691,14622,20092010,0,60,3,1,2,0,0,0,27,38,-11,33,59,-26,45,72,-27,5,5,0,0
"18291","PIT","EDM",2009020702,14623,20092010,0,60,3,2,1,0,0,0,31,35,-4,46,50,-4,68,61,7,3,5,0,0
"18292","PIT","VAN",2009020718,14625,20092010,0,60,2,6,-4,0,0,0,24,27,-3,30,41,-11,44,54,-10,6,9,0,0
"18293","PIT","NYI",2009020738,14628,20092010,1,60,6,4,2,0,0,0,29,35,-6,42,41,1,55,51,4,6,4,0,0
"18294","PIT","WSH",2009020750,14630,20092010,1,60,3,6,-3,0,0,0,38,34,4,52,44,8,68,55,13,4,2,0,0
"18295","PIT","PHI",2009020772,14633,20092010,0,60,2,1,1,0,0,0,22,28,-6,31,46,-15,50,62,-12,9,12,0,0
"18296","PIT","NYR",2009020775,14634,20092010,0,60,4,2,2,0,0,0,28,30,-2,38,41,-3,56,60,-4,2,3,0,0
"18297","PIT","OTT",2009020794,14637,20092010,1,60,1,4,-3,0,0,0,31,28,3,39,45,-6,55,60,-5,3,3,0,0
"18298","PIT","DET",2009020817,14640,20092010,1,65,1,1,0,0,0,0,47,24,23,65,39,26,76,52,24,3,5,0,0
"18299","PIT","BUF",2009020823,14641,20092010,1,60,5,4,1,0,0,0,31,34,-3,41,47,-6,51,65,-14,4,7,0,0
"18300","PIT","MTL",2009020856,14646,20092010,0,60,3,5,-2,0,0,0,21,32,-11,31,46,-15,52,71,-19,3,7,0,0
"18301","PIT","WSH",2009020870,14647,20092010,0,62.8166666666667,4,5,-1,0,0,0,35,34,1,55,53,2,77,75,2,7,5,0,0
"18302","PIT","NYI",2009020887,14650,20092010,1,60,3,1,2,0,0,0,28,38,-10,42,53,-11,50,64,-14,5,6,0,0
"18303","PIT","NYR",2009020901,14652,20092010,1,61.0333333333333,2,3,-1,0,0,0,27,39,-12,42,46,-4,56,57,-1,2,3,0,0
"18304","PIT","NSH",2009020917,14654,20092010,1,65,3,3,0,0,0,0,33,26,7,49,40,9,61,52,9,5,8,0,0
"18305","PIT","BUF",2009020929,14670,20092010,1,60,3,2,1,0,0,0,28,28,0,47,36,11,63,55,8,3,5,0,0
"18306","PIT","NYR",2009020942,14672,20092010,0,63.7,5,4,1,0,0,0,55,16,39,71,25,46,90,39,51,7,7,0,0
"18307","PIT","DAL",2009020955,14674,20092010,1,60,6,3,3,0,0,0,34,30,4,49,41,8,69,55,14,5,6,0,0
"18308","PIT","BOS",2009020965,14675,20092010,1,60,2,1,1,0,0,0,33,22,11,38,33,5,50,43,7,2,5,0,0
"18309","PIT","CAR",2009020993,14679,20092010,0,60.3833333333333,3,4,-1,0,0,0,40,21,19,59,26,33,75,30,45,2,4,0,0
"18310","PIT","N.J",2009021000,14680,20092010,0,60,1,3,-2,0,0,0,35,32,3,43,44,-1,59,54,5,8,7,0,0
"18311","PIT","T.B",2009021020,14682,20092010,0,60,2,1,1,0,0,0,39,22,17,53,28,25,69,35,34,7,5,0,0
"18312","PIT","N.J",2009021039,14685,20092010,0,60,2,5,-3,0,0,0,26,19,7,38,25,13,53,31,22,2,2,0,0
"18313","PIT","BOS",2009021042,14686,20092010,0,60,3,0,3,0,0,0,31,17,14,39,27,12,52,43,9,4,4,0,0
"18314","PIT","CAR",2009021057,14688,20092010,1,64.9833333333333,2,3,-1,0,0,0,25,29,-4,43,37,6,56,52,4,3,5,0,0
"18315","PIT","DET",2009021077,14690,20092010,0,60,1,3,-2,0,0,0,27,33,-6,36,47,-11,43,63,-20,5,7,0,0
"18316","PIT","WSH",2009021091,14692,20092010,0,65,3,3,0,0,0,0,42,32,10,52,47,5,70,65,5,5,1,0,0
"18317","PIT","PHI",2009021111,14695,20092010,1,60,4,1,3,0,0,0,31,27,4,44,41,3,59,46,13,6,5,0,0
"18318","PIT","TOR",2009021123,14696,20092010,1,65,4,4,0,0,0,0,45,29,16,55,39,16,63,55,8,3,5,0,0
"18319","PIT","T.B",2009021144,14699,20092010,1,60,0,2,-2,0,0,0,27,17,10,43,27,16,64,33,31,5,6,0,0
"18320","PIT","ATL",2009021164,14702,20092010,1,62.8333333333333,4,3,1,0,0,0,35,24,11,55,32,23,72,42,30,5,5,0,0
"18321","PIT","WSH",2009021186,14705,20092010,1,60,3,6,-3,0,0,0,29,28,1,44,35,9,62,43,19,4,1,0,0
"18322","PIT","NYI",2009021200,14707,20092010,1,60,7,3,4,0,0,0,35,35,0,48,46,2,57,66,-9,7,7,0,0
"18323","PIT","ATL",2009021217,14709,20092010,0,60,0,1,-1,0,0,0,33,22,11,44,33,11,59,43,16,5,7,0,0
"18324","PIT","NYI",2009021228,14710,20092010,0,64.4166666666667,6,5,1,0,0,0,37,38,-1,46,48,-2,64,62,2,8,11,0,0
"18325","PIT","OTT",2009030141,14713,20092010,1,60,4,5,-1,0,0,0,21,26,-5,35,33,2,53,44,9,6,4,0,0
"18326","PIT","OTT",2009030142,14715,20092010,1,60,2,1,1,0,0,0,31,20,11,53,24,29,66,39,27,3,3,0,0
"18327","PIT","OTT",2009030143,14717,20092010,0,60,4,2,2,0,0,0,24,22,2,32,34,-2,49,52,-3,7,6,0,0
"18328","PIT","OTT",2009030144,14719,20092010,0,60,7,4,3,0,0,0,42,30,12,50,45,5,64,57,7,12,8,0,0
"18329","PIT","OTT",2009030145,14721,20092010,1,80,3,3,0,0,0,0,48,34,14,61,53,8,93,64,29,9,8,0,0
"18330","PIT","OTT",2009030146,14723,20092010,0,69.9333333333333,4,3,1,0,0,0,43,31,12,55,39,16,76,49,27,2,2,0,0
"18331","PIT","MTL",2009030211,14729,20092010,1,60,6,3,3,0,0,0,24,31,-7,36,39,-3,51,61,-10,7,7,0,0
"18332","PIT","MTL",2009030212,14731,20092010,1,60,1,3,-2,0,0,0,39,21,18,52,27,25,67,34,33,3,2,0,0
"18333","PIT","MTL",2009030213,14733,20092010,0,60,2,0,2,0,0,0,25,18,7,36,31,5,52,49,3,6,4,0,0
"18334","PIT","MTL",2009030214,14735,20092010,0,60,2,3,-1,0,0,0,35,25,10,50,32,18,73,42,31,4,2,0,0
"18335","PIT","MTL",2009030215,14737,20092010,1,60,2,1,1,0,0,0,25,33,-8,51,40,11,73,58,15,3,3,0,0
"18336","PIT","MTL",2009030216,14739,20092010,0,60,3,4,-1,0,0,0,37,25,12,53,37,16,74,57,17,6,4,0,0
"18337","PIT","MTL",2009030217,14741,20092010,1,60,2,5,-3,0,0,0,39,20,19,56,28,28,82,31,51,7,5,0,0
"18338","PIT","PHI",2010020002,14889,20102011,1,60,2,3,-1,3.79241424504858,3.8312359048947,-0.0388216598461213,31,27,4,49,37,12,65,51,14,6,5,0,0
"18339","PIT","MTL",2010020016,14891,20102011,1,60,2,3,-1,6.81316375341521,5.02284803253133,1.79031572088388,38,27,11,50,38,12,61,45,16,6,4,0,0
"18340","PIT","N.J",2010020027,14893,20102011,0,60,3,1,2,5.1037925049628,2.67344368488148,2.43034882008132,31,31,0,42,36,6,48,40,8,6,2,0,0
"18341","PIT","TOR",2010020039,14895,20102011,1,60,3,4,-1,5.40015165822115,1.67317789222579,3.72697376599535,25,14,11,40,22,18,60,32,28,3,3,0,0
"18342","PIT","NYI",2010020050,14897,20102011,1,61.85,3,2,1,4.7688948766845,3.79135311219989,0.977541764484613,29,24,5,46,36,10,65,50,15,8,4,0,0
"18343","PIT","PHI",2010020058,14898,20102011,0,60,5,1,4,4.16914821116349,4.52998392073101,-0.360835709567522,32,30,2,42,49,-7,59,64,-5,9,6,0,0
"18344","PIT","OTT",2010020071,14900,20102011,1,60,5,2,3,4.80319673568192,3.76725597388577,1.03594076179616,29,34,-5,44,41,3,55,51,4,7,5,0,0
"18345","PIT","NSH",2010020089,14903,20102011,0,63.8166666666667,4,3,1,7.51456891628914,2.12769952835515,5.38686938793398,38,24,14,49,26,23,62,36,26,6,5,0,0
"18346","PIT","STL",2010020105,14905,20102011,0,60.8333333333333,0,1,-1,2.7899634864653,4.77902318140556,-1.98905969494027,31,24,7,44,38,6,51,48,3,4,3,0,0
"18347","PIT","T.B",2010020126,14909,20102011,0,60,3,5,-2,5.32514579382723,5.59541586072737,-0.270270066900139,31,31,0,39,45,-6,59,55,4,6,9,0,0
"18348","PIT","PHI",2010020139,14911,20102011,1,60,2,3,-1,3.95846775732934,2.83818699678341,1.12028076054594,28,24,4,40,29,11,56,44,12,7,5,0,0
"18349","PIT","CAR",2010020147,14912,20102011,0,60,3,0,3,3.69868850766215,2.99430186366953,0.704386643992621,31,33,-2,44,49,-5,61,67,-6,3,8,0,0
"18350","PIT","DAL",2010020169,14916,20102011,0,60,2,5,-3,5.6646065621147,4.68034154643829,0.984265015676413,23,29,-6,36,41,-5,63,56,7,6,8,0,0
"18351","PIT","ANA",2010020186,14918,20102011,0,60,2,3,-1,4.67782922743629,2.04152068579079,2.6363085416455,32,19,13,44,34,10,60,46,14,4,2,0,0
"18352","PIT","ARI",2010020196,14919,20102011,0,65,3,3,0,4.6260573786858,4.82467271885093,-0.198615340165126,36,28,8,51,48,3,67,62,5,5,4,0,0
"18353","PIT","BOS",2010020212,14923,20102011,1,60,4,7,-3,6.38600282176594,4.96211832710916,1.42388449465679,46,33,13,56,39,17,74,54,20,2,3,0,0
"18354","PIT","T.B",2010020228,14925,20102011,1,60,5,1,4,3.7003716876352,3.16653554560617,0.533836142029031,20,16,4,31,25,6,45,38,7,5,7,0,0
"18355","PIT","ATL",2010020238,14926,20102011,0,60,4,2,2,3.15327052093524,4.44095069215109,-1.28768017121585,28,33,-5,36,43,-7,49,55,-6,6,6,0,0
"18356","PIT","NYR",2010020251,14928,20102011,1,63.6333333333333,2,3,-1,4.67996741920979,5.53897722246457,-0.859009803254785,39,25,14,58,33,25,78,47,31,8,3,0,0
"18357","PIT","VAN",2010020259,14930,20102011,1,60,3,1,2,2.99255110735703,4.55519075976981,-1.56263965241278,29,30,-1,39,45,-6,57,66,-9,2,5,0,0
"18358","PIT","CAR",2010020274,14932,20102011,1,65,4,4,0,5.23795336471812,4.42368977423757,0.81426359048055,36,34,2,49,53,-4,66,69,-3,2,2,0,0
"18359","PIT","FLA",2010020305,14935,20102011,0,60,3,2,1,2.1353044580278,3.73639664027723,-1.60109218224943,26,29,-3,32,42,-10,41,61,-20,3,5,0,0
"18360","PIT","BUF",2010020307,14937,20102011,0,60,1,0,1,4.82092769973679,4.71523859781061,0.105689101926174,29,30,-1,38,43,-5,49,60,-11,6,5,0,0
"18361","PIT","OTT",2010020324,14939,20102011,1,60,2,1,1,5.09093495966852,4.48787697358057,0.603057986087954,40,44,-4,53,53,0,69,68,1,5,4,0,0
"18362","PIT","CGY",2010020335,14940,20102011,1,60,4,1,3,5.63217784295921,4.34038462206081,1.2917932208984,43,31,12,56,47,9,73,63,10,5,5,0,0
"18363","PIT","NYR",2010020348,14942,20102011,0,60,3,1,2,2.16654320904274,3.28578178863972,-1.11923857959698,27,26,1,36,41,-5,49,54,-5,2,4,0,0
"18364","PIT","ATL",2010020369,14945,20102011,1,60,3,2,1,4.63343459021416,3.29785556427669,1.33557902593748,28,22,6,41,32,9,48,49,-1,2,2,0,0
"18365","PIT","CBJ",2010020384,14947,20102011,0,60,7,2,5,4.5275708159696,1.89931618027185,2.62825463569774,35,23,12,45,28,17,55,36,19,5,6,0,0
"18366","PIT","N.J",2010020396,14949,20102011,1,60,2,1,1,6.35874563676771,2.59092229907401,3.7678233376937,34,28,6,44,35,9,62,42,20,7,5,0,0
"18367","PIT","TOR",2010020407,14951,20102011,1,60,5,2,3,3.86687663342332,3.34038847184274,0.526488161580573,26,25,1,41,34,7,57,52,5,6,9,0,0
"18368","PIT","BUF",2010020426,14954,20102011,0,60,5,2,3,3.21619328181259,5.5210562428507,-2.30486296103811,24,36,-12,31,44,-13,42,54,-12,7,8,0,0
"18369","PIT","PHI",2010020447,14957,20102011,0,60,2,3,-1,5.47676779968816,4.74457810758031,0.732189692107847,23,37,-14,40,49,-9,52,54,-2,5,7,0,0
"18370","PIT","NYR",2010020451,14958,20102011,1,60,1,4,-3,6.36530631311325,3.91854182275026,2.44676449036299,28,22,6,43,31,12,65,40,25,3,3,0,0
"18371","PIT","ARI",2010020491,14963,20102011,1,60,6,1,5,4.65563383872212,4.7460206632968,-0.0903868245746793,38,27,11,50,45,5,65,58,7,7,10,0,0
"18372","PIT","FLA",2010020503,14965,20102011,1,60,5,2,3,6.52808111795457,7.7040978759178,-1.17601675796323,34,37,-3,45,51,-6,56,63,-7,4,3,0,0
"18373","PIT","WSH",2010020510,14966,20102011,0,65,2,2,0,5.87792221253039,4.72447041352279,1.1534517990076,27,34,-7,35,46,-11,56,69,-13,7,7,0,0
"18374","PIT","OTT",2010020519,14969,20102011,0,60,1,3,-2,0,0,0,45,24,21,56,31,25,71,39,32,7,8,0,0
"18375","PIT","ATL",2010020537,14971,20102011,1,60,6,3,3,3.86489509324588,4.58794581099254,-0.723050717746666,36,34,2,46,49,-3,53,58,-5,4,9,0,0
"18376","PIT","NYI",2010020546,14972,20102011,0,65,1,1,0,10.5001798940948,3.02573297148971,7.47444692260504,38,26,12,56,36,20,84,42,42,5,6,0,0
"18377","PIT","WSH",2010020566,14975,20102011,1,60,1,3,-2,3.3394505442968,4.39374583136444,-1.05429528706764,33,32,1,50,41,9,66,50,16,4,2,0,0
"18378","PIT","T.B",2010020592,14979,20102011,1,60,8,1,7,4.48795450653415,5.78291706706477,-1.29496256053062,41,32,9,51,41,10,72,56,16,7,6,0,0
"18379","PIT","MTL",2010020600,14980,20102011,0,65,1,1,0,4.17272795699796,3.64565559991732,0.527072357080641,32,23,9,42,36,6,62,57,5,2,5,0,0
"18380","PIT","MIN",2010020616,14982,20102011,1,60,0,4,-4,4.10779563754585,6.9177503166619,-2.80995467911605,26,37,-11,33,47,-14,51,61,-10,4,5,0,0
"18381","PIT","BOS",2010020628,14984,20102011,1,60,2,4,-2,2.43484209245435,5.73787857729557,-3.30303648484122,25,32,-7,38,42,-4,54,59,-5,7,6,0,0
"18382","PIT","MTL",2010020642,14986,20102011,0,60,5,2,3,4.39252552484959,3.63784867060576,0.754676854243826,36,22,14,44,31,13,61,48,13,7,4,0,0
"18383","PIT","BOS",2010020660,14989,20102011,0,60,3,2,1,4.15693785893882,5.9129148912325,-1.75597703229369,36,46,-10,43,58,-15,50,74,-24,1,3,0,0
"18384","PIT","DET",2010020685,14992,20102011,1,60,4,1,3,4.54301203862997,2.58180212332809,1.96120991530188,29,37,-8,41,52,-11,48,69,-21,3,5,0,0
"18385","PIT","N.J",2010020698,14994,20102011,0,60,0,2,-2,5.49199477529532,2.1653931948822,3.32660158041313,23,20,3,33,32,1,41,34,7,1,4,0,0
"18386","PIT","CAR",2010020717,14996,20102011,1,60,3,2,1,4.45491998828976,3.00735187446439,1.44756811382537,31,26,5,44,34,10,55,52,3,6,7,0,0
"18387","PIT","NYI",2010020736,14999,20102011,1,60,1,0,1,1.79559473304471,3.35876626399113,-1.56317153094642,31,29,2,41,34,7,51,50,1,3,3,0,0
"18388","PIT","NYR",2010020753,15006,20102011,0,65,3,3,0,3.75150345630804,4.17445404392492,-0.422950587616889,26,29,-3,29,37,-8,39,54,-15,3,4,0,0
"18389","PIT","NYI",2010020765,15007,20102011,1,60,3,0,3,3.34822642545657,4.2664712105963,-0.918244785139731,23,20,3,36,32,4,51,57,-6,9,8,0,0
"18390","PIT","BUF",2010020777,15009,20102011,1,60,3,2,1,4.69010851767962,4.0959566805476,0.594151837132017,39,29,10,52,33,19,61,45,16,7,3,0,0
"18391","PIT","WSH",2010020793,15011,20102011,0,60,0,3,-3,5.7922403403245,3.85006093662993,1.94217940369456,22,24,-2,33,33,0,51,48,3,2,4,0,0
"18392","PIT","CBJ",2010020804,15013,20102011,1,60,1,4,-3,3.68381481497833,5.16520031169057,-1.48138549671224,33,25,8,38,36,2,48,47,1,3,1,0,0
"18393","PIT","L.A",2010020818,15015,20102011,1,64.6833333333333,2,1,1,4.32632718537934,6.34410218390099,-2.01777499852165,26,33,-7,30,45,-15,48,66,-18,2,3,0,0
"18394","PIT","NYI",2010020823,15016,20102011,0,60,3,9,-6,5.13188030154561,3.84265654527871,1.28922375626689,38,36,2,51,47,4,73,63,10,14,14,0,0
"18395","PIT","NYR",2010020838,15018,20102011,0,60,3,5,-2,4.47398292354774,5.10170057680443,-0.627717653256695,29,31,-2,37,46,-9,63,60,3,5,5,0,0
"18396","PIT","COL",2010020860,15021,20102011,0,64.1666666666667,3,2,1,7.52718149860811,3.99458499708689,3.53259650152122,36,31,5,54,42,12,72,56,16,5,2,0,0
"18397","PIT","CHI",2010020888,15025,20102011,0,65,2,2,0,5.67538761784509,4.60884410497276,1.06654351287233,26,31,-5,38,42,-4,61,54,7,3,3,0,0
"18398","PIT","WSH",2010020893,15026,20102011,1,60,0,1,-1,5.13233822268268,3.40766287519364,1.72467534748904,39,24,15,48,33,15,68,51,17,4,4,0,0
"18399","PIT","S.J",2010020904,15028,20102011,1,64.9333333333333,2,3,-1,5.3713710840093,4.79735311639047,0.574017967618829,26,38,-12,37,46,-9,58,68,-10,2,4,0,0
"18400","PIT","CAR",2010020916,15030,20102011,0,60,1,4,-3,5.11965220452603,4.21140500280308,0.908247201722954,34,21,13,47,32,15,63,41,22,3,4,0,0
"18401","PIT","TOR",2010020927,15031,20102011,0,65,5,5,0,4.45634589143447,5.8617765592935,-1.40543066785904,40,31,9,51,42,9,68,56,12,3,7,0,0
"18402","PIT","TOR",2010020952,15035,20102011,0,60.7,2,3,-1,4.1405903323141,3.14118736273667,0.999402969577423,29,20,9,45,39,6,71,51,20,3,5,0,0
"18403","PIT","N.J",2010020968,15037,20102011,0,64.5833333333333,1,2,-1,2.24398545239819,4.28812377544818,-2.04413832304999,26,30,-4,33,41,-8,54,48,6,2,1,0,0
"18404","PIT","BOS",2010020976,15038,20102011,0,61.8666666666667,3,2,1,5.58308482109328,4.47992677626064,1.10315804483264,39,31,8,48,37,11,65,51,14,2,1,0,0
"18405","PIT","BUF",2010020995,15041,20102011,1,60,3,1,2,4.64741673725075,4.4493390281641,0.198077709086647,31,30,1,41,42,-1,57,56,1,8,4,0,0
"18406","PIT","MTL",2010021023,15045,20102011,1,60,0,3,-3,4.6163444135309,1.58111332415592,3.03523108937497,26,20,6,48,28,20,63,35,28,4,3,0,0
"18407","PIT","EDM",2010021033,15046,20102011,1,60,5,1,4,5.63432737065159,2.14398521172126,3.49034215893033,33,29,4,45,35,10,56,43,13,6,4,0,0
"18408","PIT","OTT",2010021046,15048,20102011,0,60,5,1,4,5.34428303069581,3.59305742842116,1.75122560227464,41,22,19,54,32,22,79,41,38,5,4,0,0
"18409","PIT","NYR",2010021080,15053,20102011,1,60,2,5,-3,6.86201802474193,6.64294947790404,0.219068546837889,40,27,13,56,34,22,72,43,29,3,2,0,0
"18410","PIT","DET",2010021086,15054,20102011,0,65,4,4,0,6.07454554320893,5.37082530152179,0.703720241687137,25,41,-16,44,53,-9,56,64,-8,3,4,0,0
"18411","PIT","PHI",2010021105,15057,20102011,0,65,1,1,0,6.22817712319443,4.64309958276863,1.5850775404258,31,20,11,43,27,16,61,41,20,2,3,0,0
"18412","PIT","N.J",2010021111,15058,20102011,1,65,0,0,0,4.61671584418036,4.59280890569789,0.0239069384824688,26,21,5,44,32,12,61,47,14,2,4,0,0
"18413","PIT","FLA",2010021128,15060,20102011,1,65,1,1,0,4.89238067658152,7.86799922313185,-2.97561854655032,28,38,-10,43,49,-6,60,64,-4,3,2,0,0
"18414","PIT","PHI",2010021136,15062,20102011,1,60,2,5,-3,3.89519529190147,2.37290060655818,1.5222946853433,27,24,3,40,27,13,54,40,14,4,4,0,0
"18415","PIT","T.B",2010021154,15064,20102011,0,60,1,2,-1,4.84479267991702,5.22798653007146,-0.383193850154443,37,24,13,50,35,15,72,46,26,7,6,0,0
"18416","PIT","FLA",2010021172,15066,20102011,0,60,4,2,2,7.18678935808791,5.17916052218061,2.0076288359073,34,30,4,54,48,6,72,57,15,2,3,0,0
"18417","PIT","N.J",2010021186,15069,20102011,1,60,4,2,2,3.34114686141038,1.77470597578213,1.56644088562825,27,24,3,32,27,5,49,37,12,3,2,0,0
"18418","PIT","NYI",2010021205,15072,20102011,0,65,3,3,0,3.44382410626739,5.75885535124689,-2.31503124497951,38,38,0,47,47,0,55,60,-5,6,8,0,0
"18419","PIT","ATL",2010021227,15074,20102011,0,60,5,2,3,2.67983451220789,6.03472059725281,-3.35488608504492,20,39,-19,28,56,-28,41,71,-30,3,5,0,0
"18420","PIT","T.B",2010030141,15077,20102011,1,60,3,0,3,6.80355417951193,3.16478961036773,3.6387645691442,40,32,8,55,45,10,77,58,19,7,3,0,0
"18421","PIT","T.B",2010030142,15079,20102011,1,60,1,5,-4,3.65821050677914,3.85377672067125,-0.195566213892107,36,21,15,52,27,25,66,38,28,7,6,0,0
"18422","PIT","T.B",2010030143,15082,20102011,0,60,3,2,1,6.58415702385844,4.70232496796234,1.8818320558961,30,27,3,44,36,8,59,52,7,2,4,0,0
"18423","PIT","T.B",2010030144,15084,20102011,0,80,2,2,0,7.43238734595521,7.18754925753456,0.24483808842065,51,30,21,71,54,17,93,72,21,3,4,0,0
"18424","PIT","T.B",2010030145,15087,20102011,1,60,2,8,-6,5.85887152534633,2.88420481554931,2.97466670979702,33,25,8,45,33,12,67,40,27,7,7,0,0
"18425","PIT","T.B",2010030146,15089,20102011,0,60,2,4,-2,4.68221896199975,4.87224438701571,-0.190025425015961,29,21,8,38,32,6,64,45,19,7,4,0,0
"18426","PIT","T.B",2010030147,15091,20102011,1,60,0,1,-1,6.266766350127,5.40796543040778,0.858800919719215,36,23,13,57,34,23,79,45,34,6,3,0,0
"18427","PIT","VAN",2011020003,15253,20112012,0,65,3,3,0,2.277712992538,4.19364045433758,-1.91592746179958,28,36,-8,39,49,-10,49,66,-17,3,3,0,0
"18428","PIT","CGY",2011020019,15255,20112012,0,60,5,3,2,4.60073177330196,2.89572308208958,1.70500869121238,37,20,17,54,31,23,75,47,28,9,7,0,0
"18429","PIT","EDM",2011020024,15256,20112012,0,65,1,1,0,2.80861340346337,5.21991539655392,-2.41130199309055,34,35,-1,50,45,5,75,53,22,8,6,0,0
"18430","PIT","FLA",2011020032,15258,20112012,1,60,4,2,2,3.40832173041861,6.20854394961617,-2.80022221919756,29,34,-5,38,44,-6,50,59,-9,4,5,0,0
"18431","PIT","WSH",2011020039,15260,20112012,1,62.8,2,3,-1,6.46068640246813,2.78010388917755,3.68058251329057,41,19,22,56,29,27,79,40,39,5,1,0,0
"18432","PIT","BUF",2011020053,15262,20112012,1,60,2,3,-1,5.27184624117217,7.60921321991754,-2.33736697874537,31,28,3,50,39,11,60,52,8,2,1,0,0
"18433","PIT","WPG",2011020066,15264,20112012,0,60,1,2,-1,3.88959488240653,5.68718605254605,-1.79759117013953,29,34,-5,39,53,-14,50,61,-11,4,6,0,0
"18434","PIT","MIN",2011020074,15265,20112012,0,60,4,2,2,3.0967005032857,4.76430024106594,-1.66759973778024,25,26,-1,41,42,-1,55,52,3,1,5,0,0
"18435","PIT","MTL",2011020082,15267,20112012,1,60,3,1,2,6.66191573289689,1.61949022735896,5.04242550553793,32,28,4,45,37,8,58,48,10,5,4,0,0
"18436","PIT","N.J",2011020101,15269,20112012,1,60,4,1,3,6.85491411566181,2.08760459057521,4.7673095250866,29,24,5,50,27,23,71,41,30,5,2,0,0
"18437","PIT","NYI",2011020114,15272,20112012,0,60,3,0,3,5.14477266115318,3.80114643054549,1.3436262306077,29,33,-4,40,38,2,57,64,-7,2,3,0,0
"18438","PIT","NYI",2011020129,15274,20112012,1,65,2,2,0,2.77223840745864,1.94576034451666,0.826478062941987,32,19,13,48,30,18,71,44,27,7,3,0,0
"18439","PIT","TOR",2011020142,15276,20112012,0,60,3,4,-1,6.79398924711859,4.14650180751677,2.64748743960182,37,29,8,53,39,14,70,49,21,5,3,0,0
"18440","PIT","S.J",2011020177,15281,20112012,0,65,3,3,0,5.6671632565849,10.6342285191786,-4.96706526259368,36,37,-1,42,56,-14,58,73,-15,1,2,0,0
"18441","PIT","L.A",2011020193,15283,20112012,0,65,2,2,0,7.38178340997547,5.3211810361172,2.06060237385827,33,26,7,49,45,4,65,55,10,6,4,0,0
"18442","PIT","DAL",2011020224,15289,20112012,1,60,3,1,2,4.81172827417389,3.87701768702482,0.934710587149068,32,20,12,42,37,5,57,47,10,7,3,0,0
"18443","PIT","CAR",2011020232,15290,20112012,0,60,3,5,-2,7.55101485417254,4.12739296970979,3.42362188446275,40,26,14,56,34,22,76,44,32,7,6,0,0
"18444","PIT","COL",2011020250,15293,20112012,1,60,6,3,3,3.83152040070854,3.0321954859601,0.799324914748439,33,27,6,43,30,13,61,43,18,7,2,0,0
"18445","PIT","T.B",2011020263,15295,20112012,0,60,1,4,-3,4.15640779986479,1.3779753887793,2.77843241108549,34,18,16,50,22,28,75,31,44,8,7,0,0
"18446","PIT","FLA",2011020281,15297,20112012,0,60,2,3,-1,5.06937082996592,4.01039239136975,1.05897843859617,41,31,10,47,42,5,64,46,18,2,4,0,0
"18447","PIT","NYI",2011020291,15299,20112012,1,60,5,0,5,7.68059184287407,3.29904910676123,4.38154273611283,36,29,7,46,36,10,61,48,13,4,6,0,0
"18448","PIT","STL",2011020303,15301,20112012,1,64.1166666666667,2,3,-1,4.35745054786094,6.36411176266938,-2.00666121480845,33,43,-10,38,53,-15,48,77,-29,4,6,0,0
"18449","PIT","OTT",2011020319,15303,20112012,1,60,6,3,3,6.80095238645936,5.88470292978582,0.91624945667354,40,27,13,62,36,26,80,54,26,6,5,0,0
"18450","PIT","MTL",2011020331,15304,20112012,0,62.15,4,3,1,3.96592737875399,3.6224434701362,0.343483908617785,42,27,15,53,35,18,76,46,30,3,4,0,0
"18451","PIT","NYR",2011020346,15307,20112012,0,60,3,4,-1,3.01524854436229,6.04706533113495,-3.03181678677265,27,30,-3,40,43,-3,60,54,6,7,9,0,0
"18452","PIT","NYR",2011020594,15345,20112012,1,60,1,3,-2,3.35486351375039,1.94399369023768,1.41086982351271,38,21,17,52,28,24,77,37,40,4,2,0,0
"18453","PIT","NYR",2011020687,15358,20112012,0,60,4,1,3,5.73033878585294,2.95566237570182,2.77467641015112,36,31,5,44,40,4,59,57,2,3,3,0,0
"18454","PIT","NYR",2011020887,15391,20112012,1,60,2,0,2,4.36712319034118,4.60732442195877,-0.24020123161759,31,27,4,46,37,9,60,48,12,4,5,0,0
"18455","PIT","NYR",2011021054,15414,20112012,0,60,5,2,3,4.25246333284304,3.75860660756007,0.493856725282967,32,31,1,41,38,3,58,48,10,3,2,0,0
"18456","PIT","NYR",2011021204,15435,20112012,1,60,5,2,3,5.29370588567609,3.75692602871299,1.5367798569631,32,37,-5,38,39,-1,45,51,-6,2,5,0,0
"18457","PIT","PHI",2011030141,15441,20112012,1,62.3833333333333,3,4,-1,4.31932757484645,4.4163593975488,-0.0970318227023483,28,26,2,43,34,9,59,53,6,3,1,0,0
"18458","PIT","PHI",2011030142,15443,20112012,1,60,5,8,-3,8.34916266426444,5.40276358520615,2.9463990790583,28,31,-3,46,39,7,58,44,14,5,3,0,0
"18459","PIT","PHI",2011030143,15445,20112012,0,60,4,8,-4,8.1652387677459,6.62471499260255,1.54052377514336,35,34,1,52,46,6,72,58,14,12,12,0,0
"18460","PIT","PHI",2011030144,15448,20112012,0,60,10,3,7,6.84080177109293,3.86144677236776,2.97935499872517,36,25,11,45,30,15,63,43,20,12,8,0,0
"18461","PIT","PHI",2011030145,15450,20112012,1,60,3,2,1,5.4260178369077,3.92117172388205,1.50484611302565,23,26,-3,31,40,-9,41,58,-17,3,5,0,0
"18462","PIT","PHI",2011030146,15452,20112012,0,60,1,5,-4,3.76758920955763,4.16161394300002,-0.394024733442393,31,23,8,48,33,15,88,47,41,5,3,0,0
"18463","PIT","NYR",2012020015,15725,20122013,0,60,6,3,3,5.73285520242644,4.54048952268204,1.1923656797444,39,34,5,48,48,0,64,64,0,6,5,0,0
"18464","PIT","NYR",2012020095,15736,20122013,0,60,3,0,3,4.10733379484736,2.83002127060627,1.2773125242411,29,28,1,41,36,5,54,45,9,7,5,0,0
"18465","PIT","NYR",2012020406,15780,20122013,1,60,3,0,3,4.34562019463556,5.98616250022314,-1.64054230558759,27,23,4,48,28,20,66,44,22,4,3,0,0
"18466","PIT","NYR",2012020538,15798,20122013,0,60,1,6,-5,6.41400919191074,5.51142600850289,0.902583183407842,27,39,-12,36,50,-14,45,63,-18,3,5,0,0
"18467","PIT","NYR",2012020554,15800,20122013,1,65,1,1,0,3.96522714802404,5.63198791937521,-1.66676077135116,27,35,-8,29,58,-29,44,78,-34,2,2,0,0
"18468","PIT","NYI",2012030111,15826,20122013,1,60,5,0,5,3.47624362467297,4.10534515702898,-0.629101532356003,26,26,0,36,40,-4,48,62,-14,3,4,0,0
"18469","PIT","NYI",2012030112,15828,20122013,1,60,3,4,-1,5.73218299314613,9.87618090687752,-4.14399791373139,33,42,-9,44,60,-16,57,79,-22,4,5,0,0
"18470","PIT","NYI",2012030113,15830,20122013,0,68.7333333333333,5,4,1,4.84736428575206,4.38035980606219,0.467004479689876,25,36,-11,40,46,-6,55,64,-9,6,4,0,0
"18471","PIT","NYI",2012030114,15832,20122013,0,60,4,6,-2,5.144448754259,5.56873919636564,-0.424290442106638,31,24,7,41,37,4,57,53,4,3,5,0,0
"18472","PIT","NYI",2012030115,15834,20122013,1,60,4,0,4,7.50142403441714,4.4136591181159,3.08776491630124,31,31,0,52,43,9,61,57,4,8,5,0,0
"18473","PIT","NYI",2012030116,15836,20122013,0,67.8166666666667,4,3,1,3.10024531866657,3.30075369294493,-0.200508374278367,21,38,-17,33,55,-22,56,73,-17,1,3,0,0
"18474","PIT","OTT",2012030211,15839,20122013,1,60,4,1,3,4.42744954422437,4.67552915350063,-0.24807960927626,30,36,-6,42,50,-8,48,68,-20,8,9,0,0
"18475","PIT","OTT",2012030212,15842,20122013,1,60,4,3,1,6.89331186289201,4.15480993730475,2.73850192558726,42,22,20,54,28,26,62,48,14,7,3,0,0
"18476","PIT","OTT",2012030213,15844,20122013,0,80,1,1,0,5.98139318125504,9.80500149071086,-3.82360830945582,45,42,3,57,62,-5,78,89,-11,6,3,0,0
"18477","PIT","OTT",2012030214,15847,20122013,0,60,7,3,4,4.2058576354757,6.41248729754443,-2.20662966206874,42,33,9,52,47,5,63,63,0,5,4,0,0
"18478","PIT","OTT",2012030215,15849,20122013,1,60,6,2,4,5.92850773967803,5.36171708640177,0.566790653276257,33,31,2,45,43,2,55,56,-1,6,7,0,0
"18479","PIT","BOS",2012030311,15857,20122013,1,60,0,3,-3,4.18981639103679,2.4334072779828,1.75640911305399,29,30,-1,41,39,2,52,49,3,6,4,0,0
"18480","PIT","BOS",2012030312,15859,20122013,1,60,1,6,-5,4.28815925665549,2.36830877902685,1.91985047762864,27,29,-2,42,37,5,58,46,12,3,2,0,0
"18481","PIT","BOS",2012030313,15861,20122013,0,80,1,1,0,6.1829252330226,3.91320623180536,2.26971900121724,46,34,12,63,46,17,81,68,13,8,8,0,0
"18482","PIT","BOS",2012030314,15863,20122013,0,60,0,1,-1,5.85869713831926,3.04121231275386,2.8174848255654,26,24,2,41,33,8,60,45,15,4,4,0,0
"18483","PIT","NYR",2013020226,16015,20132014,0,60,1,5,-4,4.17559433545102,5.95838701992761,-1.78279268447659,29,25,4,39,42,-3,48,52,-4,8,7,0,0
"18484","PIT","NYR",2013020522,16057,20132014,0,65,3,3,0,6.29987158809672,5.84562254861885,0.454249039477872,32,32,0,42,48,-6,53,68,-15,4,6,0,0
"18485","PIT","NYR",2013020623,16073,20132014,1,60,5,2,3,2.47103316080756,3.87103528738953,-1.40000212658197,28,35,-7,37,48,-11,45,63,-18,3,4,0,0
"18486","PIT","NYR",2013020868,16108,20132014,1,65,3,3,0,2.32574997912161,9.83162551791611,-7.5058755387945,29,41,-12,41,58,-17,55,68,-13,7,8,0,0
"18487","PIT","CBJ",2013030131,16176,20132014,1,60,4,3,1,4.40082705581153,5.27471920958487,-0.87389215377334,32,34,-2,42,45,-3,59,57,2,3,4,0,0
"18488","PIT","CBJ",2013030132,16179,20132014,1,80,3,3,0,5.29010291613163,6.70509453907655,-1.41499162294493,42,41,1,62,57,5,84,78,6,8,6,0,0
"18489","PIT","CBJ",2013030133,16181,20132014,0,60,4,3,1,8.17693082383994,1.99100214184728,6.18592868199266,41,20,21,53,29,24,73,42,31,6,4,0,0
"18490","PIT","CBJ",2013030134,16183,20132014,0,62.8166666666667,3,4,-1,3.25306243328806,5.08069737942607,-1.82763494613801,25,46,-21,36,56,-20,47,76,-29,5,6,0,0
"18491","PIT","CBJ",2013030135,16186,20132014,1,60,3,1,2,9.94252574388764,4.61351359274704,5.3290121511406,51,24,27,67,34,33,82,45,37,6,3,0,0
"18492","PIT","CBJ",2013030136,16188,20132014,0,60,4,3,1,2.54193834317266,3.52356108679669,-0.98162274362403,28,27,1,36,35,1,44,52,-8,4,5,0,0
"18493","PIT","NYR",2013030221,16192,20132014,1,63.1,2,3,-1,3.08201671595452,6.94490238284,-3.86288566688548,36,27,9,48,41,7,63,53,10,4,4,0,0
"18494","PIT","NYR",2013030222,16194,20132014,1,60,3,0,3,4.14321876305621,1.66320360911777,2.48001515393844,35,22,13,46,28,18,64,41,23,5,6,0,0
"18495","PIT","NYR",2013030223,16195,20132014,0,60,2,0,2,1.29037344440843,4.6912576938048,-3.40088424939637,15,35,-20,21,52,-31,38,69,-31,1,4,0,0
"18496","PIT","NYR",2013030224,16197,20132014,0,60,4,2,2,4.74896157404921,2.58069625259951,2.1682653214497,27,15,12,46,25,21,66,38,28,3,2,0,0
"18497","PIT","NYR",2013030225,16199,20132014,1,60,1,5,-4,3.70287084818119,6.08924168537487,-2.38637083719368,32,35,-3,46,49,-3,57,65,-8,7,6,0,0
"18498","PIT","NYR",2013030226,16201,20132014,0,60,1,3,-2,5.22991451430789,3.79331400422451,1.43660051008338,37,29,8,46,39,7,68,51,17,6,8,0,0
"18499","PIT","NYR",2013030227,16203,20132014,1,60,1,2,-1,6.14177626598394,3.26864430637215,2.87313195961178,36,20,16,49,32,17,65,38,27,2,3,0,0
"18500","PIT","NYR",2014020222,16385,20142015,0,60,0,5,-5,3.88919216143222,5.44120896144887,-1.55201680001664,33,35,-2,46,45,1,64,57,7,3,4,0,0
"18501","PIT","NYR",2014020255,16389,20142015,1,65,2,2,0,4.32531423173936,3.84583396944981,0.479480262289542,38,31,7,50,41,9,66,51,15,4,6,0,0
"18502","PIT","NYR",2014020406,16412,20142015,0,63.75,3,4,-1,8.97581432283914,3.08565869968152,5.89015562315763,35,29,6,50,38,12,63,47,16,1,3,0,0
"18503","PIT","NYR",2014020672,16453,20142015,1,60,2,5,-3,6.48204326294217,2.84086748069505,3.64117578224712,34,31,3,46,36,10,60,52,8,3,6,0,0
"18504","PIT","NYR",2014030131,16541,20142015,0,60,1,2,-1,2.0047695490363,4.41431358884438,-2.40954403980808,25,38,-13,29,44,-15,51,55,-4,1,5,0,0
"18505","PIT","NYR",2014030132,16543,20142015,0,60,4,3,1,1.42223561247955,5.18627912691635,-3.7640435144368,22,26,-4,30,42,-12,37,62,-25,4,7,0,0
"18506","PIT","NYR",2014030133,16545,20142015,1,60,1,2,-1,5.62922641499426,4.83671865038923,0.792507764605034,24,26,-2,38,36,2,55,50,5,4,5,0,0
"18507","PIT","NYR",2014030134,16547,20142015,1,63.2333333333333,1,2,-1,5.04788962617221,4.78601673201941,0.261872894152794,23,24,-1,31,33,-2,50,50,0,3,3,0,0
"18508","PIT","NYR",2014030135,16549,20142015,0,70.8666666666667,1,2,-1,5.83180804608855,7.05158041662071,-1.21977237053216,38,36,2,55,52,3,74,65,9,3,3,0,0
"18509","PIT","ANA",2015020403,16775,20152016,0,60,1,2,-1,4.55510320301983,4.1134412989195,0.441661904100329,24,25,-1,45,35,10,59,57,2,3,2,0,0
"18510","PIT","COL",2015020418,16778,20152016,0,60,4,2,2,4.898335797584,3.55330978613347,1.34502601145053,33,26,7,49,35,14,62,52,10,2,5,0,0
"18511","PIT","L.A",2015020429,16780,20152016,1,65,2,2,0,6.41329263085772,5.53085862038847,0.882434010469244,42,40,2,56,55,1,70,68,2,4,3,0,0
"18512","PIT","WSH",2015020449,16783,20152016,1,60,1,4,-3,3.20312610166849,5.30902401404455,-2.10589791237607,45,34,11,55,39,16,79,52,27,2,4,0,0
"18513","PIT","BOS",2015020465,16785,20152016,0,60,0,3,-3,5.55335801347678,4.76035899015733,0.792999023319453,34,29,5,55,43,12,69,52,17,3,4,0,0
"18514","PIT","BOS",2015020477,16787,20152016,1,60,2,6,-4,6.28168972558342,6.27007943956414,0.0116102860192768,32,34,-2,48,42,6,62,60,2,6,5,0,0
"18515","PIT","CAR",2015020487,16788,20152016,1,60,1,2,-1,2.96756392144236,2.51218704125495,0.455376880187416,38,26,12,44,35,9,55,38,17,2,4,0,0
"18516","PIT","CBJ",2015020501,16790,20152016,1,60,5,2,3,5.82235257775574,4.61716467339643,1.20518790435931,35,24,11,49,29,20,61,41,20,4,3,0,0
"18517","PIT","MIN",2015020523,16795,20152016,0,60,3,1,2,5.17648879282115,2.47954513551667,2.69694365730447,32,26,6,47,37,10,61,47,14,3,4,0,0
"18518","PIT","WPG",2015020531,16796,20152016,0,60,0,1,-1,4.02458521435619,3.18074634373481,0.843838870621383,30,28,2,41,44,-3,59,51,8,2,3,0,0
"18519","PIT","TOR",2015020551,16799,20152016,1,65,2,2,0,6.57366414096776,4.06318696799387,2.51047717297389,41,36,5,51,44,7,69,59,10,8,5,0,0
"18520","PIT","DET",2015020557,16800,20152016,0,60,5,2,3,4.77647285816784,4.31064780271845,0.465825055449386,37,35,2,44,39,5,51,56,-5,6,6,0,0
"18521","PIT","NYI",2015020574,16802,20152016,1,60,5,2,3,4.05069445424306,4.07483758812305,-0.0241431338799885,43,40,3,54,52,2,62,69,-7,4,1,0,0
"18522","PIT","CHI",2015020592,16805,20152016,1,63.7833333333333,2,3,-1,7.66113371704705,6.00261573382886,1.65851798321819,36,30,6,53,44,9,68,54,14,1,2,0,0
"18523","PIT","CHI",2015020597,16806,20152016,0,60,1,3,-2,2.64288005761045,3.76766888753627,-1.12478882992582,18,37,-19,25,47,-22,37,60,-23,4,4,0,0
"18524","PIT","MTL",2015020616,16809,20152016,0,60,3,1,2,7.07322152704,5.19705370448355,1.87616782255645,32,34,-2,48,41,7,62,61,1,4,4,0,0
"18525","PIT","CAR",2015020635,16812,20152016,0,63.0333333333333,2,3,-1,5.18729684507707,2.83734857826494,2.34994826681213,25,21,4,42,28,14,55,45,10,3,4,0,0
"18526","PIT","T.B",2015020657,16815,20152016,0,62.1833333333333,4,5,-1,4.22799386963015,2.49661722924429,1.73137664038586,40,25,15,54,31,23,73,45,28,4,5,0,0
"18527","PIT","CAR",2015020670,16817,20152016,1,60,5,0,5,3.86229661109974,2.14903396027512,1.71326265082462,32,22,10,39,35,4,50,44,6,4,4,0,0
"18528","PIT","STL",2015020678,16818,20152016,0,60,2,5,-3,4.68138076796981,5.35470903285351,-0.6733282648837,38,25,13,52,30,22,70,36,34,4,3,0,0
"18529","PIT","PHI",2015020695,16821,20152016,1,60,4,3,1,0,0,0,45,32,13,55,42,13,75,56,19,4,6,0,0
"18530","PIT","VAN",2015020709,16823,20152016,1,60,5,4,1,4.2588952126971,2.74098953558291,1.51790567711419,30,32,-2,37,38,-1,52,44,8,5,1,0,0
"18531","PIT","WSH",2015020720,16861,20152016,0,60,2,3,-1,5.18973494485722,3.72418232542259,1.46555261943463,30,37,-7,40,44,-4,64,58,6,4,5,0,0
"18532","PIT","N.J",2015020732,16826,20152016,1,60,2,0,2,2.76792128567234,2.32255382389917,0.445367461773174,31,25,6,38,38,0,48,49,-1,2,4,0,0
"18533","PIT","OTT",2015020748,16833,20152016,1,60,6,5,1,5.04833023506217,3.25412838999182,1.79420184507035,44,23,21,58,28,30,69,39,30,6,3,0,0
"18534","PIT","T.B",2015020771,16836,20152016,0,60,3,6,-3,3.19591251795646,4.43796090531674,-1.24204838736028,30,29,1,43,37,6,55,49,6,3,2,0,0
"18535","PIT","FLA",2015020781,16837,20152016,0,61.45,3,2,1,5.69161754067724,5.58017280680575,0.111444733871497,35,44,-9,54,49,5,65,56,9,5,5,0,0
"18536","PIT","ANA",2015020791,16839,20152016,1,60,6,2,4,6.41504764948331,5.65680524503114,0.758242404452176,35,38,-3,45,49,-4,59,63,-4,1,2,0,0
"18537","PIT","NYR",2015020807,16841,20152016,1,60,0,3,-3,3.19448210217394,5.33340245753061,-2.13892035535667,34,22,12,48,33,15,73,41,32,2,1,0,0
"18538","PIT","CAR",2015020820,16843,20152016,0,65,1,1,0,3.24791103148164,6.24118786495819,-2.99327683347656,26,30,-4,39,57,-18,56,76,-20,1,3,0,0
"18539","PIT","FLA",2015020842,16846,20152016,0,65,1,1,0,5.92770414145707,1.68069575561094,4.24700838584613,32,28,4,43,35,8,57,49,8,2,3,0,0
"18540","PIT","DET",2015020859,16849,20152016,1,60,6,3,3,5.04941237150342,2.94557337948936,2.10383899201406,39,38,1,47,53,-6,57,64,-7,1,1,0,0
"18541","PIT","T.B",2015020874,16851,20152016,1,60,2,4,-2,4.66127430519368,4.65602036373457,0.00525394145910774,39,20,19,54,25,29,67,35,32,7,8,0,0
"18542","PIT","BUF",2015020883,16852,20152016,0,60,4,3,1,4.72126583875797,5.67778503522277,-0.956519196464797,31,27,4,39,38,1,60,50,10,4,3,0,0
"18543","PIT","BOS",2015020903,16855,20152016,0,60,1,5,-4,4.50993697874947,4.18046788539505,0.329469093354419,42,29,13,60,33,27,77,44,33,1,1,0,0
"18544","PIT","WPG",2015020922,16858,20152016,1,60,4,1,3,5.03114273492247,4.47229859595245,0.558844138970017,33,28,5,43,39,4,53,49,4,1,2,0,0
"18545","PIT","ARI",2015020939,16860,20152016,1,60,6,0,6,3.79618680223437,4.32488167101246,-0.528694868778097,33,30,3,40,34,6,57,54,3,5,3,0,0
"18546","PIT","NYR",2015020957,16863,20152016,1,60,4,1,3,3.83817219855564,3.43814205572222,0.400030142833417,26,28,-2,32,40,-8,44,52,-8,3,2,0,0
"18547","PIT","CGY",2015020970,16865,20152016,1,60,2,4,-2,3.29754844740455,3.33368253785375,-0.0361340904491954,31,30,1,41,37,4,65,45,20,2,2,0,0
"18548","PIT","N.J",2015020981,16866,20152016,0,60,6,1,5,2.58009500666564,2.10122784068517,0.478867165980468,30,18,12,34,28,6,36,35,1,6,5,0,0
"18549","PIT","NYI",2015020994,16868,20152016,0,60,1,2,-1,3.30879322427248,3.85323314093694,-0.544439916664459,35,27,8,46,40,6,68,53,15,4,5,0,0
"18550","PIT","CBJ",2015021013,16871,20152016,0,60,3,2,1,5.09757737291511,4.37987657648046,0.717700796434656,31,27,4,50,32,18,64,45,19,5,4,0,0
"18551","PIT","NYR",2015021030,16873,20152016,0,60,5,3,2,5.4362747403793,3.97327024557489,1.46300449480441,33,27,6,39,41,-2,57,57,0,4,5,0,0
"18552","PIT","NYI",2015021040,16875,20152016,1,65,1,1,0,5.01312368565406,3.6169238275902,1.39619985806386,34,26,8,47,36,11,71,57,14,4,4,0,0
"18553","PIT","CAR",2015021054,16877,20152016,1,60,4,2,2,4.68840119713488,4.16417681018356,0.524224386951317,48,33,15,55,38,17,69,45,24,5,7,0,0
"18554","PIT","PHI",2015021067,16879,20152016,0,60,4,1,3,7.65336223091522,3.30964580451837,4.34371642639685,35,17,18,52,28,24,71,45,26,3,3,0,0
"18555","PIT","WSH",2015021080,16880,20152016,1,60,6,2,4,4.19070199441887,3.06420273298863,1.12649926143024,31,18,13,41,25,16,51,40,11,8,6,0,0
"18556","PIT","N.J",2015021102,16884,20152016,1,60,0,3,-3,5.71626961654692,4.02633189657354,1.68993771997339,39,24,15,55,29,26,73,37,36,3,3,0,0
"18557","PIT","DET",2015021115,16886,20152016,0,60,7,2,5,4.6432890940705,3.55576833034473,1.08752076372576,41,23,18,54,33,21,64,38,26,7,4,0,0
"18558","PIT","NYR",2015021130,16887,20152016,0,64.5,3,2,1,5.30926102922149,5.01826411456568,0.290996914655807,32,27,5,53,42,11,79,66,13,2,2,0,0
"18559","PIT","BUF",2015021142,16889,20152016,1,65,4,4,0,6.1823811124998,2.88468584388823,3.29769526861157,46,30,16,59,34,25,81,45,36,4,4,0,0
"18560","PIT","NSH",2015021154,16891,20152016,1,60,5,2,3,4.58046238316547,1.73229096760042,2.84817141556505,41,24,17,46,31,15,56,51,5,5,5,0,0
"18561","PIT","NYI",2015021167,16893,20152016,0,60,5,0,5,4.91325674742257,4.11792439715646,0.795332350266108,33,24,9,37,38,-1,46,53,-7,7,9,0,0
"18562","PIT","PHI",2015021179,16894,20152016,1,60,6,2,4,5.71408711833647,3.18905751063721,2.52502960769925,39,30,9,50,40,10,74,59,15,2,2,0,0
"18563","PIT","OTT",2015021193,16896,20152016,0,60,5,3,2,3.45366572478088,4.35247906137079,-0.89881333658991,28,30,-2,35,40,-5,45,56,-11,2,4,0,0
"18564","PIT","WSH",2015021206,16898,20152016,0,64,4,3,1,6.43788884420152,5.28476594889172,1.1531228953098,35,30,5,46,40,6,56,52,4,4,5,0,0
"18565","PIT","PHI",2015021218,16900,20152016,0,60,1,3,-2,2.25202229700517,7.16472375870217,-4.912701461697,19,36,-17,24,50,-26,39,70,-31,3,4,0,0
"18566","PIT","NYR",2015030141,16904,20152016,1,60,5,2,3,7.06504608500599,5.88421377194106,1.18083231306492,31,37,-6,46,56,-10,56,78,-22,5,4,0,0
"18567","PIT","NYR",2015030142,16907,20152016,1,60,2,4,-2,3.80064760605455,3.04206700958841,0.758580596466146,31,28,3,41,33,8,59,50,9,7,5,0,0
"18568","PIT","NYR",2015030143,16910,20152016,0,60,3,1,2,4.0553224452399,3.57391305977944,0.481409385460459,31,17,14,39,27,12,58,42,16,5,5,0,0
"18569","PIT","NYR",2015030144,16912,20152016,0,60,5,0,5,2.65941857040161,4.365989676764,-1.70657110636239,32,31,1,44,56,-12,56,71,-15,6,5,0,0
"18570","PIT","NYR",2015030145,16914,20152016,1,60,6,3,3,2.75343884719769,3.93375172131346,-1.18031287411577,28,41,-13,36,50,-14,48,69,-21,3,4,0,0
"18571","PIT","WSH",2015030221,16919,20152016,0,69.55,3,4,-1,8.35585813898888,8.5102003091888,-0.154342170199925,45,35,10,61,49,12,77,76,1,3,5,0,0
"18572","PIT","WSH",2015030222,16921,20152016,0,60,2,1,1,4.78485050603922,1.72419934253163,3.06065116350759,35,24,11,57,30,27,79,54,25,6,3,0,0
"18573","PIT","WSH",2015030223,16923,20152016,1,60,3,2,1,2.67434143208419,5.83716253569582,-3.16282110361164,23,49,-26,30,66,-36,36,85,-49,3,4,0,0
"18574","PIT","WSH",2015030224,16925,20152016,1,62.5666666666667,3,2,1,6.34168619977231,6.99762091230969,-0.655934712537373,33,36,-3,47,55,-8,61,69,-8,5,4,0,0
"18575","PIT","WSH",2015030225,16928,20152016,0,60,1,3,-2,5.37022504733795,4.55237395671429,0.817851090623662,31,19,12,51,42,9,70,58,12,3,6,0,0
"18576","PIT","WSH",2015030226,16931,20152016,1,66.5333333333333,4,3,1,8.69657622705563,8.03939433063351,0.657181896422117,42,39,3,55,52,3,76,65,11,2,6,0,0
"18577","PIT","T.B",2015030311,16934,20152016,1,60,1,3,-2,7.61042097256723,3.5968352547934,4.01358571777382,35,20,15,50,31,19,70,41,29,3,3,0,0
"18578","PIT","T.B",2015030312,16937,20152016,1,60.6666666666667,3,2,1,5.40049709903542,4.63792985060718,0.76256724842824,41,21,20,52,31,21,69,44,25,2,1,0,0
"18579","PIT","T.B",2015030313,16939,20152016,0,60,4,2,2,3.91711379593471,2.72033966913477,1.19677412679994,48,28,20,65,38,27,78,50,28,5,3,0,0
"18580","PIT","T.B",2015030314,16941,20152016,0,60,3,4,-1,4.70891798290154,3.00379403739601,1.70512394550553,38,37,1,51,42,9,65,48,17,6,6,0,0
"18581","PIT","T.B",2015030315,16943,20152016,1,60.8833333333333,3,4,-1,4.14380598528078,2.57140130227764,1.57240468300314,34,25,9,46,34,12,54,56,-2,4,3,0,0
"18582","PIT","T.B",2015030316,16945,20152016,0,60,5,2,3,8.25922388094659,7.70856511702004,0.550658763926549,34,31,3,47,45,2,55,60,-5,3,1,0,0
"18583","PIT","T.B",2015030317,16947,20152016,1,60,2,1,1,4.49484753631987,2.07695781174698,2.41788972457289,39,17,22,49,25,24,64,42,22,6,3,0,0
"18584","PIT","S.J",2015030411,16951,20152016,1,60,3,2,1,5.04785379366513,4.2721698412206,0.775683952444524,41,26,15,52,37,15,67,58,9,4,3,0,0
"18585","PIT","S.J",2015030412,16953,20152016,1,62.5833333333333,2,1,1,3.77737500076182,3.79088787070941,-0.0135128699475899,30,22,8,42,35,7,59,49,10,2,1,0,0
"18586","PIT","S.J",2015030413,16956,20152016,0,72.3,2,3,-1,4.84794129027068,3.91713456916114,0.930806721109548,42,26,16,54,41,13,76,79,-3,1,2,0,0
"18587","PIT","S.J",2015030414,16958,20152016,0,60,3,1,2,3.44799257653358,2.08241876941611,1.36557380711747,20,24,-4,29,35,-6,49,55,-6,2,2,0,0
"18588","PIT","S.J",2015030415,16961,20152016,1,60,2,4,-2,7.2423164575157,3.58453872532118,3.65777773219452,46,22,24,59,26,33,76,36,40,4,3,0,0
"18589","PIT","S.J",2015030416,16964,20152016,0,60,3,1,2,3.71926134524983,4.15718003353686,-0.437918688287027,27,19,8,39,34,5,67,67,0,2,2,0,0
"18590","PIT","WSH",2016020007,17087,20162017,1,65,2,2,0,2.82705242116936,6.72430556229665,-3.89725314112729,30,41,-11,33,53,-20,48,68,-20,2,3,0,0
"18591","PIT","ANA",2016020021,17089,20162017,1,60,3,2,1,4.61189074785216,3.95490463105671,0.656986116795451,45,36,9,52,47,5,62,60,2,3,3,0,0
"18592","PIT","COL",2016020034,17091,20162017,1,60.3666666666667,3,4,-1,4.30684221484989,6.40452929675394,-2.09768708190404,31,31,0,44,39,5,57,57,0,6,7,0,0
"18593","PIT","MTL",2016020040,17092,20162017,0,60,0,4,-4,2.66222067519136,3.14430361370614,-0.482082938514782,36,32,4,51,42,9,60,52,8,7,7,0,0
"18594","PIT","S.J",2016020053,17094,20162017,1,60,3,2,1,2.33988170143328,4.04964893699316,-1.70976723555988,20,34,-14,34,47,-13,54,62,-8,5,3,0,0
"18595","PIT","NSH",2016020073,17096,20162017,0,60,1,5,-4,4.26543975185961,2.99036148811865,1.27507826374096,35,30,5,54,36,18,72,52,20,2,4,0,0
"18596","PIT","FLA",2016020086,17099,20162017,1,60,3,2,1,2.17506704804225,3.21362798509654,-1.03856093705429,22,22,0,25,33,-8,45,53,-8,2,4,0,0
"18597","PIT","NYI",2016020100,17101,20162017,1,60,4,2,2,8.79168687529472,3.68711231631079,5.10457455898393,35,37,-2,57,45,12,76,61,15,5,6,0,0
"18598","PIT","PHI",2016020117,17103,20162017,0,60,5,4,1,4.07739821114197,5.63128797996103,-1.55388976881906,27,42,-15,41,67,-26,53,92,-39,3,5,0,0
"18599","PIT","ANA",2016020145,17107,20162017,0,60,5,1,4,5.42641036148416,4.48962706770919,0.936783293774972,34,33,1,46,43,3,56,57,-1,5,4,0,0
"18600","PIT","L.A",2016020156,17108,20162017,0,62.6166666666667,2,3,-1,3.22947842779104,4.91128298530044,-1.6818045575094,23,27,-4,36,38,-2,46,50,-4,3,3,0,0
"18601","PIT","S.J",2016020173,17110,20162017,0,60,5,0,5,3.06997722163908,4.34916314971633,-1.27918592807725,25,32,-7,33,42,-9,47,64,-17,2,6,0,0
"18602","PIT","EDM",2016020186,17113,20162017,1,60,4,3,1,5.37931979484279,2.57294216152553,2.80637763331725,32,28,4,40,34,6,55,47,8,3,2,0,0
"18603","PIT","MIN",2016020197,17115,20162017,1,60,2,4,-2,4.05443801404908,8.29848027246771,-4.24404225841863,41,44,-3,57,52,5,73,75,-2,4,3,0,0
"18604","PIT","TOR",2016020217,17117,20162017,1,60,4,1,3,5.89062853233486,5.08729144373137,0.803337088603485,49,36,13,62,49,13,73,65,8,3,2,0,0
"18605","PIT","WSH",2016020243,17121,20162017,0,60,1,7,-6,4.25053865129303,5.96514243097794,-1.71460377968491,26,39,-13,35,50,-15,46,68,-22,6,9,0,0
"18606","PIT","NYI",2016020255,17123,20162017,0,61.4,3,2,1,6.34153854455508,1.84791758736303,4.49362095719205,35,22,13,50,31,19,74,47,27,5,2,0,0
"18607","PIT","BUF",2016020263,17124,20162017,0,65,1,1,0,7.14121798847094,3.46047745755641,3.68074053091453,47,33,14,61,39,22,76,52,24,4,6,0,0
"18608","PIT","NYR",2016020277,17126,20162017,1,60,2,5,-3,4.73357716660394,6.25858576278551,-1.52500859618158,31,36,-5,38,44,-6,54,50,4,4,3,0,0
"18609","PIT","NYR",2016020290,17128,20162017,0,60,6,1,5,5.22720898553962,3.32507979350225,1.90212919203736,38,17,21,52,29,23,71,43,28,2,4,0,0
"18610","PIT","MIN",2016020303,17130,20162017,0,60,2,6,-4,6.31787020188654,3.11130972631958,3.20656047556696,36,36,0,49,41,8,64,60,4,3,5,0,0
"18611","PIT","N.J",2016020317,17131,20162017,1,65,3,3,0,9.3040625015916,3.05348930780019,6.25057319379141,49,30,19,63,38,25,83,57,26,6,3,0,0
"18612","PIT","NYI",2016020342,17135,20162017,0,60,3,5,-2,0,0,0,34,30,4,48,46,2,64,64,0,4,5,0,0
"18613","PIT","DAL",2016020347,17136,20162017,1,60,6,2,4,7.14998776093125,4.97098572464893,2.17900203628233,40,35,5,46,46,0,63,62,1,5,3,0,0
"18614","PIT","DET",2016020365,17138,20162017,1,60,5,3,2,6.22028867660993,2.35370758273348,3.86658109387645,37,31,6,49,43,6,64,56,8,2,2,0,0
"18615","PIT","OTT",2016020379,17140,20162017,1,60,8,5,3,4.88217977492604,5.37438003832983,-0.492200263403788,46,34,12,55,45,10,72,62,10,6,5,0,0
"18616","PIT","FLA",2016020400,17143,20162017,0,60,5,1,4,5.44979553712619,3.28952145466064,2.16027408246555,30,29,1,43,39,4,53,56,-3,4,4,0,0
"18617","PIT","T.B",2016020415,17145,20162017,0,60,4,3,1,3.19831623830211,2.27589076274307,0.922425475559036,37,23,14,43,31,12,55,40,15,6,5,0,0
"18618","PIT","ARI",2016020429,17147,20162017,1,60,7,0,7,4.95273399194957,2.68553349848889,2.26720049346068,34,32,2,45,46,-1,56,59,-3,7,3,0,0
"18619","PIT","BOS",2016020442,17149,20162017,1,61.4,4,3,1,5.78459848475177,4.07937110018429,1.70522738456748,37,44,-7,50,50,0,62,69,-7,4,4,0,0
"18620","PIT","L.A",2016020454,17151,20162017,1,61,0,1,-1,3.89487943208951,4.00852146678517,-0.113642034695658,39,28,11,48,37,11,67,57,10,4,1,0,0
"18621","PIT","TOR",2016020462,17152,20162017,0,62,1,2,-1,4.26685242455052,5.30982319138616,-1.04297076683564,34,49,-15,43,62,-19,61,83,-22,3,4,0,0
"18622","PIT","NYR",2016020483,17155,20162017,1,60,7,2,5,5.93951652975193,3.6933175035237,2.24619902622823,47,28,19,62,34,28,71,46,25,4,3,0,0
"18623","PIT","CBJ",2016020497,17157,20162017,0,60,1,7,-6,3.5283350917307,5.67999655078611,-2.15166145905542,26,28,-2,35,39,-4,49,53,-4,5,5,0,0
"18624","PIT","N.J",2016020507,17158,20162017,1,60,4,1,3,4.68333462333934,2.95013809168063,1.73319653165871,39,24,15,55,31,24,73,43,30,2,2,0,0
"18625","PIT","N.J",2016020517,17162,20162017,0,60,5,2,3,2.38727188814573,4.94503865204751,-2.55776676390178,29,23,6,38,33,5,47,39,8,4,7,0,0
"18626","PIT","CAR",2016020528,17163,20162017,1,60,3,2,1,3.3848568313515,3.83976327165146,-0.454906440299965,26,46,-20,32,61,-29,43,90,-47,0,0,0,0
"18627","PIT","MTL",2016020552,17166,20162017,1,61.9,4,3,1,5.36070008337265,6.8438030881581,-1.48310300478545,41,40,1,51,46,5,68,58,10,5,2,0,0
"18628","PIT","T.B",2016020603,17174,20162017,1,60,6,2,4,4.05483511760488,5.51858171218191,-1.46374659457703,40,30,10,49,43,6,63,61,2,3,4,0,0
"18629","PIT","WSH",2016020622,17177,20162017,0,60,2,5,-3,3.22449420191263,5.48013690279913,-2.2556427008865,32,30,2,45,41,4,64,51,13,7,6,0,0
"18630","PIT","OTT",2016020625,17178,20162017,0,60,1,4,-3,3.67142401946217,3.66705544334462,0.00436857611754959,30,33,-3,41,44,-3,56,57,-1,3,6,0,0
"18631","PIT","DET",2016020644,17180,20162017,0,60,3,6,-3,3.17839049647658,5.26493765926429,-2.08654716278771,32,34,-2,42,42,0,53,57,-4,5,5,0,0
"18632","PIT","WSH",2016020661,17182,20162017,1,60.5666666666667,8,7,1,3.9740130031808,4.19035050036382,-0.216337497183019,37,28,9,51,36,15,67,52,15,2,5,0,0
"18633","PIT","MTL",2016020672,17184,20162017,0,60,4,1,3,3.38293802953558,4.8682141029858,-1.48527607345022,26,20,6,41,32,9,52,52,0,2,1,0,0
"18634","PIT","CAR",2016020687,17186,20162017,0,60,7,1,6,7.52632245128916,4.4536492177067,3.07267323358246,41,28,13,52,45,7,61,62,-1,3,3,0,0
"18635","PIT","BOS",2016020702,17188,20162017,1,60,5,1,4,5.09801069594687,6.04378729284508,-0.945776596898213,36,45,-9,41,60,-19,48,87,-39,2,5,0,0
"18636","PIT","STL",2016020717,17190,20162017,1,60,0,3,-3,3.02380408158933,3.02675987610519,-0.00295579451585581,34,28,6,40,34,6,58,49,9,6,2,0,0
"18637","PIT","BOS",2016020728,17192,20162017,0,60,3,4,-1,4.59940301320603,3.8129134583578,0.786489554848231,23,37,-14,30,52,-22,40,65,-25,8,8,0,0
"18638","PIT","NSH",2016020743,17197,20162017,1,60,4,2,2,6.22052216643351,6.87801568706345,-0.657493520629941,38,39,-1,45,52,-7,61,72,-11,4,3,0,0
"18639","PIT","CBJ",2016020766,17200,20162017,1,63.25,4,3,1,4.3275459202996,3.28637226100545,1.04117365929415,33,31,2,42,33,9,59,55,4,2,1,0,0
"18640","PIT","STL",2016020779,17201,20162017,0,60,4,1,3,0,0,0,31,23,8,43,36,7,52,53,-1,5,2,0,0
"18641","PIT","CGY",2016020792,17204,20162017,1,65,2,2,0,6.21737960263272,2.76209416612983,3.45528543650289,33,30,3,45,37,8,59,51,8,3,5,0,0
"18642","PIT","COL",2016020811,17206,20162017,0,60,4,1,3,4.07947521513051,2.69175141616415,1.38772379896636,30,28,2,41,47,-6,47,63,-16,4,4,0,0
"18643","PIT","ARI",2016020826,17208,20162017,0,64.6333333333333,3,4,-1,3.89630425717958,3.29077822889667,0.605526028282906,31,25,6,47,31,16,62,43,19,4,4,0,0
"18644","PIT","VAN",2016020837,17211,20162017,1,60,4,0,4,6.83229386655148,3.29627768765204,3.53601617889944,42,29,13,48,36,12,60,50,10,2,1,0,0
"18645","PIT","WPG",2016020850,17213,20162017,1,64.6333333333333,4,3,1,5.6911751268683,8.77465672249673,-3.08348159562843,39,47,-8,51,60,-9,65,80,-15,4,6,0,0
"18646","PIT","CBJ",2016020855,17214,20162017,0,61.0666666666667,1,2,-1,7.04258395088602,4.71952629166481,2.32305765922121,39,39,0,52,53,-1,67,73,-6,1,3,0,0
"18647","PIT","DET",2016020870,17216,20162017,1,60,2,5,-3,3.92975607845437,4.38496304949422,-0.455206971039843,26,24,2,37,36,1,46,46,0,6,6,0,0
"18648","PIT","CAR",2016020884,17218,20162017,0,60,3,1,2,3.20148172510826,3.89015510406419,-0.688673378955924,22,30,-8,30,47,-17,40,72,-32,4,5,0,0
"18649","PIT","PHI",2016020908,17222,20162017,1,60,4,2,2,3.50493840156986,4.28712558371831,-0.782187182148448,29,38,-9,35,43,-8,51,55,-4,6,5,0,0
"18650","PIT","DAL",2016020930,17225,20162017,0,60,2,3,-1,1.65491074498487,3.87524310003937,-2.2203323550545,20,32,-12,37,44,-7,60,57,3,1,1,0,0
"18651","PIT","CHI",2016020935,17226,20162017,0,60,1,4,-3,5.78982493596749,3.23358453768742,2.55624039828007,37,29,8,50,40,10,68,57,11,0,1,0,0
"18652","PIT","T.B",2016020946,17228,20162017,1,60,5,2,3,6.65875478832005,3.55841908727598,3.10033570104407,35,29,6,53,34,19,64,57,7,3,3,0,0
"18653","PIT","BUF",2016020964,17230,20162017,1,60,4,3,1,3.11557165211707,5.60622537786276,-2.49065372574569,45,49,-4,53,55,-2,65,61,4,6,6,0,0
"18654","PIT","WPG",2016020984,17233,20162017,0,60,7,4,3,0,0,0,32,35,-3,45,48,-3,57,62,-5,8,6,0,0
"18655","PIT","EDM",2016020999,17235,20162017,0,65,2,2,0,3.87919596640313,6.10483231143061,-2.22563634502747,31,42,-11,41,63,-22,56,78,-22,2,2,0,0
"18656","PIT","VAN",2016021009,17236,20162017,0,60,3,0,3,4.78827595789335,1.54143052269501,3.24684543519834,48,27,21,60,34,26,75,48,27,3,1,0,0
"18657","PIT","CGY",2016021020,17238,20162017,0,65,3,3,0,6.20325677739079,5.31608608012776,0.887170697263024,35,30,5,48,44,4,61,61,0,4,3,0,0
"18658","PIT","PHI",2016021033,17240,20162017,0,60,0,4,-4,2.5280506317421,4.11718582069823,-1.58913518895613,23,28,-5,35,37,-2,53,57,-4,2,4,0,0
"18659","PIT","N.J",2016021050,17242,20162017,1,60,6,4,2,5.39663956855657,4.43384509367201,0.962794474884561,43,36,7,54,42,12,68,57,11,7,6,0,0
"18660","PIT","FLA",2016021064,17244,20162017,1,60,4,0,4,4.88273039438332,2.73051490762737,2.15221548675595,28,21,7,34,28,6,44,47,-3,6,6,0,0
"18661","PIT","BUF",2016021076,17246,20162017,0,60,3,1,2,3.92969989044832,3.87527002502497,0.0544298654233479,35,30,5,43,43,0,54,55,-1,3,1,0,0
"18662","PIT","OTT",2016021093,17248,20162017,0,65,1,1,0,6.71388675144408,5.99514146714421,0.718745284299871,35,30,5,47,39,8,65,53,12,4,4,0,0
"18663","PIT","NYI",2016021101,17249,20162017,1,65,3,3,0,6.29501828126376,5.69543725787662,0.599581023387145,40,46,-6,52,54,-2,76,69,7,1,1,0,0
"18664","PIT","PHI",2016021117,17251,20162017,1,60,2,6,-4,5.55659555624754,5.1323197568366,0.424275799410946,27,33,-6,33,43,-10,51,56,-5,2,1,0,0
"18665","PIT","CHI",2016021137,17254,20162017,1,60,1,5,-4,2.23846283763123,3.98920067620929,-1.75073783857806,32,36,-4,38,41,-3,56,56,0,2,4,0,0
"18666","PIT","NYR",2016021150,17256,20162017,0,65,3,3,0,5.90157512545557,4.63046837547881,1.27110674997675,35,33,2,49,47,2,67,69,-2,3,2,0,0
"18667","PIT","CAR",2016021167,17258,20162017,1,60,3,2,1,3.65388877352234,5.03816367080435,-1.38427489728201,26,35,-9,38,49,-11,46,61,-15,2,2,0,0
"18668","PIT","CBJ",2016021181,17260,20162017,1,60,4,1,3,2.85729354352225,4.72666166414274,-1.86936812062049,27,39,-12,32,51,-19,43,70,-27,4,2,0,0
"18669","PIT","N.J",2016021195,17262,20162017,0,60,7,4,3,3.9957823510631,5.74618273432134,-1.75040038325824,28,38,-10,36,56,-20,41,69,-28,3,3,0,0
"18670","PIT","TOR",2016021211,17264,20162017,0,60,3,5,-2,4.70539280827506,5.89186012762366,-1.18646731934859,18,30,-12,35,51,-16,47,71,-24,2,3,0,0
"18671","PIT","NYR",2016021226,17265,20162017,0,60,2,3,-1,4.56516339682275,3.39331157389097,1.17185182293179,24,25,-1,35,38,-3,57,50,7,0,1,0,0
"18672","PIT","CBJ",2016030141,17268,20162017,1,60,3,1,2,4.79484002565732,3.94673830414831,0.848101721509011,29,32,-3,35,38,-3,47,60,-13,3,2,0,0
"18673","PIT","CBJ",2016030142,17270,20162017,1,60,4,1,3,6.43026995693799,4.15216711721539,2.2781028397226,32,40,-8,42,56,-14,55,79,-24,4,3,0,0
"18674","PIT","CBJ",2016030143,17272,20162017,0,73.1666666666667,5,4,1,8.37802754077711,6.89849470561603,1.47953283516108,47,37,10,65,47,18,94,67,27,3,2,0,0
"18675","PIT","CBJ",2016030144,17274,20162017,0,60,4,5,-1,4.9382494497404,5.23718866685074,-0.298939217110339,31,34,-3,43,52,-9,62,65,-3,3,3,0,0
"18676","PIT","CBJ",2016030145,17276,20162017,1,60,5,2,3,3.10721020424529,6.61277328709548,-3.50556308285019,32,51,-19,41,56,-15,51,72,-21,4,3,0,0
"18677","PIT","WSH",2016030221,17283,20162017,0,60,3,2,1,2.75942589017723,6.17270162618661,-3.41327573600938,21,35,-14,33,54,-21,41,83,-42,3,1,0,0
"18678","PIT","WSH",2016030222,17285,20162017,0,60,6,2,4,8.55754640212399,4.63201662217034,3.92552977995365,24,36,-12,35,55,-20,45,88,-43,3,5,0,0
"18679","PIT","WSH",2016030223,17287,20162017,1,63.2166666666667,2,3,-1,4.39283116441129,5.26149239731785,-0.868661232906566,30,33,-3,41,45,-4,55,63,-8,4,7,0,0
"18680","PIT","WSH",2016030224,17289,20162017,1,60,3,2,1,5.51468147229025,5.00095442647993,0.513727045810319,19,38,-19,28,48,-20,39,72,-33,7,5,0,0
"18681","PIT","WSH",2016030225,17292,20162017,0,60,2,4,-2,0,0,0,22,32,-10,35,46,-11,52,66,-14,2,3,0,0
"18682","PIT","WSH",2016030226,17294,20162017,1,60,2,5,-3,3.39620378613955,2.70431814156311,0.691885644576448,18,26,-8,26,38,-12,38,51,-13,4,5,0,0
"18683","PIT","WSH",2016030227,17296,20162017,0,60,2,0,2,5.45302126595925,6.56662144954752,-1.11360018358827,28,29,-1,39,42,-3,48,61,-13,2,2,0,0
"18684","PIT","OTT",2016030311,17299,20162017,1,64.9833333333333,1,2,-1,2.36869340918929,5.44454089608123,-3.07584748689194,28,35,-7,34,46,-12,56,60,-4,5,2,0,0
"18685","PIT","OTT",2016030312,17301,20162017,1,60,1,0,1,3.77684561477508,3.2964589100593,0.480386704715784,29,23,6,39,28,11,57,35,22,5,5,0,0
"18686","PIT","OTT",2016030313,17303,20162017,0,60,1,5,-4,0,0,0,26,29,-3,45,40,5,62,52,10,6,6,0,0
"18687","PIT","OTT",2016030314,17305,20162017,0,60,3,2,1,3.85649097562026,4.84550985009979,-0.989018874479526,35,26,9,41,39,2,50,52,-2,2,4,0,0
"18688","PIT","OTT",2016030315,17307,20162017,1,60,7,0,7,2.10195086500565,1.96850939227807,0.133441472727589,36,25,11,44,28,16,56,47,9,4,5,0,0
"18689","PIT","OTT",2016030316,17309,20162017,0,60,1,2,-1,5.80443498509703,4.10459998236516,1.69983500273187,46,30,16,58,38,20,75,46,29,5,5,0,0
"18690","PIT","OTT",2016030317,17311,20162017,1,80,2,2,0,4.97875549804303,2.66902054827551,2.30973494976752,41,27,14,54,38,16,70,57,13,1,2,0,0
"18691","PIT","NSH",2016030411,17315,20162017,1,60,5,3,2,2.4006868719589,5.15137227111074,-2.75068539915185,12,26,-14,14,37,-23,28,46,-18,3,3,0,0
"18692","PIT","NSH",2016030412,17317,20162017,1,60,4,1,3,3.99998427351602,4.88173758172867,-0.881753308212652,27,38,-11,33,51,-18,41,71,-30,7,5,0,0
"18693","PIT","NSH",2016030413,17320,20162017,0,60,1,5,-4,4.06955206147074,3.29081671277533,0.778735348695413,28,33,-5,39,40,-1,51,60,-9,7,7,0,0
"18694","PIT","NSH",2016030414,17322,20162017,0,60,1,4,-3,5.55922879602473,5.9081285594948,-0.348899763470065,24,26,-2,42,32,10,57,50,7,4,3,0,0
"18695","PIT","NSH",2016030415,17325,20162017,1,60,6,0,6,2.88767756780726,4.28751377508084,-1.39983620727358,24,24,0,30,34,-4,37,50,-13,9,6,0,0
"18696","PIT","NSH",2016030416,17328,20162017,0,60,2,0,2,3.48573313901058,4.57743495001341,-1.09170181100283,29,27,2,31,44,-13,41,56,-15,0,4,0,0
"18697","PIT","STL",2017020002,17443,20172018,1,61.25,4,5,-1,5.90554050657556,4.12175841696444,1.78378208961112,33,34,-1,53,46,7,72,56,16,5,4,0,0
"18698","PIT","CHI",2017020010,17444,20172018,0,60,1,10,-9,4.12292269482482,5.07984385447344,-0.956921159648619,29,44,-15,37,51,-14,50,75,-25,2,6,0,0
"18699","PIT","NSH",2017020021,17446,20172018,1,60,4,0,4,3.87981530151851,3.19943902098748,0.680376280531028,34,26,8,41,41,0,49,55,-6,8,8,0,0
"18700","PIT","WSH",2017020047,17450,20172018,0,60,3,2,1,4.05782996693986,2.85366872264422,1.20416124429565,36,22,14,41,37,4,57,54,3,6,4,0,0
"18701","PIT","T.B",2017020051,17451,20172018,0,60,4,5,-1,3.0479745939283,4.49723967013003,-1.44926507620173,40,34,6,55,47,8,65,63,2,5,5,0,0
"18702","PIT","FLA",2017020067,17453,20172018,1,60,4,3,1,5.85049699211027,3.60905293607539,2.24144405603488,33,46,-13,46,61,-15,63,67,-4,3,5,0,0
"18703","PIT","NYR",2017020082,17456,20172018,0,60.9666666666667,5,4,1,6.34511350833965,3.99105630544066,2.35405720289899,33,32,1,39,46,-7,50,63,-13,5,7,0,0
"18704","PIT","FLA",2017020107,17459,20172018,0,60,4,3,1,5.9643592618917,2.80655920412391,3.15780005776779,48,31,17,55,41,14,68,57,11,4,2,0,0
"18705","PIT","T.B",2017020114,17460,20172018,0,60,1,7,-6,4.32182062475476,3.05545429699487,1.2663663277599,29,32,-3,42,42,0,58,61,-3,5,6,0,0
"18706","PIT","EDM",2017020128,17463,20172018,1,60.7,2,1,1,4.84448475036243,6.68494345213634,-1.84045870177391,44,30,14,47,39,8,61,65,-4,3,2,0,0
"18707","PIT","WPG",2017020141,17465,20172018,1,61.1166666666667,2,1,1,3.37453145711743,3.35058003718086,0.0239514199365654,36,31,5,50,41,9,70,54,16,5,3,0,0
"18708","PIT","MIN",2017020164,17467,20172018,0,60,1,2,-1,4.41697669241694,3.20078144899162,1.21619524342532,30,29,1,41,37,4,59,44,15,3,4,0,0
"18709","PIT","WPG",2017020168,17468,20172018,0,60,1,7,-6,7.85972700880366,4.31652989228314,3.54319711652051,32,24,8,48,35,13,58,46,12,6,6,0,0
"18710","PIT","EDM",2017020182,17471,20172018,0,60,3,2,1,4.14526564876353,5.19434737975098,-1.04908173098745,30,37,-7,45,53,-8,60,70,-10,4,5,0,0
"18711","PIT","CGY",2017020195,17472,20172018,0,62.3166666666667,1,2,-1,4.62624415173866,4.3085615435848,0.317682608153859,44,34,10,55,51,4,62,71,-9,1,4,0,0
"18712","PIT","VAN",2017020210,17474,20172018,0,60,2,4,-2,6.88564372501681,1.60163441003301,5.2840093149838,39,21,18,53,34,19,60,42,18,4,2,0,0
"18713","PIT","ARI",2017020226,17477,20172018,1,60,3,1,2,4.1146389804635,2.0711701919392,2.0434687885243,37,25,12,49,31,18,56,53,3,6,1,0,0
"18714","PIT","WSH",2017020244,17480,20172018,0,60,1,4,-3,4.08722232146306,4.20098069839878,-0.113758376935721,28,31,-3,44,41,3,59,56,3,4,6,0,0
"18715","PIT","NSH",2017020258,17481,20172018,0,65,4,4,0,4.90772907740029,3.97903578550517,0.928693291895123,30,28,2,45,44,1,68,62,6,5,7,0,0
"18716","PIT","BUF",2017020267,17484,20172018,1,60.2666666666667,5,4,1,8.76013014162891,3.20904244597735,5.55108769565156,45,32,13,61,41,20,81,45,36,7,5,0,0
"18717","PIT","OTT",2017020281,17486,20172018,0,60,3,1,2,5.49928284646012,4.5124490999151,0.986833746545017,29,22,7,36,34,2,49,48,1,2,3,0,0
"18718","PIT","CHI",2017020300,17488,20172018,1,60,1,2,-1,7.02885141986646,5.35662468356895,1.6722267362975,36,38,-2,44,46,-2,59,67,-8,4,6,0,0
"18719","PIT","VAN",2017020324,17492,20172018,1,60,2,5,-3,6.70965062771947,6.49611949416568,0.213531133553792,45,37,8,56,45,11,70,56,14,5,3,0,0
"18720","PIT","BOS",2017020334,17494,20172018,0,60,3,4,-1,3.95377731816717,3.24964695629376,0.70413036187341,20,33,-13,33,43,-10,51,54,-3,1,2,0,0
"18721","PIT","T.B",2017020353,17495,20172018,1,60,5,2,3,7.0657842054595,4.7880786926637,2.27770551279579,34,35,-1,47,48,-1,55,68,-13,4,5,0,0
"18722","PIT","PHI",2017020363,17497,20172018,1,61.8,5,4,1,6.93662763056727,1.65079746451556,5.28583016605171,52,32,20,72,41,31,82,58,24,5,4,0,0
"18723","PIT","BUF",2017020388,17501,20172018,0,60,4,0,4,4.09831072063918,4.12741022474725,-0.0290995041080633,25,34,-9,37,43,-6,47,57,-10,2,5,0,0
"18724","PIT","BUF",2017020400,17502,20172018,1,60,5,1,4,7.0527771787747,3.83290436464245,3.21987281413226,29,33,-4,40,47,-7,54,63,-9,7,5,0,0
"18725","PIT","NYR",2017020416,17505,20172018,1,60,3,4,-1,7.44332183146616,5.43032193637927,2.01299989508689,44,29,15,59,33,26,76,50,26,3,2,0,0
"18726","PIT","NYI",2017020431,17507,20172018,1,61.4833333333333,4,3,1,3.73449624737259,3.35466767475009,0.3798285726225,32,26,6,45,34,11,58,56,2,2,4,0,0
"18727","PIT","TOR",2017020450,17509,20172018,1,60,3,4,-1,4.95697401135112,5.09147052660046,-0.134496515249339,36,25,11,47,34,13,70,44,26,4,1,0,0
"18728","PIT","COL",2017020462,17511,20172018,1,60,1,2,-1,6.11192960920659,4.73210479669828,1.37982481250831,40,28,12,55,40,15,69,49,20,3,4,0,0
"18729","PIT","VGK",2017020490,17514,20172018,0,60,1,2,-1,3.10316072776914,3.93717616648417,-0.834015438715031,25,26,-1,34,41,-7,56,57,-1,3,2,0,0
"18730","PIT","ARI",2017020504,17516,20172018,0,60,4,2,2,9.376606903621,3.13076359208208,6.24584331153892,33,17,16,59,24,35,74,37,37,5,3,0,0
"18731","PIT","COL",2017020514,17518,20172018,0,60,2,4,-2,4.96730179467704,7.06229955838353,-2.09499776370649,32,37,-5,40,46,-6,56,64,-8,3,4,0,0
"18732","PIT","CBJ",2017020532,17521,20172018,1,65,2,2,0,6.00639552889068,5.69520070319046,0.31119482570022,41,32,9,62,44,18,76,54,22,6,8,0,0
"18733","PIT","ANA",2017020549,17523,20172018,1,60,0,4,-4,3.70902999356063,3.34826862756745,0.360761365993181,29,23,6,43,32,11,56,42,14,3,3,0,0
"18734","PIT","CBJ",2017020562,17527,20172018,1,65,4,4,0,4.67964789098187,4.33789191102258,0.341755979959288,37,33,4,50,48,2,67,64,3,4,3,0,0
"18735","PIT","CAR",2017020580,17529,20172018,0,60,1,2,-1,3.90726626239484,4.59109038099268,-0.68382411859784,28,33,-5,37,48,-11,47,65,-18,2,2,0,0
"18736","PIT","DET",2017020595,17531,20172018,0,60,1,4,-3,5.28780663006182,4.69244839416933,0.59535823589249,38,23,15,49,34,15,61,43,18,2,1,0,0
"18737","PIT","PHI",2017020604,17533,20172018,0,60,5,1,4,3.90755912150325,5.59516911269748,-1.68760999119422,25,28,-3,36,40,-4,50,62,-12,2,4,0,0
"18738","PIT","CAR",2017020619,17535,20172018,1,60,0,4,-4,2.37070213323022,4.02631768688298,-1.65561555365275,21,33,-12,29,41,-12,51,49,2,2,1,0,0
"18739","PIT","NYI",2017020628,17536,20172018,0,60,4,0,4,4.35281968512572,5.63743054639644,-1.28461086127072,38,31,7,52,42,10,61,54,7,3,4,0,0
"18740","PIT","BOS",2017020650,17538,20172018,1,62.85,6,5,1,3.87211824320548,3.9128926503472,-0.0407744071417255,35,25,10,46,35,11,61,53,8,3,3,0,0
"18741","PIT","DET",2017020671,17544,20172018,1,60,4,1,3,4.16424048718244,2.3205269773091,1.84371350987334,36,30,6,52,41,11,68,55,13,5,7,0,0
"18742","PIT","NYR",2017020679,17545,20172018,1,60,5,2,3,5.2906639794528,3.4889077109347,1.8017562685181,47,28,19,54,34,20,65,41,24,3,1,0,0
"18743","PIT","ANA",2017020694,17548,20172018,0,60,3,5,-2,4.75454442942282,6.0240075968199,-1.26946316739708,33,33,0,46,44,2,63,53,10,7,5,0,0
"18744","PIT","L.A",2017020704,17549,20172018,0,60,3,1,2,4.28357635090785,5.51838249319042,-1.23480614228257,31,29,2,41,46,-5,51,60,-9,4,3,0,0
"18745","PIT","S.J",2017020717,17551,20172018,0,60,1,2,-1,6.72243619753135,6.14721440481907,0.575221792712284,32,36,-4,50,53,-3,78,70,8,4,4,0,0
"18746","PIT","CAR",2017020733,17554,20172018,1,60,3,1,2,4.06908825837309,3.79388662870362,0.275201629669463,33,35,-2,42,53,-11,55,71,-16,3,4,0,0
"18747","PIT","MIN",2017020748,17556,20172018,1,60,6,3,3,3.89024848767674,4.12712932447903,-0.236880836802285,39,26,13,49,35,14,59,48,11,2,5,0,0
"18748","PIT","S.J",2017020764,17561,20172018,1,60,5,2,3,6.03903996935733,6.20666992606014,-0.167629956702809,31,42,-11,42,49,-7,53,68,-15,4,6,0,0
"18749","PIT","WSH",2017020788,17564,20172018,1,60,7,4,3,5.87816012790518,5.41841186846432,0.459748259440858,39,33,6,53,40,13,64,54,10,5,4,0,0
"18750","PIT","N.J",2017020797,17565,20172018,0,60,1,3,-2,3.14314431099774,8.15560221052743,-5.01245789952969,16,38,-22,26,58,-32,41,75,-34,1,3,0,0
"18751","PIT","VGK",2017020813,17568,20172018,1,60,5,4,1,4.57993891570136,2.81899426994399,1.76094464575736,38,25,13,50,36,14,60,52,8,5,3,0,0
"18752","PIT","DAL",2017020841,17571,20172018,0,65,3,3,0,6.70399601363893,4.63464165586447,2.06935435777446,37,36,1,50,47,3,72,61,11,3,4,0,0
"18753","PIT","STL",2017020853,17573,20172018,0,60,4,1,3,5.30053617277537,2.2581816065358,3.04235456623957,23,34,-11,30,47,-17,38,57,-19,2,3,0,0
"18754","PIT","OTT",2017020868,17575,20172018,1,60,6,3,3,4.50682406779379,1.88982473877695,2.61699932901683,28,33,-5,39,42,-3,59,63,-4,1,2,0,0
"18755","PIT","L.A",2017020881,17577,20172018,1,60,3,1,2,7.15617088849551,5.81940032777308,1.33677056072243,39,35,4,49,47,2,68,59,9,4,3,0,0
"18756","PIT","TOR",2017020899,17579,20172018,1,60,5,3,2,5.34832455310971,4.22536494370434,1.12295960940537,39,32,7,47,42,5,60,55,5,1,2,0,0
"18757","PIT","CBJ",2017020908,17580,20172018,0,60,5,2,3,6.02373048055347,7.1078427509201,-1.08411227036663,23,37,-14,36,51,-15,42,62,-20,0,2,0,0
"18758","PIT","CAR",2017020942,17585,20172018,0,60,6,1,5,3.97243434902339,6.02512120780739,-2.052686858784,39,28,11,51,48,3,72,61,11,2,3,0,0
"18759","PIT","FLA",2017020951,17586,20172018,0,60,5,6,-1,4.57794183352962,1.94190623884788,2.63603559468174,37,30,7,44,36,8,63,47,16,1,3,0,0
"18760","PIT","N.J",2017020970,17589,20172018,1,60,2,3,-1,4.27399045743005,6.01798496745424,-1.74399451002419,38,38,0,48,48,0,68,61,7,3,2,0,0
"18761","PIT","BOS",2017020983,17591,20172018,0,60,4,8,-4,3.59665308290982,6.94492500214255,-3.34827191923273,26,38,-12,35,49,-14,40,74,-34,6,7,0,0
"18762","PIT","NYI",2017021004,17593,20172018,1,63.8,3,2,1,6.50385883639683,4.73159371426027,1.77226512213656,50,27,23,65,35,30,82,53,29,2,2,0,0
"18763","PIT","CGY",2017021016,17595,20172018,1,62.6,4,3,1,4.52613902009608,4.120600203707,0.405538816389083,32,38,-6,39,53,-14,54,69,-15,3,3,0,0
"18764","PIT","PHI",2017021030,17597,20172018,0,60,5,2,3,4.55758327158711,3.93268808838911,0.624895183197992,28,28,0,44,38,6,57,55,2,5,6,0,0
"18765","PIT","TOR",2017021055,17600,20172018,0,60,2,5,-3,5.98458343927632,3.11481195462509,2.86977148465123,40,26,14,52,31,21,69,43,26,4,3,0,0
"18766","PIT","DAL",2017021061,17601,20172018,1,60,3,1,2,4.66630029238877,2.55409638907086,2.11220390331791,30,18,12,37,23,14,51,38,13,5,4,0,0
"18767","PIT","NYR",2017021079,17604,20172018,0,62.8833333333333,3,4,-1,6.68514364515431,5.75712085658762,0.928022788566691,40,33,7,52,45,7,63,57,6,4,3,0,0
"18768","PIT","MTL",2017021086,17605,20172018,0,60,5,3,2,6.96348258347996,1.98702410096303,4.97645848251693,39,20,19,52,32,20,66,48,18,2,1,0,0
"18769","PIT","NYI",2017021121,17610,20172018,0,60,1,4,-3,5.69127781843641,6.50144733045454,-0.810169512018128,37,40,-3,51,50,1,64,64,0,2,6,0,0
"18770","PIT","MTL",2017021133,17611,20172018,1,60,5,3,2,5.14936339407996,3.19320352631621,1.95615986776374,39,30,9,51,37,14,66,55,11,4,4,0,0
"18771","PIT","N.J",2017021147,17613,20172018,1,60.45,3,4,-1,7.85468809099075,5.38917132855568,2.46551676243507,43,34,9,61,47,14,76,55,21,3,3,0,0
"18772","PIT","PHI",2017021163,17615,20172018,1,62.4166666666667,5,4,1,4.04655579233258,4.84170516434824,-0.795149372015658,32,45,-13,42,50,-8,52,59,-7,2,3,0,0
"18773","PIT","DET",2017021179,17617,20172018,0,60,2,5,-3,3.41726193844806,4.58283928599468,-1.16557734754662,24,26,-2,34,39,-5,59,48,11,2,2,0,0
"18774","PIT","N.J",2017021192,17619,20172018,0,60.3166666666667,4,3,1,4.85365144917884,6.60762733395677,-1.75397588477793,35,31,4,53,39,14,60,49,11,3,4,0,0
"18775","PIT","MTL",2017021211,17621,20172018,1,60,5,2,3,4.8789078786649,2.71311776664817,2.16579011201673,33,26,7,42,37,5,54,53,1,5,1,0,0
"18776","PIT","WSH",2017021221,17622,20172018,1,60,1,3,-2,4.39356544569572,5.69082147667476,-1.29725603097904,37,34,3,44,45,-1,59,57,2,7,8,0,0
"18777","PIT","CBJ",2017021245,17626,20172018,0,61.1,5,4,1,5.65722915259539,3.79700596781913,1.86022318477626,43,30,13,52,35,17,69,44,25,3,3,0,0
"18778","PIT","OTT",2017021253,17627,20172018,1,60,4,0,4,3.95709032691229,2.82249292087607,1.13459740603622,23,35,-12,35,42,-7,43,63,-20,5,4,0,0
"18779","PIT","PHI",2017030141,17632,20172018,1,60,7,0,7,2.21768936199398,1.66451573735702,0.553173624636955,33,24,9,39,35,4,52,59,-7,4,4,0,0
"18780","PIT","PHI",2017030142,17634,20172018,1,60,1,5,-4,5.4444731199612,3.11955560764613,2.32491751231506,35,20,15,48,26,22,59,30,29,6,5,0,0
"18781","PIT","PHI",2017030143,17636,20172018,0,60,5,1,4,6.04259543180478,4.42403676503712,1.61855866676766,26,27,-1,39,38,1,55,55,0,8,7,0,0
"18782","PIT","PHI",2017030144,17639,20172018,0,60,5,0,5,2.72335324325331,2.79630106859212,-0.0729478253388103,30,26,4,39,36,3,51,52,-1,4,3,0,0
"18783","PIT","PHI",2017030145,17641,20172018,1,60,2,4,-2,4.59276108264748,4.09243867213958,0.500322410507906,32,25,7,46,37,9,60,48,12,7,3,0,0
"18784","PIT","PHI",2017030146,17643,20172018,0,60,8,5,3,5.68069241155172,2.89127814640233,2.78941426514939,28,26,2,37,37,0,51,59,-8,3,5,0,0
"18785","PIT","WSH",2017030221,17647,20172018,0,60,3,2,1,3.90941237569496,5.03198217806889,-1.12256980237393,25,34,-9,34,50,-16,50,72,-22,2,1,0,0
"18786","PIT","WSH",2017030222,17650,20172018,0,60,1,4,-3,5.87017349014059,4.0928039057714,1.77736958436918,33,32,1,44,45,-1,75,69,6,5,5,0,0
"18787","PIT","WSH",2017030223,17652,20172018,1,60,3,4,-1,4.38007455982649,5.58117630803099,-1.2011017482045,22,22,0,36,36,0,48,48,0,6,6,0,0
"18788","PIT","WSH",2017030224,17654,20172018,1,60,3,1,2,4.40045845158193,2.48451993897001,1.91593851261192,24,21,3,39,35,4,52,48,4,4,3,0,0
"18789","PIT","WSH",2017030225,17656,20172018,0,60,3,6,-3,10.7137630819561,5.55938558698648,5.15437749496965,39,32,7,63,42,21,75,59,16,5,3,0,0
"18790","PIT","WSH",2017030226,17658,20172018,1,65.45,1,2,-1,5.96052600242742,5.8892412338646,0.0712847685628262,22,30,-8,38,41,-3,52,62,-10,1,1,0,0
"18791","PIT","WSH",2018020007,17808,20182019,1,61.3333333333333,7,6,1,3.85063649074711,4.26746386983785,-0.416827379090748,41,36,5,57,44,13,75,56,19,6,2,0,0
"18792","PIT","MTL",2018020022,17810,20182019,1,60,1,5,-4,3.36116193878115,3.94219554685696,-0.581033608075813,22,29,-7,34,35,-1,56,42,14,3,3,0,0
"18793","PIT","VGK",2018020050,17815,20182019,1,60,4,2,2,3.09604921345925,3.29472839835216,-0.19867918489291,22,37,-15,31,49,-18,41,76,-35,1,2,0,0
"18794","PIT","MTL",2018020062,17817,20182019,0,65,3,3,0,3.30780023612231,4.86912687709891,-1.5613266409766,28,40,-12,38,53,-15,48,78,-30,2,6,0,0
"18795","PIT","VAN",2018020081,17820,20182019,1,60.5666666666667,2,3,-1,2.91490135114873,5.6358633741329,-2.72096202298417,28,26,2,37,36,1,54,48,6,2,1,0,0
"18796","PIT","TOR",2018020090,17822,20182019,0,60,3,0,3,9.05345515980298,5.12795008695684,3.92550507284614,39,38,1,66,59,7,73,81,-8,2,1,0,0
"18797","PIT","EDM",2018020129,17827,20182019,0,62.2,6,5,1,3.6761152125094,4.88998739945414,-1.21387218694474,31,46,-15,48,61,-13,71,68,3,3,5,0,0
"18798","PIT","CGY",2018020141,17829,20182019,0,60,9,1,8,3.63996525959405,4.4430103246923,-0.803045065098246,36,39,-3,44,60,-16,57,83,-26,2,3,0,0
"18799","PIT","VAN",2018020158,17831,20182019,0,60,5,0,5,5.14277060230961,3.73511156594404,1.40765903636557,35,29,6,48,45,3,56,55,1,3,4,0,0
"18800","PIT","NYI",2018020168,17834,20182019,1,60,3,6,-3,5.10710533593829,4.2372155681951,0.869889767743189,38,25,13,52,30,22,72,40,32,3,4,0,0
"18801","PIT","NYI",2018020181,17836,20182019,0,65,2,2,0,4.80618489143671,4.43288224813296,0.373302643303759,31,26,5,42,39,3,53,51,2,5,3,0,0
"18802","PIT","TOR",2018020199,17838,20182019,1,60,0,5,-5,3.71070978562062,4.06479861649015,-0.354088830869525,31,33,-2,42,46,-4,54,59,-5,5,3,0,0
"18803","PIT","N.J",2018020212,17840,20182019,1,60,1,5,-4,4.50721611763942,5.06229226365622,-0.555076146016802,36,39,-3,46,50,-4,68,65,3,4,5,0,0
"18804","PIT","WSH",2018020224,17842,20182019,0,60,1,2,-1,5.98206330740823,2.67385716902209,3.30820613838614,42,22,20,57,29,28,78,46,32,3,5,0,0
"18805","PIT","ARI",2018020249,17845,20182019,1,60,4,0,4,3.35260405496228,5.63062896754127,-2.27802491257899,32,39,-7,38,51,-13,48,76,-28,3,4,0,0
"18806","PIT","N.J",2018020265,17848,20182019,0,60,2,4,-2,3.62305583784109,5.24831284694868,-1.62525700910758,31,35,-4,41,46,-5,55,54,1,4,3,0,0
"18807","PIT","T.B",2018020279,17850,20182019,1,60,3,4,-1,4.30452038497832,4.87923068957753,-0.574710304599202,31,26,5,39,33,6,53,46,7,6,9,0,0
"18808","PIT","OTT",2018020295,17852,20182019,0,60,4,6,-2,7.50860891670163,4.92476279891562,2.58384611778601,35,25,10,51,37,14,67,43,24,5,4,0,0
"18809","PIT","BUF",2018020310,17854,20182019,1,60.75,4,5,-1,4.41309945664761,6.29188085443489,-1.87878139778728,40,40,0,47,50,-3,54,65,-11,3,3,0,0
"18810","PIT","DAL",2018020321,17856,20182019,1,60,5,1,4,2.88413570215926,2.55026658628049,0.33386911587877,30,19,11,41,27,14,51,37,14,3,2,0,0
"18811","PIT","BOS",2018020340,17858,20182019,0,61.95,1,2,-1,5.53735860265442,5.21393833120237,0.323420271452051,37,37,0,51,46,5,67,60,7,2,0,0,0
"18812","PIT","CBJ",2018020353,17859,20182019,1,60,4,2,2,4.42812103679739,3.77406636874975,0.654054668047641,36,39,-3,50,50,0,64,63,1,1,1,0,0
"18813","PIT","WPG",2018020373,17862,20182019,0,60,4,3,1,5.28890605077027,2.24955396115183,3.03935208961843,30,27,3,45,42,3,51,54,-3,1,2,0,0
"18814","PIT","COL",2018020381,17863,20182019,0,60,3,6,-3,4.18791160568799,3.60854328268033,0.579368323007657,25,26,-1,36,30,6,53,39,14,4,1,0,0
"18815","PIT","PHI",2018020402,17866,20182019,1,60,2,4,-2,5.73183938384408,4.39459622372651,1.33724316011757,32,26,6,40,32,8,56,47,9,2,4,0,0
"18816","PIT","COL",2018020419,17869,20182019,1,60,6,3,3,3.56055619346444,5.64995186538727,-2.08939567192283,32,45,-13,39,62,-23,54,78,-24,4,4,0,0
"18817","PIT","NYI",2018020432,17871,20182019,1,60,6,2,4,5.07634248642717,3.82886144509259,1.24748104133457,28,24,4,31,32,-1,48,47,1,4,3,0,0
"18818","PIT","OTT",2018020447,17873,20182019,0,61.3333333333333,1,2,-1,4.71564200811554,4.29878904201225,0.416852966103287,36,29,7,58,36,22,85,43,42,3,6,0,0
"18819","PIT","NYI",2018020461,17875,20182019,0,65,1,1,0,5.08603041782044,1.90089269241435,3.18513772540609,24,26,-2,45,30,15,63,54,9,4,5,0,0
"18820","PIT","CHI",2018020476,17877,20182019,0,60,3,6,-3,6.17065193154849,7.23001893625042,-1.05936700470193,43,29,14,49,37,12,57,58,-1,2,2,0,0
"18821","PIT","BOS",2018020489,17879,20182019,1,60,5,3,2,5.06135060836095,5.85350183025002,-0.792151221889071,28,51,-23,30,66,-36,37,81,-44,1,2,0,0
"18822","PIT","L.A",2018020499,17880,20182019,1,63.9833333333333,4,3,1,4.62591706642002,4.04209708671988,0.583819979700138,36,41,-5,43,45,-2,54,59,-5,3,3,0,0
"18823","PIT","ANA",2018020512,17882,20182019,1,60,2,4,-2,5.16961290658219,4.94516863692243,0.224444269659753,30,36,-6,40,46,-6,57,59,-2,4,2,0,0
"18824","PIT","WSH",2018020528,17884,20182019,0,60,2,1,1,3.50808235130885,3.66821491846349,-0.160132567154646,30,32,-2,39,54,-15,57,76,-19,5,6,0,0
"18825","PIT","MIN",2018020533,17885,20182019,1,60,2,1,1,3.72368252709049,2.8863864732557,0.837296053834791,37,41,-4,48,46,2,56,62,-6,4,3,0,0
"18826","PIT","CAR",2018020554,17887,20182019,0,60,3,0,3,3.69463355917,5.80173997234272,-2.10710641317272,32,39,-7,41,60,-19,56,76,-20,2,4,0,0
"18827","PIT","DET",2018020569,17892,20182019,1,60,5,2,3,5.21067137013911,6.13092949497513,-0.920258124836021,40,29,11,52,37,15,66,50,16,3,1,0,0
"18828","PIT","STL",2018020592,17894,20182019,0,60,6,1,5,4.80321630350586,4.85528037747804,-0.0520640739721756,30,31,-1,38,51,-13,43,74,-31,4,2,0,0
"18829","PIT","MIN",2018020603,17896,20182019,0,60,3,2,1,5.81661211837491,4.92273503780598,0.893877080568927,32,33,-1,43,47,-4,52,62,-10,2,2,0,0
"18830","PIT","NYR",2018020617,17898,20182019,0,60,7,2,5,2.81503778134356,3.70575620788509,-0.890718426541525,25,30,-5,30,45,-15,42,63,-21,2,2,0,0
"18831","PIT","WPG",2018020629,17900,20182019,1,60,4,0,4,3.88723439397972,4.32251562854094,-0.435281234561216,33,33,0,41,43,-2,55,68,-13,3,1,0,0
"18832","PIT","CHI",2018020650,17902,20182019,1,60,3,5,-2,4.38101409782951,6.05919744842686,-1.67818335059735,34,31,3,41,42,-1,52,54,-2,3,3,0,0
"18833","PIT","FLA",2018020660,17904,20182019,1,60,5,1,4,4.38678084817349,4.42089265310577,-0.0341118049322802,31,37,-6,40,50,-10,50,72,-22,5,5,0,0
"18834","PIT","ANA",2018020686,17907,20182019,0,60,7,4,3,6.55231849700548,5.20748473587446,1.34483376113102,36,25,11,56,36,20,72,48,24,3,2,0,0
"18835","PIT","L.A",2018020698,17908,20182019,0,60,2,5,-3,6.53491018272775,4.46330333691731,2.07160684581044,40,25,15,61,36,25,78,46,32,4,3,0,0
"18836","PIT","S.J",2018020720,17911,20182019,0,60,2,5,-3,4.68583141930867,5.2129855053081,-0.527154085999427,24,29,-5,36,41,-5,48,57,-9,2,2,0,0
"18837","PIT","ARI",2018020738,17914,20182019,0,64.1666666666667,3,2,1,3.86861428321572,7.58328822794576,-3.71467394473004,35,33,2,46,46,0,63,66,-3,4,4,0,0
"18838","PIT","VGK",2018020750,17915,20182019,0,60,3,7,-4,4.05989368518567,4.74524286211567,-0.685349176930004,37,35,2,46,43,3,56,63,-7,2,2,0,0
"18839","PIT","N.J",2018020772,17924,20182019,1,60,3,6,-3,8.20023299889522,3.79315648448348,4.40707651441174,40,32,8,54,40,14,76,49,27,5,2,0,0
"18840","PIT","T.B",2018020776,17926,20182019,1,60,4,2,2,4.55041418131441,3.15331617453558,1.39709800677883,22,35,-13,32,49,-17,48,66,-18,5,4,0,0
"18841","PIT","OTT",2018020784,17928,20182019,1,60,5,3,2,4.62712838583684,5.53025069863625,-0.903122312799411,40,40,0,60,45,15,76,58,18,2,2,0,0
"18842","PIT","TOR",2018020791,17929,20182019,0,60,2,3,-1,4.16917797415026,5.21686387201771,-1.04768589786745,30,33,-3,45,54,-9,64,76,-12,1,2,0,0
"18843","PIT","CAR",2018020813,17932,20182019,1,60,0,4,-4,3.13130354241002,7.78430211138857,-4.65299856897855,23,32,-9,28,44,-16,44,62,-18,2,2,0,0
"18844","PIT","FLA",2018020824,17934,20182019,0,64.2333333333333,2,3,-1,4.23608572266335,10.3351407835709,-6.09905506090751,31,42,-11,45,58,-13,54,70,-16,3,3,0,0
"18845","PIT","T.B",2018020847,17936,20182019,0,60,4,5,-1,3.81720216114627,4.32512878635316,-0.507926625206892,32,34,-2,44,45,-1,58,60,-2,2,2,0,0
"18846","PIT","PHI",2018020860,17938,20182019,0,60,4,1,3,5.95448127764394,7.24661880303029,-1.29213752538635,28,51,-23,35,66,-31,50,82,-32,2,4,0,0
"18847","PIT","EDM",2018020875,17940,20182019,1,60,3,1,2,7.54728481415441,5.12737346173299,2.41991135242142,34,39,-5,41,48,-7,52,62,-10,1,3,0,0
"18848","PIT","CGY",2018020893,17943,20182019,1,60,4,5,-1,5.52105871932145,3.6931924266537,1.82786629266775,38,31,7,50,43,7,66,53,13,5,4,0,0
"18849","PIT","NYR",2018020904,17944,20182019,1,60,6,5,1,4.76732338091824,5.07120571881912,-0.303882337900873,41,44,-3,47,61,-14,65,71,-6,4,2,0,0
"18850","PIT","N.J",2018020917,17946,20182019,0,60,4,3,1,4.5963428802981,8.46601858121483,-3.86967570091673,28,36,-8,40,46,-6,51,54,-3,2,2,0,0
"18851","PIT","S.J",2018020933,17948,20182019,1,60,0,4,-4,2.9640044686343,3.04859868481992,-0.0845942161856219,26,33,-7,32,42,-10,45,58,-13,3,8,0,0
"18852","PIT","PHI",2018020953,17950,20182019,0,61.9833333333333,3,4,-1,5.19721201858376,8.85433271579677,-3.65712069721301,43,37,6,55,50,5,67,69,-2,3,5,0,0
"18853","PIT","CBJ",2018020973,17953,20182019,0,60,5,2,3,3.87380308989009,2.96838714081878,0.905415949071312,27,23,4,33,30,3,48,49,-1,2,3,0,0
"18854","PIT","BUF",2018020991,17956,20182019,0,64.1833333333333,3,4,-1,7.40882640092387,2.77273077356363,4.63609562736024,44,30,14,54,35,19,71,50,21,4,3,0,0
"18855","PIT","MTL",2018021003,17957,20182019,0,60,5,1,4,3.71560791434577,5.22049296181649,-1.50488504747072,25,37,-12,34,57,-23,43,77,-34,3,3,0,0
"18856","PIT","FLA",2018021022,17960,20182019,1,62.7333333333333,3,2,1,6.08097048114207,3.72762858815021,2.35334189299186,37,34,3,50,41,9,69,54,15,2,3,0,0
"18857","PIT","CBJ",2018021034,17962,20182019,1,60,3,0,3,4.49466886134613,3.36206438047364,1.13260448087249,31,25,6,41,35,6,53,59,-6,5,4,0,0
"18858","PIT","CBJ",2018021054,17964,20182019,0,60,1,4,-3,3.88566774884929,3.72688075505721,0.158786993792079,29,33,-4,41,42,-1,53,52,1,4,5,0,0
"18859","PIT","BOS",2018021062,17965,20182019,1,60,4,2,2,5.25077921905904,4.96806970976479,0.28270950929425,37,41,-4,47,49,-2,63,65,-2,5,5,0,0
"18860","PIT","WSH",2018021073,17967,20182019,1,60,5,3,2,6.20046639849897,7.54506263248921,-1.34459623399023,30,41,-11,40,53,-13,46,74,-28,5,3,0,0
"18861","PIT","BUF",2018021083,17969,20182019,0,60,5,0,5,2.62655036871295,4.71257849355425,-2.0860281248413,28,26,2,36,35,1,54,50,4,5,3,0,0
"18862","PIT","STL",2018021099,17971,20182019,1,60,1,5,-4,6.28599460397982,4.32759439735673,1.95840020662308,41,26,15,50,38,12,66,45,21,4,2,0,0
"18863","PIT","PHI",2018021115,17972,20182019,1,64.9333333333333,1,2,-1,3.63041109102132,6.33317899839839,-2.70276790737707,42,38,4,55,45,10,68,57,11,4,3,0,0
"18864","PIT","CAR",2018021126,17974,20182019,0,65,2,2,0,9.69352974027977,8.59152133179487,1.10200840848491,38,39,-1,49,61,-12,60,76,-16,3,4,0,0
"18865","PIT","NSH",2018021141,17976,20182019,0,65,1,1,0,4.1995521824546,4.57964595412977,-0.38009377167517,33,29,4,54,38,16,69,54,15,2,3,0,0
"18866","PIT","DAL",2018021160,17978,20182019,0,60,3,2,1,6.02386700734496,4.92034606364905,1.10352094369591,30,31,-1,43,45,-2,60,60,0,1,3,0,0
"18867","PIT","NYR",2018021171,17980,20182019,0,60,5,2,3,4.48420510661313,5.28203054458572,-0.797825437972597,36,35,1,48,46,2,58,58,0,3,3,0,0
"18868","PIT","NSH",2018021198,17984,20182019,1,60,1,3,-2,3.35328691637769,3.75177356575957,-0.39848664938188,43,26,17,46,42,4,56,52,4,4,2,0,0
"18869","PIT","CAR",2018021216,17986,20182019,1,60,3,1,2,3.57379010540899,5.60107785824221,-2.02728775283322,28,38,-10,34,54,-20,44,77,-33,3,4,0,0
"18870","PIT","DET",2018021233,17988,20182019,0,60,1,4,-3,4.15772074693814,4.7960183700895,-0.63829762315136,39,26,13,51,39,12,69,49,20,2,1,0,0
"18871","PIT","DET",2018021245,17990,20182019,1,60,4,1,3,4.62066146982124,4.22377724322655,0.396884226594693,47,34,13,57,50,7,75,63,12,5,3,0,0
"18872","PIT","NYR",2018021264,17992,20182019,1,62.15,3,4,-1,4.46796971731237,2.36193159760842,2.10603811970395,39,30,9,59,36,23,79,43,36,4,0,0,0
"18873","PIT","NYI",2018030141,17996,20182019,0,64.65,3,4,-1,4.18260227848077,3.36302204262626,0.819580235854511,44,33,11,66,49,17,83,62,21,5,4,0,0
"18874","PIT","NYI",2018030142,17998,20182019,0,60,1,3,-2,4.95307364497182,2.65465679824223,2.29841684672959,33,34,-1,47,43,4,62,59,3,4,8,0,0
"18875","PIT","NYI",2018030143,18000,20182019,1,60,1,4,-3,2.12781137452112,6.01902284683633,-3.89121147231521,26,36,-10,35,48,-13,58,61,-3,4,3,0,0
"18876","PIT","NYI",2018030144,18002,20182019,1,60,1,3,-2,3.82896537939092,4.44893240735675,-0.619967027965835,33,26,7,51,38,13,74,54,20,4,4,0,0
"18877","S.J","ANA",2008020008,14161,20082009,1,60,4,1,3,0,0,0,41,29,12,48,30,18,63,40,23,7,2,0,0
"18878","S.J","L.A",2008020028,14163,20082009,1,60,3,1,2,0,0,0,41,13,28,58,21,37,69,34,35,6,4,0,0
"18879","S.J","L.A",2008020031,14164,20082009,0,60,1,0,1,0,0,0,19,21,-2,42,36,6,55,49,6,3,5,0,0
"18880","S.J","CBJ",2008020043,14166,20082009,1,60,5,2,3,0,0,0,25,33,-8,33,41,-8,51,58,-7,3,7,0,0
"18881","S.J","ANA",2008020061,14169,20082009,0,60,0,4,-4,0,0,0,38,20,18,52,36,16,59,43,16,8,7,0,0
"18882","S.J","PHI",2008020075,14170,20082009,1,61.4166666666667,5,4,1,0,0,0,45,17,28,62,29,33,81,40,41,11,6,0,0
"18883","S.J","PHI",2008020089,14174,20082009,0,65,6,6,0,0,0,0,35,29,6,43,39,4,62,50,12,7,5,0,0
"18884","S.J","FLA",2008020102,14176,20082009,0,60,3,4,-1,0,0,0,50,35,15,56,42,14,75,52,23,5,3,0,0
"18885","S.J","T.B",2008020111,14177,20082009,0,60,3,0,3,0,0,0,45,22,23,58,25,33,69,33,36,6,2,0,0
"18886","S.J","PIT",2008020132,14180,20082009,1,60,2,1,1,0,0,0,34,11,23,50,19,31,66,27,39,6,2,0,0
"18887","S.J","DET",2008020147,14182,20082009,1,60,4,2,2,0,0,0,33,27,6,44,34,10,58,51,7,4,4,0,0
"18888","S.J","COL",2008020165,14185,20082009,0,60,5,3,2,0,0,0,29,36,-7,43,49,-6,55,61,-6,2,3,0,0
"18889","S.J","MIN",2008020177,14187,20082009,1,60,3,1,2,0,0,0,49,24,25,62,34,28,73,44,29,6,3,0,0
"18890","S.J","STL",2008020191,14189,20082009,1,65,4,4,0,0,0,0,43,29,14,65,38,27,93,50,43,8,7,0,0
"18891","S.J","DAL",2008020206,14191,20082009,1,60,2,1,1,0,0,0,33,24,9,52,35,17,69,44,25,3,4,0,0
"18892","S.J","ARI",2008020211,14192,20082009,0,60,2,4,-2,0,0,0,32,30,2,45,41,4,64,47,17,5,7,0,0
"18893","S.J","NSH",2008020220,14194,20082009,1,62.4666666666667,3,4,-1,0,0,0,57,29,28,65,37,28,87,51,36,8,3,0,0
"18894","S.J","CGY",2008020235,14196,20082009,1,60,6,1,5,0,0,0,46,24,22,55,34,21,66,45,21,11,6,0,0
"18895","S.J","CHI",2008020255,14199,20082009,0,60,6,5,1,0,0,0,31,33,-2,39,40,-1,49,46,3,6,5,0,0
"18896","S.J","NSH",2008020261,14200,20082009,0,60,4,1,3,0,0,0,32,33,-1,43,38,5,56,44,12,8,7,0,0
"18897","S.J","WSH",2008020296,14205,20082009,1,60,7,2,5,0,0,0,28,21,7,37,29,8,48,42,6,7,5,0,0
"18898","S.J","CHI",2008020320,14209,20082009,1,60.75,3,2,1,0,0,0,40,26,14,56,36,20,68,58,10,3,1,0,0
"18899","S.J","DAL",2008020333,14211,20082009,0,60,6,2,4,0,0,0,30,27,3,37,39,-2,43,51,-8,6,6,0,0
"18900","S.J","ARI",2008020344,14212,20082009,0,60,3,2,1,0,0,0,23,20,3,38,31,7,48,46,2,4,6,0,0
"18901","S.J","TOR",2008020360,14215,20082009,1,60,5,2,3,0,0,0,30,31,-1,46,38,8,66,50,16,4,5,0,0
"18902","S.J","CBJ",2008020375,14217,20082009,1,60,3,2,1,0,0,0,22,31,-9,38,39,-1,56,54,2,6,2,0,0
"18903","S.J","EDM",2008020390,14219,20082009,1,62.6666666666667,2,3,-1,0,0,0,43,17,26,57,26,31,72,40,32,3,5,0,0
"18904","S.J","ANA",2008020421,14224,20082009,1,60,2,0,2,0,0,0,27,31,-4,40,46,-6,55,63,-8,6,5,0,0
"18905","S.J","STL",2008020440,14226,20082009,1,60,5,4,1,0,0,0,38,33,5,56,42,14,70,59,11,6,8,0,0
"18906","S.J","L.A",2008020445,14228,20082009,0,65,2,2,0,0,0,0,25,28,-3,40,46,-6,59,62,-3,1,5,0,0
"18907","S.J","CBJ",2008020456,14230,20082009,0,62.9166666666667,1,2,-1,0,0,0,48,32,16,60,39,21,77,46,31,5,3,0,0
"18908","S.J","DET",2008020466,14231,20082009,0,60,0,6,-6,0,0,0,24,28,-4,33,37,-4,40,47,-7,3,4,0,0
"18909","S.J","NYR",2008020485,14233,20082009,1,60,3,2,1,0,0,0,30,34,-4,48,44,4,58,64,-6,5,2,0,0
"18910","S.J","VAN",2008020506,14236,20082009,1,60,5,0,5,0,0,0,31,33,-2,43,41,2,53,45,8,7,2,0,0
"18911","S.J","STL",2008020523,14240,20082009,0,65,2,2,0,0,0,0,26,28,-2,37,39,-2,53,49,4,3,2,0,0
"18912","S.J","DAL",2008020535,14242,20082009,0,60,3,1,2,0,0,0,19,29,-10,24,45,-21,32,57,-25,4,6,0,0
"18913","S.J","MIN",2008020548,14244,20082009,0,61.6333333333333,2,3,-1,0,0,0,34,32,2,48,40,8,58,54,4,2,3,0,0
"18914","S.J","NYI",2008020575,14247,20082009,1,60,5,3,2,0,0,0,47,24,23,62,35,27,84,45,39,6,4,0,0
"18915","S.J","CGY",2008020593,14250,20082009,0,60,2,5,-3,0,0,0,28,28,0,44,34,10,53,50,3,6,5,0,0
"18916","S.J","EDM",2008020611,14253,20082009,0,60,4,1,3,0,0,0,31,26,5,46,35,11,54,47,7,5,7,0,0
"18917","S.J","VAN",2008020624,14254,20082009,0,60,4,2,2,0,0,0,27,26,1,40,39,1,48,46,2,6,6,0,0
"18918","S.J","T.B",2008020641,14257,20082009,1,60,7,1,6,0,0,0,42,25,17,59,31,28,75,41,34,10,4,0,0
"18919","S.J","CGY",2008020655,14259,20082009,1,60,2,3,-1,0,0,0,35,31,4,44,44,0,56,64,-8,6,6,0,0
"18920","S.J","DET",2008020672,14261,20082009,1,60,6,5,1,0,0,0,41,34,7,55,40,15,67,52,15,6,6,0,0
"18921","S.J","VAN",2008020691,14264,20082009,1,63.1333333333333,2,1,1,0,0,0,29,14,15,40,19,21,49,28,21,5,1,0,0
"18922","S.J","COL",2008020709,14271,20082009,0,60,3,0,3,0,0,0,38,31,7,51,51,0,63,65,-2,3,3,0,0
"18923","S.J","ARI",2008020724,14273,20082009,1,60,2,0,2,0,0,0,29,24,5,46,32,14,59,42,17,6,7,0,0
"18924","S.J","CHI",2008020741,14275,20082009,1,60,2,4,-2,0,0,0,34,29,5,43,43,0,58,62,-4,4,3,0,0
"18925","S.J","CAR",2008020771,14280,20082009,1,65,3,3,0,0,0,0,40,29,11,56,37,19,80,48,32,6,4,0,0
"18926","S.J","CBJ",2008020784,14282,20082009,0,61.55,2,3,-1,0,0,0,30,20,10,45,27,18,62,35,27,5,1,0,0
"18927","S.J","BOS",2008020795,14285,20082009,0,60,5,2,3,0,0,0,31,30,1,42,39,3,51,51,0,1,5,0,0
"18928","S.J","PIT",2008020806,14286,20082009,0,65,1,1,0,0,0,0,37,36,1,50,53,-3,68,64,4,1,3,0,0
"18929","S.J","BUF",2008020820,14288,20082009,0,65,5,5,0,0,0,0,35,35,0,43,43,0,51,52,-1,2,7,0,0
"18930","S.J","N.J",2008020834,14290,20082009,0,60,5,6,-1,0,0,0,32,29,3,38,39,-1,48,49,-1,5,8,0,0
"18931","S.J","EDM",2008020853,14292,20082009,1,60,4,2,2,0,0,0,31,26,5,38,37,1,46,54,-8,8,10,0,0
"18932","S.J","L.A",2008020870,14294,20082009,1,60,4,2,2,0,0,0,40,32,8,55,40,15,72,52,20,10,9,0,0
"18933","S.J","ATL",2008020878,14296,20082009,1,60,3,1,2,0,0,0,31,23,8,37,33,4,58,45,13,3,5,0,0
"18934","S.J","DAL",2008020892,14298,20082009,0,60,1,0,1,0,0,0,24,29,-5,29,47,-18,45,64,-19,3,4,0,0
"18935","S.J","DET",2008020907,14300,20082009,0,60,1,4,-3,0,0,0,35,33,2,45,45,0,55,58,-3,8,9,0,0
"18936","S.J","OTT",2008020914,14301,20082009,0,60,2,1,1,0,0,0,24,24,0,31,31,0,43,47,-4,4,4,0,0
"18937","S.J","MTL",2008020926,14303,20082009,0,60,2,3,-1,0,0,0,48,21,27,67,27,40,91,37,54,2,1,0,0
"18938","S.J","DAL",2008020952,14306,20082009,1,60,1,4,-3,0,0,0,25,31,-6,38,46,-8,52,55,-3,7,7,0,0
"18939","S.J","MIN",2008020963,14308,20082009,1,64.7666666666667,3,4,-1,0,0,0,35,36,-1,48,42,6,64,58,6,2,0,0,0
"18940","S.J","VAN",2008020978,14310,20082009,0,60,1,3,-2,0,0,0,29,29,0,48,36,12,57,49,8,5,8,0,0
"18941","S.J","MIN",2008020997,14313,20082009,0,63.5666666666667,5,4,1,0,0,0,23,29,-6,28,35,-7,45,55,-10,3,3,0,0
"18942","S.J","STL",2008021012,14315,20082009,0,60,1,3,-2,0,0,0,25,26,-1,37,39,-2,43,45,-2,8,5,0,0
"18943","S.J","L.A",2008021030,14317,20082009,1,65,1,1,0,0,0,0,39,24,15,52,34,18,78,46,32,8,4,0,0
"18944","S.J","ANA",2008021036,14318,20082009,0,60,1,0,1,0,0,0,30,34,-4,42,46,-4,54,59,-5,4,4,0,0
"18945","S.J","NSH",2008021062,14322,20082009,1,65,2,2,0,0,0,0,38,26,12,46,37,9,65,45,20,4,2,0,0
"18946","S.J","DAL",2008021070,14324,20082009,1,60,5,2,3,0,0,0,30,25,5,39,43,-4,53,53,0,4,4,0,0
"18947","S.J","COL",2008021084,14325,20082009,1,60,3,1,2,0,0,0,28,32,-4,36,44,-8,52,61,-9,3,2,0,0
"18948","S.J","CHI",2008021100,14328,20082009,0,65,5,5,0,0,0,0,28,32,-4,35,37,-2,46,46,0,2,2,0,0
"18949","S.J","NSH",2008021106,14329,20082009,0,60,2,3,-1,0,0,0,31,33,-2,38,48,-10,48,61,-13,4,4,0,0
"18950","S.J","CGY",2008021135,14333,20082009,0,60,2,1,1,0,0,0,17,29,-12,26,38,-12,36,57,-21,3,3,0,0
"18951","S.J","EDM",2008021155,14336,20082009,0,60,2,1,1,0,0,0,22,26,-4,34,43,-9,42,52,-10,4,6,0,0
"18952","S.J","ANA",2008021173,14338,20082009,1,60,2,5,-3,0,0,0,30,28,2,38,38,0,45,45,0,4,2,0,0
"18953","S.J","ANA",2008021179,14339,20082009,0,60,3,2,1,0,0,0,26,21,5,35,30,5,44,34,10,11,5,0,0
"18954","S.J","COL",2008021196,14341,20082009,1,65,0,0,0,0,0,0,30,20,10,48,27,21,73,40,33,5,3,0,0
"18955","S.J","L.A",2008021219,14345,20082009,0,60,3,4,-1,0,0,0,30,24,6,52,34,18,65,40,25,7,5,0,0
"18956","S.J","ANA",2008030151,14350,20082009,1,60,0,2,-2,0,0,0,35,17,18,43,27,16,61,38,23,6,4,0,0
"18957","S.J","ANA",2008030152,14353,20082009,1,60,2,3,-1,0,0,0,44,26,18,62,40,22,83,51,32,6,2,0,0
"18958","S.J","ANA",2008030153,14355,20082009,0,60,4,3,1,0,0,0,35,30,5,45,40,5,54,52,2,5,4,0,0
"18959","S.J","ANA",2008030154,14357,20082009,0,60,0,4,-4,0,0,0,31,26,5,40,42,-2,46,55,-9,3,6,0,0
"18960","S.J","ANA",2008030155,14359,20082009,1,66.0333333333333,3,2,1,0,0,0,48,25,23,61,40,21,86,61,25,3,3,0,0
"18961","S.J","ANA",2008030156,14361,20082009,0,60,1,4,-3,0,0,0,37,32,5,57,52,5,71,62,9,10,10,0,0
"18962","S.J","COL",2009020003,14518,20092010,0,60,2,5,-3,0,0,0,40,20,20,59,30,29,75,38,37,6,3,0,0
"18963","S.J","ANA",2009020022,14520,20092010,0,60,4,1,3,0,0,0,37,25,12,52,37,15,61,50,11,7,8,0,0
"18964","S.J","L.A",2009020032,14523,20092010,0,60,4,6,-2,0,0,0,29,30,-1,37,44,-7,48,57,-9,5,5,0,0
"18965","S.J","MIN",2009020061,14527,20092010,1,60,4,2,2,0,0,0,29,40,-11,37,54,-17,51,71,-20,5,8,0,0
"18966","S.J","NYI",2009020097,14534,20092010,0,60,4,1,3,0,0,0,29,32,-3,38,39,-1,62,51,11,5,5,0,0
"18967","S.J","NYR",2009020106,14536,20092010,0,60,7,3,4,0,0,0,30,29,1,43,47,-4,50,60,-10,7,3,0,0
"18968","S.J","T.B",2009020123,14539,20092010,0,60,2,5,-3,0,0,0,34,25,9,40,35,5,52,40,12,3,1,0,0
"18969","S.J","ATL",2009020134,14541,20092010,0,60,4,3,1,0,0,0,25,27,-2,33,33,0,44,52,-8,4,4,0,0
"18970","S.J","PHI",2009020145,14542,20092010,0,60,4,1,3,0,0,0,28,38,-10,36,46,-10,48,67,-19,6,6,0,0
"18971","S.J","L.A",2009020164,14545,20092010,1,65,1,1,0,0,0,0,30,29,1,39,44,-5,67,59,8,2,2,0,0
"18972","S.J","COL",2009020179,14547,20092010,1,60,3,1,2,0,0,0,46,25,21,62,36,26,82,43,39,5,5,0,0
"18973","S.J","CAR",2009020192,14549,20092010,0,60,5,1,4,0,0,0,25,26,-1,41,36,5,51,51,0,5,3,0,0
"18974","S.J","DET",2009020212,14553,20092010,0,65,1,1,0,0,0,0,34,36,-2,43,57,-14,51,74,-23,4,3,0,0
"18975","S.J","PIT",2009020237,14555,20092010,1,60,5,0,5,0,0,0,35,27,8,46,47,-1,65,60,5,8,6,0,0
"18976","S.J","NSH",2009020246,14558,20092010,1,60,4,3,1,0,0,0,29,26,3,43,42,1,55,52,3,1,2,0,0
"18977","S.J","DAL",2009020261,14560,20092010,1,65,2,2,0,0,0,0,32,36,-4,45,48,-3,69,62,7,4,6,0,0
"18978","S.J","STL",2009020276,14562,20092010,0,60,3,1,2,0,0,0,17,39,-22,32,53,-21,42,69,-27,5,6,0,0
"18979","S.J","CHI",2009020282,14563,20092010,0,60.6833333333333,3,4,-1,0,0,0,23,30,-7,32,42,-10,43,52,-9,4,2,0,0
"18980","S.J","NSH",2009020292,14565,20092010,0,60,3,4,-1,0,0,0,32,31,1,47,42,5,64,56,8,2,4,0,0
"18981","S.J","PHI",2009020312,14568,20092010,1,60,6,3,3,0,0,0,29,29,0,41,36,5,60,49,11,8,6,0,0
"18982","S.J","ANA",2009020325,14569,20092010,0,60,3,2,1,0,0,0,36,30,6,46,42,4,54,55,-1,4,5,0,0
"18983","S.J","CHI",2009020352,14573,20092010,1,60,2,7,-5,0,0,0,24,41,-17,39,52,-13,55,63,-8,6,2,0,0
"18984","S.J","EDM",2009020365,14575,20092010,0,65,4,4,0,0,0,0,31,33,-2,48,52,-4,61,63,-2,5,6,0,0
"18985","S.J","VAN",2009020381,14577,20092010,0,60,4,2,2,0,0,0,30,27,3,41,40,1,52,46,6,5,4,0,0
"18986","S.J","OTT",2009020393,14579,20092010,1,60,5,2,3,0,0,0,33,27,6,48,37,11,66,54,12,3,5,0,0
"18987","S.J","STL",2009020408,14581,20092010,1,65,2,2,0,0,0,0,34,30,4,49,48,1,63,67,-4,6,4,0,0
"18988","S.J","CGY",2009020426,14583,20092010,1,60,1,2,-1,0,0,0,36,36,0,49,50,-1,63,69,-6,4,6,0,0
"18989","S.J","L.A",2009020451,14587,20092010,1,61.2666666666667,4,5,-1,0,0,0,34,28,6,50,35,15,63,46,17,7,5,0,0
"18990","S.J","DAL",2009020465,14589,20092010,1,65,2,2,0,0,0,0,35,44,-9,54,64,-10,64,80,-16,5,8,0,0
"18991","S.J","ANA",2009020510,14595,20092010,1,60,4,1,3,0,0,0,37,21,16,51,33,18,67,48,19,6,5,0,0
"18992","S.J","DAL",2009020539,14599,20092010,0,60,4,2,2,0,0,0,32,38,-6,44,58,-14,53,66,-13,1,6,0,0
"18993","S.J","CHI",2009020542,14600,20092010,0,60,3,2,1,0,0,0,14,47,-33,19,60,-41,32,77,-45,6,8,0,0
"18994","S.J","ANA",2009020569,14604,20092010,1,60,5,2,3,0,0,0,25,32,-7,36,52,-16,51,63,-12,3,5,0,0
"18995","S.J","EDM",2009020622,14611,20092010,1,60,4,1,3,0,0,0,27,23,4,33,29,4,51,42,9,5,6,0,0
"18996","S.J","L.A",2009020628,14613,20092010,1,60,2,6,-4,0,0,0,47,20,27,61,30,31,77,42,35,5,5,0,0
"18997","S.J","STL",2009020644,14615,20092010,1,64.1,2,1,1,0,0,0,44,29,15,57,43,14,78,62,16,5,6,0,0
"18998","S.J","DET",2009020672,14618,20092010,1,60,1,4,-3,0,0,0,32,22,10,41,26,15,58,37,21,2,1,0,0
"18999","S.J","L.A",2009020679,14620,20092010,0,60,2,1,1,0,0,0,36,34,2,46,45,1,54,59,-5,3,5,0,0
"19000","S.J","BOS",2009020704,14623,20092010,1,65,1,1,0,0,0,0,42,31,11,55,44,11,77,56,21,2,2,0,0
"19001","S.J","EDM",2009020711,14625,20092010,1,60,4,2,2,0,0,0,36,29,7,62,39,23,85,51,34,3,1,0,0
"19002","S.J","CGY",2009020732,14627,20092010,1,60,9,1,8,0,0,0,46,22,24,56,30,26,69,39,30,4,3,0,0
"19003","S.J","L.A",2009020740,14628,20092010,0,60,5,1,4,0,0,0,24,37,-13,31,51,-20,38,64,-26,7,7,0,0
"19004","S.J","ANA",2009020756,14630,20092010,1,60,3,1,2,0,0,0,25,27,-2,43,37,6,62,52,10,5,5,0,0
"19005","S.J","CHI",2009020800,14637,20092010,1,61.6166666666667,3,4,-1,0,0,0,37,39,-2,51,47,4,68,61,7,3,2,0,0
"19006","S.J","MIN",2009020816,14639,20092010,1,60,5,2,3,0,0,0,36,38,-2,47,49,-2,61,62,-1,7,5,0,0
"19007","S.J","DET",2009020835,14642,20092010,1,60,2,4,-2,0,0,0,34,37,-3,44,51,-7,65,74,-9,3,6,0,0
"19008","S.J","STL",2009020846,14644,20092010,0,60,4,2,2,0,0,0,31,37,-6,43,48,-5,59,58,1,4,5,0,0
"19009","S.J","NSH",2009020866,14646,20092010,0,60,4,3,1,0,0,0,29,38,-9,38,52,-14,50,65,-15,5,4,0,0
"19010","S.J","TOR",2009020871,14648,20092010,0,60,3,2,1,0,0,0,26,34,-8,36,49,-13,50,68,-18,2,3,0,0
"19011","S.J","DET",2009020895,14651,20092010,0,65,2,2,0,0,0,0,26,52,-26,36,66,-30,45,80,-35,3,7,0,0
"19012","S.J","N.J",2009020934,14670,20092010,1,60,3,4,-1,0,0,0,20,25,-5,34,40,-6,47,56,-9,1,3,0,0
"19013","S.J","MTL",2009020949,14672,20092010,1,60,3,2,1,0,0,0,40,30,10,59,41,18,85,51,34,7,7,0,0
"19014","S.J","NSH",2009020999,14679,20092010,1,60,8,5,3,0,0,0,26,45,-19,38,57,-19,59,75,-16,3,4,0,0
"19015","S.J","FLA",2009021014,14681,20092010,1,62.7666666666667,2,3,-1,0,0,0,39,28,11,59,40,19,78,55,23,3,4,0,0
"19016","S.J","ANA",2009021023,14682,20092010,0,60,2,4,-2,0,0,0,33,33,0,51,43,8,67,48,19,5,7,0,0
"19017","S.J","DAL",2009021037,14684,20092010,0,60,2,8,-6,0,0,0,47,31,16,65,41,24,80,50,30,4,6,0,0
"19018","S.J","VAN",2009021051,14686,20092010,0,60,2,3,-1,0,0,0,34,26,8,58,35,23,74,50,24,3,4,0,0
"19019","S.J","CGY",2009021054,14687,20092010,0,60,3,4,-1,0,0,0,28,24,4,36,36,0,53,42,11,3,3,0,0
"19020","S.J","EDM",2009021075,14689,20092010,0,60,1,5,-4,0,0,0,28,25,3,52,32,20,81,36,45,6,4,0,0
"19021","S.J","MIN",2009021086,14691,20092010,0,60,4,1,3,0,0,0,17,19,-2,35,35,0,52,46,6,5,4,0,0
"19022","S.J","DAL",2009021106,14693,20092010,1,60,3,0,3,0,0,0,41,27,14,53,38,15,64,47,17,8,4,0,0
"19023","S.J","VAN",2009021120,14695,20092010,1,60,4,2,2,0,0,0,30,37,-7,39,54,-15,52,69,-17,3,4,0,0
"19024","S.J","COL",2009021127,14696,20092010,1,60,4,3,1,0,0,0,32,45,-13,42,52,-10,58,66,-8,2,4,0,0
"19025","S.J","DAL",2009021146,14699,20092010,0,60,1,5,-4,0,0,0,30,29,1,45,46,-1,54,58,-4,6,7,0,0
"19026","S.J","MIN",2009021160,14701,20092010,0,60,3,2,1,0,0,0,28,29,-1,41,35,6,48,47,1,3,6,0,0
"19027","S.J","COL",2009021177,14703,20092010,0,62.9833333333333,4,5,-1,0,0,0,22,40,-18,28,52,-24,40,69,-29,3,6,0,0
"19028","S.J","CGY",2009021190,14705,20092010,0,60,2,1,1,0,0,0,26,39,-13,38,49,-11,47,66,-19,2,4,0,0
"19029","S.J","VAN",2009021206,14707,20092010,1,60,4,2,2,0,0,0,31,32,-1,43,47,-4,55,59,-4,9,9,0,0
"19030","S.J","COL",2009030151,14713,20092010,1,60,1,2,-1,0,0,0,26,30,-4,40,35,5,57,45,12,3,3,0,0
"19031","S.J","COL",2009030152,14715,20092010,1,65.3666666666667,6,5,1,0,0,0,52,22,30,68,29,39,100,43,57,8,5,0,0
"19032","S.J","COL",2009030153,14717,20092010,0,60.85,0,1,-1,0,0,0,51,17,34,71,24,47,93,33,60,7,3,0,0
"19033","S.J","COL",2009030154,14719,20092010,0,70.4,2,1,1,0,0,0,45,34,11,57,46,11,81,59,22,4,4,0,0
"19034","S.J","COL",2009030155,14721,20092010,1,60,5,0,5,0,0,0,37,28,9,50,46,4,68,54,14,6,4,0,0
"19035","S.J","COL",2009030156,14723,20092010,0,60,5,2,3,0,0,0,34,18,16,46,26,20,61,41,20,3,3,0,0
"19036","S.J","DET",2009030231,14728,20092010,1,60,4,3,1,0,0,0,27,23,4,42,45,-3,59,66,-7,8,7,0,0
"19037","S.J","DET",2009030232,14731,20092010,1,60,4,3,1,0,0,0,45,31,14,57,43,14,71,58,13,10,4,0,0
"19038","S.J","DET",2009030233,14733,20092010,0,67.1166666666667,4,3,1,0,0,0,33,35,-2,47,53,-6,60,72,-12,6,3,0,0
"19039","S.J","DET",2009030234,14735,20092010,0,60,1,7,-6,0,0,0,29,37,-8,42,46,-4,49,60,-11,9,12,0,0
"19040","S.J","DET",2009030235,14737,20092010,1,60,2,1,1,0,0,0,32,34,-2,45,46,-1,56,63,-7,4,4,0,0
"19041","S.J","CHI",2009030321,14745,20092010,1,60,1,2,-1,0,0,0,45,40,5,59,53,6,78,76,2,5,0,0,0
"19042","S.J","CHI",2009030322,14747,20092010,1,60,2,4,-2,0,0,0,27,22,5,39,34,5,62,52,10,3,6,0,0
"19043","S.J","CHI",2009030323,14750,20092010,0,72.4,2,3,-1,0,0,0,46,38,8,61,48,13,88,60,28,6,2,0,0
"19044","S.J","CHI",2009030324,14752,20092010,0,60,2,4,-2,0,0,0,18,27,-9,23,40,-17,41,59,-18,2,5,0,0
"19045","S.J","ATL",2010020066,14898,20102011,1,60,2,4,-2,5.86947238292431,5.37826356838923,0.491208814535085,39,28,11,56,37,19,70,49,21,5,4,0,0
"19046","S.J","CAR",2010020077,14901,20102011,1,60,2,5,-3,5.61098932739081,3.54089610286428,2.07009322452653,43,31,12,49,43,6,69,58,11,6,5,0,0
"19047","S.J","COL",2010020090,14903,20102011,0,60,4,2,2,6.84183840377955,4.26994584685747,2.57189255692208,34,31,3,47,38,9,61,47,14,6,4,0,0
"19048","S.J","EDM",2010020110,14905,20102011,0,60,6,1,5,5.57881974149979,4.12206151266582,1.45675822883396,34,22,12,44,31,13,56,36,20,6,6,0,0
"19049","S.J","CGY",2010020113,14906,20102011,0,60,0,4,-4,2.38433986201349,4.53289634510293,-2.14855648308944,27,30,-3,37,46,-9,55,56,-1,2,6,0,0
"19050","S.J","N.J",2010020128,14909,20102011,1,60,5,2,3,0,0,0,39,29,10,50,39,11,64,53,11,4,6,0,0
"19051","S.J","ANA",2010020156,14912,20102011,1,60,5,2,3,4.78060169877426,3.53791767262737,1.24268402614689,41,24,17,55,35,20,70,54,16,6,3,0,0
"19052","S.J","MIN",2010020162,14915,20102011,0,60,0,1,-1,5.16846822242655,1.78609077554486,3.38237744688169,36,16,20,44,26,18,59,39,20,6,9,0,0
"19053","S.J","STL",2010020176,14917,20102011,0,60,0,2,-2,3.24841390979299,3.76417225698242,-0.515758347189433,25,29,-4,40,46,-6,56,59,-3,5,8,0,0
"19054","S.J","T.B",2010020198,14919,20102011,1,60,5,2,3,4.14347765080993,3.46987686873035,0.673600782079575,39,35,4,57,46,11,69,58,11,6,4,0,0
"19055","S.J","ANA",2010020210,14922,20102011,1,64.45,2,3,-1,7.64891236388939,4.26625956452335,3.38265279936604,41,20,21,59,31,28,76,38,38,4,2,0,0
"19056","S.J","NYI",2010020226,14924,20102011,1,65,1,1,0,3.95654870625731,3.60894448483918,0.347604221418123,38,25,13,58,38,20,79,49,30,5,1,0,0
"19057","S.J","CGY",2010020242,14926,20102011,1,60,4,3,1,4.95885140277096,3.31120374514238,1.64764765762858,35,31,4,52,46,6,62,67,-5,4,7,0,0
"19058","S.J","L.A",2010020253,14928,20102011,1,60,6,3,3,1.97072494772146,4.30247763545363,-2.33175268773217,34,35,-1,42,49,-7,62,57,5,4,3,0,0
"19059","S.J","COL",2010020265,14930,20102011,0,62.1166666666667,3,4,-1,3.5788579186883,1.44623944247439,2.13261847621391,43,22,21,54,29,25,68,42,26,4,2,0,0
"19060","S.J","DAL",2010020273,14931,20102011,0,62.8666666666667,4,5,-1,6.66387239603383,4.39443488968391,2.26943750634992,39,41,-2,60,51,9,71,62,9,4,4,0,0
"19061","S.J","CHI",2010020319,14937,20102011,1,60,5,2,3,5.04563765582861,3.31185748189904,1.73378017392957,29,32,-3,42,47,-5,52,61,-9,6,4,0,0
"19062","S.J","VAN",2010020333,14939,20102011,0,60,1,6,-5,6.06690738839097,4.57107162344619,1.49583576494479,33,32,1,41,35,6,62,44,18,1,1,0,0
"19063","S.J","EDM",2010020343,14940,20102011,0,60,4,3,1,2.6930685704574,2.98793421528649,-0.294865644829088,25,25,0,36,34,2,53,52,1,4,3,0,0
"19064","S.J","DET",2010020357,14943,20102011,1,60,3,5,-2,2.156283829936,5.045019197074,-2.888735367138,28,29,-1,38,44,-6,52,56,-4,2,4,0,0
"19065","S.J","OTT",2010020370,14945,20102011,0,60,4,0,4,5.76334575072423,3.7148740634929,2.04847168723133,33,28,5,49,34,15,63,44,19,3,4,0,0
"19066","S.J","MTL",2010020380,14947,20102011,0,60,1,3,-2,2.7109453062003,2.29078357115111,0.420161735049192,27,19,8,35,28,7,58,39,19,2,0,0,0
"19067","S.J","DET",2010020399,14949,20102011,0,60,5,2,3,6.46499025333273,2.57310735003707,3.89188290329566,35,27,8,49,42,7,63,50,13,4,6,0,0
"19068","S.J","PHI",2010020406,14951,20102011,0,65,4,4,0,6.56478905668955,6.95226328101126,-0.387474224321707,33,35,-2,47,48,-1,68,65,3,5,4,0,0
"19069","S.J","CHI",2010020437,14954,20102011,1,63.8666666666667,2,1,1,6.74834667067807,2.36803129219503,4.38031537848305,30,29,1,47,39,8,67,53,14,2,1,0,0
"19070","S.J","DAL",2010020446,14956,20102011,1,65,2,2,0,9.15771216223948,3.7331860292179,5.42452613302157,33,31,2,43,45,-2,59,61,-2,1,3,0,0
"19071","S.J","NSH",2010020457,14958,20102011,0,60,2,3,-1,3.14899259813119,5.32138479463174,-2.17239219650055,27,35,-8,41,44,-3,52,59,-7,4,4,0,0
"19072","S.J","DAL",2010020466,14959,20102011,0,61.3333333333333,4,3,1,5.99612456836621,2.64610473911807,3.35001982924814,43,18,25,60,25,35,77,41,36,6,2,0,0
"19073","S.J","STL",2010020480,14961,20102011,0,60,4,1,3,4.73012772659422,4.69369360944256,0.0364341171516571,34,22,12,50,34,16,62,48,14,6,4,0,0
"19074","S.J","EDM",2010020501,14964,20102011,1,60,2,1,1,2.90964504436124,4.1862514045788,-1.27660636021756,30,27,3,35,40,-5,49,55,-6,4,2,0,0
"19075","S.J","L.A",2010020535,14970,20102011,1,60,0,4,-4,2.54010998133208,6.45520255969313,-3.91509257836105,24,37,-13,34,45,-11,57,59,-2,3,3,0,0
"19076","S.J","MIN",2010020548,14972,20102011,0,60,3,5,-2,3.5541509286641,3.91794158768607,-0.363790659021973,32,24,8,47,37,10,70,46,24,4,4,0,0
"19077","S.J","CHI",2010020554,14973,20102011,0,60,5,3,2,7.5830820214469,3.6381596004976,3.9449224209493,25,29,-4,30,42,-12,44,56,-12,6,5,0,0
"19078","S.J","L.A",2010020571,14975,20102011,0,60,1,0,1,3.05321459950551,5.42773163957281,-2.3745170400673,19,29,-10,33,46,-13,41,53,-12,2,3,0,0
"19079","S.J","VAN",2010020585,14977,20102011,1,60,3,4,-1,4.57440457769553,5.1149491174001,-0.54054453970457,35,47,-12,52,57,-5,63,70,-7,2,3,0,0
"19080","S.J","NSH",2010020620,14982,20102011,1,60,1,2,-1,5.65411137588671,3.77756194477843,1.87654943110829,43,26,17,59,33,26,81,44,37,2,0,0,0
"19081","S.J","ANA",2010020627,14983,20102011,0,60,0,1,-1,4.99488334724447,2.5197651378403,2.47511820940417,37,28,9,53,47,6,74,58,16,3,2,0,0
"19082","S.J","TOR",2010020641,14985,20102011,1,60,2,4,-2,7.39441277022706,4.5513345246317,2.84307824559536,42,26,16,65,32,33,73,44,29,4,4,0,0
"19083","S.J","EDM",2010020653,14987,20102011,1,60,2,5,-3,4.35287597841868,4.79559812062644,-0.442722142207753,43,29,14,52,40,12,75,56,19,6,5,0,0
"19084","S.J","STL",2010020671,14989,20102011,1,60,4,2,2,2.7777415610326,4.78551242011599,-2.00777085908339,29,30,-1,46,42,4,65,64,1,6,3,0,0
"19085","S.J","VAN",2010020706,14994,20102011,0,65,1,1,0,4.38049570219876,3.82917048594391,0.551325216254856,46,37,9,59,45,14,76,64,12,2,5,0,0
"19086","S.J","MIN",2010020722,14996,20102011,1,60,4,3,1,5.96889506958246,4.59273501010216,1.3761600594803,42,26,16,53,35,18,66,46,20,4,6,0,0
"19087","S.J","L.A",2010020750,15000,20102011,0,65,2,2,0,4.50037668569712,2.53724501252873,1.96313167316839,24,20,4,41,39,2,58,61,-3,2,1,0,0
"19088","S.J","ANA",2010020769,15007,20102011,0,60,4,3,1,7.17674025371525,2.71681406906646,4.45992618464879,28,30,-2,38,44,-6,43,60,-17,2,5,0,0
"19089","S.J","BOS",2010020782,15010,20102011,0,60,2,0,2,3.53212072093365,3.38511225992128,0.147008461012369,18,26,-8,26,35,-9,39,60,-21,2,4,0,0
"19090","S.J","N.J",2010020822,15016,20102011,0,60,1,2,-1,4.58940586901736,4.38086987752467,0.208535991492681,32,23,9,39,28,11,46,37,9,2,3,0,0
"19091","S.J","FLA",2010020841,15018,20102011,0,60,2,3,-1,3.49989695261061,3.5618972296943,-0.0620002770836816,30,22,8,45,34,11,68,45,23,2,4,0,0
"19092","S.J","NSH",2010020852,15020,20102011,0,63.8833333333333,2,1,1,8.36863926556543,2.91143209391982,5.45720717164562,50,31,19,58,40,18,70,51,19,4,2,0,0
"19093","S.J","COL",2010020885,15024,20102011,1,60,4,0,4,6.22853390866658,3.76978974304222,2.45874416562435,33,25,8,43,39,4,56,60,-4,4,4,0,0
"19094","S.J","DET",2010020897,15027,20102011,0,60,4,3,1,6.46333361347206,4.82745607892866,1.6358775345434,43,38,5,54,44,10,61,54,7,3,2,0,0
"19095","S.J","PIT",2010020904,15028,20102011,0,64.9333333333333,3,2,1,4.79735311639047,5.3713710840093,-0.574017967618829,38,26,12,46,37,9,68,58,10,4,2,0,0
"19096","S.J","CGY",2010020921,15030,20102011,0,65,3,3,0,7.06104178579762,3.87734069075533,3.18370109504229,33,24,9,49,35,14,63,52,11,2,3,0,0
"19097","S.J","COL",2010020951,15034,20102011,1,65,1,1,0,7.34625600591971,2.79495374981524,4.55130225610447,35,19,16,58,34,24,86,45,41,4,2,0,0
"19098","S.J","DET",2010020967,15036,20102011,1,60,3,1,2,4.75471893080976,5.33797638447845,-0.583257453668693,28,27,1,45,39,6,61,60,1,5,5,0,0
"19099","S.J","DAL",2010020982,15038,20102011,1,60,2,3,-1,4.74614582244658,3.74180418847573,1.00434163397085,31,28,3,49,44,5,73,56,17,6,4,0,0
"19100","S.J","NSH",2010021000,15041,20102011,1,63.4,3,2,1,5.03262285611709,2.60513213415106,2.42749072196602,33,25,8,51,36,15,71,56,15,2,4,0,0
"19101","S.J","VAN",2010021014,15043,20102011,1,65,4,4,0,8.54814958073757,4.37655912064656,4.17159046009101,48,28,20,65,42,23,78,57,21,10,9,0,0
"19102","S.J","NYR",2010021032,15045,20102011,1,65,2,2,0,4.10704027352995,4.89497543103062,-0.787935157500669,33,22,11,49,31,18,77,45,32,4,2,0,0
"19103","S.J","CHI",2010021039,15047,20102011,0,60,3,6,-3,5.77584302606834,5.96975276787998,-0.193909741811645,36,34,2,44,42,2,64,50,14,3,6,0,0
"19104","S.J","DAL",2010021049,15048,20102011,0,60,6,3,3,9.82594818365578,6.4607620242366,3.36518615941918,39,37,2,54,57,-3,67,78,-11,3,4,0,0
"19105","S.J","MIN",2010021065,15050,20102011,1,60,3,2,1,7.44062745467818,4.05327422945993,3.38735322521825,50,30,20,62,32,30,78,46,32,6,2,0,0
"19106","S.J","STL",2010021079,15052,20102011,1,60,5,3,2,6.41090888235359,3.85527957731392,2.55562930503966,34,45,-11,46,58,-12,67,77,-10,3,3,0,0
"19107","S.J","CGY",2010021101,15056,20102011,1,60,6,3,3,4.48839483284974,5.58774624473881,-1.09935141188907,38,25,13,49,35,14,67,51,16,2,1,0,0
"19108","S.J","L.A",2010021110,15057,20102011,0,65,3,3,0,6.29641777025063,6.02010152097876,0.276316249271872,28,38,-10,41,47,-6,51,61,-10,3,5,0,0
"19109","S.J","DAL",2010021159,15064,20102011,1,60,6,0,6,8.83072197460368,5.46991796027269,3.36080401433099,52,29,23,64,39,25,83,56,27,3,3,0,0
"19110","S.J","ANA",2010021174,15066,20102011,1,60,4,2,2,5.53938327317472,4.4779668780975,1.06141639507722,33,22,11,48,32,16,67,47,20,1,4,0,0
"19111","S.J","L.A",2010021183,15068,20102011,1,60,6,1,5,4.72228433649798,4.77753677799046,-0.0552524414924846,35,32,3,44,41,3,49,61,-12,0,3,0,0
"19112","S.J","ANA",2010021199,15070,20102011,0,60,2,6,-4,7.82569995347876,3.98797213310635,3.83772782037241,38,34,4,54,50,4,66,55,11,5,7,0,0
"19113","S.J","L.A",2010030161,15078,20102011,1,74.7333333333333,3,2,1,6.99575859830608,6.30894432787318,0.686814270432905,45,35,10,59,49,10,80,82,-2,3,4,0,0
"19114","S.J","L.A",2010030162,15080,20102011,1,60,0,4,-4,5.30350248432469,3.04331008263398,2.26019240169071,34,23,11,50,30,20,72,38,34,5,6,0,0
"19115","S.J","L.A",2010030163,15083,20102011,0,63.15,6,5,1,7.34362515042085,4.83428487576733,2.50934027465352,36,22,14,55,33,22,73,47,26,3,3,0,0
"19116","S.J","L.A",2010030164,15085,20102011,0,60,6,3,3,5.23700731296377,6.5508811789897,-1.31387386602593,27,38,-11,40,56,-16,54,72,-18,6,7,0,0
"19117","S.J","L.A",2010030165,15087,20102011,1,60,1,3,-2,0,0,0,52,22,30,66,27,39,89,41,48,4,1,0,0
"19118","S.J","L.A",2010030166,15089,20102011,0,62.3666666666667,4,3,1,4.60629821591829,5.11807940468702,-0.511781188768737,35,29,6,48,41,7,67,59,8,3,2,0,0
"19119","S.J","DET",2010030241,15093,20102011,1,67.05,2,1,1,7.75819559862248,3.22170597861987,4.53648962000261,46,25,21,65,36,29,92,57,35,7,4,0,0
"19120","S.J","DET",2010030242,15095,20102011,1,60,2,1,1,4.55184710721836,3.89796416190984,0.653882945308524,37,34,3,47,47,0,70,71,-1,7,7,0,0
"19121","S.J","DET",2010030243,15098,20102011,0,69.35,4,3,1,6.78591723667394,7.73596875404473,-0.950051517370797,38,41,-3,49,57,-8,60,81,-21,4,4,0,0
"19122","S.J","DET",2010030244,15100,20102011,0,60,3,4,-1,3.94022146059433,9.17934030672768,-5.23911884613335,28,40,-12,35,50,-15,42,62,-20,4,6,0,0
"19123","S.J","DET",2010030245,15102,20102011,1,60,3,4,-1,7.38068843929796,2.88026491063647,4.50042352866149,42,22,20,56,29,27,73,49,24,5,3,0,0
"19124","S.J","DET",2010030246,15104,20102011,0,60,1,3,-2,3.49357541010249,7.6463351844842,-4.15275977438171,25,45,-20,35,60,-25,52,72,-20,8,9,0,0
"19125","S.J","DET",2010030247,15106,20102011,1,60,3,2,1,3.34241086013935,5.72123429432895,-2.3788234341896,30,40,-10,36,51,-15,56,76,-20,3,4,0,0
"19126","S.J","VAN",2010030321,15109,20102011,0,60,2,3,-1,4.58751344906341,5.71741932502482,-1.12990587596141,29,38,-9,32,50,-18,45,71,-26,2,5,0,0
"19127","S.J","VAN",2010030322,15112,20102011,0,60,3,7,-4,3.230828251676,5.00502156531002,-1.77419331363402,31,38,-7,40,52,-12,50,64,-14,3,9,0,0
"19128","S.J","VAN",2010030323,15114,20102011,1,60,4,3,1,4.90920139420172,5.60736615140922,-0.698164757207508,38,30,8,52,40,12,74,66,8,10,4,0,0
"19129","S.J","VAN",2010030324,15116,20102011,1,60,2,4,-2,3.77982515372423,2.7102416150592,1.06958353866503,35,13,22,51,22,29,74,31,43,5,6,0,0
"19130","S.J","VAN",2010030325,15118,20102011,0,80,2,2,0,9.00188226512432,7.24776897241436,1.75411329270996,52,29,23,66,48,18,92,73,19,4,1,0,0
"19131","S.J","ANA",2011020048,15261,20112012,0,60,0,1,-1,3.71603323426098,2.81368613158836,0.902347102672617,31,23,8,45,35,10,64,45,19,5,3,0,0
"19132","S.J","STL",2011020062,15262,20112012,1,60,2,4,-2,7.13648123206798,3.5839591853437,3.55252204672428,36,20,16,49,34,15,75,50,25,3,4,0,0
"19133","S.J","ANA",2011020068,15264,20112012,1,60,2,3,-1,6.79439337978511,2.80818806363443,3.98620531615068,43,22,21,63,31,32,93,43,50,6,3,0,0
"19134","S.J","N.J",2011020091,15268,20112012,0,65,3,3,0,5.49262419133936,4.21028833567834,1.28233585566102,41,19,22,50,27,23,57,37,20,5,5,0,0
"19135","S.J","BOS",2011020097,15269,20112012,0,60,4,2,2,4.88937086417902,10.2569583749864,-5.3675875108074,30,39,-9,41,59,-18,50,80,-30,1,2,0,0
"19136","S.J","NSH",2011020117,15272,20112012,0,60,3,1,2,5.87229631576287,1.23340058790964,4.63889572785323,36,20,16,43,28,15,57,45,12,2,4,0,0
"19137","S.J","DET",2011020137,15275,20112012,0,60,4,2,2,4.79536825560945,4.03591279659304,0.759455459016408,30,32,-2,34,47,-13,44,64,-20,4,5,0,0
"19138","S.J","NYI",2011020144,15276,20112012,0,61.1166666666667,3,2,1,4.47511775029125,5.3262768223135,-0.851159072022254,30,37,-7,40,45,-5,53,61,-8,4,4,0,0
"19139","S.J","NYR",2011020157,15278,20112012,0,60,2,5,-3,2.72696838238615,3.94122124326714,-1.21425286088099,26,31,-5,38,43,-5,54,55,-1,3,5,0,0
"19140","S.J","PIT",2011020177,15281,20112012,1,65,3,3,0,10.6342285191786,5.6671632565849,4.96706526259368,37,36,1,56,42,14,73,58,15,2,1,0,0
"19141","S.J","NSH",2011020194,15283,20112012,1,62.8833333333333,3,4,-1,6.61248511241865,6.02499287724813,0.58749223517052,38,35,3,50,44,6,69,55,14,4,3,0,0
"19142","S.J","L.A",2011020201,15285,20112012,1,60,4,2,2,4.95457307563629,2.24300569732638,2.71156737830991,38,31,7,46,40,6,62,64,-2,6,6,0,0
"19143","S.J","MIN",2011020221,15288,20112012,1,60,3,1,2,5.9825669110287,2.56451251711587,3.41805439391283,36,22,14,44,27,17,68,42,26,6,4,0,0
"19144","S.J","DET",2011020270,15295,20112012,1,60,5,2,3,3.83375948863032,4.83867586161068,-1.00491637298036,28,42,-14,34,60,-26,41,84,-43,1,3,0,0
"19145","S.J","DAL",2011020284,15297,20112012,0,60,4,1,3,4.65503605338745,4.56529192843016,0.0897441249572921,38,31,7,51,53,-2,60,66,-6,9,6,0,0
"19146","S.J","COL",2011020287,15298,20112012,0,60,4,1,3,2.11717403744115,3.96463194612152,-1.84745790868038,18,37,-19,32,44,-12,47,54,-7,6,1,0,0
"19147","S.J","CHI",2011020312,15301,20112012,1,60,1,0,1,3.6698825679148,4.141309030927,-0.471426463012206,21,34,-13,29,44,-15,40,59,-19,4,4,0,0
"19148","S.J","VAN",2011020335,15304,20112012,1,60,2,3,-1,5.83880724197661,4.58397025903832,1.25483698293829,45,27,18,60,36,24,78,56,22,3,1,0,0
"19149","S.J","L.A",2011020344,15306,20112012,0,60,0,2,-2,6.89553951862035,5.80000739521347,1.09553212340688,33,33,0,56,46,10,75,58,17,7,6,0,0
"19150","S.J","MTL",2011020365,15309,20112012,1,65,3,3,0,4.55693693237845,3.50226948701311,1.05466744536534,41,32,9,53,39,14,76,57,19,1,1,0,0
"19151","S.J","FLA",2011020383,15311,20112012,1,60,3,5,-2,4.87112528234138,3.81424786066054,1.05687742168084,26,35,-9,40,42,-2,60,63,-3,3,5,0,0
"19152","S.J","MIN",2011020401,15314,20112012,1,60,1,2,-1,5.15962628442867,3.24419307988137,1.9154332045473,42,21,21,60,28,32,93,45,48,2,2,0,0
"19153","S.J","DAL",2011020416,15316,20112012,1,60,5,2,3,3.77767490612132,1.84991311827999,1.92776178784133,36,20,16,42,31,11,54,55,-1,6,6,0,0
"19154","S.J","STL",2011020428,15318,20112012,0,60,0,1,-1,2.18399897767813,2.09802321885218,0.0859757588259527,24,19,5,36,29,7,52,47,5,6,5,0,0
"19155","S.J","CHI",2011020434,15319,20112012,0,64.4333333333333,2,3,-1,5.58822842486552,3.09407581150299,2.49415261336253,37,34,3,44,40,4,55,54,1,2,3,0,0
"19156","S.J","COL",2011020447,15321,20112012,0,65,3,3,0,7.27402330306359,5.49114777939394,1.78287552366965,30,33,-3,37,45,-8,54,60,-6,3,2,0,0
"19157","S.J","COL",2011020460,15323,20112012,1,60,5,4,1,5.31674427015241,2.4011506918325,2.91559357831992,34,27,7,49,40,9,73,52,21,3,3,0,0
"19158","S.J","EDM",2011020477,15325,20112012,1,60,3,2,1,4.27922096558198,2.01929491853323,2.25992604704875,37,25,12,46,36,10,68,54,14,5,3,0,0
"19159","S.J","T.B",2011020499,15329,20112012,1,60,7,2,5,3.14187699697504,3.36649970721919,-0.224622710244148,43,24,19,57,37,20,72,57,15,4,4,0,0
"19160","S.J","L.A",2011020518,15331,20112012,1,65,1,1,0,5.26879139884841,4.36220182891944,0.906589569928968,35,29,6,52,41,11,76,61,15,6,4,0,0
"19161","S.J","ANA",2011020528,15334,20112012,1,60,2,3,-1,5.32882874918869,2.18663534650113,3.14219340268755,38,23,15,51,31,20,66,48,18,2,2,0,0
"19162","S.J","VAN",2011020541,15336,20112012,1,63.3833333333333,2,3,-1,3.9527176004718,5.44156907114666,-1.48885147067486,35,30,5,44,49,-5,60,70,-10,5,5,0,0
"19163","S.J","VAN",2011020572,15341,20112012,0,65,2,2,0,4.53561904106391,4.93991137916601,-0.404292338102096,35,29,6,49,40,9,56,64,-8,4,7,0,0
"19164","S.J","ANA",2011020583,15343,20112012,0,60,3,1,2,6.34457740554353,5.62072512402665,0.723852281516884,36,27,9,51,48,3,62,66,-4,4,3,0,0
"19165","S.J","CBJ",2011020592,15344,20112012,1,60,2,1,1,3.49683125002775,2.99256489467685,0.504266355350907,39,24,15,54,33,21,66,45,21,5,1,0,0
"19166","S.J","MIN",2011020624,15349,20112012,0,65,4,4,0,8.46976822544821,6.80007910256973,1.66968912287848,38,31,7,56,52,4,73,63,10,4,4,0,0
"19167","S.J","WPG",2011020638,15351,20112012,0,60,2,0,2,6.87147498305421,2.48760253138607,4.38387245166814,37,24,13,54,37,17,66,56,10,3,3,0,0
"19168","S.J","CBJ",2011020654,15353,20112012,0,60,2,1,1,3.98230036951645,2.74762039693209,1.23467997258436,33,26,7,43,32,11,56,45,11,3,3,0,0
"19169","S.J","CHI",2011020661,15354,20112012,0,60,3,4,-1,3.2670547278467,3.32239568344266,-0.0553409555959661,24,40,-16,30,56,-26,34,72,-38,3,1,0,0
"19170","S.J","CGY",2011020680,15356,20112012,1,65,1,1,0,3.96392734169785,6.15219477505889,-2.18826743336103,31,28,3,49,42,7,69,68,1,3,1,0,0
"19171","S.J","OTT",2011020694,15358,20112012,1,60,1,4,-3,4.00218197514187,4.56555218750259,-0.563370212360724,37,21,16,50,35,15,65,48,17,4,5,0,0
"19172","S.J","VAN",2011020701,15360,20112012,0,60,3,4,-1,6.76482577982824,6.5324990908266,0.232326689001638,26,30,-4,42,47,-5,52,70,-18,1,4,0,0
"19173","S.J","EDM",2011020720,15362,20112012,0,65,1,1,0,6.97251096733089,4.13688231710694,2.83562865022395,45,18,27,65,27,38,77,41,36,0,1,0,0
"19174","S.J","CGY",2011020732,15363,20112012,0,60,1,0,1,4.54029856645502,2.65914128993791,1.88115727651711,27,25,2,41,35,6,48,57,-9,3,2,0,0
"19175","S.J","CBJ",2011020748,15370,20112012,1,60,6,0,6,2.86964549939148,3.65869733448199,-0.789051835090504,43,30,13,54,45,9,70,59,11,4,2,0,0
"19176","S.J","DAL",2011020761,15372,20112012,1,60,5,2,3,4.09321068006102,3.04061752077541,1.05259315928561,37,21,16,52,30,22,73,41,32,6,3,0,0
"19177","S.J","CGY",2011020800,15378,20112012,1,60,3,4,-1,5.35412206896581,4.84954839481452,0.504573674151288,37,36,1,58,50,8,71,61,10,2,4,0,0
"19178","S.J","CHI",2011020815,15380,20112012,1,60,5,3,2,3.07015076680129,6.58409606797235,-3.51394530117105,27,33,-6,37,40,-3,50,65,-15,7,5,0,0
"19179","S.J","STL",2011020833,15382,20112012,0,60,0,3,-3,4.13360041739493,6.44314396635016,-2.30954354895523,25,28,-3,39,40,-1,57,58,-1,4,6,0,0
"19180","S.J","T.B",2011020853,15386,20112012,0,64.45,5,6,-1,5.25274510611962,2.83163817332684,2.42110693279278,50,25,25,66,31,35,76,43,33,3,1,0,0
"19181","S.J","CAR",2011020859,15387,20112012,0,60,2,3,-1,8.72720925181056,6.22744300447357,2.49976624733699,37,25,12,52,34,18,70,44,26,2,3,0,0
"19182","S.J","DET",2011020874,15389,20112012,0,60,2,3,-1,4.40377393806557,3.25098344691912,1.15279049114645,33,28,5,45,32,13,57,40,17,4,3,0,0
"19183","S.J","CBJ",2011020888,15391,20112012,0,60,3,6,-3,3.73611410713056,4.7234535800817,-0.987339472951135,41,35,6,50,42,8,60,52,8,4,7,0,0
"19184","S.J","TOR",2011020899,15393,20112012,0,60,2,1,1,3.25607589562424,3.55882566981822,-0.302749774193982,25,30,-5,43,41,2,58,56,2,2,0,0,0
"19185","S.J","NSH",2011020923,15395,20112012,0,60,2,6,-4,3.3490951963322,5.453219121031,-2.1041239246988,34,21,13,45,29,16,56,40,16,3,4,0,0
"19186","S.J","MIN",2011020930,15396,20112012,0,60,3,4,-1,4.6651001084568,4.25572297115312,0.40937713730368,28,26,2,38,31,7,54,45,9,3,4,0,0
"19187","S.J","PHI",2011020945,15398,20112012,1,60,1,0,1,4.03987257019207,3.81113695450409,0.228735615687981,23,26,-3,34,37,-3,52,55,-3,1,2,0,0
"19188","S.J","STL",2011020973,15402,20112012,1,60,1,3,-2,3.91579915191951,4.67136641404798,-0.755567262128466,19,32,-13,32,40,-8,51,69,-18,3,5,0,0
"19189","S.J","EDM",2011020995,15405,20112012,1,65,2,2,0,6.51638263665539,3.78626414650353,2.73011849015187,30,26,4,43,45,-2,67,60,7,2,1,0,0
"19190","S.J","DAL",2011021006,15407,20112012,0,65,3,3,0,7.09214456076734,6.30871185335855,0.783432707408792,48,35,13,66,52,14,88,65,23,3,2,0,0
"19191","S.J","ARI",2011021023,15409,20112012,0,60,0,3,-3,6.39714408584405,4.45280412138212,1.94433996446193,42,29,13,55,42,13,82,54,28,3,1,0,0
"19192","S.J","EDM",2011021035,15411,20112012,0,60,3,2,1,3.83178154674533,4.03790272620972,-0.20612117946439,33,22,11,43,32,11,56,43,13,3,2,0,0
"19193","S.J","CGY",2011021044,15412,20112012,0,64.3333333333333,2,3,-1,5.92325117585574,3.99778274311029,1.92546843274545,31,22,9,49,31,18,67,39,28,4,3,0,0
"19194","S.J","NSH",2011021059,15414,20112012,1,65,1,1,0,6.81291929193821,5.31089020304103,1.50202908889719,35,33,2,52,44,8,78,57,21,5,3,0,0
"19195","S.J","DET",2011021075,15416,20112012,1,63.3833333333333,3,2,1,5.13619133844622,2.33706636310671,2.79912497533951,35,28,7,52,40,12,70,59,11,3,2,0,0
"19196","S.J","ANA",2011021087,15418,20112012,1,60,3,5,-2,5.31823078383481,5.04058957973029,0.277641204104512,30,40,-10,46,46,0,63,65,-2,3,2,0,0
"19197","S.J","L.A",2011021096,15419,20112012,0,60,2,5,-3,3.40744480328931,7.06982496706769,-3.66238016377838,22,42,-20,31,56,-25,44,71,-27,2,4,0,0
"19198","S.J","BOS",2011021109,15421,20112012,1,60,2,1,1,5.40771388902346,4.69282488540193,0.714889003621522,27,17,10,36,29,7,49,46,3,1,1,0,0
"19199","S.J","ARI",2011021126,15423,20112012,1,65,3,3,0,5.05469607101986,3.23967743352841,1.81501863749145,32,27,5,57,30,27,85,40,45,5,1,0,0
"19200","S.J","COL",2011021139,15425,20112012,1,60,5,1,4,3.50473864933156,8.619269232433,-5.11453058310144,36,32,4,54,44,10,69,71,-2,4,2,0,0
"19201","S.J","ANA",2011021153,15427,20112012,0,60,1,3,-2,4.41001857157244,5.10092373621592,-0.690905164643482,29,28,1,40,36,4,51,48,3,1,0,0,0
"19202","S.J","ARI",2011021160,15428,20112012,0,60,0,2,-2,5.08285508624334,4.78357252200658,0.299282564236762,38,33,5,56,43,13,70,58,12,1,1,0,0
"19203","S.J","DAL",2011021180,15430,20112012,1,60,3,0,3,3.19099357072264,3.05168720302117,0.139306367701472,34,22,12,42,33,9,57,46,11,6,3,0,0
"19204","S.J","DAL",2011021196,15433,20112012,0,60,5,2,3,5.66881123952044,4.93547536830951,0.733335871210926,26,31,-5,41,44,-3,61,66,-5,3,2,0,0
"19205","S.J","L.A",2011021214,15435,20112012,0,65,5,5,0,3.61572520799136,7.11829872637802,-3.50257351838666,31,36,-5,41,51,-10,54,70,-16,6,8,0,0
"19206","S.J","L.A",2011021230,15437,20112012,1,63.9666666666667,3,2,1,3.27479738747934,5.26326556020649,-1.98846817272715,23,31,-8,39,42,-3,51,66,-15,5,3,0,0
"19207","S.J","STL",2011030161,15442,20112012,0,80,2,2,0,4.73693259087304,7.32597500533806,-2.58904241446502,31,42,-11,42,59,-17,61,76,-15,4,4,0,0
"19208","S.J","STL",2011030162,15444,20112012,0,60,0,3,-3,3.34555309580173,5.42825224692933,-2.0826991511276,29,33,-4,42,42,0,59,59,0,9,12,0,0
"19209","S.J","STL",2011030163,15446,20112012,1,60,3,4,-1,5.1781470255177,3.00023799625847,2.17790902925923,29,27,2,46,35,11,66,43,23,5,5,0,0
"19210","S.J","STL",2011030164,15449,20112012,1,60,1,2,-1,3.16559409604815,3.21620351220736,-0.0506094161592046,25,24,1,39,31,8,65,47,18,4,3,0,0
"19211","S.J","STL",2011030165,15451,20112012,0,60,1,3,-2,3.1086562451419,5.92631193158741,-2.81765568644551,27,27,0,39,41,-2,60,54,6,2,2,0,0
"19212","S.J","CGY",2012020016,15725,20122013,0,60,4,1,3,3.7944311046158,3.15030155286618,0.644129551749617,29,32,-3,37,46,-9,52,58,-6,6,3,0,0
"19213","S.J","EDM",2012020035,15727,20122013,0,60,6,3,3,3.59391674669823,2.56722720776118,1.02668953893705,31,29,2,39,37,2,51,47,4,6,6,0,0
"19214","S.J","ARI",2012020049,15729,20122013,1,60,5,3,2,5.66429197995376,3.88136639428558,1.78292558566818,35,35,0,50,52,-2,68,77,-9,7,5,0,0
"19215","S.J","COL",2012020057,15731,20122013,1,60,4,0,4,8.18338318075985,3.16346013118164,5.01992304957821,43,24,19,53,37,16,77,60,17,8,3,0,0
"19216","S.J","VAN",2012020072,15732,20122013,1,60,4,1,3,3.54042224358326,5.08386951973353,-1.54344727615027,27,24,3,34,41,-7,47,62,-15,9,8,0,0
"19217","S.J","ANA",2012020087,15734,20122013,1,65,2,2,0,3.87247712530615,4.95222194495125,-1.0797448196451,18,30,-12,37,45,-8,52,67,-15,2,4,0,0
"19218","S.J","EDM",2012020100,15736,20122013,1,65,2,2,0,5.07063710318675,2.62238794930951,2.44824915387724,38,28,10,57,34,23,76,47,29,5,3,0,0
"19219","S.J","NSH",2012020118,15738,20122013,1,65,1,1,0,4.3128862711601,3.3344493131608,0.978436957999293,27,24,3,37,35,2,54,53,1,5,5,0,0
"19220","S.J","ANA",2012020127,15740,20122013,0,60,1,2,-1,3.64765123543118,3.3716163687139,0.276034866717286,26,32,-6,44,43,1,68,58,10,6,6,0,0
"19221","S.J","CHI",2012020137,15741,20122013,1,60,3,5,-2,3.3462063932966,4.545948296407,-1.19974190311041,33,31,2,44,35,9,55,46,9,6,4,0,0
"19222","S.J","ARI",2012020159,15745,20122013,1,65,0,0,0,2.67136483077047,3.69578711752024,-1.02442228674977,33,21,12,51,34,17,73,45,28,4,3,0,0
"19223","S.J","CBJ",2012020174,15747,20122013,0,60,2,6,-4,3.35496455116663,5.0220081589398,-1.66704360777317,27,36,-9,33,46,-13,45,56,-11,3,4,0,0
"19224","S.J","NSH",2012020184,15748,20122013,0,62.1333333333333,0,1,-1,4.83136184554314,3.04381799615484,1.7875438493883,25,25,0,37,34,3,55,48,7,5,3,0,0
"19225","S.J","CHI",2012020201,15751,20122013,0,60,1,4,-3,5.31539314428483,4.20181367906298,1.11357946522185,28,37,-9,38,45,-7,53,54,-1,6,7,0,0
"19226","S.J","STL",2012020230,15755,20122013,0,60,2,1,1,4.41589964214904,3.08986011697561,1.32603952517343,25,26,-1,36,36,0,51,54,-3,5,4,0,0
"19227","S.J","CHI",2012020249,15758,20122013,0,60,1,2,-1,2.03676963278849,4.45661848472264,-2.41984885193415,27,34,-7,36,42,-6,51,59,-8,5,3,0,0
"19228","S.J","DAL",2012020260,15759,20122013,0,60,1,3,-2,5.83296966936539,4.93645939507454,0.896510274290852,32,28,4,52,46,6,59,60,-1,8,8,0,0
"19229","S.J","COL",2012020283,15762,20122013,1,65,2,2,0,5.98927690553319,4.19394535563697,1.79533154989622,41,27,14,58,35,23,80,47,33,5,2,0,0
"19230","S.J","DET",2012020298,15764,20122013,1,65,1,1,0,3.79677226830972,5.4295318685472,-1.63275960023748,26,34,-8,37,50,-13,60,75,-15,1,2,0,0
"19231","S.J","NSH",2012020310,15766,20122013,1,60,2,1,1,4.99644700373756,3.24737164381077,1.74907535992679,39,19,20,50,26,24,68,52,16,4,1,0,0
"19232","S.J","VAN",2012020333,15769,20122013,0,65,2,2,0,5.60600483132293,4.74126481369002,0.86474001763291,30,38,-8,44,53,-9,54,73,-19,3,5,0,0
"19233","S.J","CGY",2012020337,15770,20122013,0,60,1,4,-3,4.96841810370927,4.11943174147746,0.848986362231813,33,26,7,48,39,9,62,47,15,4,3,0,0
"19234","S.J","STL",2012020358,15773,20122013,1,61.2,3,4,-1,3.53028291565715,5.60132140348641,-2.07103848782926,25,35,-10,30,49,-19,53,64,-11,3,5,0,0
"19235","S.J","COL",2012020373,15774,20122013,0,64.9833333333333,2,3,-1,8.21278586348931,5.08247900494747,3.13030685854184,38,42,-4,54,54,0,66,68,-2,5,4,0,0
"19236","S.J","STL",2012020383,15776,20122013,0,60,2,4,-2,5.49571288781954,5.77231773477979,-0.276604846960254,41,21,20,53,32,21,75,44,31,4,4,0,0
"19237","S.J","L.A",2012020401,15778,20122013,1,60,4,3,1,4.16342732612247,7.75563320095534,-3.59220587483287,26,37,-11,40,44,-4,55,68,-13,3,3,0,0
"19238","S.J","L.A",2012020417,15780,20122013,0,60,2,5,-3,4.4478940482004,4.56205926633652,-0.114165218136126,22,24,-2,37,41,-4,57,56,1,2,1,0,0
"19239","S.J","ANA",2012020427,15782,20122013,0,60,3,5,-2,4.2105567646795,3.77324885711577,0.437307907563723,35,28,7,51,36,15,67,44,23,3,1,0,0
"19240","S.J","EDM",2012020441,15784,20122013,0,65,3,3,0,4.55458441222228,3.9751837059739,0.579400706248379,34,27,7,49,41,8,64,58,6,3,6,0,0
"19241","S.J","MIN",2012020457,15787,20122013,0,60,0,2,-2,3.68532300461084,2.15323075575157,1.53209224885927,33,24,9,45,29,16,61,43,18,4,3,0,0
"19242","S.J","ANA",2012020478,15789,20122013,0,60,5,3,2,5.11492557642869,3.33630558223172,1.77861999419697,39,27,12,47,39,8,59,59,0,5,2,0,0
"19243","S.J","ANA",2012020491,15791,20122013,1,60,4,0,4,5.57013526239461,3.20336605434409,2.36676920805053,29,22,7,39,36,3,52,66,-14,4,3,0,0
"19244","S.J","DET",2012020501,15792,20122013,1,60,2,0,2,3.72152729630761,4.43174377066316,-0.710216474355548,24,27,-3,36,43,-7,52,66,-14,0,1,0,0
"19245","S.J","ARI",2012020516,15794,20122013,1,65,2,2,0,2.70169781544973,3.0331945149228,-0.331496699473064,34,29,5,59,39,20,86,55,31,1,1,0,0
"19246","S.J","VAN",2012020530,15796,20122013,1,60,3,2,1,3.40909374773219,4.62672708322503,-1.21763333549285,35,25,10,49,38,11,60,65,-5,3,0,0,0
"19247","S.J","MIN",2012020542,15798,20122013,1,60,4,2,2,4.53584115358535,3.81244658435942,0.723394569225931,33,33,0,45,43,2,55,65,-10,7,3,0,0
"19248","S.J","CGY",2012020558,15800,20122013,1,60,2,1,1,4.48034136157398,3.62510242930148,0.855238932272501,41,24,17,57,32,25,79,45,34,3,2,0,0
"19249","S.J","DAL",2012020570,15802,20122013,1,65,4,4,0,5.56377884165327,3.45975079954371,2.10402804210956,36,34,2,49,49,0,63,73,-10,3,3,0,0
"19250","S.J","CBJ",2012020584,15804,20122013,0,60,0,4,-4,5.16618089465192,4.45282894952106,0.713351945130853,30,30,0,45,43,2,59,53,6,2,3,0,0
"19251","S.J","DET",2012020601,15806,20122013,0,65,2,2,0,6.45177219862671,3.74684649005636,2.70492570857035,30,29,1,45,42,3,55,59,-4,4,4,0,0
"19252","S.J","DAL",2012020618,15808,20122013,0,60,1,2,-1,6.75137740001082,2.57643931484199,4.17493808516883,32,19,13,53,25,28,83,35,48,2,5,0,0
"19253","S.J","ARI",2012020631,15810,20122013,0,60,4,0,4,6.19911147645325,4.63220966243431,1.56690181401895,41,35,6,53,55,-2,65,68,-3,3,4,0,0
"19254","S.J","L.A",2012020639,15811,20122013,1,65,2,2,0,4.26348349901312,6.63839059803286,-2.37490709901974,35,43,-8,47,53,-6,68,68,0,5,5,0,0
"19255","S.J","MIN",2012020653,15813,20122013,1,60,6,1,5,5.79605980875203,4.25023477489594,1.54582503385609,29,28,1,41,41,0,54,59,-5,2,1,0,0
"19256","S.J","CBJ",2012020674,15816,20122013,1,60,3,4,-1,5.56285190861672,3.29364484822145,2.26920706039527,35,22,13,51,34,17,71,52,19,3,2,0,0
"19257","S.J","DAL",2012020689,15818,20122013,1,60,3,2,1,7.23711274961352,4.14396755091103,3.09314519870249,37,26,11,53,40,13,81,63,18,3,3,0,0
"19258","S.J","ARI",2012020693,15819,20122013,0,60,1,2,-1,2.89487888658186,5.1429819230581,-2.24810303647624,34,32,2,46,44,2,66,58,8,2,4,0,0
"19259","S.J","L.A",2012020720,15822,20122013,0,60,2,3,-1,3.4585928596789,5.0181817607081,-1.5595889010292,25,27,-2,33,47,-14,45,61,-16,0,1,0,0
"19260","S.J","VAN",2012030171,15826,20122013,0,60,3,1,2,2.95569805963896,6.11864435646704,-3.16294629682808,28,31,-3,35,44,-9,46,59,-13,5,3,0,0
"19261","S.J","VAN",2012030172,15828,20122013,0,65.5166666666667,3,2,1,7.22100794286234,5.56435773381963,1.65665020904271,33,31,2,43,48,-5,54,70,-16,5,3,0,0
"19262","S.J","VAN",2012030173,15830,20122013,1,60,5,2,3,5.61892365250969,6.37991813151062,-0.760994479000924,38,30,8,48,39,9,65,59,6,11,4,0,0
"19263","S.J","VAN",2012030174,15832,20122013,1,73.3,4,3,1,8.4701322925539,5.87363412811101,2.59649816444289,47,35,12,66,47,19,82,70,12,6,3,0,0
"19264","S.J","L.A",2012030241,15839,20122013,0,60,0,2,-2,5.59559524749056,4.45415332744597,1.1414419200446,35,20,15,55,37,18,69,47,22,3,1,0,0
"19265","S.J","L.A",2012030242,15841,20122013,0,60,3,4,-1,5.09932584661874,6.39394093924511,-1.29461509262637,31,31,0,41,46,-5,51,61,-10,4,6,0,0
"19266","S.J","L.A",2012030243,15843,20122013,1,61.4833333333333,2,1,1,6.0692993629109,5.61731538164895,0.451983981261947,40,27,13,55,41,14,81,64,17,6,3,0,0
"19267","S.J","L.A",2012030244,15846,20122013,1,60,2,1,1,3.13704345266888,3.85485324085539,-0.717809788186514,23,23,0,39,36,3,56,61,-5,4,3,0,0
"19268","S.J","L.A",2012030245,15848,20122013,0,60,0,3,-3,2.04806484638539,4.68854471595068,-2.6404798695653,24,29,-5,36,48,-12,45,67,-22,3,3,0,0
"19269","S.J","L.A",2012030246,15851,20122013,1,60,2,1,1,3.30329493797035,3.37047547663678,-0.0671805386664346,26,25,1,37,36,1,50,56,-6,4,2,0,0
"19270","S.J","L.A",2012030247,15853,20122013,0,60,1,2,-1,3.45938146751723,6.842466450762,-3.38308498324477,26,18,8,39,30,9,55,41,14,3,4,0,0
"19271","S.J","VAN",2013020014,15981,20132014,1,60,4,1,3,5.98852391439141,5.44961140077794,0.538912513613468,35,22,13,52,44,8,74,62,12,8,6,0,0
"19272","S.J","ARI",2013020031,15983,20132014,1,60,4,1,3,8.40338949716534,3.12113351261564,5.28225598454969,51,23,28,66,30,36,79,44,35,4,1,0,0
"19273","S.J","NYR",2013020044,15986,20132014,1,60,9,2,7,7.21536877695439,3.39770074433181,3.81766803262258,47,20,27,69,38,31,91,54,37,3,3,0,0
"19274","S.J","VAN",2013020056,15988,20132014,0,60,4,1,3,4.94677275779395,2.91406962347025,2.0327031343237,29,26,3,42,28,14,57,41,16,3,1,0,0
"19275","S.J","OTT",2013020074,15990,20132014,1,60,3,2,1,8.39471424639896,3.10314514616039,5.29156910023858,50,23,27,72,32,40,87,48,39,5,4,0,0
"19276","S.J","STL",2013020089,15993,20132014,0,60,6,2,4,6.54560030158609,4.77629985841824,1.76930044316785,39,27,12,55,41,14,65,59,6,6,6,0,0
"19277","S.J","DAL",2013020106,15995,20132014,0,65,3,3,0,6.78551506960503,7.42868841708221,-0.643173347477187,35,31,4,62,47,15,86,65,21,5,2,0,0
"19278","S.J","CGY",2013020121,15997,20132014,1,60,6,3,3,5.99067227735213,3.68696719130139,2.30370508605074,36,19,17,52,27,25,75,48,27,11,7,0,0
"19279","S.J","DET",2013020126,15999,20132014,0,65,0,0,0,4.26419974325108,4.58287735155318,-0.318677608302096,27,24,3,31,39,-8,45,50,-5,3,2,0,0
"19280","S.J","BOS",2013020139,16002,20132014,0,60,1,2,-1,6.97132138994493,3.06397578377312,3.90734560617182,39,17,22,53,30,23,71,43,28,1,1,0,0
"19281","S.J","MTL",2013020157,16004,20132014,0,60,2,0,2,5.83005014449736,4.93586563663672,0.894184507860643,37,22,15,52,31,21,70,43,27,4,1,0,0
"19282","S.J","OTT",2013020166,16005,20132014,0,60,5,2,3,4.22878679360292,5.98424718953007,-1.75546039592714,29,40,-11,41,53,-12,53,69,-16,3,3,0,0
"19283","S.J","L.A",2013020187,16008,20132014,0,62.5333333333333,3,4,-1,2.83362323197071,6.29022686200743,-3.45660363003673,20,23,-3,32,46,-14,39,63,-24,4,6,0,0
"19284","S.J","ARI",2013020211,16011,20132014,1,65,2,2,0,4.33162391663063,7.0072659640573,-2.67564204742666,50,30,20,61,38,23,87,58,29,5,4,0,0
"19285","S.J","VAN",2013020240,16016,20132014,1,60,2,4,-2,5.04234304208512,3.30006107754568,1.74228196453944,24,34,-10,38,41,-3,53,48,5,4,4,0,0
"19286","S.J","WPG",2013020259,16019,20132014,0,65,4,4,0,4.27909116573344,8.07292270893375,-3.79383154320031,34,46,-12,47,62,-15,57,79,-22,6,3,0,0
"19287","S.J","CGY",2013020273,16021,20132014,0,61.2166666666667,3,2,1,5.09009154420346,3.4586591363186,1.63143240788486,35,13,22,50,18,32,73,32,41,2,2,0,0
"19288","S.J","VAN",2013020283,16023,20132014,0,62.6333333333333,2,1,1,2.56278991116756,6.65909499244299,-4.09630508127542,30,35,-5,38,50,-12,63,71,-8,5,3,0,0
"19289","S.J","EDM",2013020293,16024,20132014,0,60,3,1,2,7.93329029239248,6.02410153578967,1.90918875660282,37,31,6,56,45,11,68,63,5,5,4,0,0
"19290","S.J","CHI",2013020306,16026,20132014,0,60,1,5,-4,2.9402428100293,4.00830505572674,-1.06806224569743,24,27,-3,33,37,-4,47,54,-7,2,2,0,0
"19291","S.J","T.B",2013020335,16030,20132014,1,60,5,1,4,4.58063491297071,6.11877785503202,-1.53814294206131,36,37,-1,54,53,1,65,70,-5,2,1,0,0
"19292","S.J","N.J",2013020352,16032,20132014,1,60,2,1,1,4.81414875090604,2.30319522318314,2.5109535277229,30,19,11,41,27,14,57,45,12,3,1,0,0
"19293","S.J","L.A",2013020377,16036,20132014,1,65,2,2,0,9.23678910925049,5.74460140586284,3.49218770338765,40,40,0,62,51,11,78,73,5,4,4,0,0
"19294","S.J","STL",2013020385,16038,20132014,1,60,6,3,3,3.80021266902804,4.28825679759029,-0.488044128562251,32,24,8,42,36,6,61,63,-2,7,7,0,0
"19295","S.J","ANA",2013020402,16039,20132014,1,65,3,3,0,6.11796558220109,4.19513614846528,1.92282943373581,35,31,4,52,43,9,79,59,20,7,5,0,0
"19296","S.J","TOR",2013020410,16042,20132014,0,60,4,2,2,6.25975730038938,3.1333134243614,3.12644387602798,41,30,11,67,39,28,86,48,38,4,3,0,0
"19297","S.J","CAR",2013020433,16045,20132014,0,60,3,5,-2,3.22575286461506,7.84762456287493,-4.62187169825987,25,35,-10,36,47,-11,59,67,-8,2,1,0,0
"19298","S.J","MIN",2013020449,16047,20132014,0,60,1,3,-2,4.22453398778362,3.21168505589594,1.01284893188767,38,13,25,51,22,29,69,33,36,4,2,0,0
"19299","S.J","NYI",2013020469,16049,20132014,1,65,2,2,0,7.18811665306566,6.30115166155156,0.886964991514105,48,28,20,68,37,31,95,62,33,4,1,0,0
"19300","S.J","MIN",2013020483,16051,20132014,1,60,3,1,2,5.94131617352832,3.96994859380538,1.97136757972294,39,30,9,55,44,11,68,60,8,7,4,0,0
"19301","S.J","NSH",2013020495,16053,20132014,0,60,2,3,-1,5.51660785195418,3.92659467831254,1.59001317364164,38,23,15,47,28,19,59,38,21,2,2,0,0
"19302","S.J","STL",2013020516,16056,20132014,0,60,4,2,2,3.58969854996121,2.87039395581814,0.719304594143068,27,22,5,40,35,5,49,58,-9,4,4,0,0
"19303","S.J","L.A",2013020533,16058,20132014,0,60,1,4,-3,4.26278788157754,5.41310629882355,-1.15031841724601,32,32,0,48,46,2,57,59,-2,3,2,0,0
"19304","S.J","DAL",2013020550,16060,20132014,1,65,2,2,0,2.62826527362824,5.11717328499071,-2.48890801136247,39,46,-7,48,59,-11,61,71,-10,3,2,0,0
"19305","S.J","COL",2013020566,16062,20132014,1,65,4,4,0,7.99626060132869,5.84453863518138,2.15172196614731,45,33,12,64,43,21,90,65,25,4,3,0,0
"19306","S.J","ARI",2013020576,16066,20132014,0,65,3,3,0,3.89745044007347,5.18767417757772,-1.29022373750425,32,37,-5,53,48,5,72,64,8,3,2,0,0
"19307","S.J","ANA",2013020594,16068,20132014,1,60,3,1,2,3.34711198313744,3.77789425978699,-0.430782276649552,23,31,-8,36,40,-4,51,70,-19,2,1,0,0
"19308","S.J","ANA",2013020607,16070,20132014,0,60,3,6,-3,4.44014314166679,1.5135169284747,2.92662621319209,36,38,-2,50,42,8,65,53,12,6,4,0,0
"19309","S.J","EDM",2013020621,16072,20132014,1,60,5,1,4,4.04432881883986,3.78532668028849,0.259002138551372,36,24,12,49,35,14,64,47,17,3,3,0,0
"19310","S.J","COL",2013020627,16074,20132014,0,60,3,4,-1,3.70172325694466,3.66808190797019,0.03364134897447,33,21,12,45,28,17,67,36,31,4,5,0,0
"19311","S.J","CHI",2013020640,16075,20132014,0,65,2,2,0,9.13712991290959,7.18814267501875,1.94898723789083,42,35,7,48,44,4,65,58,7,1,0,0,0
"19312","S.J","NSH",2013020650,16077,20132014,0,60,2,3,-1,4.32094942973345,3.74613002274446,0.574819406988986,28,28,0,40,41,-1,60,48,12,5,2,0,0
"19313","S.J","DET",2013020668,16079,20132014,1,60,4,1,3,5.27428574235819,4.12661581486464,1.14766992749355,26,25,1,45,36,9,59,54,5,7,7,0,0
"19314","S.J","BOS",2013020684,16081,20132014,1,60,0,1,-1,4.72494388872292,5.14082459712453,-0.415880708401607,26,22,4,44,38,6,60,59,1,1,3,0,0
"19315","S.J","FLA",2013020714,16086,20132014,0,60,3,0,3,4.45644226719706,2.65982960449624,1.79661266270082,39,24,15,52,31,21,58,45,13,4,3,0,0
"19316","S.J","T.B",2013020724,16088,20132014,0,60,5,4,1,4.62985654364456,3.84662802137245,0.783228522272111,32,29,3,42,44,-2,57,57,0,3,5,0,0
"19317","S.J","CGY",2013020745,16090,20132014,1,60,3,2,1,3.82507928406994,3.54845976491924,0.276619519150699,27,23,4,37,32,5,58,55,3,1,0,0,0
"19318","S.J","WPG",2013020768,16093,20132014,1,60,1,0,1,4.15319857511343,1.95181245464033,2.2013861204731,32,20,12,50,34,16,66,45,21,4,3,0,0
"19319","S.J","MIN",2013020783,16095,20132014,1,63.5,3,2,1,4.20654619873676,1.57233256730251,2.63421363143425,32,22,10,45,34,11,71,45,26,2,2,0,0
"19320","S.J","L.A",2013020794,16097,20132014,1,60,0,1,-1,2.34097642259439,5.88711434967523,-3.54613792708083,23,21,2,31,33,-2,55,55,0,5,6,0,0
"19321","S.J","EDM",2013020807,16099,20132014,0,60,0,3,-3,6.1230398775042,1.92435673748863,4.19868314001556,59,27,32,78,31,47,100,38,62,4,3,0,0
"19322","S.J","CGY",2013020815,16100,20132014,0,60,1,4,-3,3.33378210790397,4.67897872428875,-1.34519661638478,28,30,-2,39,40,-1,52,52,0,1,2,0,0
"19323","S.J","CHI",2013020834,16102,20132014,1,65,1,1,0,4.59278696648488,4.49691130948486,0.0958756570000219,39,30,9,47,44,3,58,65,-7,4,4,0,0
"19324","S.J","PHI",2013020843,16104,20132014,1,60,2,5,-3,1.71759491570992,4.80851921813713,-3.0909243024272,22,28,-6,29,41,-12,46,61,-15,5,2,0,0
"19325","S.J","DAL",2013020855,16106,20132014,1,61.8666666666667,2,1,1,7.84174017002806,1.02607284335977,6.81566732666829,21,20,1,36,30,6,57,48,9,3,1,0,0
"19326","S.J","CBJ",2013020871,16108,20132014,1,60,3,2,1,7.50562000807258,2.79745594477845,4.70816406329413,47,21,26,61,33,28,74,50,24,5,4,0,0
"19327","S.J","PHI",2013020889,16128,20132014,0,60,7,3,4,4.09298037618493,2.53746877449805,1.55551160168688,29,30,-1,47,40,7,57,51,6,5,5,0,0
"19328","S.J","N.J",2013020913,16131,20132014,0,60,4,2,2,0.960509247845039,3.83253353102373,-2.87202428317869,22,23,-1,23,34,-11,29,36,-7,1,4,0,0
"19329","S.J","CAR",2013020933,16133,20132014,1,64.3,2,3,-1,8.88821319054364,4.76957367546856,4.11863951507507,37,35,2,56,48,8,73,63,10,1,2,0,0
"19330","S.J","MTL",2013020962,16137,20132014,1,60,4,0,4,5.0237190164038,2.56507550838745,2.45864350801636,33,27,6,45,33,12,57,47,10,9,8,0,0
"19331","S.J","TOR",2013020984,16140,20132014,1,60,6,2,4,5.56708410875581,4.11161227368672,1.45547183506909,48,21,27,65,28,37,90,35,55,6,2,0,0
"19332","S.J","CBJ",2013020991,16142,20132014,0,65,3,3,0,4.37838731508236,6.46824029480594,-2.08985297972358,27,38,-11,33,53,-20,45,71,-26,3,3,0,0
"19333","S.J","NYI",2013020996,16143,20132014,0,60,4,3,1,4.53071860552882,4.39029457801371,0.14042402751511,26,38,-12,40,49,-9,50,62,-12,1,0,0,0
"19334","S.J","NYR",2013021016,16145,20132014,0,60,1,0,1,3.6689678186321,5.59430832431826,-1.92534050568616,29,41,-12,37,53,-16,56,75,-19,1,3,0,0
"19335","S.J","FLA",2013021037,16147,20132014,1,60,2,3,-1,9.44377591295051,2.41296093493293,7.03081497801759,54,24,30,75,31,44,99,40,59,6,2,0,0
"19336","S.J","ANA",2013021050,16149,20132014,1,60,3,2,1,5.37429565793354,3.28023959991697,2.09405605801658,28,18,10,47,31,16,65,48,17,3,2,0,0
"19337","S.J","CGY",2013021078,16153,20132014,0,65,1,1,0,4.97633542163021,3.05213937813543,1.92419604349478,34,27,7,52,34,18,69,48,21,2,3,0,0
"19338","S.J","EDM",2013021088,16154,20132014,0,60,5,2,3,5.41694831383938,3.3330056888517,2.08394262498769,34,30,4,46,38,8,63,60,3,3,2,0,0
"19339","S.J","WPG",2013021101,16156,20132014,1,60,3,4,-1,4.19663555742702,5.66492632495263,-1.46829076752561,30,31,-1,41,45,-4,55,66,-11,5,6,0,0
"19340","S.J","COL",2013021109,16158,20132014,0,60,2,3,-1,7.59526197065134,3.52194674347993,4.07331522717141,49,22,27,62,30,32,87,33,54,5,5,0,0
"19341","S.J","EDM",2013021139,16161,20132014,1,60,5,4,1,5.30088477098109,2.16207227809178,3.1388124928893,33,29,4,45,39,6,61,49,12,9,5,0,0
"19342","S.J","L.A",2013021152,16163,20132014,1,60,2,1,1,4.46439629330416,6.58142377412878,-2.11702748082462,21,27,-6,32,53,-21,49,80,-31,4,7,0,0
"19343","S.J","NSH",2013021170,16165,20132014,1,60,0,3,-3,5.57661771209392,5.12557358906562,0.451044123028304,35,24,11,53,34,19,74,44,30,3,2,0,0
"19344","S.J","ANA",2013021193,16169,20132014,0,60,2,5,-3,5.46262489142828,3.70342041537113,1.75920447605714,38,30,8,57,47,10,70,62,8,6,4,0,0
"19345","S.J","COL",2013021211,16171,20132014,1,60,5,1,4,6.6773581703892,5.60792726461659,1.06943090577261,30,33,-3,47,40,7,59,51,8,2,2,0,0
"19346","S.J","ARI",2013021218,16172,20132014,0,60,3,2,1,2.92817056667991,4.73584978823283,-1.80767922155292,32,32,0,37,48,-11,49,66,-17,3,1,0,0
"19347","S.J","L.A",2013030181,16177,20132014,1,60,6,3,3,5.43288061002386,4.53030672640775,0.902573883616109,33,34,-1,49,39,10,65,58,7,5,5,0,0
"19348","S.J","L.A",2013030182,16180,20132014,1,60,7,2,5,4.80589218740351,2.16371800408425,2.64217418331926,40,26,14,50,36,14,60,58,2,8,4,0,0
"19349","S.J","L.A",2013030183,16182,20132014,0,66.3333333333333,4,3,1,7.26972826915954,8.02509420344904,-0.755365934289502,40,31,9,55,56,-1,65,73,-8,4,4,0,0
"19350","S.J","L.A",2013030184,16184,20132014,0,60,3,6,-3,5.73898029813517,4.70499589098654,1.03398440714864,39,31,8,59,43,16,71,53,18,8,9,0,0
"19351","S.J","L.A",2013030185,16186,20132014,1,60,0,3,-3,4.24368592018283,3.57126069789043,0.672425222292397,30,41,-11,46,51,-5,62,62,0,6,6,0,0
"19352","S.J","L.A",2013030186,16188,20132014,0,60,1,4,-3,6.73620967292886,6.38968542925431,0.346524243674544,26,30,-4,43,42,1,59,55,4,7,7,0,0
"19353","S.J","L.A",2013030187,16190,20132014,1,60,1,5,-4,7.60970592705939,7.27234054496853,0.337365382090866,40,30,10,52,44,8,75,60,15,6,3,0,0
"19354","S.J","L.A",2014020004,16351,20142015,0,60,4,0,4,4.31657264293307,6.23686289946251,-1.92029025652945,30,34,-4,45,53,-8,58,68,-10,4,5,0,0
"19355","S.J","WPG",2014020032,16354,20142015,1,60,3,0,3,3.12620774365496,3.38651349359787,-0.260305749942916,26,30,-4,40,39,1,54,55,-1,9,3,0,0
"19356","S.J","NYI",2014020050,16359,20142015,0,65,3,3,0,2.54033971204808,5.19527054345235,-2.65493083140427,23,45,-22,35,62,-27,59,78,-19,1,2,0,0
"19357","S.J","N.J",2014020067,16361,20142015,0,60,4,2,2,4.53296959685423,3.99707561786779,0.535893978986437,32,37,-5,40,42,-2,48,50,-2,4,3,0,0
"19358","S.J","NYR",2014020075,16362,20142015,0,60,0,4,-4,5.09755727648735,3.76037993328646,1.33717734320089,33,29,4,43,40,3,58,53,5,4,2,0,0
"19359","S.J","BOS",2014020079,16364,20142015,0,60,3,5,-2,5.42278533084436,5.04934994548967,0.373435385354696,34,33,1,42,47,-5,58,63,-5,2,3,0,0
"19360","S.J","CBJ",2014020100,16366,20142015,1,60,4,5,-1,4.42400921432233,3.30814013179085,1.11586908253147,37,28,9,46,39,7,57,51,6,5,4,0,0
"19361","S.J","ANA",2014020120,16369,20142015,0,60,4,1,3,6.57377010014534,3.5446449474218,3.02912515272354,37,34,3,54,51,3,69,66,3,10,10,0,0
"19362","S.J","COL",2014020133,16371,20142015,0,65,2,2,0,9.54542321801918,6.53379799911454,3.01162521890464,51,33,18,66,46,20,84,53,31,6,5,0,0
"19363","S.J","MIN",2014020145,16373,20142015,0,65,3,3,0,5.03445023741705,7.59504616161576,-2.56059592419871,28,46,-18,38,59,-21,55,72,-17,2,1,0,0
"19364","S.J","NYI",2014020152,16375,20142015,1,60,3,1,2,6.09778488636948,4.05107790301554,2.04670698335394,31,20,11,43,38,5,62,63,-1,1,3,0,0
"19365","S.J","VAN",2014020196,16380,20142015,1,60,2,3,-1,5.30850822780303,2.37793765310198,2.93057057470105,36,19,17,54,20,34,79,23,56,4,1,0,0
"19366","S.J","DAL",2014020211,16382,20142015,0,60,5,3,2,4.9507299592442,5.20011053998314,-0.249380580738944,29,40,-11,43,56,-13,67,78,-11,4,7,0,0
"19367","S.J","CHI",2014020216,16383,20142015,0,60,2,5,-3,7.05700073598655,4.7385637880725,2.31843694791405,34,37,-3,42,43,-1,59,53,6,3,5,0,0
"19368","S.J","FLA",2014020225,16385,20142015,0,60,1,4,-3,3.03201587291551,3.62752948240282,-0.595513609487313,26,30,-4,38,35,3,55,41,14,2,2,0,0
"19369","S.J","T.B",2014020236,16387,20142015,0,60,2,1,1,4.16524503212702,3.08897976330991,1.07626526881711,39,33,6,54,42,12,71,54,17,3,4,0,0
"19370","S.J","CBJ",2014020256,16389,20142015,0,60,1,2,-1,5.52476945973467,4.35596312302025,1.16880633671442,37,28,9,53,30,23,72,39,33,2,3,0,0
"19371","S.J","CAR",2014020260,16390,20142015,0,60,2,0,2,3.32952445122444,8.45274934651388,-5.12322489528944,19,45,-26,32,67,-35,46,89,-43,1,2,0,0
"19372","S.J","FLA",2014020290,16394,20142015,1,65,2,2,0,5.03519649992484,4.59064326972257,0.444553230202267,30,28,2,44,43,1,70,63,7,3,5,0,0
"19373","S.J","ARI",2014020307,16396,20142015,1,65,3,3,0,6.55249619983718,3.96379841482849,2.58869778500869,43,25,18,60,29,31,91,48,43,4,2,0,0
"19374","S.J","ANA",2014020355,16403,20142015,1,60,6,4,2,2.61294929896603,2.95698177308943,-0.344032474123397,35,34,1,47,43,4,62,54,8,8,8,0,0
"19375","S.J","PHI",2014020370,16406,20142015,1,60,2,1,1,6.43024060816425,3.00109477539081,3.42914583277344,27,29,-2,42,37,5,49,49,0,1,2,0,0
"19376","S.J","BOS",2014020386,16408,20142015,1,60,7,4,3,6.48933662586933,3.62889263234683,2.86044399352249,44,24,20,62,37,25,81,52,29,5,3,0,0
"19377","S.J","EDM",2014020405,16411,20142015,0,60,1,2,-1,3.42861549300142,1.46585763001349,1.96275786298793,21,24,-3,31,27,4,43,43,0,3,3,0,0
"19378","S.J","EDM",2014020418,16413,20142015,1,60,5,2,3,3.07212620549797,4.92907104043388,-1.85694483493591,24,27,-3,32,42,-10,48,64,-16,1,2,0,0
"19379","S.J","MIN",2014020430,16415,20142015,1,60,2,1,1,4.05129838513676,3.26831788359095,0.782980501545808,30,19,11,51,30,21,67,53,14,4,3,0,0
"19380","S.J","EDM",2014020473,16422,20142015,1,60,4,3,1,4.38877214002423,3.18983653966916,1.19893560035507,30,28,2,42,38,4,63,54,9,3,1,0,0
"19381","S.J","STL",2014020490,16424,20142015,1,64.3666666666667,3,2,1,4.93772351386724,2.24590918991498,2.69181432395226,30,20,10,46,35,11,66,50,16,3,0,0,0
"19382","S.J","ANA",2014020501,16426,20142015,0,60.9666666666667,2,3,-1,5.87945387669049,5.00867624033303,0.87077763635746,32,32,0,43,47,-4,56,59,-3,2,3,0,0
"19383","S.J","L.A",2014020526,16431,20142015,0,60,1,3,-2,1.8184607380009,2.81799080024939,-0.999530062248486,22,29,-7,27,43,-16,39,60,-21,2,4,0,0
"19384","S.J","VAN",2014020544,16434,20142015,1,60,1,3,-2,5.03270789375529,2.53626753354911,2.49644036020618,32,21,11,52,35,17,65,48,17,6,1,0,0
"19385","S.J","ANA",2014020552,16435,20142015,0,60,3,0,3,4.74292862147558,5.40966177842461,-0.666733156949022,27,28,-1,43,47,-4,60,59,1,9,4,0,0
"19386","S.J","STL",2014020575,16438,20142015,1,60,2,7,-5,1.89808970503509,4.07053332836343,-2.17244362332834,20,33,-13,26,47,-21,44,64,-20,11,8,0,0
"19387","S.J","WPG",2014020583,16440,20142015,0,60,3,2,1,5.45996250522148,2.32866828427388,3.1312942209476,37,19,18,50,34,16,65,47,18,6,3,0,0
"19388","S.J","MIN",2014020588,16441,20142015,0,63.15,4,3,1,6.42441583943578,7.32565487676601,-0.90123903733023,26,31,-5,42,38,4,58,49,9,5,3,0,0
"19389","S.J","STL",2014020601,16443,20142015,0,60,2,7,-5,4.1649560979086,4.72061994328396,-0.555663845375364,26,28,-2,36,48,-12,42,55,-13,3,4,0,0
"19390","S.J","NYR",2014020623,16445,20142015,1,60,1,3,-2,4.87450590115986,5.54648890843032,-0.671983007270455,31,32,-1,45,43,2,63,63,0,3,2,0,0
"19391","S.J","ARI",2014020639,16448,20142015,0,60,3,2,1,5.10087880131323,4.74536107538734,0.355517725925893,25,29,-4,36,42,-6,56,58,-2,3,3,0,0
"19392","S.J","TOR",2014020653,16450,20142015,1,60,3,1,2,5.48064800095744,3.49096876254953,1.98967923840792,42,25,17,50,36,14,71,57,14,3,3,0,0
"19393","S.J","N.J",2014020682,16454,20142015,1,60,2,5,-3,5.63900833570663,3.18672340910416,2.45228492660247,36,34,2,51,40,11,69,56,13,4,3,0,0
"19394","S.J","L.A",2014020696,16456,20142015,1,60,4,2,2,3.99084244124128,5.24813079521846,-1.25728835397717,25,28,-3,40,38,2,55,48,7,4,6,0,0
"19395","S.J","ANA",2014020721,16464,20142015,1,60,6,3,3,4.3527924203157,2.86830638881474,1.48448603150096,33,28,5,44,39,5,64,60,4,5,2,0,0
"19396","S.J","CHI",2014020737,16466,20142015,1,60,2,0,2,4.63071509485599,2.2314272458658,2.39928784899018,20,31,-11,34,36,-2,46,50,-4,4,2,0,0
"19397","S.J","EDM",2014020744,16468,20142015,1,65,4,4,0,7.85029241633646,4.30611739103915,3.54417502529731,37,40,-3,60,55,5,74,71,3,2,1,0,0
"19398","S.J","VAN",2014020767,16471,20142015,0,60,5,1,4,0,0,0,38,34,4,49,41,8,61,52,9,4,3,0,0
"19399","S.J","CAR",2014020783,16473,20142015,1,60,4,5,-1,3.38799282677937,6.21790052604047,-2.8299076992611,27,30,-3,42,46,-4,51,62,-11,1,4,0,0
"19400","S.J","ARI",2014020821,16479,20142015,0,60,4,2,2,4.23938377760351,6.52804425009526,-2.28866047249176,26,36,-10,34,53,-19,48,71,-23,4,3,0,0
"19401","S.J","T.B",2014020837,16481,20142015,1,60,2,5,-3,6.62958753530984,4.43266278345273,2.19692475185711,35,33,2,54,43,11,66,50,16,4,2,0,0
"19402","S.J","DAL",2014020865,16485,20142015,0,60,5,2,3,4.78923811968343,6.22572062027029,-1.43648250058686,28,39,-11,42,60,-18,55,84,-29,2,3,0,0
"19403","S.J","L.A",2014020883,16487,20142015,1,60,1,2,-1,2.3256027460302,3.99776165191724,-1.67215890588704,32,29,3,44,48,-4,62,62,0,3,2,0,0
"19404","S.J","DET",2014020916,16492,20142015,1,60,2,3,-1,2.96705800871881,5.70458404836245,-2.73752603964364,22,35,-13,34,51,-17,51,74,-23,6,6,0,0
"19405","S.J","OTT",2014020932,16494,20142015,1,60,2,4,-2,3.24452571122674,3.9760237622977,-0.731498051070957,30,31,-1,43,45,-2,60,66,-6,3,4,0,0
"19406","S.J","MTL",2014020941,16496,20142015,1,60,4,0,4,5.99450747214723,2.52968909440096,3.46481837774627,37,20,17,50,30,20,71,48,23,3,0,0,0
"19407","S.J","VAN",2014020951,16497,20142015,0,60,6,2,4,3.98184212942192,6.68528816301841,-2.70344603359649,30,28,2,36,44,-8,46,59,-13,1,5,0,0
"19408","S.J","VAN",2014020979,16501,20142015,1,60,2,3,-1,7.06424263468944,5.37025708786678,1.69398554682266,40,34,6,55,44,11,72,66,6,4,7,0,0
"19409","S.J","CHI",2014021020,16508,20142015,1,60,2,6,-4,4.53815769211526,5.82615821100978,-1.28800051889452,35,30,5,47,42,5,63,59,4,4,4,0,0
"19410","S.J","WPG",2014021046,16511,20142015,0,60,2,5,-3,9.13505061221925,2.81379528343678,6.32125532878247,40,22,18,52,33,19,75,46,29,4,4,0,0
"19411","S.J","TOR",2014021053,16513,20142015,0,60,4,1,3,6.7052643097941,3.23458478120891,3.47067952858519,42,28,14,64,36,28,79,48,31,6,3,0,0
"19412","S.J","MTL",2014021069,16515,20142015,0,60,0,2,-2,5.43295944821875,7.12846672520825,-1.6955072769895,29,29,0,50,41,9,72,60,12,3,1,0,0
"19413","S.J","OTT",2014021086,16517,20142015,0,60,2,5,-3,5.85871789252269,7.62641877576243,-1.76770088323974,31,37,-6,41,45,-4,59,56,3,1,1,0,0
"19414","S.J","DET",2014021108,16520,20142015,0,60,6,4,2,6.24371367069779,5.23618487562635,1.00752879507144,30,34,-4,39,53,-14,47,70,-23,2,5,0,0
"19415","S.J","PHI",2014021118,16522,20142015,0,65,2,2,0,10.0465995129634,3.58112117748533,6.46547833547811,44,18,26,58,26,32,83,47,36,4,3,0,0
"19416","S.J","COL",2014021152,16526,20142015,1,60,5,1,4,6.70103946892777,2.14128842030732,4.55975104862045,30,20,10,36,23,13,64,36,28,1,2,0,0
"19417","S.J","ARI",2014021166,16528,20142015,1,60,3,1,2,5.24842038376119,5.17087769735099,0.0775426864101973,37,21,16,55,34,21,79,51,28,3,2,0,0
"19418","S.J","ARI",2014021177,16529,20142015,0,60,3,5,-2,8.65587435054636,7.04564321895396,1.6102311315924,45,36,9,65,52,13,86,68,18,6,4,0,0
"19419","S.J","DAL",2014021189,16531,20142015,1,60,1,5,-4,3.80451911673072,4.63086021691561,-0.826341100184891,24,25,-1,39,33,6,60,61,-1,5,6,0,0
"19420","S.J","EDM",2014021212,16534,20142015,0,60,3,1,2,8.84461187686389,4.73385402961168,4.11075784725222,52,27,25,71,39,32,95,56,39,0,2,0,0
"19421","S.J","L.A",2014021219,16536,20142015,0,60,1,4,-3,2.2098921866824,5.15000075686112,-2.94010857017872,21,36,-15,33,48,-15,36,62,-26,4,4,0,0
"19422","S.J","L.A",2015020004,16715,20152016,0,60,5,1,4,4.51006557536311,3.44437690466845,1.06568867069467,32,20,12,44,31,13,54,44,10,8,7,0,0
"19423","S.J","ANA",2015020030,16718,20152016,1,60,2,0,2,8.11229625553892,5.21512354961305,2.89717270592587,44,27,17,56,40,16,76,57,19,1,1,0,0
"19424","S.J","N.J",2015020058,16724,20152016,0,65,1,1,0,2.84726845395989,3.65558843540222,-0.808319981442331,34,32,2,39,42,-3,46,47,-1,3,7,0,0
"19425","S.J","NYI",2015020071,16725,20152016,0,60,3,6,-3,4.32332086442329,4.70929984685384,-0.385978982430546,25,34,-9,37,44,-7,49,58,-9,2,4,0,0
"19426","S.J","NYR",2015020080,16727,20152016,0,60,0,4,-4,2.15031009772622,2.76139930563512,-0.611089207908901,22,28,-6,28,40,-12,49,50,-1,2,1,0,0
"19427","S.J","L.A",2015020099,16730,20152016,1,60,1,4,-3,4.73485221916896,4.59782281407388,0.137029405095085,40,29,11,50,42,8,63,60,3,6,5,0,0
"19428","S.J","CAR",2015020117,16732,20152016,1,60,5,2,3,3.92398417537333,4.07955038012005,-0.155566204746719,21,34,-13,32,41,-9,38,65,-27,1,3,0,0
"19429","S.J","DAL",2015020155,16739,20152016,0,60,3,5,-2,3.88708421238933,5.17307606154645,-1.28599184915713,29,25,4,40,44,-4,46,56,-10,4,5,0,0
"19430","S.J","COL",2015020164,16740,20152016,0,60,4,3,1,4.08417723402945,3.0148278974666,1.06934933656285,32,26,6,38,33,5,43,41,2,2,4,0,0
"19431","S.J","CBJ",2015020180,16742,20152016,1,60,2,5,-3,5.10634986338869,4.18268678720415,0.923663076184539,43,24,19,61,31,30,78,49,29,4,2,0,0
"19432","S.J","ANA",2015020210,16746,20152016,1,60,0,1,-1,5.26527882512892,2.91408261854667,2.35119620658224,31,17,14,43,29,14,53,43,10,4,2,0,0
"19433","S.J","NYI",2015020227,16749,20152016,1,60,2,4,-2,4.24659269384574,2.38438282970458,1.86220986414116,36,25,11,42,27,15,59,49,10,3,3,0,0
"19434","S.J","DET",2015020244,16752,20152016,0,60,3,2,1,1.86369398465857,5.45856405493851,-3.59487007027994,14,28,-14,24,37,-13,27,53,-26,2,3,0,0
"19435","S.J","BOS",2015020267,16756,20152016,0,60,5,4,1,3.75481058476726,2.39445372384844,1.36035686091881,28,29,-1,35,39,-4,48,51,-3,5,3,0,0
"19436","S.J","PHI",2015020279,16758,20152016,0,63.75,1,0,1,0,0,0,21,34,-13,34,45,-11,49,67,-18,4,2,0,0
"19437","S.J","CBJ",2015020305,16761,20152016,0,60,5,3,2,6.72197424176557,3.98880083564177,2.7331734061238,29,31,-2,43,35,8,64,50,14,5,3,0,0
"19438","S.J","CHI",2015020329,16764,20152016,1,60,2,5,-3,3.50420454933192,3.72982084098476,-0.225616291652841,29,26,3,42,46,-4,55,65,-10,5,3,0,0
"19439","S.J","ANA",2015020387,16773,20152016,0,60,0,1,-1,4.94574408818153,5.28516521483165,-0.339421126650123,23,26,-3,36,44,-8,49,59,-10,4,4,0,0
"19440","S.J","T.B",2015020397,16774,20152016,1,60,3,4,-1,6.21604675101116,2.76531347594836,3.4507332750628,34,20,14,45,25,20,69,38,31,8,4,0,0
"19441","S.J","EDM",2015020419,16778,20152016,0,63.9833333333333,3,4,-1,4.84450160716369,3.1601544378791,1.68434716928459,28,20,8,42,28,14,59,42,17,4,2,0,0
"19442","S.J","MIN",2015020444,16781,20152016,1,60,0,2,-2,5.82001477849553,3.98215581018476,1.83785896831078,25,30,-5,37,37,0,55,54,1,2,1,0,0
"19443","S.J","MTL",2015020458,16784,20152016,0,60,3,1,2,1.16813041071873,4.19033464670065,-3.02220423598192,18,27,-9,27,40,-13,38,68,-30,0,2,0,0
"19444","S.J","TOR",2015020469,16786,20152016,0,62.2166666666667,5,4,1,6.55565187880711,4.93051733452012,1.62513454428699,44,31,13,56,48,8,69,66,3,4,3,0,0
"19445","S.J","OTT",2015020480,16787,20152016,0,60,2,4,-2,7.33389682393328,6.77293704925847,0.560959774674806,33,35,-2,49,45,4,67,60,7,4,3,0,0
"19446","S.J","CHI",2015020498,16789,20152016,0,62.35,3,4,-1,4.70699683457133,4.86291232501389,-0.155915490442567,36,32,4,40,42,-2,55,56,-1,3,1,0,0
"19447","S.J","L.A",2015020516,16791,20152016,0,60,5,3,2,4.91031326382111,5.7752067688973,-0.864893505076187,23,36,-13,34,57,-23,41,69,-28,5,4,0,0
"19448","S.J","COL",2015020540,16797,20152016,1,60,3,6,-3,4.18855186356814,3.12562324755709,1.06292861601105,38,26,12,57,30,27,83,37,46,3,6,0,0
"19449","S.J","PHI",2015020555,16799,20152016,1,60,4,2,2,3.844790548319,4.32235750183463,-0.477566953515634,33,19,14,41,31,10,51,50,1,8,5,0,0
"19450","S.J","WPG",2015020578,16802,20152016,1,60,1,4,-3,3.31282161385752,6.69266769244713,-3.37984607858961,28,27,1,37,39,-2,58,53,5,6,4,0,0
"19451","S.J","DET",2015020607,16807,20152016,1,60,1,2,-1,4.88347298228473,4.70790313698263,0.175569845302102,36,25,11,53,33,20,67,46,21,4,5,0,0
"19452","S.J","TOR",2015020619,16809,20152016,1,60,7,0,7,6.51408967014868,3.26345550000713,3.25063417014155,31,28,3,45,43,2,65,60,5,4,3,0,0
"19453","S.J","WPG",2015020638,16812,20152016,0,60,4,1,3,3.60394833202906,2.42869198968816,1.1752563423409,27,22,5,37,28,9,47,49,-2,5,3,0,0
"19454","S.J","EDM",2015020653,16814,20152016,1,65,1,1,0,7.04995450872229,5.65322046977235,1.39673403894994,37,25,12,50,35,15,61,52,9,4,1,0,0
"19455","S.J","DAL",2015020669,16816,20152016,1,61.2,4,3,1,3.80067416126985,5.05472192871443,-1.25404776744458,39,35,4,45,43,2,59,63,-4,2,2,0,0
"19456","S.J","OTT",2015020681,16818,20152016,1,65,3,3,0,7.05321515774995,2.09267467925383,4.96054047849611,35,17,18,61,27,34,86,40,46,2,2,0,0
"19457","S.J","ARI",2015020701,16821,20152016,0,60,3,1,2,3.62907142995391,3.35906480528951,0.270006624664404,23,24,-1,43,40,3,53,54,-1,2,1,0,0
"19458","S.J","MIN",2015020710,16823,20152016,1,60,4,3,1,3.64862879758584,4.6548541369848,-1.00622533939895,33,28,5,45,36,9,68,52,16,3,3,0,0
"19459","S.J","L.A",2015020724,16824,20152016,1,64.1,2,3,-1,4.94207465106581,5.99432736269517,-1.05225271162936,32,32,0,44,50,-6,62,67,-5,4,4,0,0
"19460","S.J","COL",2015020739,16826,20152016,1,60,6,1,5,3.25408375789266,2.60333630857122,0.650747449321443,24,22,2,32,35,-3,46,57,-11,6,6,0,0
"19461","S.J","ANA",2015020755,16833,20152016,0,60,2,3,-1,3.12635982249049,5.18132780163432,-2.05496797914384,32,25,7,46,42,4,69,55,14,3,4,0,0
"19462","S.J","CHI",2015020803,16840,20152016,0,60,2,0,2,6.47770035668509,2.62690419150749,3.8507961651776,27,33,-6,36,43,-7,51,57,-6,1,3,0,0
"19463","S.J","ARI",2015020834,16844,20152016,1,60,4,1,3,1.9175631430553,1.78398298145402,0.133580161601287,28,23,5,45,31,14,63,52,11,6,4,0,0
"19464","S.J","T.B",2015020852,16847,20152016,0,60,4,2,2,3.89052163175074,6.94001454190584,-3.0494929101551,31,30,1,42,46,-4,55,58,-3,3,2,0,0
"19465","S.J","CAR",2015020870,16850,20152016,0,60,2,5,-3,2.59038395711832,4.81633049289667,-2.22594653577835,24,37,-13,35,46,-11,43,60,-17,2,4,0,0
"19466","S.J","COL",2015020904,16855,20152016,0,65,3,3,0,5.67395705042873,4.64568313050404,1.02827391992469,33,41,-8,44,50,-6,62,64,-2,1,2,0,0
"19467","S.J","VAN",2015020934,16859,20152016,0,60,4,1,3,5.54576569214987,7.22658485003939,-1.68081915788952,28,24,4,39,37,2,50,50,0,4,1,0,0
"19468","S.J","MTL",2015020942,16860,20152016,1,60,6,2,4,5.21303565062948,4.96014975340222,0.252885897227259,36,23,13,49,38,11,67,55,12,2,3,0,0
"19469","S.J","VAN",2015020964,16863,20152016,0,60,3,2,1,4.16340940119699,4.02484596981402,0.138563431382966,30,30,0,40,37,3,61,55,6,4,1,0,0
"19470","S.J","VAN",2015020979,16865,20152016,1,60,2,4,-2,2.28771736107592,3.82551944546867,-1.53780208439275,34,26,8,42,30,12,56,43,13,4,7,0,0
"19471","S.J","EDM",2015021000,16868,20152016,0,60,3,0,3,3.22315429485491,4.28993495256873,-1.06678065771382,22,31,-9,31,44,-13,45,60,-15,2,3,0,0
"19472","S.J","N.J",2015021012,16870,20152016,1,60,0,3,-3,3.25067177403253,2.94973934363225,0.30093243040028,30,16,14,41,22,19,67,37,30,3,1,0,0
"19473","S.J","BOS",2015021046,16875,20152016,1,60,3,2,1,3.8034992602561,2.40024008542971,1.40325917482639,27,23,4,44,37,7,69,54,15,4,1,0,0
"19474","S.J","ARI",2015021059,16877,20152016,0,60,1,3,-2,2.54839399226967,4.8625230495818,-2.31412905731213,28,22,6,45,31,14,65,47,18,2,2,0,0
"19475","S.J","NYR",2015021069,16879,20152016,1,60,4,1,3,8.72121672911244,2.73962221166585,5.9815945174466,52,26,26,63,39,24,81,56,25,4,3,0,0
"19476","S.J","ARI",2015021084,16880,20152016,1,60,3,0,3,4.51029672287405,4.05500064557418,0.455296077299863,36,25,11,44,34,10,60,52,8,5,4,0,0
"19477","S.J","EDM",2015021111,16884,20152016,1,60,3,6,-3,2.72744682804519,3.11459413668126,-0.387147308636074,26,22,4,41,30,11,55,50,5,4,1,0,0
"19478","S.J","DAL",2015021118,16886,20152016,1,60,2,4,-2,5.11639512698457,4.22339580132393,0.892999325660639,36,17,19,60,25,35,80,33,47,8,5,0,0
"19479","S.J","L.A",2015021139,16888,20152016,1,60,5,2,3,6.88585966266692,3.14104831748409,3.74481134518282,31,32,-1,38,42,-4,55,70,-15,2,3,0,0
"19480","S.J","VAN",2015021148,16889,20152016,0,60,4,1,3,5.01571821836683,3.57608881814787,1.43962940021896,31,24,7,41,34,7,46,48,-2,3,2,0,0
"19481","S.J","VAN",2015021161,16891,20152016,1,60,2,4,-2,4.59691846213579,4.01131128689849,0.585607175237299,34,26,8,47,41,6,60,59,1,4,4,0,0
"19482","S.J","MIN",2015021195,16896,20152016,0,60,3,0,3,2.86535487706986,4.14998929079957,-1.28463441372971,20,29,-9,29,37,-8,43,48,-5,3,3,0,0
"19483","S.J","WPG",2015021214,16898,20152016,1,60,4,5,-1,4.31194416768631,3.03407867741771,1.2778654902686,25,26,-1,37,34,3,50,49,1,4,4,0,0
"19484","S.J","ARI",2015021230,16900,20152016,1,60,1,0,1,6.29582618848809,4.00321239952481,2.29261378896328,32,20,12,51,32,19,69,45,24,6,4,0,0
"19485","S.J","L.A",2015030181,16905,20152016,0,60,4,3,1,4.68409340571816,4.77346328162002,-0.0893698759018662,23,24,-1,47,43,4,57,58,-1,4,3,0,0
"19486","S.J","L.A",2015030182,16907,20152016,0,60,2,1,1,4.40084540715907,4.29519177187467,0.105653635284398,23,27,-4,36,51,-15,53,79,-26,5,5,0,0
"19487","S.J","L.A",2015030183,16909,20152016,1,63.7833333333333,1,2,-1,5.56347455529612,5.05535895206399,0.508115603232138,30,24,6,47,40,7,74,58,16,6,4,0,0
"19488","S.J","L.A",2015030184,16911,20152016,1,60,3,2,1,4.07575169525808,5.74347424797452,-1.66772255271644,29,28,1,40,41,-1,58,66,-8,4,2,0,0
"19489","S.J","L.A",2015030185,16913,20152016,0,60,6,3,3,5.49674892441544,3.48998683440025,2.00676209001519,28,22,6,36,40,-4,47,69,-22,3,1,0,0
"19490","S.J","PIT",2015030411,16951,20152016,0,60,2,3,-1,4.2721698412206,5.04785379366513,-0.775683952444524,26,41,-15,37,52,-15,58,67,-9,3,4,0,0
"19491","S.J","PIT",2015030412,16953,20152016,0,62.5833333333333,1,2,-1,3.79088787070941,3.77737500076182,0.0135128699475899,22,30,-8,35,42,-7,49,59,-10,1,2,0,0
"19492","S.J","PIT",2015030413,16956,20152016,1,72.3,3,2,1,3.91713456916114,4.84794129027068,-0.930806721109548,26,42,-16,41,54,-13,79,76,3,2,1,0,0
"19493","S.J","PIT",2015030414,16958,20152016,1,60,1,3,-2,2.08241876941611,3.44799257653358,-1.36557380711747,24,20,4,35,29,6,55,49,6,2,2,0,0
"19494","S.J","PIT",2015030415,16961,20152016,0,60,4,2,2,3.58453872532118,7.2423164575157,-3.65777773219452,22,46,-24,26,59,-33,36,76,-40,3,4,0,0
"19495","S.J","PIT",2015030416,16964,20152016,1,60,1,3,-2,4.15718003353686,3.71926134524983,0.437918688287027,19,27,-8,34,39,-5,67,67,0,2,2,0,0
"19496","S.J","L.A",2016020004,17086,20162017,1,60,2,1,1,5.6518385366071,4.1688675081823,1.4829710284248,31,22,9,51,37,14,73,58,15,4,2,0,0
"19497","S.J","CBJ",2016020023,17089,20162017,0,60,3,2,1,5.8867414432407,3.45500787087392,2.43173357236677,38,28,10,43,41,2,55,58,-3,4,2,0,0
"19498","S.J","NYR",2016020033,17091,20162017,0,60,4,7,-3,7.18930328544229,4.95165853719664,2.23764474824566,31,29,2,43,37,6,61,44,17,5,4,0,0
"19499","S.J","NYI",2016020038,17092,20162017,0,60,3,2,1,3.33100855443809,3.71281719121725,-0.381808636779169,27,23,4,37,31,6,54,44,10,1,2,0,0
"19500","S.J","PIT",2016020053,17094,20162017,0,60,2,3,-1,4.04964893699316,2.33988170143328,1.70976723555988,34,20,14,47,34,13,62,54,8,3,5,0,0
"19501","S.J","DET",2016020067,17096,20162017,0,60,0,2,-2,2.9403151832521,4.06501127028605,-1.12469608703395,18,20,-2,25,26,-1,34,33,1,4,3,0,0
"19502","S.J","ANA",2016020093,17099,20162017,1,61.4,2,1,1,4.44748646535108,1.77157717519367,2.67590929015741,36,20,16,43,28,15,66,46,20,5,3,0,0
"19503","S.J","CBJ",2016020106,17101,20162017,1,60,3,1,2,6.04759408672544,2.76690686168149,3.28068722504395,29,25,4,47,35,12,65,56,9,2,3,0,0
"19504","S.J","ARI",2016020141,17106,20162017,0,60,2,3,-1,5.95523806032725,4.98257987340912,0.972658186918125,41,30,11,59,48,11,86,60,26,2,2,0,0
"19505","S.J","PIT",2016020173,17110,20162017,1,60,0,5,-5,4.34916314971633,3.06997722163908,1.27918592807725,32,25,7,42,33,9,64,47,17,6,2,0,0
"19506","S.J","T.B",2016020213,17117,20162017,0,60,3,1,2,3.20202445390169,4.36336312860658,-1.16133867470489,20,26,-6,30,39,-9,39,55,-16,2,2,0,0
"19507","S.J","CAR",2016020231,17120,20162017,0,60,0,1,-1,2.97716420079814,5.33298454934993,-2.35582034855179,22,33,-11,37,45,-8,50,62,-12,1,1,0,0
"19508","S.J","ARI",2016020269,17124,20162017,0,61.2666666666667,2,3,-1,5.96069670831816,2.49986156416407,3.46083514415409,45,26,19,64,33,31,79,46,33,3,4,0,0
"19509","S.J","N.J",2016020282,17126,20162017,1,60,4,0,4,8.134949583446,2.81751429266296,5.31743529078303,42,26,16,57,38,19,84,55,29,5,3,0,0
"19510","S.J","CHI",2016020299,17128,20162017,1,60,2,1,1,3.15062686637975,3.69084335149819,-0.540216485118435,35,34,1,49,49,0,55,66,-11,5,3,0,0
"19511","S.J","NYI",2016020305,17130,20162017,1,60,3,2,1,5.24136553479002,5.84012459870428,-0.598759063914258,28,28,0,48,43,5,63,55,8,2,1,0,0
"19512","S.J","ANA",2016020321,17131,20162017,1,60,2,3,-1,4.29333698796108,4.78281668975251,-0.489479701791424,23,26,-3,35,38,-3,61,53,8,3,1,0,0
"19513","S.J","ARI",2016020341,17134,20162017,1,60.3166666666667,2,1,1,4.20160197762016,4.48223937270814,-0.280637395087979,42,19,23,55,30,25,64,44,20,3,3,0,0
"19514","S.J","L.A",2016020344,17135,20162017,0,60,4,1,3,3.70562811626587,5.37499223958002,-1.66936412331415,24,27,-3,35,49,-14,47,70,-23,1,2,0,0
"19515","S.J","MTL",2016020358,17137,20162017,1,60,2,1,1,2.50607922258496,6.32160672894679,-3.81552750636183,30,32,-2,39,47,-8,51,62,-11,3,3,0,0
"19516","S.J","ANA",2016020410,17144,20162017,0,60,2,3,-1,2.83864190449822,4.47807883929068,-1.63943693479246,24,32,-8,42,42,0,63,61,2,1,3,0,0
"19517","S.J","CAR",2016020420,17145,20162017,1,60,4,3,1,3.59002066135872,3.49918986583361,0.0908307955251075,20,33,-13,34,44,-10,44,68,-24,2,3,0,0
"19518","S.J","TOR",2016020435,17148,20162017,0,65,2,2,0,6.11954676325419,4.72621669549153,1.39333006776266,42,31,11,57,51,6,78,60,18,7,4,0,0
"19519","S.J","MTL",2016020455,17151,20162017,0,60,4,2,2,2.49536976064896,4.17239684347275,-1.6770270828238,23,28,-5,33,41,-8,47,73,-26,5,3,0,0
"19520","S.J","CHI",2016020474,17153,20162017,0,60,1,4,-3,7.06001306937299,4.16502924659289,2.89498382278009,34,26,8,38,36,2,57,49,8,2,2,0,0
"19521","S.J","EDM",2016020516,17158,20162017,1,63.3666666666667,3,2,1,3.84911359713055,3.76751104314462,0.0816025539859311,31,18,13,46,34,12,59,48,11,4,6,0,0
"19522","S.J","ANA",2016020526,17162,20162017,0,62.7666666666667,3,2,1,4.15843747742474,4.58119011976186,-0.422752642337116,25,36,-11,34,59,-25,48,71,-23,4,1,0,0
"19523","S.J","PHI",2016020547,17165,20162017,1,60,2,0,2,4.16648175683804,4.0361448074366,0.130336949401439,34,21,13,44,31,13,55,49,6,3,2,0,0
"19524","S.J","L.A",2016020558,17166,20162017,0,60,2,3,-1,4.34186519448122,3.79347596807929,0.548389226401923,20,27,-7,33,44,-11,44,60,-16,3,5,0,0
"19525","S.J","L.A",2016020571,17169,20162017,1,60.9666666666667,1,2,-1,6.63591494128923,2.62692871126552,4.00898623002371,27,35,-8,41,47,-6,55,65,-10,3,3,0,0
"19526","S.J","MIN",2016020584,17171,20162017,1,60,4,5,-1,3.67484139207927,3.4399823169224,0.234859075156876,34,26,8,43,44,-1,62,58,4,1,3,0,0
"19527","S.J","DET",2016020602,17173,20162017,1,60,6,3,3,3.74824136527513,5.65370435599471,-1.90546299071957,35,35,0,45,50,-5,63,64,-1,2,1,0,0
"19528","S.J","EDM",2016020618,17176,20162017,0,60,5,3,2,5.64876127964817,6.4204299809644,-0.77166870131623,28,36,-8,37,46,-9,52,71,-19,2,2,0,0
"19529","S.J","WPG",2016020660,17182,20162017,1,60,5,2,3,0,0,0,32,28,4,48,40,8,68,58,10,3,2,0,0
"19530","S.J","L.A",2016020676,17184,20162017,0,60,3,2,1,4.1729846352432,4.84949822817316,-0.676513592929961,27,24,3,43,37,6,53,54,-1,6,6,0,0
"19531","S.J","T.B",2016020684,17185,20162017,1,60,2,1,1,4.74507867440116,4.29770228685811,0.447376387543045,24,25,-1,37,39,-2,50,56,-6,2,4,0,0
"19532","S.J","COL",2016020701,17187,20162017,1,61.3,3,2,1,2.93100945692277,3.96328360150801,-1.03227414458524,30,33,-3,38,44,-6,59,64,-5,4,1,0,0
"19533","S.J","COL",2016020712,17189,20162017,0,60,5,2,3,3.94299108395717,3.01963384181727,0.9233572421399,26,28,-2,37,32,5,46,44,2,4,3,0,0
"19534","S.J","WPG",2016020721,17190,20162017,0,60,4,3,1,5.6799012829515,7.32512443582527,-1.64522315287377,26,34,-8,38,49,-11,57,67,-10,3,2,0,0
"19535","S.J","EDM",2016020740,17192,20162017,1,60,1,4,-3,5.87154411303345,4.09829413834932,1.77324997468413,33,21,12,53,32,21,81,41,40,3,2,0,0
"19536","S.J","CHI",2016020754,17197,20162017,1,60,3,1,2,3.93340223372797,3.05946046946337,0.8739417642646,29,25,4,42,35,7,64,56,8,3,3,0,0
"19537","S.J","VAN",2016020765,17199,20162017,0,60,4,1,3,5.41629809030565,3.40397335597438,2.01232473433127,32,33,-1,40,48,-8,55,69,-14,3,2,0,0
"19538","S.J","ARI",2016020783,17201,20162017,1,65,2,2,0,7.80615389216109,4.50912141765826,3.29703247450283,40,28,12,52,43,9,65,55,10,5,5,0,0
"19539","S.J","BOS",2016020802,17206,20162017,0,60,3,6,-3,3.05353248101071,5.79059205474186,-2.73705957373115,26,33,-7,37,42,-5,49,50,-1,2,3,0,0
"19540","S.J","PHI",2016020817,17208,20162017,0,61.0666666666667,1,2,-1,5.8010405851528,5.4548048934812,0.346235691671609,24,35,-11,39,59,-20,56,75,-19,4,4,0,0
"19541","S.J","N.J",2016020828,17209,20162017,0,60,4,1,3,6.20509421563474,2.7200748984193,3.48501931721545,38,22,16,50,31,19,59,43,16,6,2,0,0
"19542","S.J","ARI",2016020866,17215,20162017,0,60,4,1,3,7.44969458435662,5.59379721542427,1.85589736893235,33,37,-4,51,53,-2,62,71,-9,2,0,0,0
"19543","S.J","BOS",2016020877,17216,20162017,1,62.6,1,2,-1,4.12839377485216,3.89589468197664,0.232499092875514,30,28,2,42,42,0,65,57,8,2,2,0,0
"19544","S.J","VAN",2016020911,17222,20162017,0,60,4,1,3,4.4804791229144,3.4352698403236,1.0452092825908,26,36,-10,38,45,-7,53,68,-15,1,2,0,0
"19545","S.J","TOR",2016020933,17225,20162017,1,60,3,1,2,6.98663650097308,4.43584423646051,2.55079226451257,37,21,16,53,35,18,71,55,16,2,3,0,0
"19546","S.J","VAN",2016020945,17227,20162017,1,60,3,1,2,4.02023580634292,2.46419877215521,1.55603703418771,32,18,14,43,25,18,64,42,22,3,3,0,0
"19547","S.J","MIN",2016020965,17230,20162017,0,60,1,3,-2,4.06432142015547,3.88325576743227,0.181065652723191,21,28,-7,27,38,-11,37,58,-21,3,3,0,0
"19548","S.J","WPG",2016020972,17231,20162017,0,60,3,2,1,4.78686071073117,4.08815101807704,0.69870969265413,30,33,-3,43,47,-4,58,63,-5,3,4,0,0
"19549","S.J","DAL",2016021015,17237,20162017,1,60,5,1,4,4.35317754941751,6.56753119945131,-2.2143536500338,26,30,-4,37,47,-10,47,62,-15,5,2,0,0
"19550","S.J","ANA",2016021062,17243,20162017,1,60,1,2,-1,8.23057037306717,3.00989549278893,5.22067488027824,34,27,7,53,35,18,76,53,23,5,4,0,0
"19551","S.J","DAL",2016021073,17245,20162017,0,60,0,1,-1,4.1421345140011,4.58207030809717,-0.439935794096073,30,20,10,51,34,17,72,50,22,2,2,0,0
"19552","S.J","MIN",2016021082,17246,20162017,0,60,2,3,-1,4.74674635627889,3.69844053867614,1.04830581760275,23,27,-4,33,37,-4,47,52,-5,1,3,0,0
"19553","S.J","DAL",2016021103,17249,20162017,0,60,1,6,-5,3.64366459075609,3.63617617960517,0.00748841115091636,21,29,-8,41,39,2,62,58,4,3,2,0,0
"19554","S.J","NYR",2016021136,17253,20162017,1,63.1666666666667,5,4,1,3.85436969254448,3.50516697851208,0.349202714032401,35,28,7,56,44,12,72,61,11,3,4,0,0
"19555","S.J","EDM",2016021149,17255,20162017,0,60,2,3,-1,3.04295192792688,4.18143893314209,-1.13848700521521,40,22,18,53,40,13,77,60,17,3,4,0,0
"19556","S.J","VAN",2016021172,17258,20162017,0,60,3,1,2,3.33788944716798,3.45298136331597,-0.115091916147991,25,30,-5,30,37,-7,37,56,-19,1,1,0,0
"19557","S.J","VAN",2016021191,17260,20162017,1,60,3,1,2,3.77702958221198,5.89139481401071,-2.11436523179873,25,34,-9,42,43,-1,57,71,-14,1,3,0,0
"19558","S.J","EDM",2016021205,17262,20162017,1,60,2,4,-2,4.19335663161473,4.264677438545,-0.0713208069302667,15,32,-17,27,41,-14,55,57,-2,5,5,0,0
"19559","S.J","EDM",2016030181,17268,20162017,0,63.3666666666667,3,2,1,7.02453578618588,2.13090226037184,4.89363352581404,44,19,25,64,30,34,87,43,44,7,4,0,0
"19560","S.J","EDM",2016030182,17270,20162017,0,60,0,2,-2,1.8965173489975,4.91044354637047,-3.01392619737298,16,36,-20,20,52,-32,36,77,-41,6,4,0,0
"19561","S.J","EDM",2016030183,17272,20162017,1,60,0,1,-1,3.60727602952102,3.23644138840609,0.370834641114925,23,22,1,38,32,6,57,54,3,2,1,0,0
"19562","S.J","EDM",2016030184,17274,20162017,1,60,7,0,7,5.27487055156064,2.45791263518012,2.81695791638052,32,23,9,50,34,16,70,53,17,6,4,0,0
"19563","S.J","EDM",2016030185,17276,20162017,0,78.25,3,4,-1,4.56777133606374,8.42547981745884,-3.85770848139509,30,48,-18,42,69,-27,56,107,-51,1,3,0,0
"19564","S.J","EDM",2016030186,17278,20162017,1,60,1,3,-2,5.69246065426364,4.6458339546225,1.04662669964114,28,21,7,44,31,13,70,48,22,3,1,0,0
"19565","S.J","PHI",2017020004,17443,20172018,1,60,3,5,-2,5.58420802804693,5.42552158837235,0.158686439674582,35,31,4,47,43,4,64,60,4,6,5,0,0
"19566","S.J","L.A",2017020030,17446,20172018,1,60,1,4,-3,3.37813710798417,5.62678192638856,-2.24864481840439,25,39,-14,38,48,-10,52,62,-10,4,6,0,0
"19567","S.J","NYI",2017020076,17453,20172018,1,60,1,3,-2,4.82773109786517,3.37348733941326,1.45424375845191,41,23,18,53,31,22,77,51,26,2,4,0,0
"19568","S.J","MTL",2017020091,17456,20172018,1,60,5,2,3,8.21941910935533,5.09084963960777,3.12856946974756,35,30,5,49,40,9,65,60,5,7,6,0,0
"19569","S.J","N.J",2017020105,17459,20172018,0,60,3,0,3,2.48052758831679,3.8354622423426,-1.35493465402581,33,28,5,44,37,7,58,47,11,4,5,0,0
"19570","S.J","NYI",2017020115,17460,20172018,0,60,3,5,-2,4.76943178217334,2.98020847116052,1.78922331101282,31,23,8,46,34,12,63,50,13,4,2,0,0
"19571","S.J","NYR",2017020124,17462,20172018,0,60,4,1,3,2.99765735885923,4.96316591763753,-1.96550855877829,24,34,-10,29,48,-19,36,59,-23,1,6,0,0
"19572","S.J","BOS",2017020138,17465,20172018,0,60,1,2,-1,3.40201925463771,2.64425969763818,0.757759556999531,37,33,4,55,42,13,71,56,15,6,2,0,0
"19573","S.J","TOR",2017020177,17469,20172018,1,60,3,2,1,4.58318970247637,3.82491998350179,0.758269718974589,39,18,21,50,30,20,71,55,16,4,0,0,0
"19574","S.J","ANA",2017020212,17474,20172018,1,65,1,1,0,5.24599606270203,4.00210554629808,1.24389051640395,45,26,19,60,37,23,77,56,21,3,1,0,0
"19575","S.J","T.B",2017020234,17478,20172018,1,60,1,5,-4,3.92917270969491,4.73748390996901,-0.808311200274095,33,30,3,46,45,1,68,56,12,2,4,0,0
"19576","S.J","VAN",2017020260,17481,20172018,1,60,5,0,5,5.6399776582918,4.63358895335296,1.00638870493884,31,41,-10,41,50,-9,56,71,-15,5,4,0,0
"19577","S.J","L.A",2017020264,17482,20172018,0,60,2,1,1,3.52249279839452,3.33118227357369,0.191310524820835,33,27,6,45,44,1,59,66,-7,3,4,0,0
"19578","S.J","BOS",2017020304,17488,20172018,1,60,1,3,-2,6.06451023666159,4.15313724550651,1.91137299115508,37,20,17,56,35,21,86,47,39,5,3,0,0
"19579","S.J","ANA",2017020315,17490,20172018,1,65,2,2,0,9.9235711825313,4.08277118721287,5.84079999531843,42,30,12,61,37,24,80,44,36,3,2,0,0
"19580","S.J","ARI",2017020331,17492,20172018,0,60,3,1,2,2.90976500812442,3.78750409812983,-0.877739090005406,26,27,-1,35,35,0,46,51,-5,1,3,0,0
"19581","S.J","VGK",2017020347,17494,20172018,0,61.35,4,5,-1,3.80866296511394,5.34144222883333,-1.53277926371939,26,33,-7,39,43,-4,61,62,-1,2,4,0,0
"19582","S.J","WPG",2017020357,17495,20172018,1,60,4,0,4,7.72399502882035,4.2670032150636,3.45699181375676,34,38,-4,45,54,-9,59,75,-16,2,3,0,0
"19583","S.J","PHI",2017020370,17498,20172018,0,60,3,1,2,7.70933433619211,3.15539879906708,4.55393553712504,34,23,11,47,30,17,69,45,24,6,3,0,0
"19584","S.J","T.B",2017020399,17502,20172018,0,60,2,5,-3,3.27799893141128,4.27586366874675,-0.997864737335476,27,43,-16,37,51,-14,54,71,-17,1,2,0,0
"19585","S.J","CAR",2017020438,17507,20172018,1,60.3666666666667,5,4,1,7.10753410006873,3.44110747496597,3.66642662510276,33,25,8,47,36,11,63,48,15,3,3,0,0
"19586","S.J","MIN",2017020459,17510,20172018,1,63.4333333333333,3,4,-1,6.54040018007722,1.84834211249836,4.69205806757886,34,24,10,57,36,21,83,47,36,7,3,0,0
"19587","S.J","VAN",2017020495,17515,20172018,0,64.5666666666667,3,4,-1,5.45314230792653,6.00906542382654,-0.555923115900014,37,40,-3,47,50,-3,63,55,8,4,3,0,0
"19588","S.J","EDM",2017020515,17518,20172018,0,60,3,5,-2,5.00992465331365,6.40060887577132,-1.39068422245767,21,29,-8,37,37,0,57,52,5,3,3,0,0
"19589","S.J","VAN",2017020538,17521,20172018,1,61.8833333333333,5,4,1,4.68339319724919,5.05783625033744,-0.374443053088248,32,40,-8,48,52,-4,63,62,1,5,4,0,0
"19590","S.J","L.A",2017020557,17523,20172018,1,60,2,0,2,2.84528742289285,3.47128791525029,-0.626000492357441,31,28,3,46,40,6,62,61,1,9,6,0,0
"19591","S.J","DAL",2017020596,17531,20172018,0,60,0,6,-6,3.1655844778324,4.90056503243977,-1.73498055460738,26,32,-6,37,48,-11,52,60,-8,4,4,0,0
"19592","S.J","MTL",2017020606,17533,20172018,0,60,4,1,3,5.82717879682134,4.59757850524335,1.22960029157799,33,31,2,47,42,5,57,57,0,4,5,0,0
"19593","S.J","TOR",2017020617,17535,20172018,0,65,2,2,0,4.09856236894848,5.56258213709108,-1.46401976814261,35,28,7,49,46,3,61,59,2,5,3,0,0
"19594","S.J","WPG",2017020646,17538,20172018,0,60,1,4,-3,4.77452107883801,3.86178661117447,0.91273446766354,32,30,2,47,39,8,68,54,14,4,3,0,0
"19595","S.J","ARI",2017020678,17544,20172018,1,62.7,6,5,1,6.23258307935248,6.91956234841928,-0.686979269066796,44,21,23,65,30,35,86,47,39,1,1,0,0
"19596","S.J","L.A",2017020685,17546,20172018,0,60,4,1,3,4.93506000994239,6.30919767263893,-1.37413766269654,33,36,-3,48,54,-6,65,69,-4,2,2,0,0
"19597","S.J","ARI",2017020692,17547,20172018,0,65,2,2,0,2.37232956930529,5.35667680396,-2.98434723465471,22,32,-10,32,48,-16,47,77,-30,2,2,0,0
"19598","S.J","COL",2017020703,17549,20172018,0,60,3,5,-2,4.72694169718307,1.9014859210306,2.82545577615246,48,22,26,56,32,24,79,44,35,7,4,0,0
"19599","S.J","PIT",2017020717,17551,20172018,1,60,2,1,1,6.14721440481907,6.72243619753135,-0.575221792712284,36,32,4,53,50,3,70,78,-8,4,4,0,0
"19600","S.J","ANA",2017020724,17552,20172018,0,60,6,2,4,5.61064826487564,6.28983418188961,-0.679185917013978,26,35,-9,38,55,-17,53,73,-20,5,3,0,0
"19601","S.J","WPG",2017020743,17554,20172018,1,60.3,4,5,-1,3.84934045193602,4.75210220623156,-0.902761754295547,33,23,10,41,39,2,64,60,4,5,2,0,0
"19602","S.J","NYR",2017020760,17556,20172018,1,60,5,6,-1,6.25433102695388,3.86747606870046,2.38685495825342,28,29,-1,51,37,14,62,50,12,1,3,0,0
"19603","S.J","PIT",2017020764,17561,20172018,0,60,2,5,-3,6.20666992606014,6.03903996935733,0.167629956702809,42,31,11,49,42,7,68,53,15,6,4,0,0
"19604","S.J","DET",2017020774,17562,20172018,0,65,1,1,0,4.59668410714869,6.55828265467545,-1.96159854752676,31,44,-13,49,54,-5,62,67,-5,2,3,0,0
"19605","S.J","CBJ",2017020790,17564,20172018,0,60,3,1,2,4.19147107226308,3.52087766460681,0.67059340765627,28,29,-1,42,44,-2,56,63,-7,4,2,0,0
"19606","S.J","CAR",2017020807,17566,20172018,0,60,3,1,2,3.35990871556825,4.09677044310592,-0.736861727537676,26,30,-4,38,43,-5,51,58,-7,0,1,0,0
"19607","S.J","COL",2017020822,17568,20172018,0,60,1,3,-2,5.93111280974699,5.59965010124142,0.331462708505569,39,20,19,50,32,18,71,44,27,2,2,0,0
"19608","S.J","VGK",2017020834,17570,20172018,1,60,3,5,-2,5.48419515698435,3.1368938259111,2.34730133107325,38,33,5,45,51,-6,56,65,-9,4,5,0,0
"19609","S.J","EDM",2017020851,17572,20172018,1,60,6,4,2,4.35288447989842,3.05595320910882,1.2969312707896,30,31,-1,38,44,-6,58,65,-7,1,3,0,0
"19610","S.J","ANA",2017020860,17573,20172018,0,65,2,2,0,11.134201066161,3.50699675797659,7.62720430818445,39,27,12,56,41,15,65,59,6,1,2,0,0
"19611","S.J","ARI",2017020875,17575,20172018,1,60,1,2,-1,7.95019895787301,4.06184071012753,3.88835824774547,41,26,15,63,34,29,79,46,33,5,3,0,0
"19612","S.J","VAN",2017020889,17577,20172018,1,60,4,1,3,3.35346323724737,7.93178200540933,-4.57831876816196,30,44,-14,43,59,-16,57,72,-15,3,1,0,0
"19613","S.J","DAL",2017020911,17580,20172018,1,60,5,2,3,4.49289731564932,4.27146971668117,0.221427598968148,28,28,0,40,40,0,49,65,-16,2,0,0,0
"19614","S.J","CHI",2017020944,17585,20172018,0,60,1,3,-2,5.45172279170947,4.50786990097549,0.943852890733979,43,36,7,57,43,14,70,66,4,1,2,0,0
"19615","S.J","MIN",2017020961,17587,20172018,0,64.8,2,3,-1,3.08558112961593,8.2480655683903,-5.16248443877437,28,41,-13,38,53,-15,48,77,-29,1,3,0,0
"19616","S.J","EDM",2017020977,17589,20172018,1,60,5,2,3,6.29008509364843,7.41601442894898,-1.12592933530055,37,26,11,49,40,9,67,60,7,4,3,0,0
"19617","S.J","CHI",2017020990,17591,20172018,1,60,7,2,5,4.01731293165358,3.04895622569893,0.968356705954648,34,34,0,45,43,2,59,71,-12,1,2,0,0
"19618","S.J","CBJ",2017021014,17594,20172018,1,60,2,4,-2,3.6215591035143,7.16046584605647,-3.53890674254217,35,28,7,49,38,11,60,55,5,4,2,0,0
"19619","S.J","DET",2017021070,17602,20172018,1,60,5,3,2,5.42476873843749,2.94614290903883,2.47862582939866,34,26,8,49,35,14,60,48,12,3,2,0,0
"19620","S.J","EDM",2017021080,17604,20172018,0,62.6666666666667,4,3,1,0,0,0,40,28,12,54,38,16,66,52,14,3,1,0,0
"19621","S.J","VAN",2017021107,17607,20172018,0,60,5,3,2,5.23918076435075,5.21240155963527,0.0267792047154813,30,31,-1,41,47,-6,51,70,-19,4,4,0,0
"19622","S.J","N.J",2017021131,17610,20172018,1,60,6,2,4,3.50337704914466,5.49523982591904,-1.99186277677438,25,28,-3,42,45,-3,64,62,2,2,4,0,0
"19623","S.J","VGK",2017021145,17612,20172018,1,60.65,2,1,1,6.05302668413788,3.88949061877065,2.16353606536723,44,25,19,59,36,23,80,49,31,5,2,0,0
"19624","S.J","CHI",2017021174,17616,20172018,0,65,3,3,0,4.87815025176678,4.39969287269693,0.478457379069855,38,31,7,55,41,14,81,61,20,3,2,0,0
"19625","S.J","VGK",2017021217,17621,20172018,0,60,2,3,-1,4.81179741254891,6.06928222762053,-1.25748481507162,31,38,-7,39,56,-17,54,79,-25,2,4,0,0
"19626","S.J","DAL",2017021237,17624,20172018,1,60,2,4,-2,4.43168835920968,4.29149287900407,0.140195480205608,31,23,8,42,37,5,57,58,-1,1,1,0,0
"19627","S.J","COL",2017021252,17626,20172018,1,60,4,2,2,8.19091815898719,3.86117833600212,4.32973982298507,36,25,11,50,39,11,68,67,1,2,1,0,0
"19628","S.J","MIN",2017021271,17628,20172018,1,60,3,6,-3,5.37088686069183,4.68458717194153,0.686299688750296,30,24,6,48,32,16,70,55,15,2,1,0,0
"19629","S.J","ANA",2017030181,17633,20172018,0,60,3,0,3,7.88006364073681,5.02373527900091,2.8563283617359,34,25,9,57,45,12,70,65,5,7,4,0,0
"19630","S.J","ANA",2017030182,17635,20172018,0,60,3,2,1,6.49441191972255,6.46476118613411,0.0296507335884435,35,30,5,53,45,8,68,61,7,4,3,0,0
"19631","S.J","ANA",2017030183,17637,20172018,1,60,8,1,7,6.5577391431143,6.47991975256735,0.0778193905469564,36,46,-10,50,57,-7,66,75,-9,9,4,0,0
"19632","S.J","ANA",2017030184,17639,20172018,1,60,2,1,1,2.76728203145699,3.25019096920082,-0.482908937743828,24,31,-7,35,42,-7,54,61,-7,3,4,0,0
"19633","S.J","VGK",2017030241,17647,20172018,0,60,0,7,-7,4.82443754474058,6.43993411085464,-1.61549656611405,33,34,-1,41,55,-14,67,68,-1,5,8,0,0
"19634","S.J","VGK",2017030242,17649,20172018,0,80,3,3,0,4.75358726275385,2.82739838794636,1.9261888748075,42,28,14,60,44,16,83,77,6,9,6,0,0
"19635","S.J","VGK",2017030243,17651,20172018,1,68.2833333333333,3,4,-1,6.68193330189774,4.65876994561222,2.02316335628552,42,33,9,49,52,-3,66,75,-9,4,6,0,0
"19636","S.J","VGK",2017030244,17653,20172018,1,60,4,0,4,3.73369535422671,4.63726213751364,-0.903566783286934,34,34,0,46,43,3,59,62,-3,6,6,0,0
"19637","S.J","VGK",2017030245,17655,20172018,0,60,3,5,-2,5.75704617072257,5.85715982491337,-0.100113654190795,30,39,-9,39,53,-14,63,71,-8,4,5,0,0
"19638","S.J","VGK",2017030246,17657,20172018,1,60,0,3,-3,5.4478014439997,4.80750350535503,0.640297938644669,28,33,-5,46,41,5,68,55,13,2,1,0,0
"19639","S.J","ANA",2018020004,17807,20182019,1,60,2,5,-3,5.78302199899917,3.33973804855486,2.44328395044431,33,15,18,55,21,34,71,34,37,3,3,0,0
"19640","S.J","L.A",2018020016,17809,20182019,0,62.9,3,2,1,5.17360584821206,4.23269284679554,0.940913001416519,33,21,12,56,38,18,68,53,15,3,5,0,0
"19641","S.J","NYI",2018020033,17812,20182019,0,60,0,4,-4,3.48453679625527,4.19324834696312,-0.708711550707847,35,30,5,47,41,6,70,50,20,4,4,0,0
"19642","S.J","PHI",2018020036,17813,20182019,0,60,8,2,6,8.40032348256452,6.09047030261595,2.30985317994857,48,33,15,62,51,11,70,59,11,5,6,0,0
"19643","S.J","NYR",2018020049,17815,20182019,0,60.6166666666667,2,3,-1,4.96928445865977,4.45672125794772,0.512563200712053,43,27,16,61,37,24,81,50,31,4,3,0,0
"19644","S.J","N.J",2018020071,17818,20182019,0,60,2,3,-1,5.69824741597034,4.9742286126058,0.724018803364546,39,36,3,52,44,8,64,57,7,3,7,0,0
"19645","S.J","NYI",2018020114,17824,20182019,1,60,4,1,3,7.498000358912,2.26714334856227,5.23085701034972,41,25,16,61,31,30,76,41,35,6,5,0,0
"19646","S.J","CAR",2018020146,17830,20182019,0,65,3,3,0,4.03373788257886,6.85973631994693,-2.82599843736807,23,41,-18,39,64,-25,51,80,-29,3,2,0,0
"19647","S.J","ANA",2018020164,17832,20182019,0,62.2,4,3,1,5.66445991471612,3.86750003485404,1.79695987986208,49,30,19,67,41,26,83,51,32,3,2,0,0
"19648","S.J","NYR",2018020177,17834,20182019,1,65,3,3,0,6.35048124432797,3.27113022807264,3.07935101625533,34,37,-3,49,48,1,65,63,2,2,4,0,0
"19649","S.J","CBJ",2018020191,17836,20182019,1,60,1,4,-3,6.85292152772308,7.72054803948413,-0.867626511761046,45,27,18,56,38,18,86,42,44,4,2,0,0
"19650","S.J","PHI",2018020206,17838,20182019,1,60.2166666666667,4,3,1,3.8424601010872,3.19470073550474,0.64775936558246,35,25,10,46,36,10,62,42,20,3,3,0,0
"19651","S.J","MIN",2018020223,17841,20182019,1,60,4,3,1,4.79001469761221,5.5217832615599,-0.731768563947696,22,26,-4,38,45,-7,53,66,-13,0,3,0,0
"19652","S.J","DAL",2018020234,17843,20182019,0,60,3,4,-1,8.91664166641931,2.47330275055337,6.44333891586594,36,22,14,59,36,23,77,47,30,3,1,0,0
"19653","S.J","TOR",2018020285,17850,20182019,1,60,3,5,-2,7.0016023813108,7.12599297092422,-0.124390589613414,45,34,11,62,51,11,72,71,1,6,6,0,0
"19654","S.J","EDM",2018020317,17855,20182019,1,60.85,3,4,-1,4.55942837486509,2.35580761991534,2.20362075494975,25,23,2,34,32,2,44,45,-1,3,1,0,0
"19655","S.J","VAN",2018020346,17858,20182019,1,60,4,0,4,5.052002751705,2.89461141309369,2.15739133861131,24,19,5,32,31,1,48,47,1,6,4,0,0
"19656","S.J","VGK",2018020356,17859,20182019,0,60,0,6,-6,3.48623142213885,2.55109581747047,0.935135604668377,33,36,-3,46,43,3,62,60,2,5,8,0,0
"19657","S.J","TOR",2018020379,17863,20182019,0,60,3,5,-2,5.97868819124415,4.86434349458409,1.11434469666005,41,29,12,56,42,14,74,50,24,3,4,0,0
"19658","S.J","MTL",2018020409,17867,20182019,0,60,3,1,2,4.94260461830709,6.69311306333111,-1.75050844502402,29,41,-12,43,51,-8,62,73,-11,4,2,0,0
"19659","S.J","CAR",2018020428,17870,20182019,1,60,5,1,4,4.65898542748801,6.21968105793349,-1.56069563044548,23,40,-17,31,57,-26,41,77,-36,3,4,0,0
"19660","S.J","DAL",2018020440,17872,20182019,0,60,2,3,-1,4.907551093027,4.05136669566855,0.856184397358447,43,30,13,56,36,20,69,45,24,2,2,0,0
"19661","S.J","ARI",2018020452,17873,20182019,0,60,5,3,2,6.25178489630343,4.14948592643486,2.10229896986857,33,20,13,44,32,12,67,46,21,1,1,0,0
"19662","S.J","N.J",2018020464,17875,20182019,1,60,5,2,3,4.60295744774339,4.19524624856422,0.407711199179175,34,24,10,50,36,14,64,46,18,2,2,0,0
"19663","S.J","DAL",2018020486,17878,20182019,1,60,3,2,1,4.3491981800471,2.85635226688464,1.49284591316245,24,22,2,34,30,4,51,40,11,1,0,0,0
"19664","S.J","CHI",2018020509,17881,20182019,0,60,7,3,4,6.78920936528836,0.907660081749782,5.88154928353857,43,20,23,52,23,29,66,39,27,3,5,0,0
"19665","S.J","MIN",2018020521,17883,20182019,0,60,4,0,4,6.15226186183281,2.76036912522977,3.39189273660304,25,26,-1,36,34,2,52,48,4,1,0,0,0
"19666","S.J","WPG",2018020541,17885,20182019,1,60,3,5,-2,5.5181060424229,2.70099831805356,2.81710772436934,44,25,19,57,30,27,79,40,39,4,3,0,0
"19667","S.J","L.A",2018020550,17887,20182019,1,62.4833333333333,2,3,-1,4.07579440902555,2.51600954169953,1.55978486732602,31,31,0,47,35,12,76,46,30,1,1,0,0
"19668","S.J","ARI",2018020566,17888,20182019,1,65,3,3,0,7.04548921275154,2.10960468818423,4.93588452456731,38,26,12,46,33,13,74,45,29,6,5,0,0
"19669","S.J","ANA",2018020579,17892,20182019,1,60,4,2,2,7.53998587793514,3.24285702388881,4.29712885404633,39,27,12,51,41,10,62,64,-2,4,5,0,0
"19670","S.J","EDM",2018020585,17894,20182019,0,60,7,4,3,6.42823563900311,1.97368732235831,4.4545483166448,40,26,14,58,34,24,68,40,28,3,1,0,0
"19671","S.J","COL",2018020619,17898,20182019,0,60,5,4,1,4.81703363198488,4.22670676495181,0.59032686703307,27,35,-8,37,46,-9,53,57,-4,3,4,0,0
"19672","S.J","T.B",2018020644,17901,20182019,1,60,5,2,3,5.94396821026658,2.92366440023761,3.02030381002896,33,20,13,45,33,12,60,46,14,3,2,0,0
"19673","S.J","L.A",2018020656,17903,20182019,1,60,3,1,2,3.2035133707468,2.66685418304354,0.536659187703266,29,23,6,40,28,12,60,44,16,3,0,0,0
"19674","S.J","EDM",2018020667,17904,20182019,1,60,7,2,5,4.69455490313703,2.94013196672631,1.75442293641072,36,22,14,50,30,20,63,36,27,4,3,0,0
"19675","S.J","VGK",2018020681,17906,20182019,0,60,3,2,1,2.63097478076816,4.97808520173817,-2.34711042097001,27,38,-11,38,46,-8,60,66,-6,2,3,0,0
"19676","S.J","PIT",2018020720,17911,20182019,1,60,5,2,3,5.2129855053081,4.68583141930867,0.527154085999427,29,24,5,41,36,5,57,48,9,2,2,0,0
"19677","S.J","ARI",2018020725,17912,20182019,0,60,3,6,-3,4.06283185168286,7.44269259127122,-3.37986073958837,29,41,-12,42,54,-12,66,65,1,3,4,0,0
"19678","S.J","T.B",2018020744,17915,20182019,0,60,3,6,-3,5.06533372116564,2.21063426753062,2.85469945363502,39,26,13,56,36,20,78,48,30,3,4,0,0
"19679","S.J","ARI",2018020801,17929,20182019,1,63.2333333333333,3,2,1,2.89036072160798,2.65280435139721,0.237556370210768,35,33,2,40,48,-8,57,59,-2,2,5,0,0
"19680","S.J","WPG",2018020818,17932,20182019,0,62.8166666666667,3,2,1,3.57344249162903,2.62111808893678,0.952324402692252,38,27,11,54,50,4,68,67,1,4,6,0,0
"19681","S.J","CGY",2018020835,17934,20182019,0,60,5,2,3,3.52125858795625,5.71481151067411,-2.19355292271786,30,38,-8,41,53,-12,53,73,-20,3,7,0,0
"19682","S.J","EDM",2018020849,17936,20182019,0,60,5,2,3,5.35115664709161,4.10223109702117,1.24892555007043,31,23,8,41,34,7,54,47,7,6,2,0,0
"19683","S.J","VAN",2018020862,17938,20182019,0,60,7,2,5,3.50808587531674,2.44193592707254,1.0661499482442,24,27,-3,38,41,-3,51,52,-1,4,3,0,0
"19684","S.J","VAN",2018020902,17943,20182019,1,60,3,2,1,4.7142386532505,2.07002955912026,2.64420909413025,26,34,-8,42,45,-3,63,62,1,4,4,0,0
"19685","S.J","BOS",2018020915,17945,20182019,1,63.9833333333333,5,6,-1,5.16908576136469,3.12735284425435,2.04173291711034,38,20,18,55,31,24,66,39,27,4,5,0,0
"19686","S.J","PIT",2018020933,17948,20182019,0,60,4,0,4,3.04859868481992,2.9640044686343,0.0845942161856219,33,26,7,42,32,10,58,45,13,8,3,0,0
"19687","S.J","CBJ",2018020949,17950,20182019,0,60,0,4,-4,2.41868887925952,2.93403152798383,-0.515342648724315,26,26,0,34,33,1,40,44,-4,2,2,0,0
"19688","S.J","DET",2018020957,17951,20182019,0,60,5,3,2,5.58561558250608,1.58673564925266,3.99887993325342,37,23,14,46,26,20,63,35,28,3,2,0,0
"19689","S.J","BOS",2018020968,17953,20182019,0,60,1,4,-3,2.86445110505792,2.53058968714513,0.333861417912796,20,32,-12,30,44,-14,46,51,-5,5,5,0,0
"19690","S.J","COL",2018020998,17956,20182019,1,60,4,3,1,4.09182395434421,5.47094289127836,-1.37911893693414,40,25,15,53,40,13,75,53,22,3,2,0,0
"19691","S.J","CHI",2018021016,17958,20182019,1,60,5,2,3,2.80746240464214,3.71293965575751,-0.905477251115371,34,30,4,43,47,-4,54,63,-9,1,3,0,0
"19692","S.J","MTL",2018021043,17962,20182019,1,60,5,2,3,5.39166389553975,6.91311988670714,-1.52145599116739,25,39,-14,33,54,-21,46,67,-21,0,1,0,0
"19693","S.J","MIN",2018021068,17966,20182019,0,60,3,0,3,2.91257600316749,2.99573937742389,-0.0831633742564009,29,24,5,39,42,-3,47,58,-11,3,3,0,0
"19694","S.J","WPG",2018021077,17967,20182019,0,60,5,4,1,7.79438880069233,2.83358225045959,4.96080655023275,36,25,11,48,38,10,66,47,19,2,2,0,0
"19695","S.J","VGK",2018021121,17973,20182019,1,60,3,7,-4,5.04041971697006,5.9255321062242,-0.885112389254136,39,42,-3,55,51,4,69,56,13,6,7,0,0
"19696","S.J","L.A",2018021147,17976,20182019,0,60,2,4,-2,4.95920384287456,7.555497310188,-2.59629346731344,25,35,-10,42,44,-2,60,48,12,3,1,0,0
"19697","S.J","ANA",2018021149,17977,20182019,0,60.6333333333333,3,4,-1,2.54995232302596,2.96566824982287,-0.415715926796912,26,21,5,43,39,4,65,47,18,5,3,0,0
"19698","S.J","DET",2018021177,17980,20182019,1,60,2,3,-1,9.34542347391834,4.26981243394505,5.0756110399733,41,23,18,62,32,30,87,43,44,4,1,0,0
"19699","S.J","CHI",2018021196,17983,20182019,1,60,4,5,-1,4.47497091055266,2.63926445972174,1.83570645083091,30,27,3,43,30,13,63,39,24,5,2,0,0
"19700","S.J","VGK",2018021211,17985,20182019,1,60.3666666666667,4,3,1,5.57010974756849,3.52056990005647,2.04953984751202,34,26,8,42,35,7,55,44,11,6,5,0,0
"19701","S.J","CGY",2018021220,17986,20182019,1,60,3,5,-2,2.44642663132065,3.42234141378412,-0.975914782463474,15,28,-13,27,44,-17,47,55,-8,2,6,0,0
"19702","S.J","VAN",2018021237,17988,20182019,0,60,2,4,-2,4.0280450603459,5.64529592574973,-1.61725086540383,35,23,12,49,34,15,61,46,15,4,2,0,0
"19703","S.J","EDM",2018021252,17990,20182019,0,60,3,2,1,3.41037152941863,2.76173262683938,0.64863890257925,27,28,-1,34,35,-1,41,51,-10,3,5,0,0
"19704","S.J","COL",2018021271,17992,20182019,1,60,5,2,3,4.47362259973306,4.59273412459879,-0.11911152486573,30,30,0,42,42,0,58,62,-4,2,2,0,0
"19705","S.J","VGK",2018030181,17996,20182019,1,60,5,2,3,4.99834517601346,3.80955837666443,1.18878679934903,33,26,7,43,41,2,64,57,7,7,6,0,0
"19706","S.J","VGK",2018030182,17998,20182019,1,60,3,5,-2,5.63195503648603,3.65247039918265,1.97948463730338,37,23,14,47,34,13,73,44,29,11,6,0,0
"19707","S.J","VGK",2018030183,18000,20182019,0,60,3,6,-3,4.83980169526522,6.75685052006966,-1.91704882480444,28,40,-12,38,54,-16,51,71,-20,5,7,0,0
"19708","S.J","VGK",2018030184,18002,20182019,0,60,0,5,-5,4.13899831946395,4.20515493194548,-0.0661566124815334,28,27,1,40,39,1,60,51,9,4,9,0,0
"19709","S.J","VGK",2018030185,18004,20182019,1,60,5,2,3,4.97880306973821,5.01108600501902,-0.0322829352808185,29,32,-3,43,42,1,64,60,4,3,2,0,0
"19710","S.J","VGK",2018030186,18007,20182019,0,80,1,1,0,6.0608874955069,8.39380378457522,-2.33291628906832,28,51,-23,38,74,-36,67,103,-36,2,2,0,0
"19711","S.J","VGK",2018030187,18009,20182019,1,78.3166666666667,5,4,1,6.26192426538182,3.04138986382895,3.22053440155287,48,38,10,63,47,16,88,63,25,4,2,0,0
"19712","S.J","COL",2018030241,18012,20182019,1,60,5,2,3,4.33745445005688,5.19352530319884,-0.856070853141961,27,28,-1,38,37,1,54,59,-5,3,3,0,0
"19713","S.J","COL",2018030242,18014,20182019,1,60,3,4,-1,4.14175350659934,4.00161459457013,0.140138912029215,34,32,2,43,44,-1,68,60,8,3,2,0,0
"19714","S.J","COL",2018030243,18016,20182019,0,60,4,2,2,5.47451184563767,2.94955545585253,2.52495638978514,31,27,4,41,31,10,60,49,11,4,4,0,0
"19715","S.J","COL",2018030244,18018,20182019,0,60,0,3,-3,2.6140491308997,3.35445179507178,-0.74040266417208,32,28,4,48,40,8,68,54,14,3,6,0,0
"19716","S.J","COL",2018030245,18020,20182019,1,60,2,1,1,5.0375578747915,3.54761367567698,1.48994419911452,39,22,17,52,35,17,74,54,20,5,3,0,0
"19717","S.J","COL",2018030246,18022,20182019,0,62.5333333333333,3,4,-1,3.27152905261028,2.96920566674817,0.30232338586211,22,26,-4,38,37,1,61,57,4,1,3,0,0
"19718","S.J","COL",2018030247,18024,20182019,1,60,3,2,1,3.70719015737592,1.90307777602777,1.80411238134815,27,29,-2,37,39,-2,55,56,-1,3,3,0,0
"19719","STL","NSH",2008020014,14162,20082009,1,60,5,2,3,0,0,0,22,22,0,36,39,-3,43,49,-6,6,4,0,0
"19720","STL","NYI",2008020018,14163,20082009,0,60,2,5,-3,0,0,0,26,34,-8,36,49,-13,56,61,-5,3,4,0,0
"19721","STL","TOR",2008020032,14165,20082009,0,65,4,4,0,0,0,0,26,39,-13,39,59,-20,56,79,-23,5,7,0,0
"19722","STL","DAL",2008020054,14168,20082009,1,60,6,1,5,0,0,0,23,30,-7,37,42,-5,44,52,-8,5,4,0,0
"19723","STL","CHI",2008020073,14170,20082009,1,65,3,3,0,0,0,0,29,26,3,43,32,11,58,47,11,4,4,0,0
"19724","STL","DET",2008020090,14174,20082009,1,60,3,4,-1,0,0,0,24,34,-10,40,46,-6,51,57,-6,7,5,0,0
"19725","STL","L.A",2008020104,14176,20082009,1,60,0,4,-4,0,0,0,15,29,-14,31,42,-11,43,56,-13,7,6,0,0
"19726","STL","FLA",2008020116,14177,20082009,1,60,4,0,4,0,0,0,31,17,14,45,36,9,59,52,7,8,5,0,0
"19727","STL","CAR",2008020142,14182,20082009,1,60,0,1,-1,0,0,0,19,29,-10,38,44,-6,45,61,-16,3,6,0,0
"19728","STL","PIT",2008020159,14184,20082009,1,60,3,6,-3,0,0,0,22,28,-6,35,44,-9,51,49,2,4,6,0,0
"19729","STL","ANA",2008020180,14188,20082009,0,60,2,5,-3,0,0,0,32,27,5,41,37,4,50,49,1,5,1,0,0
"19730","STL","S.J",2008020191,14189,20082009,0,65,4,4,0,0,0,0,29,43,-14,38,65,-27,50,93,-43,7,8,0,0
"19731","STL","L.A",2008020207,14191,20082009,0,60,3,5,-2,0,0,0,27,31,-4,52,45,7,69,58,11,4,6,0,0
"19732","STL","BUF",2008020221,14195,20082009,0,60,3,4,-1,0,0,0,33,32,1,46,48,-2,57,57,0,2,4,0,0
"19733","STL","CHI",2008020240,14197,20082009,0,62.25,4,3,1,0,0,0,30,35,-5,35,46,-11,48,64,-16,6,6,0,0
"19734","STL","MTL",2008020253,14199,20082009,1,65,2,2,0,0,0,0,26,26,0,37,44,-7,47,53,-6,9,10,0,0
"19735","STL","ANA",2008020284,14204,20082009,1,62.65,3,2,1,0,0,0,28,28,0,40,33,7,51,53,-2,6,6,0,0
"19736","STL","MIN",2008020292,14205,20082009,0,60,2,1,1,0,0,0,26,32,-6,32,48,-16,44,68,-24,2,4,0,0
"19737","STL","NSH",2008020306,14208,20082009,0,65,0,0,0,0,0,0,17,47,-30,28,59,-31,42,75,-33,5,6,0,0
"19738","STL","COL",2008020318,14209,20082009,0,60,1,3,-2,0,0,0,22,28,-6,34,35,-1,50,49,1,2,3,0,0
"19739","STL","EDM",2008020334,14212,20082009,1,60,2,4,-2,0,0,0,29,22,7,38,38,0,43,48,-5,5,5,0,0
"19740","STL","ATL",2008020347,14213,20082009,0,60,4,2,2,0,0,0,47,30,17,59,42,17,78,52,26,4,2,0,0
"19741","STL","MIN",2008020363,14216,20082009,0,60,0,4,-4,0,0,0,22,38,-16,34,49,-15,42,61,-19,3,5,0,0
"19742","STL","CGY",2008020377,14218,20082009,1,62.35,3,4,-1,0,0,0,25,30,-5,38,44,-6,45,55,-10,5,5,0,0
"19743","STL","ARI",2008020389,14219,20082009,1,60,4,3,1,0,0,0,30,26,4,46,36,10,56,47,9,4,6,0,0
"19744","STL","NSH",2008020401,14221,20082009,1,60,6,3,3,0,0,0,26,21,5,47,28,19,58,37,21,5,2,0,0
"19745","STL","ANA",2008020413,14223,20082009,0,60,2,4,-2,0,0,0,28,36,-8,39,46,-7,47,53,-6,6,5,0,0
"19746","STL","L.A",2008020420,14224,20082009,0,60,2,6,-4,0,0,0,28,32,-4,39,48,-9,56,60,-4,7,9,0,0
"19747","STL","S.J",2008020440,14226,20082009,0,60,4,5,-1,0,0,0,33,38,-5,42,56,-14,59,70,-11,8,6,0,0
"19748","STL","CGY",2008020451,14229,20082009,1,60,3,6,-3,0,0,0,31,31,0,42,42,0,53,52,1,8,6,0,0
"19749","STL","WSH",2008020461,14231,20082009,0,60,2,4,-2,0,0,0,31,29,2,35,42,-7,55,58,-3,5,5,0,0
"19750","STL","MIN",2008020482,14233,20082009,1,60,4,2,2,0,0,0,24,26,-2,39,39,0,47,53,-6,4,6,0,0
"19751","STL","BOS",2008020487,14234,20082009,1,60,3,6,-3,0,0,0,32,28,4,41,39,2,49,48,1,3,4,0,0
"19752","STL","DET",2008020502,14236,20082009,0,60,1,4,-3,0,0,0,34,41,-7,49,55,-6,58,68,-10,7,8,0,0
"19753","STL","S.J",2008020523,14240,20082009,1,65,2,2,0,0,0,0,28,26,2,39,37,2,49,53,-4,2,3,0,0
"19754","STL","ANA",2008020528,14241,20082009,1,60,3,4,-1,0,0,0,30,29,1,43,38,5,54,47,7,8,6,0,0
"19755","STL","N.J",2008020544,14243,20082009,1,60,3,4,-1,0,0,0,31,26,5,44,38,6,53,55,-2,1,3,0,0
"19756","STL","CAR",2008020560,14246,20082009,0,60,1,2,-1,0,0,0,31,29,2,45,46,-1,60,59,1,3,4,0,0
"19757","STL","CBJ",2008020572,14247,20082009,1,60,5,2,3,0,0,0,27,22,5,39,31,8,49,45,4,11,5,0,0
"19758","STL","VAN",2008020612,14253,20082009,0,60,6,4,2,0,0,0,36,22,14,50,28,22,65,39,26,5,2,0,0
"19759","STL","EDM",2008020627,14255,20082009,0,60,1,2,-1,0,0,0,22,28,-6,38,38,0,52,49,3,5,5,0,0
"19760","STL","CGY",2008020639,14257,20082009,0,60,1,3,-2,0,0,0,28,34,-6,40,43,-3,50,58,-8,5,7,0,0
"19761","STL","COL",2008020651,14259,20082009,1,60,5,2,3,0,0,0,26,26,0,38,30,8,49,43,6,3,4,0,0
"19762","STL","CHI",2008020669,14261,20082009,1,61.3833333333333,1,2,-1,0,0,0,28,21,7,49,35,14,56,50,6,5,3,0,0
"19763","STL","BOS",2008020677,14263,20082009,0,65,4,4,0,0,0,0,31,26,5,40,38,2,54,55,-1,5,6,0,0
"19764","STL","CHI",2008020698,14265,20082009,0,60,2,0,2,0,0,0,29,21,8,33,26,7,53,39,14,4,4,0,0
"19765","STL","OTT",2008020721,14273,20082009,1,60,1,3,-2,0,0,0,23,30,-7,37,44,-7,48,56,-8,3,5,0,0
"19766","STL","PHI",2008020738,14275,20082009,1,60,4,0,4,0,0,0,35,36,-1,45,56,-11,53,77,-24,10,12,0,0
"19767","STL","DET",2008020745,14277,20082009,0,65,3,3,0,0,0,0,33,21,12,43,33,10,50,48,2,5,3,0,0
"19768","STL","CBJ",2008020751,14278,20082009,0,60,4,2,2,0,0,0,22,35,-13,30,51,-21,34,65,-31,4,6,0,0
"19769","STL","EDM",2008020768,14280,20082009,1,65,1,1,0,0,0,0,34,23,11,53,36,17,62,49,13,4,3,0,0
"19770","STL","COL",2008020786,14282,20082009,1,60,4,1,3,0,0,0,23,24,-1,34,34,0,45,47,-2,5,6,0,0
"19771","STL","VAN",2008020801,14285,20082009,1,60,4,6,-2,0,0,0,28,30,-2,37,43,-6,47,62,-15,5,7,0,0
"19772","STL","NSH",2008020815,14287,20082009,0,65,3,3,0,0,0,0,27,34,-7,34,45,-11,49,67,-18,4,5,0,0
"19773","STL","CHI",2008020822,14288,20082009,1,60,1,0,1,0,0,0,23,22,1,32,38,-6,45,47,-2,6,6,0,0
"19774","STL","NYR",2008020843,14291,20082009,1,60,2,1,1,0,0,0,33,20,13,42,31,11,57,45,12,3,3,0,0
"19775","STL","CBJ",2008020855,14293,20082009,0,60,3,4,-1,0,0,0,24,21,3,34,29,5,50,40,10,5,3,0,0
"19776","STL","NSH",2008020866,14294,20082009,0,62.8666666666667,2,1,1,0,0,0,36,29,7,47,39,8,57,54,3,4,4,0,0
"19777","STL","NSH",2008020885,14296,20082009,1,62.6,0,1,-1,0,0,0,30,22,8,38,40,-2,48,47,1,3,1,0,0
"19778","STL","ARI",2008020901,14299,20082009,1,60,2,1,1,0,0,0,24,25,-1,30,40,-10,40,49,-9,0,3,0,0
"19779","STL","DAL",2008020916,14301,20082009,0,60,3,1,2,0,0,0,22,42,-20,32,58,-26,38,77,-39,4,7,0,0
"19780","STL","ARI",2008020932,14303,20082009,0,60,3,1,2,0,0,0,30,27,3,46,38,8,54,57,-3,4,5,0,0
"19781","STL","DET",2008020950,14306,20082009,1,60,0,5,-5,0,0,0,22,36,-14,27,50,-23,36,63,-27,3,8,0,0
"19782","STL","T.B",2008020967,14309,20082009,0,60.45,4,3,1,0,0,0,36,23,13,54,33,21,63,42,21,5,4,0,0
"19783","STL","FLA",2008020975,14310,20082009,0,60,3,5,-2,0,0,0,29,35,-6,41,44,-3,56,54,2,4,5,0,0
"19784","STL","DAL",2008020998,14313,20082009,1,60,5,2,3,0,0,0,27,22,5,34,33,1,41,42,-1,8,8,0,0
"19785","STL","S.J",2008021012,14315,20082009,1,60,3,1,2,0,0,0,26,25,1,39,37,2,45,43,2,5,8,0,0
"19786","STL","DET",2008021020,14317,20082009,1,60,2,5,-3,0,0,0,32,27,5,44,30,14,53,43,10,4,4,0,0
"19787","STL","MIN",2008021035,14318,20082009,1,60,5,3,2,0,0,0,36,22,14,49,33,16,65,47,18,7,3,0,0
"19788","STL","EDM",2008021048,14320,20082009,0,65,1,1,0,0,0,0,32,34,-2,47,47,0,64,72,-8,4,4,0,0
"19789","STL","VAN",2008021060,14322,20082009,0,60,0,3,-3,0,0,0,30,21,9,43,36,7,52,51,1,6,3,0,0
"19790","STL","CGY",2008021069,14323,20082009,0,60,3,2,1,0,0,0,28,35,-7,43,51,-8,49,75,-26,3,5,0,0
"19791","STL","L.A",2008021093,14327,20082009,1,60,2,0,2,0,0,0,23,22,1,30,39,-9,43,54,-11,5,6,0,0
"19792","STL","VAN",2008021107,14329,20082009,1,60,4,2,2,0,0,0,32,23,9,45,29,16,54,43,11,7,6,0,0
"19793","STL","CBJ",2008021124,14331,20082009,1,65,3,3,0,0,0,0,28,27,1,40,34,6,51,41,10,7,5,0,0
"19794","STL","CBJ",2008021128,14332,20082009,0,60,5,2,3,0,0,0,27,28,-1,33,41,-8,39,60,-21,7,5,0,0
"19795","STL","CHI",2008021148,14335,20082009,0,60,1,3,-2,0,0,0,17,30,-13,18,41,-23,22,55,-33,3,7,0,0
"19796","STL","DET",2008021153,14336,20082009,0,60,5,4,1,0,0,0,33,38,-5,43,53,-10,54,79,-25,4,5,0,0
"19797","STL","DAL",2008021171,14338,20082009,0,60.2666666666667,4,5,-1,0,0,0,26,24,2,49,33,16,65,47,18,5,2,0,0
"19798","STL","ARI",2008021195,14341,20082009,0,60,5,1,4,0,0,0,24,29,-5,27,40,-13,40,60,-20,2,2,0,0
"19799","STL","CBJ",2008021211,14344,20082009,1,60,3,1,2,0,0,0,25,17,8,37,23,14,41,33,8,7,1,0,0
"19800","STL","COL",2008021227,14346,20082009,0,60,1,0,1,0,0,0,17,28,-11,29,42,-13,37,50,-13,3,4,0,0
"19801","STL","VAN",2008030171,14349,20082009,0,60,1,2,-1,0,0,0,26,31,-5,36,39,-3,48,49,-1,8,7,0,0
"19802","STL","VAN",2008030172,14351,20082009,0,60,0,3,-3,0,0,0,30,27,3,41,44,-3,56,61,-5,5,6,0,0
"19803","STL","VAN",2008030173,14353,20082009,1,60,2,3,-1,0,0,0,26,26,0,40,35,5,52,51,1,7,8,0,0
"19804","STL","VAN",2008030174,14355,20082009,1,79.6833333333333,2,3,-1,0,0,0,49,36,13,62,48,14,78,54,24,6,3,0,0
"19805","STL","DET",2009020008,14519,20092010,0,60,4,3,1,0,0,0,23,34,-11,38,45,-7,50,65,-15,4,4,0,0
"19806","STL","DET",2009020020,14520,20092010,1,60,5,3,2,0,0,0,32,33,-1,40,48,-8,55,68,-13,6,6,0,0
"19807","STL","ATL",2009020042,14525,20092010,1,60,2,4,-2,0,0,0,31,22,9,42,29,13,48,38,10,3,2,0,0
"19808","STL","L.A",2009020056,14527,20092010,1,60,1,2,-1,0,0,0,30,26,4,39,37,2,52,44,8,5,6,0,0
"19809","STL","ARI",2009020086,14532,20092010,0,63.6166666666667,2,3,-1,0,0,0,24,34,-10,33,54,-21,44,64,-20,2,4,0,0
"19810","STL","ANA",2009020105,14534,20092010,0,60,5,0,5,0,0,0,32,26,6,56,34,22,64,42,22,7,5,0,0
"19811","STL","PIT",2009020109,14537,20092010,0,60,1,5,-4,0,0,0,23,43,-20,32,53,-21,50,67,-17,3,5,0,0
"19812","STL","MIN",2009020128,14540,20092010,1,60,3,1,2,0,0,0,26,21,5,40,30,10,51,43,8,6,3,0,0
"19813","STL","DAL",2009020138,14541,20092010,1,60,1,4,-3,0,0,0,28,31,-3,44,42,2,58,53,5,8,10,0,0
"19814","STL","CAR",2009020157,14545,20092010,0,60,5,2,3,0,0,0,18,36,-18,29,60,-31,37,82,-45,1,6,0,0
"19815","STL","ARI",2009020168,14546,20092010,1,60,0,2,-2,0,0,0,32,29,3,45,46,-1,59,56,3,3,2,0,0
"19816","STL","FLA",2009020187,14548,20092010,1,60,0,4,-4,0,0,0,34,27,7,44,33,11,64,40,24,3,3,0,0
"19817","STL","CGY",2009020213,14553,20092010,1,62.8333333333333,1,2,-1,0,0,0,31,32,-1,42,44,-2,63,54,9,5,6,0,0
"19818","STL","PHI",2009020231,14555,20092010,0,65,1,1,0,0,0,0,31,36,-5,44,54,-10,71,72,-1,6,7,0,0
"19819","STL","ATL",2009020238,14556,20092010,0,65,2,2,0,0,0,0,32,40,-8,45,51,-6,54,70,-16,4,6,0,0
"19820","STL","VAN",2009020245,14558,20092010,1,60,6,1,5,0,0,0,30,23,7,38,39,-1,48,51,-3,9,7,0,0
"19821","STL","NSH",2009020259,14560,20092010,1,60,1,3,-2,0,0,0,22,37,-15,29,50,-21,38,66,-28,5,3,0,0
"19822","STL","S.J",2009020276,14562,20092010,1,60,1,3,-2,0,0,0,39,17,22,53,32,21,69,42,27,6,5,0,0
"19823","STL","ARI",2009020302,14567,20092010,1,60.2833333333333,3,2,1,0,0,0,30,36,-6,48,46,2,57,54,3,4,4,0,0
"19824","STL","NYI",2009020320,14569,20092010,1,60,4,1,3,0,0,0,26,24,2,44,39,5,55,49,6,4,3,0,0
"19825","STL","BOS",2009020333,14571,20092010,1,60,2,4,-2,0,0,0,31,23,8,45,33,12,64,42,22,3,3,0,0
"19826","STL","DAL",2009020347,14573,20092010,0,65,3,3,0,0,0,0,38,37,1,53,54,-1,67,64,3,3,6,0,0
"19827","STL","NSH",2009020364,14575,20092010,0,60,3,1,2,0,0,0,38,38,0,48,52,-4,53,70,-17,3,5,0,0
"19828","STL","DET",2009020374,14576,20092010,1,65,3,3,0,0,0,0,35,36,-1,46,58,-12,54,72,-18,2,1,0,0
"19829","STL","CBJ",2009020386,14578,20092010,0,60,2,5,-3,0,0,0,29,27,2,36,34,2,47,44,3,4,4,0,0
"19830","STL","S.J",2009020408,14581,20092010,0,65,2,2,0,0,0,0,30,34,-4,48,49,-1,67,63,4,4,6,0,0
"19831","STL","L.A",2009020415,14583,20092010,0,65,4,4,0,0,0,0,31,40,-9,48,57,-9,60,69,-9,5,2,0,0
"19832","STL","COL",2009020435,14585,20092010,1,60,0,4,-4,0,0,0,35,22,13,58,29,29,78,33,45,1,1,0,0
"19833","STL","DET",2009020447,14587,20092010,0,60,1,0,1,0,0,0,26,42,-16,32,63,-31,44,85,-41,4,6,0,0
"19834","STL","EDM",2009020462,14589,20092010,1,60,3,5,-2,0,0,0,30,38,-8,39,46,-7,60,55,5,4,4,0,0
"19835","STL","CGY",2009020489,14593,20092010,1,60,4,3,1,0,0,0,34,23,11,48,31,17,61,46,15,5,4,0,0
"19836","STL","CHI",2009020500,14594,20092010,0,60,0,3,-3,0,0,0,27,35,-8,35,45,-10,48,51,-3,7,9,0,0
"19837","STL","T.B",2009020514,14596,20092010,1,60,3,6,-3,0,0,0,26,24,2,44,33,11,54,43,11,7,5,0,0
"19838","STL","VAN",2009020530,14598,20092010,0,60,3,1,2,0,0,0,26,30,-4,35,40,-5,44,59,-15,4,5,0,0
"19839","STL","EDM",2009020540,14599,20092010,0,60,7,2,5,0,0,0,26,25,1,39,38,1,59,52,7,5,3,0,0
"19840","STL","CGY",2009020556,14601,20092010,0,65,1,1,0,0,0,0,27,24,3,37,36,1,48,58,-10,2,2,0,0
"19841","STL","MIN",2009020565,14604,20092010,0,60,3,4,-1,0,0,0,18,20,-2,28,34,-6,37,43,-6,5,5,0,0
"19842","STL","BUF",2009020572,14605,20092010,1,60,3,5,-2,0,0,0,35,24,11,52,30,22,69,37,32,6,5,0,0
"19843","STL","NSH",2009020586,14607,20092010,1,60,3,4,-1,0,0,0,27,30,-3,38,45,-7,50,60,-10,4,7,0,0
"19844","STL","VAN",2009020604,14609,20092010,1,62.4,3,4,-1,0,0,0,25,30,-5,35,43,-8,44,57,-13,7,12,0,0
"19845","STL","CHI",2009020618,14611,20092010,1,60,3,6,-3,0,0,0,22,33,-11,46,44,2,62,53,9,4,7,0,0
"19846","STL","S.J",2009020644,14615,20092010,0,64.1,1,2,-1,0,0,0,29,44,-15,43,57,-14,62,78,-16,6,5,0,0
"19847","STL","ANA",2009020653,14616,20092010,0,60,2,4,-2,0,0,0,22,29,-7,28,46,-18,35,61,-26,3,5,0,0
"19848","STL","L.A",2009020671,14618,20092010,0,60,4,3,1,0,0,0,32,24,8,45,42,3,55,49,6,3,5,0,0
"19849","STL","CBJ",2009020686,14621,20092010,1,60,4,1,3,0,0,0,23,27,-4,33,32,1,44,42,2,4,6,0,0
"19850","STL","MIN",2009020699,14623,20092010,1,60,1,0,1,0,0,0,37,19,18,47,28,19,59,41,18,3,5,0,0
"19851","STL","NYR",2009020716,14625,20092010,1,60,4,1,3,0,0,0,25,22,3,38,37,1,50,51,-1,4,2,0,0
"19852","STL","CBJ",2009020726,14627,20092010,0,60,2,4,-2,0,0,0,32,30,2,42,40,2,56,59,-3,4,4,0,0
"19853","STL","MTL",2009020742,14629,20092010,0,63.3166666666667,4,3,1,0,0,0,28,38,-10,43,48,-5,61,63,-2,5,5,0,0
"19854","STL","OTT",2009020745,14630,20092010,0,60,2,3,-1,0,0,0,29,30,-1,37,39,-2,53,55,-2,4,5,0,0
"19855","STL","ANA",2009020768,14632,20092010,1,65,3,3,0,0,0,0,21,37,-16,33,56,-23,46,73,-27,1,3,0,0
"19856","STL","CGY",2009020776,14634,20092010,0,60,2,0,2,0,0,0,29,34,-5,42,52,-10,51,72,-21,3,3,0,0
"19857","STL","VAN",2009020792,14636,20092010,0,60,2,3,-1,0,0,0,27,34,-7,35,42,-7,51,50,1,4,7,0,0
"19858","STL","EDM",2009020799,14637,20092010,0,60,2,1,1,0,0,0,20,25,-5,32,36,-4,51,57,-6,2,3,0,0
"19859","STL","CBJ",2009020812,14639,20092010,1,61.5333333333333,2,3,-1,0,0,0,27,19,8,44,26,18,59,35,24,5,6,0,0
"19860","STL","CHI",2009020837,14643,20092010,0,60,3,2,1,0,0,0,19,34,-15,28,43,-15,32,52,-20,3,2,0,0
"19861","STL","S.J",2009020846,14644,20092010,1,60,2,4,-2,0,0,0,37,31,6,48,43,5,58,59,-1,5,4,0,0
"19862","STL","CHI",2009020865,14646,20092010,1,60,1,2,-1,0,0,0,35,30,5,43,38,5,58,46,12,8,6,0,0
"19863","STL","COL",2009020873,14648,20092010,0,60,2,5,-3,0,0,0,34,33,1,44,42,2,56,55,1,2,6,0,0
"19864","STL","DET",2009020881,14649,20092010,1,65,3,3,0,0,0,0,45,42,3,56,49,7,73,68,5,5,4,0,0
"19865","STL","TOR",2009020902,14652,20092010,1,60,4,0,4,0,0,0,33,30,3,40,44,-4,53,54,-1,4,9,0,0
"19866","STL","WSH",2009020911,14653,20092010,1,65,3,3,0,0,0,0,36,34,2,46,46,0,61,62,-1,8,5,0,0
"19867","STL","ARI",2009020933,14670,20092010,0,60,5,2,3,0,0,0,35,39,-4,48,53,-5,53,63,-10,6,6,0,0
"19868","STL","DAL",2009020947,14672,20092010,0,60,6,1,5,0,0,0,27,30,-3,43,42,1,62,57,5,4,4,0,0
"19869","STL","COL",2009020962,14674,20092010,0,60,3,7,-4,0,0,0,42,33,9,60,44,16,73,51,22,5,6,0,0
"19870","STL","NYI",2009020991,14679,20092010,0,65,1,1,0,0,0,0,36,30,6,50,43,7,69,60,9,6,5,0,0
"19871","STL","CBJ",2009021012,14681,20092010,0,60,5,1,4,0,0,0,36,25,11,45,34,11,54,41,13,6,7,0,0
"19872","STL","MIN",2009021021,14682,20092010,0,60,2,4,-2,0,0,0,38,20,18,57,30,27,78,32,46,7,4,0,0
"19873","STL","COL",2009021034,14684,20092010,1,60,3,5,-2,0,0,0,39,26,13,61,33,28,76,38,38,5,3,0,0
"19874","STL","NYR",2009021043,14686,20092010,0,60,4,3,1,0,0,0,16,29,-13,32,45,-13,48,56,-8,3,6,0,0
"19875","STL","N.J",2009021060,14688,20092010,0,60,1,0,1,0,0,0,20,29,-9,23,46,-23,33,55,-22,3,4,0,0
"19876","STL","NSH",2009021072,14689,20092010,1,60,2,3,-1,0,0,0,25,39,-14,35,50,-15,45,63,-18,3,4,0,0
"19877","STL","DET",2009021093,14692,20092010,0,60,2,4,-2,0,0,0,32,24,8,41,37,4,60,53,7,2,2,0,0
"19878","STL","L.A",2009021104,14693,20092010,1,60,3,1,2,0,0,0,25,31,-6,32,44,-12,38,63,-25,3,8,0,0
"19879","STL","EDM",2009021124,14696,20092010,1,60,2,1,1,0,0,0,31,24,7,39,37,2,57,47,10,4,5,0,0
"19880","STL","CHI",2009021139,14698,20092010,1,60,4,2,2,0,0,0,30,34,-4,43,46,-3,50,66,-16,1,2,0,0
"19881","STL","NSH",2009021155,14700,20092010,0,60,2,3,-1,0,0,0,33,32,1,39,42,-3,53,60,-7,5,5,0,0
"19882","STL","DAL",2009021172,14702,20092010,1,60,2,1,1,0,0,0,23,25,-2,31,36,-5,46,48,-2,7,6,0,0
"19883","STL","CBJ",2009021180,14704,20092010,1,63.9833333333333,2,1,1,0,0,0,34,28,6,49,35,14,61,47,14,7,7,0,0
"19884","STL","CHI",2009021195,14706,20092010,0,60,5,6,-1,0,0,0,31,26,5,37,34,3,53,52,1,6,7,0,0
"19885","STL","ANA",2009021210,14708,20092010,1,60,6,3,3,0,0,0,48,26,22,66,39,27,79,45,34,7,5,0,0
"19886","STL","NSH",2009021219,14709,20092010,0,65,1,1,0,0,0,0,34,36,-2,41,46,-5,62,62,0,2,3,0,0
"19887","STL","PHI",2010020019,14891,20102011,1,61.7833333333333,2,1,1,0,0,0,25,30,-5,44,44,0,59,59,0,13,9,0,0
"19888","STL","ANA",2010020029,14893,20102011,1,60,5,1,4,4.38913146152117,1.32255647098646,3.06657499053472,53,14,39,67,19,48,82,25,57,14,10,0,0
"19889","STL","NSH",2010020044,14896,20102011,0,60,3,4,-1,3.59836531537439,2.46301326597859,1.13535204939581,35,22,13,46,33,13,58,42,16,6,4,0,0
"19890","STL","DAL",2010020062,14898,20102011,0,65,2,2,0,5.18374674688675,2.06581340441395,3.1179333424728,43,25,18,55,32,23,72,42,30,5,5,0,0
"19891","STL","CHI",2010020073,14900,20102011,0,63.8333333333333,2,3,-1,4.83443906783941,4.7494202004309,0.0850188674085075,34,33,1,42,42,0,58,66,-8,1,3,0,0
"19892","STL","CHI",2010020096,14904,20102011,1,60,4,2,2,3.31378877224051,2.92177817062475,0.392010601615766,28,25,3,41,31,10,51,48,3,4,4,0,0
"19893","STL","PIT",2010020105,14905,20102011,1,60.8333333333333,1,0,1,4.77902318140556,2.7899634864653,1.98905969494027,24,31,-7,38,44,-6,48,51,-3,3,4,0,0
"19894","STL","NSH",2010020133,14910,20102011,0,60,3,0,3,4.35623855804442,3.73386679310352,0.622371764940908,34,24,10,46,37,9,59,54,5,4,4,0,0
"19895","STL","ATL",2010020149,14912,20102011,1,65,3,3,0,4.96563697476557,5.69936154491734,-0.733724570151765,35,28,7,50,45,5,63,59,4,3,7,0,0
"19896","STL","S.J",2010020176,14917,20102011,1,60,2,0,2,3.76417225698242,3.24841390979299,0.515758347189433,29,25,4,46,40,6,59,56,3,8,5,0,0
"19897","STL","BOS",2010020188,14919,20102011,0,65,1,1,0,6.98630736810455,3.6544660111207,3.33184135698386,35,34,1,46,41,5,63,55,8,5,4,0,0
"19898","STL","NYR",2010020200,14920,20102011,0,60,2,0,2,2.88386615167838,2.57324826772674,0.310617883951636,22,27,-5,30,38,-8,42,54,-12,4,3,0,0
"19899","STL","CBJ",2010020213,14923,20102011,0,60,1,8,-7,6.13166553794872,5.76712572356448,0.364539814384237,30,35,-5,39,45,-6,57,53,4,7,8,0,0
"19900","STL","NSH",2010020224,14924,20102011,1,65,2,2,0,3.40694746059307,3.53030451270752,-0.123357052114443,23,26,-3,37,37,0,44,49,-5,6,6,0,0
"19901","STL","ARI",2010020241,14926,20102011,0,60,3,5,-2,5.33095593929839,4.2916041102726,1.03935182902579,38,27,11,56,35,21,72,38,34,2,6,0,0
"19902","STL","COL",2010020252,14928,20102011,0,60,3,6,-3,3.932107675937,3.427920008206,0.504187667731003,30,23,7,38,37,1,56,46,10,5,6,0,0
"19903","STL","DET",2010020263,14930,20102011,0,60,3,7,-4,5.15800294551957,5.58161710872082,-0.423614163201254,36,31,5,53,44,9,68,57,11,4,6,0,0
"19904","STL","OTT",2010020278,14932,20102011,1,60,5,2,3,7.8864291376085,3.14704378276206,4.73938535484644,33,20,13,47,26,21,62,34,28,7,4,0,0
"19905","STL","N.J",2010020289,14933,20102011,1,60,3,2,1,4.3201713753019,4.3956857605109,-0.0755143852090043,27,37,-10,39,51,-12,47,63,-16,4,3,0,0
"19906","STL","NSH",2010020316,14937,20102011,0,65,1,1,0,4.67071905836929,1.78652355546046,2.88419550290882,15,30,-15,30,43,-13,40,61,-21,3,3,0,0
"19907","STL","DAL",2010020332,14939,20102011,0,60,2,3,-1,3.4754115783962,2.69035892962711,0.785052648769096,27,22,5,39,37,2,52,53,-1,1,3,0,0
"19908","STL","DAL",2010020339,14940,20102011,1,60,1,2,-1,6.52223139220951,5.51757067305152,1.00466071915798,36,23,13,51,25,26,68,30,38,3,4,0,0
"19909","STL","CHI",2010020355,14943,20102011,0,60,5,7,-2,4.93079277038851,3.25291903025936,1.67787374012914,26,24,2,33,33,0,44,43,1,6,7,0,0
"19910","STL","WSH",2010020361,14944,20102011,1,60,1,4,-3,3.8437831359995,5.71419231212349,-1.87040917612399,38,26,12,50,35,15,65,43,22,4,2,0,0
"19911","STL","EDM",2010020389,14947,20102011,0,60.3833333333333,1,2,-1,5.02588525257306,2.76762180717196,2.2582634454011,32,26,6,45,31,14,63,40,23,2,2,0,0
"19912","STL","VAN",2010020395,14948,20102011,0,60,3,2,1,0,0,0,28,23,5,35,31,4,53,50,3,5,5,0,0
"19913","STL","CBJ",2010020416,14952,20102011,1,60,4,1,3,3.74897411376229,2.78949454553367,0.959479568228616,24,28,-4,32,38,-6,43,56,-13,4,9,0,0
"19914","STL","CAR",2010020432,14954,20102011,1,65,1,1,0,6.63777926861076,2.83374127890988,3.80403798970087,39,29,10,62,42,20,75,48,27,5,2,0,0
"19915","STL","DET",2010020453,14958,20102011,0,60,2,5,-3,3.38029871580147,6.66123732872074,-3.28093861291927,21,37,-16,33,51,-18,46,65,-19,3,5,0,0
"19916","STL","L.A",2010020464,14959,20102011,1,60,6,4,2,2.44667776940332,3.69236583845781,-1.24568806905449,31,29,2,39,34,5,48,50,-2,6,7,0,0
"19917","STL","S.J",2010020480,14961,20102011,1,60,1,4,-3,4.69369360944256,4.73012772659422,-0.0364341171516571,22,34,-12,34,50,-16,48,62,-14,4,6,0,0
"19918","STL","VAN",2010020493,14963,20102011,1,60,1,3,-2,3.57982131726203,3.20746127333405,0.372360043927983,16,29,-13,31,43,-12,47,61,-14,3,5,0,0
"19919","STL","ATL",2010020497,14964,20102011,0,60,4,2,2,6.38532273358351,8.68179101329292,-2.29646827970942,27,39,-12,38,47,-9,55,57,-2,4,4,0,0
"19920","STL","DET",2010020513,14966,20102011,1,60,4,3,1,2.94274288195368,6.40834429999813,-3.46560141804446,25,38,-13,40,55,-15,49,65,-16,4,4,0,0
"19921","STL","NSH",2010020525,14969,20102011,1,60,2,0,2,4.9457866132143,3.7584012883899,1.18738532482439,26,32,-6,35,42,-7,46,49,-3,1,0,0,0
"19922","STL","CHI",2010020540,14971,20102011,1,60,3,1,2,5.43303716038007,4.23589802213706,1.197139138243,43,26,17,57,38,19,64,50,14,4,2,0,0
"19923","STL","ARI",2010020562,14974,20102011,1,60,4,3,1,3.83432567795535,6.68682084095781,-2.85249516300246,22,33,-11,37,50,-13,51,72,-21,2,3,0,0
"19924","STL","DAL",2010020576,14976,20102011,1,60,2,4,-2,3.23630033875816,3.12021590532731,0.116084433430842,30,27,3,40,40,0,60,56,4,2,2,0,0
"19925","STL","TOR",2010020598,14980,20102011,0,65,5,5,0,6.15986352985308,4.70461570052794,1.45524782932515,44,31,13,55,44,11,74,68,6,1,2,0,0
"19926","STL","NYR",2010020618,14982,20102011,1,60,1,2,-1,2.52594575261935,2.42660449919595,0.0993412534234039,25,24,1,38,35,3,54,40,14,5,5,0,0
"19927","STL","ARI",2010020629,14984,20102011,1,60,3,4,-1,6.60075590887573,5.24290316832048,1.35785274055524,36,33,3,50,48,2,63,61,2,3,3,0,0
"19928","STL","ANA",2010020645,14986,20102011,0,60,4,7,-3,5.61828904363054,3.14482423651498,2.47346480711556,34,24,10,58,33,25,74,43,31,5,4,0,0
"19929","STL","L.A",2010020652,14987,20102011,0,60,3,1,2,4.03814308710184,3.65647799563885,0.381665091462992,21,25,-4,28,41,-13,40,52,-12,1,2,0,0
"19930","STL","S.J",2010020671,14989,20102011,0,60,2,4,-2,4.78551242011599,2.7777415610326,2.00777085908339,30,29,1,42,46,-4,64,65,-1,3,6,0,0
"19931","STL","L.A",2010020689,14992,20102011,1,60,2,1,1,5.85381094697823,2.68125490599778,3.17255604098045,26,27,-1,42,36,6,59,54,5,5,4,0,0
"19932","STL","DET",2010020703,14994,20102011,1,61.85,3,4,-1,6.19503208560151,4.6923412686956,1.50269081690591,29,29,0,44,50,-6,57,69,-12,2,1,0,0
"19933","STL","CBJ",2010020719,14996,20102011,1,60,2,5,-3,3.48412569961511,4.16345231374726,-0.679326614132151,21,30,-9,33,41,-8,52,54,-2,5,7,0,0
"19934","STL","COL",2010020731,14998,20102011,0,60,3,4,-1,4.30075286718784,3.51391752898053,0.786835338207311,24,32,-8,43,42,1,56,52,4,3,4,0,0
"19935","STL","CGY",2010020748,15000,20102011,0,60,1,4,-3,6.07740196052356,4.70672447513789,1.37067748538567,29,21,8,43,33,10,60,44,16,2,3,0,0
"19936","STL","COL",2010020759,15027,20102011,1,60,3,4,-1,7.22631685243876,5.69781175401295,1.52850509842582,45,27,18,62,43,19,81,58,23,2,5,0,0
"19937","STL","EDM",2010020780,15009,20102011,1,60,5,3,2,0,0,0,26,32,-6,36,40,-4,54,58,-4,4,4,0,0
"19938","STL","T.B",2010020795,15011,20102011,0,64.8833333333333,3,4,-1,5.50760848023921,4.52073375728833,0.986874722950887,32,40,-8,49,53,-4,65,65,0,4,5,0,0
"19939","STL","FLA",2010020807,15013,20102011,0,60,2,1,1,4.89245540498814,4.27766755432822,0.614787850659923,28,31,-3,38,41,-3,51,55,-4,5,5,0,0
"19940","STL","MIN",2010020826,15016,20102011,1,65,4,4,0,4.73969245114131,2.97763444128213,1.76205800985917,35,27,8,53,32,21,64,40,24,3,2,0,0
"19941","STL","MIN",2010020835,15017,20102011,0,60,1,3,-2,1.16714627266975,2.25686784170102,-1.08972156903127,25,31,-6,34,42,-8,51,48,3,5,7,0,0
"19942","STL","VAN",2010020845,15019,20102011,1,60,3,2,1,6.63112303134403,3.35157028860074,3.27955274274329,34,25,9,44,40,4,56,52,4,5,1,0,0
"19943","STL","BUF",2010020872,15023,20102011,0,60,3,0,3,4.73717602016404,3.69963710352455,1.03753891663949,24,25,-1,32,34,-2,41,48,-7,4,3,0,0
"19944","STL","ANA",2010020882,15024,20102011,1,60,9,3,6,2.61232569254935,3.94455614977596,-1.33223045722661,23,25,-2,31,32,-1,43,47,-4,5,4,0,0
"19945","STL","CHI",2010020892,15026,20102011,1,60,3,5,-2,4.61894885774836,5.29674160450668,-0.677792746758314,34,26,8,53,38,15,71,45,26,2,1,0,0
"19946","STL","VAN",2010020913,15029,20102011,0,60,2,3,-1,5.98333249794086,3.80224649594626,2.1810860019946,30,27,3,49,37,12,66,49,17,4,1,0,0
"19947","STL","EDM",2010020922,15030,20102011,0,60,5,0,5,2.52495923178503,2.77758848900703,-0.252629257221997,22,39,-17,29,49,-20,41,71,-30,5,4,0,0
"19948","STL","CGY",2010020937,15032,20102011,0,60,0,1,-1,9.06146509082464,2.25638400134631,6.80508108947834,27,20,7,39,31,8,51,55,-4,3,3,0,0
"19949","STL","CGY",2010020947,15034,20102011,1,60,0,6,-6,4.34929956806409,4.3277362419467,0.0215633261173949,25,29,-4,43,33,10,67,41,26,2,4,0,0
"19950","STL","WSH",2010020960,15036,20102011,0,60,2,3,-1,3.82411647109984,2.00923138982164,1.8148850812782,27,30,-3,42,41,1,64,58,6,3,1,0,0
"19951","STL","NYI",2010020973,15038,20102011,0,60,2,5,-3,3.90285788275824,2.70700441157533,1.19585347118291,23,22,1,36,36,0,50,48,2,4,5,0,0
"19952","STL","CBJ",2010020990,15040,20102011,1,65,4,4,0,5.31561716677772,3.51621228514705,1.79940488163067,36,28,8,46,35,11,66,53,13,3,4,0,0
"19953","STL","CBJ",2010021004,15042,20102011,0,60.9,4,3,1,3.10954766327268,3.68113694202475,-0.571589278752072,26,22,4,30,33,-3,39,49,-10,2,4,0,0
"19954","STL","MTL",2010021011,15043,20102011,1,60,4,1,3,0,0,0,27,28,-1,40,44,-4,53,61,-8,4,4,0,0
"19955","STL","DET",2010021029,15045,20102011,1,60,3,5,-2,6.05913565547962,3.2310153250267,2.82812033045292,29,27,2,47,40,7,57,50,7,4,2,0,0
"19956","STL","ANA",2010021054,15049,20102011,0,60,1,2,-1,5.79987534497832,4.99001214469899,0.809863200279324,31,24,7,48,34,14,64,46,18,2,3,0,0
"19957","STL","L.A",2010021064,15050,20102011,0,60,4,0,4,8.89843399231904,3.51153248077389,5.38690151154515,39,17,22,55,31,24,67,53,14,3,1,0,0
"19958","STL","S.J",2010021079,15052,20102011,0,60,3,5,-2,3.85527957731392,6.41090888235359,-2.55562930503966,45,34,11,58,46,12,77,67,10,3,3,0,0
"19959","STL","ARI",2010021097,15055,20102011,0,60,1,2,-1,4.31279967715091,5.24643166554597,-0.933631988395064,30,23,7,43,41,2,61,55,6,1,4,0,0
"19960","STL","EDM",2010021106,15057,20102011,1,60,4,0,4,1.69107591705131,2.15338777358129,-0.462311856529987,30,12,18,34,24,10,48,48,0,7,5,0,0
"19961","STL","MIN",2010021124,15059,20102011,0,60,6,3,3,4.55005605117913,1.28541581006721,3.26464024111192,47,16,31,61,24,37,72,32,40,5,1,0,0
"19962","STL","MIN",2010021141,15062,20102011,1,65,2,2,0,5.36392702427111,3.44287326833,1.9210537559411,29,28,1,38,33,5,53,45,8,6,6,0,0
"19963","STL","DET",2010021148,15063,20102011,0,60,10,3,7,7.10611602015251,5.14422228680633,1.96189373334619,47,44,3,58,56,2,68,67,1,5,4,0,0
"19964","STL","CGY",2010021162,15065,20102011,1,60,2,3,-1,2.21819411580162,4.59224560336635,-2.37405148756472,27,25,2,41,37,4,54,44,10,5,7,0,0
"19965","STL","CBJ",2010021178,15067,20102011,0,60,6,1,5,6.68160833569709,4.60508090084477,2.07652743485232,33,24,9,43,35,8,51,53,-2,3,3,0,0
"19966","STL","COL",2010021189,15069,20102011,1,60,3,1,2,5.02748370063637,2.40843035909347,2.61905334154289,29,27,2,44,39,5,53,54,-1,6,5,0,0
"19967","STL","CHI",2010021197,15070,20102011,0,63.3166666666667,3,4,-1,2.50963718581625,3.97185773744422,-1.46222055162798,24,39,-15,29,46,-17,40,60,-20,2,4,0,0
"19968","STL","NSH",2010021222,15073,20102011,1,60,2,0,2,2.5091630188399,2.56185573661294,-0.0526927177730432,25,24,1,36,33,3,46,48,-2,1,1,0,0
"19969","STL","NSH",2011020015,15255,20112012,1,60,2,4,-2,3.91443097992217,4.80953982149367,-0.895108841571499,33,16,17,47,22,25,68,35,33,5,4,0,0
"19970","STL","CGY",2011020028,15257,20112012,1,60,5,2,3,4.36869343782956,2.23458415525965,2.13410928256991,35,17,18,40,26,14,56,44,12,5,4,0,0
"19971","STL","DAL",2011020046,15260,20112012,0,60,2,3,-1,6.26428706875677,1.73170340781987,4.5325836609369,38,24,14,57,34,23,77,42,35,7,8,0,0
"19972","STL","S.J",2011020062,15262,20112012,0,60,4,2,2,3.5839591853437,7.13648123206798,-3.55252204672428,20,36,-16,34,49,-15,50,75,-25,4,3,0,0
"19973","STL","ANA",2011020063,15263,20112012,0,60,2,4,-2,6.3990846028193,3.55345157370175,2.84563302911755,30,23,7,47,37,10,58,52,6,5,5,0,0
"19974","STL","L.A",2011020078,15265,20112012,0,60,0,5,-5,5.09562029087101,4.09729518447421,0.998325106396805,27,24,3,44,36,8,55,49,6,4,4,0,0
"19975","STL","CAR",2011020093,15268,20112012,1,63.9666666666667,3,2,1,8.08167366179987,3.51652764703613,4.56514601476374,43,29,14,55,45,10,65,59,6,1,2,0,0
"19976","STL","PHI",2011020100,15269,20112012,0,60,4,2,2,3.32876858597551,3.36980941571557,-0.0410408297400551,25,36,-11,34,41,-7,45,58,-13,3,4,0,0
"19977","STL","VAN",2011020124,15273,20112012,0,60,3,0,3,4.47287269856315,3.80386260789783,0.669010090665324,31,32,-1,41,51,-10,48,72,-24,3,2,0,0
"19978","STL","CGY",2011020139,15275,20112012,0,60,1,3,-2,5.47383531482774,4.7057018629053,0.768133451922438,29,18,11,45,27,18,61,41,20,3,3,0,0
"19979","STL","EDM",2011020156,15277,20112012,0,60,2,4,-2,5.1936788688181,4.44804103148635,0.745637837331742,30,30,0,39,36,3,51,49,2,3,4,0,0
"19980","STL","VAN",2011020182,15282,20112012,1,60,3,2,1,4.11793117834941,4.6230268214058,-0.505095643056393,28,30,-2,42,40,2,55,54,1,3,4,0,0
"19981","STL","MIN",2011020191,15283,20112012,0,60,1,2,-1,3.67598909989465,3.47883863979951,0.197150460095145,31,26,5,44,39,5,60,48,12,6,7,0,0
"19982","STL","CHI",2011020208,15286,20112012,1,60,3,0,3,4.44560959025603,3.69650947884656,0.749100111409462,23,29,-6,38,36,2,54,48,6,2,4,0,0
"19983","STL","TOR",2011020216,15288,20112012,1,65,2,2,0,6.4464518444729,2.3832628093582,4.0631890351147,40,22,18,56,33,23,77,40,37,6,4,0,0
"19984","STL","T.B",2011020236,15290,20112012,1,60,3,0,3,3.30910167918773,2.94651901884936,0.362582660338376,24,19,5,38,26,12,58,35,23,5,6,0,0
"19985","STL","DET",2011020252,15293,20112012,1,60,2,1,1,2.56767215306172,4.83996665553423,-2.2722945024725,37,22,15,47,38,9,57,58,-1,4,5,0,0
"19986","STL","FLA",2011020264,15295,20112012,1,60,4,1,3,5.70029094725282,3.81388038162777,1.88641056562506,31,21,10,38,31,7,50,48,2,5,3,0,0
"19987","STL","MIN",2011020283,15297,20112012,0,65,2,2,0,3.8911555747909,3.51891314669774,0.372242428093159,27,32,-5,37,37,0,50,47,3,2,2,0,0
"19988","STL","L.A",2011020298,15300,20112012,1,60,2,3,-1,2.96712487346515,4.00149381073015,-1.034368937265,25,28,-3,35,34,1,52,45,7,6,6,0,0
"19989","STL","PIT",2011020303,15301,20112012,0,64.1166666666667,3,2,1,6.36411176266938,4.35745054786094,2.00666121480845,43,33,10,53,38,15,77,48,29,6,4,0,0
"19990","STL","CGY",2011020323,15303,20112012,1,60,2,0,2,4.51411264516202,2.65860081179881,1.85551183336321,24,24,0,43,36,7,60,53,7,1,4,0,0
"19991","STL","CBJ",2011020338,15305,20112012,0,60,2,1,1,2.99140813987469,2.48689572521334,0.504512414661349,29,24,5,37,31,6,44,43,1,5,5,0,0
"19992","STL","WSH",2011020347,15307,20112012,0,60,2,1,1,3.2289394170657,1.09720694071558,2.13173247635012,30,19,11,41,24,17,61,30,31,4,2,0,0
"19993","STL","COL",2011020369,15310,20112012,0,65,2,2,0,4.95827359077521,5.10482701880949,-0.146553428034281,37,35,2,47,49,-2,55,68,-13,4,5,0,0
"19994","STL","CHI",2011020378,15311,20112012,1,60,2,5,-3,3.78704236191697,4.39328829396982,-0.606245932052843,25,36,-11,43,45,-2,60,60,0,7,6,0,0
"19995","STL","DET",2011020395,15314,20112012,1,60,3,2,1,3.80682051694021,3.94347642172215,-0.136655904781948,26,29,-3,34,39,-5,49,49,0,9,8,0,0
"19996","STL","ANA",2011020413,15316,20112012,1,60,4,2,2,3.1093436479714,2.97202580480371,0.137317843167693,24,23,1,38,33,5,49,45,4,4,5,0,0
"19997","STL","S.J",2011020428,15318,20112012,1,60,1,0,1,2.09802321885218,2.18399897767813,-0.0859757588259527,19,24,-5,29,36,-7,47,52,-5,5,6,0,0
"19998","STL","NYR",2011020456,15323,20112012,1,60,4,1,3,5.57164030600688,2.77053265855648,2.80110764745041,36,26,10,50,37,13,61,44,17,1,0,0,0
"19999","STL","NSH",2011020473,15325,20112012,0,65,1,1,0,9.07598913370748,3.85459798457975,5.22139114912773,40,20,20,54,30,24,77,40,37,6,1,0,0
"20000","STL","CBJ",2011020480,15326,20112012,1,60,6,4,2,6.04351485355437,5.05255720307468,0.990957650479686,34,32,2,42,51,-9,49,58,-9,3,5,0,0
"20001","STL","COL",2011020497,15329,20112012,0,60,2,3,-1,5.803385582957,2.09388018473578,3.70950539822122,39,22,17,53,30,23,68,41,27,5,4,0,0
"20002","STL","ARI",2011020516,15331,20112012,0,60,3,2,1,5.34736317989882,4.51915097000892,0.828212209889898,18,26,-8,31,32,-1,43,47,-4,3,4,0,0
"20003","STL","DAL",2011020523,15334,20112012,1,60,5,3,2,4.13236335511726,2.65966044775269,1.47270290736458,38,23,15,52,31,21,69,42,27,3,3,0,0
"20004","STL","DET",2011020534,15335,20112012,0,60,2,3,-1,4.37847879225592,7.03206552820396,-2.65358673594804,31,32,-1,39,47,-8,57,62,-5,6,6,0,0
"20005","STL","NSH",2011020554,15338,20112012,1,65,1,1,0,4.40650768180058,5.76580212400586,-1.35929444220528,36,34,2,50,43,7,65,55,10,4,2,0,0
"20006","STL","DET",2011020563,15339,20112012,0,60,0,3,-3,4.38348673296114,4.72456150143989,-0.34107476847875,31,31,0,46,48,-2,60,61,-1,3,4,0,0
"20007","STL","ARI",2011020578,15342,20112012,1,60,4,1,3,5.27285782666877,5.41495018767637,-0.142092361007599,31,35,-4,43,45,-2,51,64,-13,2,4,0,0
"20008","STL","EDM",2011020589,15344,20112012,1,60,4,3,1,4.05888059118297,3.46254452318317,0.5963360679998,37,32,5,46,45,1,58,60,-2,8,6,0,0
"20009","STL","COL",2011020606,15346,20112012,1,60,4,0,4,4.19459608071061,2.66557018209687,1.52902589861374,39,15,24,65,25,40,75,36,39,7,6,0,0
"20010","STL","MTL",2011020622,15349,20112012,0,60,3,0,3,0,0,0,25,19,6,35,31,4,53,43,10,5,4,0,0
"20011","STL","VAN",2011020636,15351,20112012,1,60.7666666666667,2,3,-1,3.95603520867007,4.96879408647328,-1.01275887780321,33,21,12,49,29,20,60,42,18,5,4,0,0
"20012","STL","MIN",2011020655,15353,20112012,1,65,2,2,0,5.92138265781114,3.2265319802612,2.69485067754993,49,31,18,68,44,24,97,53,44,6,7,0,0
"20013","STL","DAL",2011020669,15355,20112012,1,60,1,0,1,8.75847938517109,6.27348135958891,2.48499802558217,32,22,10,49,34,15,61,53,8,5,4,0,0
"20014","STL","EDM",2011020690,15358,20112012,1,60,1,0,1,4.67532077576283,3.63770357239991,1.03761720336291,38,15,23,59,23,36,76,37,39,6,3,0,0
"20015","STL","BUF",2011020707,15360,20112012,1,60,4,2,2,5.98950101620109,6.28391898539849,-0.294417969197401,27,21,6,47,40,7,62,52,10,5,6,0,0
"20016","STL","DET",2011020718,15362,20112012,0,60,1,3,-2,1.38979625111097,2.59050290306914,-1.20070665195817,22,28,-6,31,41,-10,41,54,-13,3,7,0,0
"20017","STL","L.A",2011020764,15373,20112012,1,60,1,0,1,4.89267429565371,4.23614563291942,0.656528662734289,33,22,11,47,36,11,61,51,10,1,1,0,0
"20018","STL","NSH",2011020775,15374,20112012,0,60,1,3,-2,5.54657527586096,5.18103821054683,0.365537065314129,43,37,6,55,47,8,74,58,16,2,2,0,0
"20019","STL","OTT",2011020791,15377,20112012,0,60,3,1,2,3.93053769360995,5.55905715271365,-1.6285194591037,18,29,-11,25,44,-19,35,64,-29,2,5,0,0
"20020","STL","N.J",2011020801,15379,20112012,0,65,3,3,0,3.29505900503136,3.87100209291935,-0.575943087887985,26,27,-1,35,40,-5,41,43,-2,0,3,0,0
"20021","STL","COL",2011020823,15381,20112012,1,63.3,3,2,1,6.46027620680979,1.30035436539296,5.15992184141684,44,19,25,61,25,36,79,35,44,5,2,0,0
"20022","STL","S.J",2011020833,15382,20112012,1,60,3,0,3,6.44314396635016,4.13360041739493,2.30954354895523,28,25,3,40,39,1,58,57,1,6,4,0,0
"20023","STL","CBJ",2011020839,15384,20112012,0,60,1,2,-1,4.92802173570303,5.44623134625726,-0.518209610554234,32,33,-1,43,47,-4,59,57,2,2,5,0,0
"20024","STL","NYI",2011020854,15386,20112012,1,60,5,1,4,2.47835326655695,5.09538078281912,-2.61702751626217,26,27,-1,42,40,2,51,60,-9,3,5,0,0
"20025","STL","MIN",2011020867,15388,20112012,1,60,4,0,4,3.77291401718685,1.11503378228986,2.65788023489699,34,13,21,52,20,32,74,31,43,9,6,0,0
"20026","STL","CHI",2011020875,15389,20112012,0,60,1,3,-2,2.22862404600437,4.56628260418074,-2.33765855817637,30,27,3,39,38,1,42,53,-11,2,4,0,0
"20027","STL","BOS",2011020897,15392,20112012,1,60,2,4,-2,3.05363401869545,2.47173210496294,0.581901913732509,32,19,13,49,26,23,70,38,32,1,1,0,0
"20028","STL","NSH",2011020903,15393,20112012,0,65,2,2,0,3.42255748502794,6.20175381971058,-2.77919633468264,24,27,-3,29,40,-11,43,61,-18,1,1,0,0
"20029","STL","WPG",2011020915,15395,20112012,0,65,2,2,0,2.1365939259349,6.82612803051597,-4.68953410458107,16,41,-25,27,55,-28,42,67,-25,1,2,0,0
"20030","STL","CGY",2011020936,15397,20112012,0,60,3,1,2,4.51370960002939,2.85412405570969,1.6595855443197,24,21,3,35,28,7,43,43,0,4,4,0,0
"20031","STL","EDM",2011020948,15399,20112012,0,60,5,2,3,4.72232901674579,3.7526261069288,0.969702909816988,31,24,7,45,31,14,52,41,11,5,2,0,0
"20032","STL","VAN",2011020957,15400,20112012,0,60,0,2,-2,4.19318252007361,3.06278502996429,1.13039749010932,29,24,5,38,34,4,45,46,-1,2,2,0,0
"20033","STL","S.J",2011020973,15402,20112012,0,60,3,1,2,4.67136641404798,3.91579915191951,0.755567262128466,32,19,13,40,32,8,69,51,18,5,3,0,0
"20034","STL","CHI",2011020990,15405,20112012,1,60,5,1,4,6.58743621728536,3.12046219631156,3.46697402097379,31,20,11,46,32,14,50,45,5,2,5,0,0
"20035","STL","ANA",2011021004,15407,20112012,1,60,3,1,2,5.72279628837714,3.01723822479835,2.70555806357879,27,25,2,44,34,10,58,43,15,4,3,0,0
"20036","STL","CBJ",2011021020,15409,20112012,1,60,4,1,3,7.83940329243342,4.14596135129045,3.69344194114296,29,22,7,46,32,14,55,44,11,8,6,0,0
"20037","STL","CBJ",2011021027,15410,20112012,0,60,2,1,1,5.7977899306983,5.52294907720284,0.274840853495466,26,34,-8,34,43,-9,43,65,-22,5,9,0,0
"20038","STL","CHI",2011021043,15412,20112012,0,65,3,3,0,4.61088194441982,8.12829872197472,-3.5174167775549,24,46,-22,33,68,-35,45,86,-41,2,7,0,0
"20039","STL","CAR",2011021055,15414,20112012,0,60,0,2,-2,3.16904159593486,3.76313136995304,-0.594089774018187,40,30,10,58,40,18,72,51,21,4,6,0,0
"20040","STL","T.B",2011021071,15416,20112012,0,60,3,1,2,2.84321838465985,5.44824187853737,-2.60502349387752,21,23,-2,28,39,-11,38,55,-17,2,3,0,0
"20041","STL","ANA",2011021101,15420,20112012,0,60,3,4,-1,2.9981110376782,3.5631298890803,-0.565018851402101,38,22,16,50,28,22,68,39,29,3,5,0,0
"20042","STL","L.A",2011021108,15421,20112012,0,65,0,0,0,8.96607235918648,5.69616248487728,3.2699098743092,35,37,-2,56,54,2,68,68,0,3,2,0,0
"20043","STL","ARI",2011021133,15424,20112012,0,60,4,0,4,2.56566986916175,3.17673681646087,-0.611066947299119,29,20,9,42,33,9,54,50,4,4,5,0,0
"20044","STL","NSH",2011021146,15426,20112012,1,60,3,0,3,2.26441093666654,2.95913049281808,-0.69471955615154,24,24,0,37,30,7,55,48,7,1,1,0,0
"20045","STL","CHI",2011021159,15428,20112012,0,65,3,3,0,3.57891171157826,4.55850643957092,-0.979594727992662,20,40,-20,31,47,-16,47,55,-8,2,2,0,0
"20046","STL","CBJ",2011021175,15430,20112012,1,60,2,5,-3,3.57966576497238,4.60594782174667,-1.02628205677428,36,33,3,53,39,14,69,50,19,9,12,0,0
"20047","STL","DET",2011021200,15434,20112012,1,65,2,2,0,4.7656487874774,4.67186313768616,0.0937856497912435,29,28,1,41,40,1,45,64,-19,2,3,0,0
"20048","STL","ARI",2011021215,15436,20112012,1,60,1,4,-3,4.36688566020761,5.80853486718843,-1.44164920698081,32,32,0,46,44,2,56,57,-1,8,8,0,0
"20049","STL","DAL",2011021227,15437,20112012,0,60,3,2,1,6.20547180301037,4.84898740740375,1.35648439560662,35,35,0,51,43,8,68,62,6,7,6,0,0
"20050","STL","S.J",2011030161,15442,20112012,1,80,2,2,0,7.32597500533806,4.73693259087304,2.58904241446502,42,31,11,59,42,17,76,61,15,4,4,0,0
"20051","STL","S.J",2011030162,15444,20112012,1,60,3,0,3,5.42825224692933,3.34555309580173,2.0826991511276,33,29,4,42,42,0,59,59,0,12,9,0,0
"20052","STL","S.J",2011030163,15446,20112012,0,60,4,3,1,3.00023799625847,5.1781470255177,-2.17790902925923,27,29,-2,35,46,-11,43,66,-23,5,5,0,0
"20053","STL","S.J",2011030164,15449,20112012,0,60,2,1,1,3.21620351220736,3.16559409604815,0.0506094161592046,24,25,-1,31,39,-8,47,65,-18,3,4,0,0
"20054","STL","S.J",2011030165,15451,20112012,1,60,3,1,2,5.92631193158741,3.1086562451419,2.81765568644551,27,27,0,41,39,2,54,60,-6,2,2,0,0
"20055","STL","L.A",2011030231,15458,20112012,1,60,1,3,-2,5.40185669857237,4.85649847865193,0.545358219920445,29,29,0,37,43,-6,49,66,-17,3,4,0,0
"20056","STL","L.A",2011030232,15460,20112012,1,60,2,5,-3,3.13860985629981,2.23248749220056,0.906122364099247,29,21,8,38,31,7,50,44,6,14,11,0,0
"20057","STL","L.A",2011030233,15463,20112012,0,60,2,4,-2,4.7094658185124,4.69924710912164,0.010218709390756,20,22,-2,37,46,-9,47,57,-10,2,5,0,0
"20058","STL","L.A",2011030234,15466,20112012,0,60,1,3,-2,6.88010826951358,3.18118178419536,3.69892648531822,24,19,5,35,30,5,40,41,-1,5,5,0,0
"20059","STL","DET",2012020009,15724,20122013,1,60,6,0,6,4.86590661119222,1.58109066369669,3.28481594749552,36,14,22,52,27,25,65,39,26,5,4,0,0
"20060","STL","NSH",2012020022,15726,20122013,0,65,3,3,0,5.63951741065179,3.88821421826651,1.75130319238528,39,24,15,55,35,20,71,42,29,4,8,0,0
"20061","STL","CHI",2012020033,15727,20122013,0,60,2,3,-1,3.82312240242027,3.93658223655075,-0.113459834130481,34,27,7,41,37,4,60,46,14,2,3,0,0
"20062","STL","NSH",2012020045,15729,20122013,1,60,3,0,3,1.76839094317984,1.33672274873334,0.431668194446502,24,13,11,28,21,7,41,34,7,5,4,0,0
"20063","STL","DAL",2012020061,15731,20122013,0,60,4,3,1,3.84821044122649,5.08617485794821,-1.23796441672172,32,23,9,41,34,7,51,48,3,3,4,0,0
"20064","STL","MIN",2012020071,15732,20122013,1,62.2666666666667,5,4,1,6.6350953119947,4.36427390244516,2.27082140954954,34,16,18,46,29,17,60,40,20,6,4,0,0
"20065","STL","CBJ",2012020096,15736,20122013,0,60,4,1,3,4.07453624851769,6.27263402065061,-2.19809777213292,25,25,0,38,35,3,42,49,-7,5,4,0,0
"20066","STL","DET",2012020104,15737,20122013,0,60,3,5,-2,3.54791123546053,4.724973080582,-1.17706184512148,26,31,-5,37,35,2,48,51,-3,5,6,0,0
"20067","STL","NSH",2012020136,15741,20122013,1,60,1,6,-5,4.21791157594998,3.9950651958352,0.222846380114788,32,19,13,40,30,10,58,36,22,7,4,0,0
"20068","STL","DET",2012020149,15743,20122013,1,60,1,5,-4,4.65539846126921,2.19904927865306,2.45634918261615,27,29,-2,41,40,1,55,47,8,2,3,0,0
"20069","STL","ANA",2012020163,15745,20122013,1,65,5,5,0,3.7053591597105,1.44363456498832,2.26172459472218,31,23,8,45,29,16,62,44,18,2,1,0,0
"20070","STL","L.A",2012020175,15747,20122013,1,60,1,4,-3,3.25706237660415,2.76010552941794,0.496956847186216,22,23,-1,34,30,4,43,41,2,6,6,0,0
"20071","STL","DET",2012020189,15749,20122013,0,60.8666666666667,4,3,1,4.08166444543167,1.70681713573867,2.374847309693,25,18,7,33,27,6,46,51,-5,4,5,0,0
"20072","STL","CGY",2012020202,15751,20122013,0,60,5,2,3,3.7402338096872,4.58113556322087,-0.840901753533672,25,32,-7,34,38,-4,46,55,-9,5,5,0,0
"20073","STL","VAN",2012020218,15753,20122013,0,65,3,3,0,3.14282857545186,5.20516919778311,-2.06234062233125,23,31,-8,32,44,-12,43,67,-24,2,4,0,0
"20074","STL","S.J",2012020230,15755,20122013,1,60,1,2,-1,3.08986011697561,4.41589964214904,-1.32603952517343,26,25,1,36,36,0,54,51,3,4,5,0,0
"20075","STL","COL",2012020235,15756,20122013,0,64.7166666666667,0,1,-1,6.3956085309037,3.40306671991129,2.99254181099241,33,20,13,49,30,19,71,47,24,2,1,0,0
"20076","STL","CBJ",2012020259,15759,20122013,1,60,2,1,1,3.00976781453937,2.91136986047786,0.098397954061511,23,20,3,31,29,2,40,52,-12,4,6,0,0
"20077","STL","CHI",2012020294,15764,20122013,1,60,0,3,-3,2.45444806746673,2.32574933740986,0.128698730056868,21,23,-2,28,30,-2,39,40,-1,5,2,0,0
"20078","STL","EDM",2012020299,15765,20122013,1,60,4,2,2,3.55832722094417,5.09331298700999,-1.53498576606582,30,17,13,42,30,12,64,45,19,2,3,0,0
"20079","STL","DAL",2012020314,15767,20122013,0,60,1,4,-3,3.222630712892,6.09176573657896,-2.86913502368697,26,27,-1,41,43,-2,61,58,3,1,3,0,0
"20080","STL","L.A",2012020334,15769,20122013,0,60,4,6,-2,3.1323608814273,5.05259896865027,-1.92023808722297,14,29,-15,20,40,-20,30,55,-25,5,7,0,0
"20081","STL","ARI",2012020348,15771,20122013,0,60,6,3,3,3.5920141430106,3.2897768697585,0.302237273252103,30,26,4,41,39,2,47,57,-10,4,6,0,0
"20082","STL","S.J",2012020358,15773,20122013,0,61.2,4,3,1,5.60132140348641,3.53028291565715,2.07103848782926,35,25,10,49,30,19,64,53,11,5,3,0,0
"20083","STL","ANA",2012020374,15774,20122013,0,60,2,4,-2,3.90748956839785,3.37005072643115,0.537438841966705,31,22,9,44,31,13,51,48,3,3,7,0,0
"20084","STL","S.J",2012020383,15776,20122013,1,60,4,2,2,5.77231773477979,5.49571288781954,0.276604846960254,21,41,-20,32,53,-21,44,75,-31,4,4,0,0
"20085","STL","ARI",2012020397,15778,20122013,1,60,3,0,3,4.70219462252953,3.49274056334991,1.20945405917962,30,28,2,41,37,4,54,55,-1,5,3,0,0
"20086","STL","ANA",2012020414,15780,20122013,1,60.75,2,1,1,2.778113990149,2.25519449132095,0.522919498828049,21,28,-7,37,41,-4,47,59,-12,3,2,0,0
"20087","STL","VAN",2012020436,15783,20122013,0,60,2,3,-1,5.11667511251289,3.21876251236563,1.89791260014727,34,19,15,41,31,10,59,46,13,3,2,0,0
"20088","STL","EDM",2012020464,15787,20122013,0,60,3,0,3,2.82401143526658,2.97958634400857,-0.155574908741983,25,19,6,39,24,15,57,34,23,3,3,0,0
"20089","STL","CGY",2012020470,15788,20122013,0,60,2,3,-1,5.73120203282451,2.70152976398822,3.02967226883629,38,17,21,50,25,25,70,39,31,5,4,0,0
"20090","STL","EDM",2012020485,15790,20122013,1,60,0,3,-3,5.97867916926043,2.65956245688722,3.31911671237322,43,19,24,58,25,33,68,34,34,5,3,0,0
"20091","STL","L.A",2012020497,15792,20122013,1,60,2,4,-2,2.70315345673225,4.80099737562256,-2.09784391889031,22,40,-18,30,56,-26,42,74,-32,3,4,0,0
"20092","STL","MIN",2012020526,15796,20122013,0,60,4,1,3,3.72497328196187,2.37976264418103,1.34521063778084,24,25,-1,32,33,-1,48,46,2,1,5,0,0
"20093","STL","CHI",2012020549,15799,20122013,0,65,3,3,0,3.87329419486923,4.5330882271935,-0.659794032324271,22,36,-14,27,49,-22,36,58,-22,1,2,0,0
"20094","STL","CBJ",2012020555,15800,20122013,1,60,3,1,2,2.37822367856279,4.09463462612558,-1.71641094756279,19,27,-8,30,37,-7,40,50,-10,7,5,0,0
"20095","STL","DET",2012020569,15802,20122013,0,60,1,0,1,2.83476764475228,4.57893013593275,-1.74416249118048,25,28,-3,30,43,-13,37,56,-19,3,4,0,0
"20096","STL","NSH",2012020588,15804,20122013,0,60,1,0,1,5.34882307014777,3.53041061857948,1.81841245156829,26,15,11,37,21,16,53,30,23,1,0,0,0
"20097","STL","MIN",2012020603,15806,20122013,0,60,2,0,2,2.47018251515692,3.24159981333651,-0.771417298179585,20,23,-3,24,33,-9,38,46,-8,1,3,0,0
"20098","STL","CBJ",2012020606,15807,20122013,0,60,1,4,-3,6.70432253135368,3.78997319802875,2.91434933332494,32,19,13,48,30,18,60,40,20,5,2,0,0
"20099","STL","CHI",2012020621,15809,20122013,1,60,0,2,-2,2.93794745521882,3.73108237591805,-0.793134920699231,30,26,4,41,38,3,51,47,4,7,7,0,0
"20100","STL","VAN",2012020637,15811,20122013,1,65,1,1,0,5.37362185149425,3.28573144568394,2.08789040581031,36,22,14,57,36,21,77,47,30,8,7,0,0
"20101","STL","ARI",2012020650,15813,20122013,1,65,1,1,0,4.94966048403876,5.97136531465003,-1.02170483061127,30,34,-4,38,47,-9,50,64,-14,3,6,0,0
"20102","STL","DAL",2012020656,15814,20122013,1,60,2,1,1,3.15131154515257,2.51130666691461,0.64000487823796,20,22,-2,27,30,-3,37,45,-8,3,2,0,0
"20103","STL","COL",2012020672,15816,20122013,0,60,3,5,-2,5.66580528982797,7.89544183707892,-2.22963654725095,32,31,1,50,44,6,67,60,7,4,3,0,0
"20104","STL","COL",2012020686,15818,20122013,1,60,3,1,2,4.9559757199022,1.85772290573732,3.09825281416488,34,18,16,51,27,24,72,38,34,6,4,0,0
"20105","STL","CGY",2012020701,15820,20122013,1,60,4,1,3,3.53024309198372,1.19787363906653,2.33236945291719,20,19,1,33,28,5,46,43,3,5,4,0,0
"20106","STL","CHI",2012020716,15822,20122013,1,60,3,1,2,4.86998404840156,2.75436907459516,2.1156149738064,28,23,5,44,34,10,61,46,15,2,2,0,0
"20107","STL","L.A",2012030181,15825,20122013,1,73.4333333333333,2,1,1,5.85763605417378,6.15558575609439,-0.297949701920608,42,29,13,66,43,23,83,61,22,6,3,0,0
"20108","STL","L.A",2012030182,15827,20122013,1,60,2,1,1,5.46513458262007,4.5645831945294,0.900551388090662,25,29,-4,37,35,2,48,42,6,4,4,0,0
"20109","STL","L.A",2012030183,15829,20122013,0,60,0,1,-1,4.1700227128706,4.4266294527115,-0.25660673984089,30,21,9,46,40,6,56,54,2,5,5,0,0
"20110","STL","L.A",2012030184,15831,20122013,0,60,3,4,-1,3.85527331801131,5.33483911433723,-1.47956579632591,22,29,-7,32,52,-20,37,71,-34,4,4,0,0
"20111","STL","L.A",2012030185,15833,20122013,1,68,2,3,-1,8.86660870545893,6.59418877714779,2.27241992831114,36,25,11,54,43,11,75,57,18,1,2,0,0
"20112","STL","L.A",2012030186,15835,20122013,0,60,1,2,-1,4.35680734671769,2.91889834476751,1.43790900195017,22,16,6,43,24,19,52,29,23,1,1,0,0
"20113","STL","NSH",2013020010,15981,20132014,1,60,4,2,2,4.06920539485873,2.28155290423956,1.78765249061917,28,30,-2,37,41,-4,44,56,-12,4,5,0,0
"20114","STL","FLA",2013020027,15983,20132014,1,60,7,0,7,4.78328656339363,2.11714409710839,2.66614246628524,34,19,15,44,29,15,50,41,9,7,9,0,0
"20115","STL","CHI",2013020045,15987,20132014,1,60,3,2,1,4.67663390008966,2.56553583938512,2.11109806070453,34,28,6,43,37,6,52,51,1,4,4,0,0
"20116","STL","NYR",2013020070,15990,20132014,1,60,5,3,2,5.55596091130076,3.25233666998321,2.30362424131755,34,29,5,45,40,5,60,53,7,8,7,0,0
"20117","STL","S.J",2013020089,15993,20132014,1,60,2,6,-4,4.77629985841824,6.54560030158609,-1.76930044316785,27,39,-12,41,55,-14,59,65,-6,6,6,0,0
"20118","STL","CHI",2013020104,15995,20132014,0,65,2,2,0,6.44596874584893,2.99897525865526,3.44699348719366,28,29,-1,36,39,-3,48,53,-5,4,5,0,0
"20119","STL","WPG",2013020108,15996,20132014,0,65,3,3,0,4.52219264306768,4.28917237538468,0.233020267682998,32,29,3,44,45,-1,62,66,-4,3,2,0,0
"20120","STL","VAN",2013020153,16003,20132014,1,64.75,2,3,-1,5.09085887745459,4.61434909622767,0.476509781226923,24,21,3,44,33,11,57,44,13,3,3,0,0
"20121","STL","NSH",2013020163,16004,20132014,0,60,6,1,5,3.54427743023723,2.82351219241536,0.720765237821865,30,23,7,47,34,13,56,45,11,7,5,0,0
"20122","STL","WPG",2013020181,16007,20132014,1,60,3,2,1,4.52052256265097,3.53679134027334,0.983731222377628,33,23,10,46,32,14,65,41,24,6,5,0,0
"20123","STL","FLA",2013020195,16010,20132014,0,60,4,0,4,5.562125691853,2.72977475480207,2.83235093705093,23,31,-8,35,41,-6,46,57,-11,4,2,0,0
"20124","STL","T.B",2013020202,16011,20132014,0,60,2,4,-2,2.8115771718345,6.1908943002818,-3.37931712844729,30,25,5,42,38,4,59,54,5,4,3,0,0
"20125","STL","MTL",2013020220,16014,20132014,0,65,2,2,0,4.87594538103167,1.44499267772403,3.43095270330764,32,27,5,41,32,9,79,43,36,4,2,0,0
"20126","STL","CGY",2013020238,16016,20132014,1,60,3,2,1,2.87768579048105,1.59010771627072,1.28757807421033,27,20,7,37,31,6,47,49,-2,4,7,0,0
"20127","STL","ARI",2013020272,16021,20132014,1,60.9333333333333,2,3,-1,3.59853428823408,1.86800910125021,1.73052518698387,39,19,20,51,22,29,68,33,35,1,1,0,0
"20128","STL","COL",2013020281,16023,20132014,1,60,7,3,4,4.67283238192297,4.91119539985084,-0.238363017927867,29,24,5,40,37,3,52,46,6,5,5,0,0
"20129","STL","CAR",2013020298,16025,20132014,1,60,4,2,2,5.24749350536149,4.57186253837903,0.675630966982459,32,20,12,48,30,18,65,40,25,5,4,0,0
"20130","STL","WSH",2013020304,16026,20132014,0,60,1,4,-3,5.48905987893507,3.68931897855509,1.79974090037997,47,20,27,63,37,26,85,49,36,5,4,0,0
"20131","STL","BUF",2013020312,16028,20132014,0,60,4,1,3,4.08060555534757,4.341330076335,-0.260724520987424,31,24,7,46,33,13,63,46,17,3,2,0,0
"20132","STL","BOS",2013020326,16030,20132014,0,65,2,2,0,5.296928619151,3.99539312582056,1.30153549333045,26,31,-5,33,43,-10,51,66,-15,1,1,0,0
"20133","STL","DAL",2013020347,16032,20132014,1,60,6,1,5,3.54110813834268,3.93359135590834,-0.392483217565662,25,35,-10,37,50,-13,45,62,-17,3,3,0,0
"20134","STL","MIN",2013020360,16034,20132014,1,60,3,0,3,5.18719662750829,3.25290257786401,1.93429404964428,21,22,-1,41,31,10,54,43,11,3,3,0,0
"20135","STL","COL",2013020375,16036,20132014,0,60,4,1,3,4.36498674571599,2.35878926126315,2.00619748445284,35,26,9,44,34,10,55,56,-1,2,5,0,0
"20136","STL","S.J",2013020385,16038,20132014,0,60,3,6,-3,4.28825679759029,3.80021266902804,0.488044128562251,24,32,-8,36,42,-6,63,61,2,7,7,0,0
"20137","STL","L.A",2013020409,16041,20132014,0,60,2,3,-1,5.87613399664406,2.91649625045829,2.95963774618576,27,23,4,41,33,8,47,44,3,4,3,0,0
"20138","STL","NYI",2013020428,16044,20132014,1,60,5,1,4,2.64757010312587,3.17936715950191,-0.531797056376035,26,23,3,35,36,-1,47,42,5,8,5,0,0
"20139","STL","ANA",2013020445,16046,20132014,1,60,2,5,-3,4.3592550791509,4.43044531748092,-0.0711902383300185,28,23,5,42,29,13,57,33,24,4,3,0,0
"20140","STL","WPG",2013020464,16049,20132014,0,60,2,1,1,2.67903523295945,3.18952771469753,-0.510492481738083,20,21,-1,35,31,4,57,43,14,4,5,0,0
"20141","STL","TOR",2013020477,16051,20132014,1,60,6,3,3,5.28954268261111,1.58486538892612,3.70467729368499,36,22,14,52,28,24,61,40,21,3,3,0,0
"20142","STL","CBJ",2013020494,16053,20132014,0,60.3666666666667,4,3,1,5.44192864899234,4.6468763660057,0.795052282986644,31,33,-2,38,46,-8,54,61,-7,4,8,0,0
"20143","STL","OTT",2013020507,16055,20132014,0,63.9833333333333,2,3,-1,5.2417395505181,9.54719089774881,-4.3054513472307,32,32,0,39,49,-10,51,66,-15,3,4,0,0
"20144","STL","S.J",2013020516,16056,20132014,1,60,2,4,-2,2.87039395581814,3.58969854996121,-0.719304594143068,22,27,-5,35,40,-5,58,49,9,4,4,0,0
"20145","STL","MTL",2013020530,16058,20132014,1,60,5,1,4,3.90551681437978,3.65966575406492,0.245851060314862,29,26,3,36,31,5,52,44,8,7,5,0,0
"20146","STL","EDM",2013020549,16060,20132014,0,60,6,0,6,5.21821886362159,2.3177313185588,2.90048754506279,33,23,10,41,35,6,56,55,1,7,6,0,0
"20147","STL","CGY",2013020563,16062,20132014,0,65,3,3,0,3.0640091194,3.66699754608544,-0.602988426685442,35,29,6,43,41,2,56,61,-5,4,5,0,0
"20148","STL","CHI",2013020581,16067,20132014,1,65,5,5,0,4.54067935599596,4.33384074945312,0.206838606542846,25,32,-7,43,41,2,61,53,8,4,1,0,0
"20149","STL","DAL",2013020588,16068,20132014,0,64.8166666666667,3,2,1,5.12249535217416,5.9638439520495,-0.841348599875346,22,30,-8,32,48,-16,46,73,-27,2,5,0,0
"20150","STL","MIN",2013020601,16070,20132014,0,60,2,1,1,4.80727031322391,5.65756054083658,-0.850290227612675,23,25,-2,38,38,0,51,62,-11,1,3,0,0
"20151","STL","L.A",2013020616,16072,20132014,1,60,5,0,5,4.38379653580603,4.82011982275631,-0.436323286950284,26,30,-4,34,46,-12,42,70,-28,4,6,0,0
"20152","STL","CBJ",2013020633,16074,20132014,1,60,6,2,4,6.14833244527108,3.04325555224204,3.10507689302904,37,24,13,51,31,20,67,44,23,2,2,0,0
"20153","STL","EDM",2013020653,16077,20132014,0,60,5,2,3,5.38297813006648,1.65502558082335,3.72795254924313,30,18,12,48,27,21,65,38,27,3,0,0,0
"20154","STL","CGY",2013020665,16079,20132014,0,60,5,0,5,4.20173167260948,3.16838136065568,1.0333503119538,29,33,-4,37,43,-6,50,63,-13,7,7,0,0
"20155","STL","VAN",2013020674,16080,20132014,0,60,1,2,-1,6.79596576494782,5.70365930546541,1.09230645948242,31,22,9,41,30,11,58,47,11,1,2,0,0
"20156","STL","ARI",2013020703,16084,20132014,1,60,2,1,1,1.63665614195634,3.47936962448875,-1.84271348253242,18,21,-3,26,32,-6,34,49,-15,3,3,0,0
"20157","STL","L.A",2013020715,16086,20132014,1,60,1,4,-3,3.97162828331624,4.31647568603512,-0.344847402718881,29,31,-2,41,39,2,51,51,0,8,9,0,0
"20158","STL","ANA",2013020731,16088,20132014,1,60,2,3,-1,5.31641722359927,4.98552010778803,0.33089711581124,36,21,15,50,35,15,73,49,24,3,4,0,0
"20159","STL","DET",2013020742,16090,20132014,0,60,4,1,3,5.26950134746181,3.07000736249847,2.19949398496334,39,23,16,49,37,12,64,50,14,5,6,0,0
"20160","STL","N.J",2013020747,16091,20132014,0,60,1,7,-6,3.33949441667726,3.56925725447945,-0.229762837802191,27,23,4,31,29,2,45,33,12,3,4,0,0
"20161","STL","NYR",2013020760,16093,20132014,0,60,2,1,1,2.45854477234244,3.67204115381719,-1.21349638147476,25,35,-10,35,43,-8,53,60,-7,3,4,0,0
"20162","STL","NYI",2013020775,16095,20132014,0,65,3,3,0,6.3014374839795,3.98174224322429,2.31969524075521,35,36,-1,50,44,6,62,58,4,4,7,0,0
"20163","STL","N.J",2013020801,16098,20132014,1,60,3,0,3,4.40306355147868,3.66631916731876,0.73674438415992,25,23,2,35,36,-1,53,55,-2,5,5,0,0
"20164","STL","CAR",2013020820,16101,20132014,0,60,1,3,-2,5.8161437260278,5.46367893768239,0.352464788345412,28,31,-3,47,46,1,53,71,-18,4,4,0,0
"20165","STL","NSH",2013020830,16102,20132014,1,65,3,3,0,3.47703000176261,5.32418324645732,-1.84715324469471,34,31,3,46,48,-2,62,62,0,3,1,0,0
"20166","STL","OTT",2013020850,16105,20132014,1,65,4,4,0,6.63062630867353,4.57112663774489,2.05949967092864,50,31,19,64,39,25,76,50,26,9,3,0,0
"20167","STL","BOS",2013020864,16107,20132014,1,63.4833333333333,3,2,1,4.89621614844975,6.91874662658665,-2.0225304781369,27,38,-11,37,44,-7,46,61,-15,5,6,0,0
"20168","STL","WPG",2013020873,16109,20132014,1,65,3,3,0,2.50798260745069,3.79227921483107,-1.28429660738038,26,31,-5,34,39,-5,49,51,-2,7,5,0,0
"20169","STL","VAN",2013020885,16127,20132014,0,60,0,1,-1,3.39860990018781,3.6587344996442,-0.26012459945639,20,35,-15,38,47,-9,52,58,-6,3,4,0,0
"20170","STL","ANA",2013020901,16129,20132014,0,60,0,1,-1,3.01702250784973,1.46763917146018,1.54938333638955,18,19,-1,48,30,18,75,38,37,4,4,0,0
"20171","STL","ARI",2013020918,16131,20132014,0,60,4,2,2,4.95064403070137,3.01946786840563,1.93117616229574,30,25,5,47,34,13,57,49,8,3,3,0,0
"20172","STL","T.B",2013020928,16133,20132014,1,60,4,2,2,3.81564498303357,1.98915704007959,1.82648794295398,29,17,12,41,29,12,58,39,19,2,4,0,0
"20173","STL","NSH",2013020943,16135,20132014,0,60,2,1,1,1.42662373876919,1.74104707475635,-0.314423335987158,22,21,1,30,29,1,33,40,-7,3,5,0,0
"20174","STL","COL",2013020954,16137,20132014,0,60,2,1,1,2.74293110412452,3.73329499148531,-0.990363887360786,25,27,-2,35,41,-6,49,58,-9,1,3,0,0
"20175","STL","MIN",2013020966,16138,20132014,0,65,2,2,0,3.88156786151194,3.67190582925105,0.209662032260894,22,19,3,33,34,-1,48,46,2,2,3,0,0
"20176","STL","DAL",2013020982,16140,20132014,1,63.7,2,3,-1,6.67019257848733,6.67040759063093,-0.000215012143598869,30,30,0,42,42,0,57,52,5,4,3,0,0
"20177","STL","EDM",2013020993,16142,20132014,1,60,6,2,4,3.75166353019788,3.25700501294599,0.494658517251894,37,25,12,55,34,21,72,43,29,8,6,0,0
"20178","STL","NSH",2013021009,16144,20132014,0,60,4,1,3,3.90155577075348,5.03796381209395,-1.13640804134047,26,31,-5,34,39,-5,47,52,-5,3,5,0,0
"20179","STL","WPG",2013021024,16146,20132014,1,60,3,1,2,6.29248915614698,2.33351587760262,3.95897327854436,26,17,9,44,25,19,62,36,26,7,5,0,0
"20180","STL","CHI",2013021039,16148,20132014,0,60,0,4,-4,3.93983490725077,5.2965020625852,-1.35666715533443,23,30,-7,34,43,-9,45,52,-7,3,3,0,0
"20181","STL","PHI",2013021055,16151,20132014,0,60,1,4,-3,2.91242996370815,3.04089807397395,-0.128468110265796,33,19,14,50,31,19,71,55,16,10,8,0,0
"20182","STL","TOR",2013021079,16154,20132014,0,60,5,3,2,6.61024569346807,5.54273238015594,1.06751331331213,49,25,24,66,34,32,80,45,35,3,3,0,0
"20183","STL","MIN",2013021098,16156,20132014,1,60,5,1,4,2.44008764722776,2.72797665107646,-0.287889003848704,24,28,-4,35,38,-3,51,49,2,6,7,0,0
"20184","STL","DAL",2013021115,16158,20132014,1,60,2,4,-2,5.056338442173,4.18209152016789,0.874246922005113,35,27,8,42,38,4,57,48,9,6,5,0,0
"20185","STL","PHI",2013021136,16161,20132014,1,65,0,0,0,2.14430772438936,3.12591787258862,-0.981610148199252,28,31,-3,49,37,12,66,49,17,4,3,0,0
"20186","STL","BUF",2013021149,16163,20132014,1,60,2,1,1,3.2271072042131,3.26846652950917,-0.0413593252960709,28,25,3,45,33,12,64,45,19,2,3,0,0
"20187","STL","COL",2013021161,16165,20132014,1,60,0,4,-4,2.36636580422748,3.9263247653289,-1.55995896110142,31,29,2,44,44,0,60,53,7,9,12,0,0
"20188","STL","CHI",2013021174,16166,20132014,0,60,2,4,-2,3.10227415601371,4.03680368537607,-0.934529529362358,23,35,-12,30,45,-15,38,60,-22,4,5,0,0
"20189","STL","WSH",2013021186,16168,20132014,1,60,1,4,-3,4.47392418807542,3.05734590460045,1.41657828347496,29,22,7,54,26,28,80,32,48,4,5,0,0
"20190","STL","MIN",2013021201,16170,20132014,0,60,2,4,-2,4.98389035321085,3.14131255086977,1.84257780234108,45,15,30,58,21,37,64,27,37,3,4,0,0
"20191","STL","DAL",2013021209,16171,20132014,0,60,0,3,-3,2.5223808802628,7.78702432897836,-5.26464344871556,22,40,-18,33,60,-27,45,75,-30,4,7,0,0
"20192","STL","DET",2013021224,16173,20132014,1,60,0,3,-3,2.20848772650805,4.44627765554469,-2.23778992903664,23,21,2,28,36,-8,40,46,-6,3,4,0,0
"20193","STL","CHI",2013030161,16177,20132014,1,80,3,3,0,9.67284514677885,4.94687566616449,4.72596948061437,38,35,3,63,48,15,76,71,5,3,5,0,0
"20194","STL","CHI",2013030162,16179,20132014,1,65.8333333333333,4,3,1,6.54294668979128,5.33121909718466,1.21172759260662,31,28,3,45,39,6,63,53,10,8,5,0,0
"20195","STL","CHI",2013030163,16181,20132014,0,60,0,2,-2,7.33033660631918,5.35814140428556,1.97219520203362,34,25,9,46,32,14,70,49,21,3,4,0,0
"20196","STL","CHI",2013030164,16183,20132014,0,71.2833333333333,3,4,-1,5.37169041525362,6.48674968391424,-1.11505926866062,33,34,-1,45,49,-4,62,74,-12,6,3,0,0
"20197","STL","CHI",2013030165,16185,20132014,1,67.6,2,3,-1,5.83783091776161,4.84813496272545,0.989695955036154,29,30,-1,44,42,2,65,60,5,3,3,0,0
"20198","STL","CHI",2013030166,16187,20132014,0,60,1,5,-4,5.06732008992321,4.47864806617144,0.588672023751769,36,27,9,46,32,14,66,45,21,5,3,0,0
"20199","STL","NYR",2014020011,16352,20142015,1,60,2,3,-1,2.64205061167013,3.09483894693976,-0.452788335269631,25,25,0,34,31,3,52,43,9,7,5,0,0
"20200","STL","CGY",2014020026,16354,20142015,1,60,4,1,3,5.75695589129464,1.96807822701521,3.78887766427943,39,24,15,53,32,21,68,47,21,7,8,0,0
"20201","STL","L.A",2014020055,16359,20142015,0,65,0,0,0,6.88798024730204,4.623365019419,2.26461522788304,43,18,25,56,37,19,74,49,25,5,5,0,0
"20202","STL","ARI",2014020072,16361,20142015,0,60,6,1,5,4.90917343183537,3.42050141538493,1.48867201645044,36,25,11,52,37,15,66,52,14,5,5,0,0
"20203","STL","ANA",2014020077,16362,20142015,0,60,0,3,-3,5.9136113496895,2.90025366761428,3.01335768207522,28,25,3,42,37,5,56,48,8,2,3,0,0
"20204","STL","VAN",2014020095,16366,20142015,1,60,1,4,-3,4.6858439649659,2.97948703326779,1.70635693169811,32,23,9,44,33,11,67,40,27,7,4,0,0
"20205","STL","CHI",2014020112,16368,20142015,1,60,3,2,1,5.08810329827247,3.3658452718052,1.72225802646727,31,24,7,45,37,8,52,53,-1,4,4,0,0
"20206","STL","DAL",2014020132,16371,20142015,0,61.4666666666667,4,3,1,3.28202209485015,2.66037624241267,0.621645852437487,27,28,-1,34,39,-5,48,53,-5,5,4,0,0
"20207","STL","ANA",2014020144,16373,20142015,1,60,2,0,2,3.27721726620803,3.35879754680013,-0.0815802805921066,29,24,5,45,35,10,59,48,11,3,4,0,0
"20208","STL","COL",2014020161,16375,20142015,1,65,2,2,0,3.65307820484759,2.75204635845148,0.901031846396108,29,29,0,40,38,2,56,49,7,3,4,0,0
"20209","STL","NYR",2014020171,16377,20142015,0,65,3,3,0,3.47771657076669,5.92572114012748,-2.44800456936079,34,39,-5,48,54,-6,61,72,-11,4,5,0,0
"20210","STL","N.J",2014020173,16378,20142015,0,60,1,0,1,4.40881646224238,2.40033406409202,2.00848239815036,23,26,-3,30,32,-2,38,47,-9,3,3,0,0
"20211","STL","N.J",2014020191,16380,20142015,1,60,4,3,1,3.61937327933265,5.30530258059116,-1.68592930125851,29,27,2,39,40,-1,49,51,-2,3,3,0,0
"20212","STL","NSH",2014020210,16382,20142015,1,60,1,2,-1,4.37265770426893,5.53289969754405,-1.16024199327512,29,35,-6,41,44,-3,54,54,0,1,2,0,0
"20213","STL","BUF",2014020226,16385,20142015,1,60,6,1,5,3.84165970244794,2.47979575728692,1.36186394516102,29,29,0,38,34,4,56,45,11,6,5,0,0
"20214","STL","NSH",2014020237,16387,20142015,1,60,4,3,1,2.28235589025105,4.06800878338981,-1.78565289313877,27,25,2,32,36,-4,40,57,-17,4,6,0,0
"20215","STL","WSH",2014020258,16389,20142015,1,60,4,1,3,3.55055661895312,4.57671146493522,-1.02615484598209,34,25,9,46,36,10,57,48,9,3,1,0,0
"20216","STL","BOS",2014020267,16392,20142015,0,60,0,2,-2,4.19061478169169,1.61274840820142,2.57786637349027,33,17,16,43,27,16,55,39,16,2,1,0,0
"20217","STL","MTL",2014020282,16394,20142015,0,60,1,4,-3,6.10660484991422,3.63824259239482,2.4683622575194,32,30,2,44,40,4,56,57,-1,0,2,0,0
"20218","STL","OTT",2014020295,16396,20142015,0,60,3,2,1,2.324465849719,4.65719818198704,-2.33273233226805,33,26,7,44,40,4,55,57,-2,5,5,0,0
"20219","STL","WPG",2014020308,16397,20142015,0,60,4,2,2,4.31569765706081,2.04866356992216,2.26703408713865,29,30,-1,37,38,-1,47,54,-7,4,1,0,0
"20220","STL","OTT",2014020317,16399,20142015,1,65,2,2,0,5.54745284051276,5.5169427517283,0.0305100887844603,29,33,-4,41,49,-8,47,74,-27,8,5,0,0
"20221","STL","EDM",2014020342,16402,20142015,1,64.3333333333333,4,3,1,7.00301223521819,1.98881844140124,5.01419379381696,41,16,25,61,26,35,76,39,37,3,0,0,0
"20222","STL","MIN",2014020351,16403,20142015,0,65,2,2,0,4.05942947384079,4.72747890933533,-0.668049435494538,26,38,-12,38,55,-17,47,72,-25,2,3,0,0
"20223","STL","CHI",2014020373,16407,20142015,0,60,1,4,-3,3.6743251702286,4.54058656158668,-0.866261391358077,41,33,8,48,44,4,60,60,0,7,5,0,0
"20224","STL","NSH",2014020383,16408,20142015,0,60,3,4,-1,3.65123342912891,1.52364319894696,2.12759023018195,32,24,8,42,32,10,55,52,3,3,2,0,0
"20225","STL","NYI",2014020397,16410,20142015,0,60,6,4,2,4.49353462118052,3.0212519345805,1.47228268660001,40,27,13,52,34,18,72,51,21,6,6,0,0
"20226","STL","FLA",2014020408,16412,20142015,1,60,4,2,2,6.51493317011477,2.1757713750755,4.33916179503927,28,34,-6,40,41,-1,50,50,0,4,3,0,0
"20227","STL","NYI",2014020427,16415,20142015,1,60,6,3,3,4.78018936641399,2.85779055990861,1.92239880650538,33,28,5,45,41,4,52,58,-6,4,5,0,0
"20228","STL","COL",2014020445,16417,20142015,0,61.05,3,2,1,7.5897647659684,3.0657446309051,4.52402013506329,42,25,17,56,34,22,72,50,22,5,6,0,0
"20229","STL","L.A",2014020458,16420,20142015,1,60,5,2,3,5.00362082564526,2.54516409040662,2.45845673523864,23,23,0,32,30,2,42,41,1,3,6,0,0
"20230","STL","L.A",2014020472,16422,20142015,0,60,4,6,-2,2.8920724223618,6.60407507204218,-3.71200264968038,28,37,-9,46,57,-11,59,71,-12,4,7,0,0
"20231","STL","S.J",2014020490,16424,20142015,0,64.3666666666667,2,3,-1,2.24590918991498,4.93772351386724,-2.69181432395226,20,30,-10,35,46,-11,50,66,-16,0,3,0,0
"20232","STL","COL",2014020513,16427,20142015,0,60,0,5,-5,3.96838953182775,5.03627388807897,-1.06788435625122,26,41,-15,34,48,-14,52,60,-8,4,7,0,0
"20233","STL","DAL",2014020521,16431,20142015,1,60,3,4,-1,5.08186012255464,4.35188816589653,0.729971956658119,33,24,9,50,35,15,69,47,22,5,6,0,0
"20234","STL","COL",2014020535,16433,20142015,1,60,3,0,3,3.63984602785786,2.49371505703311,1.14613097082474,25,16,9,47,22,25,56,33,23,1,1,0,0
"20235","STL","NSH",2014020542,16434,20142015,0,60,2,3,-1,4.98244244486041,4.81048217558964,0.171960269270768,28,47,-19,38,64,-26,56,80,-24,4,4,0,0
"20236","STL","ANA",2014020565,16437,20142015,0,60,3,4,-1,6.12359618702143,4.46397400591971,1.65962218110172,42,33,9,56,43,13,69,60,9,5,5,0,0
"20237","STL","S.J",2014020575,16438,20142015,0,60,7,2,5,4.07053332836343,1.89808970503509,2.17244362332834,33,20,13,47,26,21,64,44,20,8,11,0,0
"20238","STL","ARI",2014020591,16441,20142015,0,60,6,0,6,6.40680781483024,3.86682627368714,2.53998154114311,39,23,16,57,34,23,65,46,19,5,1,0,0
"20239","STL","S.J",2014020601,16443,20142015,1,60,7,2,5,4.72061994328396,4.1649560979086,0.555663845375364,28,26,2,48,36,12,55,42,13,4,3,0,0
"20240","STL","EDM",2014020635,16448,20142015,1,60,4,2,2,3.90533811785281,2.46029725135304,1.44504086649977,29,15,14,37,26,11,45,43,2,6,5,0,0
"20241","STL","TOR",2014020667,16452,20142015,1,60,3,0,3,0,0,0,33,27,6,51,43,8,65,56,9,3,2,0,0
"20242","STL","COL",2014020679,16454,20142015,1,60,3,1,2,2.84554980733446,2.57999699564607,0.265552811688394,30,18,12,49,25,24,57,37,20,2,3,0,0
"20243","STL","T.B",2014020750,16469,20142015,1,61.2666666666667,2,1,1,2.50628772407799,3.58070889715759,-1.0744211730796,18,31,-13,37,46,-9,48,56,-8,3,4,0,0
"20244","STL","T.B",2014020813,16478,20142015,0,60,6,3,3,4.71183517170721,1.75919568611425,2.95263948559295,44,29,15,49,41,8,58,54,4,3,3,0,0
"20245","STL","DAL",2014020851,16483,20142015,1,60,1,4,-3,4.10878269715403,2.7688557600819,1.33992693707213,28,22,6,39,35,4,57,43,14,3,4,0,0
"20246","STL","MTL",2014020899,16490,20142015,1,60,2,5,-3,3.79756706001373,3.9445420834423,-0.146975023428567,29,23,6,46,37,9,61,46,15,3,3,0,0
"20247","STL","WPG",2014020914,16492,20142015,0,65,1,1,0,5.13711930076261,4.45637278811773,0.680746512644873,29,31,-2,39,42,-3,58,65,-7,4,4,0,0
"20248","STL","EDM",2014020931,16494,20142015,0,60,2,1,1,4.12617414246779,2.70520069624763,1.42097344622016,27,22,5,50,33,17,65,49,16,2,1,0,0
"20249","STL","PHI",2014020957,16499,20142015,0,60,1,3,-2,2.16952207915347,5.45630161842928,-3.28677953927581,29,31,-2,36,45,-9,57,60,-3,1,2,0,0
"20250","STL","TOR",2014020971,16501,20142015,0,60,6,1,5,4.20156868210102,2.97324513725471,1.22832354484631,44,24,20,56,34,22,65,41,24,7,8,0,0
"20251","STL","WPG",2014020996,16504,20142015,1,60,5,4,1,5.30912144843023,1.75627286759845,3.55284858083178,27,16,11,37,32,5,48,46,2,8,8,0,0
"20252","STL","PHI",2014021008,16506,20142015,1,65,0,0,0,6.12182103568921,2.95710135567481,3.1647196800144,35,28,7,50,40,10,66,63,3,2,4,0,0
"20253","STL","MIN",2014021026,16508,20142015,1,60,1,3,-2,5.43180439260323,1.43365988566802,3.9981445069352,42,19,23,59,25,34,83,36,47,4,4,0,0
"20254","STL","DAL",2014021032,16509,20142015,0,60,3,0,3,3.33170170080402,2.95701071954136,0.37469098126266,21,28,-7,28,41,-13,37,59,-22,3,7,0,0
"20255","STL","WPG",2014021058,16513,20142015,0,65,1,1,0,4.80883694968585,5.45605146549053,-0.647214515804683,33,34,-1,38,50,-12,53,73,-20,5,4,0,0
"20256","STL","MIN",2014021066,16515,20142015,0,60,3,6,-3,4.65468029785552,4.8329937921788,-0.178313494323277,29,28,1,40,37,3,54,49,5,4,4,0,0
"20257","STL","DAL",2014021164,16528,20142015,0,60,7,5,2,0,0,0,21,32,-11,27,47,-20,41,65,-24,4,6,0,0
"20258","STL","WPG",2014021195,16532,20142015,1,60,0,1,-1,4.98976761795348,3.67638693447225,1.31338068348123,30,31,-1,47,44,3,60,57,3,6,6,0,0
"20259","STL","MIN",2014021226,16536,20142015,1,60,4,2,2,3.66341630167881,3.96277124258631,-0.299354940907506,24,25,-1,33,31,2,50,50,0,3,5,0,0
"20260","STL","MIN",2014030151,16541,20142015,1,60,2,4,-2,5.15731513459468,3.27312803595851,1.88418709863618,21,29,-8,38,35,3,58,49,9,2,4,0,0
"20261","STL","MIN",2014030152,16543,20142015,1,60,4,1,3,5.65249111689627,3.3222528711708,2.33023824572547,27,25,2,36,35,1,50,47,3,3,1,0,0
"20262","STL","MIN",2014030153,16545,20142015,0,60,0,3,-3,4.26887057034672,5.53878018661635,-1.26990961626963,17,24,-7,29,36,-7,47,55,-8,0,3,0,0
"20263","STL","MIN",2014030154,16547,20142015,0,60,6,1,5,4.66400726977736,1.42490330020203,3.23910396957532,26,18,8,48,28,20,57,43,14,2,1,0,0
"20264","STL","MIN",2014030155,16549,20142015,1,60,1,4,-3,4.29980863587116,2.28673901990987,2.01306961596129,37,19,18,55,26,29,73,39,34,3,3,0,0
"20265","STL","MIN",2014030156,16551,20142015,0,60,1,4,-3,4.63096287951339,5.28469135134947,-0.653728471836075,31,21,10,42,32,10,65,38,27,3,2,0,0
"20266","STL","EDM",2015020008,16716,20152016,1,60,3,1,2,3.91374759422803,2.93784244595276,0.975905148275264,31,25,6,44,32,12,57,49,8,4,4,0,0
"20267","STL","MIN",2015020025,16718,20152016,0,60,2,3,-1,6.72502479149261,3.45027231622953,3.27475247526309,32,19,13,43,29,14,62,43,19,4,5,0,0
"20268","STL","EDM",2015020056,16723,20152016,0,60,4,2,2,5.99361889581346,2.14473584160442,3.84888305420904,29,26,3,42,34,8,55,51,4,4,5,0,0
"20269","STL","WPG",2015020076,16726,20152016,0,60,4,2,2,4.05427803596831,4.02511422247858,0.0291638134897312,41,29,12,47,41,6,56,50,6,9,10,0,0
"20270","STL","MTL",2015020085,16728,20152016,0,60,0,3,-3,6.3269715344868,6.35104134938484,-0.0240698148980414,38,36,2,47,44,3,65,56,9,3,2,0,0
"20271","STL","NYI",2015020111,16732,20152016,1,64,2,3,-1,5.97778361556539,2.76662882301025,3.21115479255513,40,22,18,60,29,31,79,46,33,5,3,0,0
"20272","STL","T.B",2015020129,16735,20152016,1,60,2,0,2,3.21259563670174,2.42252145317616,0.790074183525576,24,26,-2,35,36,-1,45,53,-8,3,1,0,0
"20273","STL","ANA",2015020141,16737,20152016,1,60,2,1,1,3.85329132596962,3.06729942795567,0.785991898013947,34,23,11,41,37,4,54,46,8,6,5,0,0
"20274","STL","MIN",2015020162,16739,20152016,1,64.4333333333333,3,2,1,3.7242885883461,6.08332038519438,-2.35903179684829,26,31,-5,35,41,-6,44,53,-9,4,7,0,0
"20275","STL","N.J",2015020216,16749,20152016,0,60,2,0,2,2.91388314163487,3.68208167318164,-0.768198531546773,28,24,4,35,29,6,45,39,6,3,2,0,0
"20276","STL","NYR",2015020231,16751,20152016,0,60,3,6,-3,6.04914455680409,5.16504321430357,0.884101342500529,34,22,12,47,33,14,68,49,19,4,3,0,0
"20277","STL","WPG",2015020266,16755,20152016,1,60,3,2,1,3.24381553457351,2.61224868583807,0.631566848735446,28,18,10,37,30,7,48,42,6,5,5,0,0
"20278","STL","NYI",2015020384,16773,20152016,0,65,1,1,0,2.7559431042464,2.50246281275642,0.253480291489978,32,25,7,41,39,2,50,51,-1,3,3,0,0
"20279","STL","TOR",2015020393,16774,20152016,1,60,1,4,-3,3.51056620373424,3.69927262443525,-0.18870642070101,28,29,-1,40,37,3,48,47,1,3,5,0,0
"20280","STL","PHI",2015020424,16779,20152016,1,60,2,4,-2,4.94515925571613,4.43950405549286,0.505655200223273,37,29,8,40,40,0,55,54,1,3,2,0,0
"20281","STL","DAL",2015020440,16781,20152016,1,60,3,0,3,2.22865768796444,3.89381315627203,-1.66515546830759,26,26,0,37,32,5,44,53,-9,6,5,0,0
"20282","STL","COL",2015020446,16782,20152016,1,60,1,3,-2,5.84889563664492,3.43629830941791,2.41259732722702,43,18,25,60,31,29,78,36,42,1,2,0,0
"20283","STL","WPG",2015020461,16784,20152016,0,60,4,3,1,3.60551660596386,5.9707038609719,-2.36518725500805,26,36,-10,37,44,-7,56,66,-10,4,3,0,0
"20284","STL","PHI",2015020500,16790,20152016,0,60,3,4,-1,4.76728061951469,4.92746523800709,-0.160184618492397,29,31,-2,40,43,-3,55,63,-8,3,4,0,0
"20285","STL","DAL",2015020521,16795,20152016,1,65,2,2,0,5.39405966539744,3.96473757656713,1.4293220888303,37,24,13,48,28,20,68,37,31,4,1,0,0
"20286","STL","DAL",2015020529,16796,20152016,0,60,0,3,-3,2.94454385437943,6.32208178460132,-3.3775379302219,22,38,-16,35,58,-23,48,79,-31,4,5,0,0
"20287","STL","MIN",2015020559,16800,20152016,1,60,1,3,-2,4.29447621987492,3.22858352771436,1.06589269216056,34,29,5,45,35,10,62,44,18,4,2,0,0
"20288","STL","TOR",2015020570,16802,20152016,0,60,1,4,-3,4.65028105973397,5.6134527407703,-0.963171681036329,40,33,7,56,43,13,67,66,1,2,5,0,0
"20289","STL","COL",2015020598,16806,20152016,0,64.7166666666667,3,4,-1,4.71141563185665,5.41456750040589,-0.703151868549241,38,33,5,56,47,9,71,65,6,2,3,0,0
"20290","STL","ANA",2015020613,16808,20152016,0,65,3,3,0,1.80626337842921,9.1666810104507,-7.36041763202149,28,39,-11,38,57,-19,51,71,-20,4,5,0,0
"20291","STL","N.J",2015020636,16812,20152016,1,60,5,2,3,4.13911586335598,3.29424701590324,0.844868847452744,37,24,13,45,31,14,57,48,9,5,4,0,0
"20292","STL","MTL",2015020665,16816,20152016,1,62.0666666666667,4,3,1,3.91003384913576,6.24223135481589,-2.33219750568012,22,49,-27,33,61,-28,43,75,-32,6,11,0,0
"20293","STL","PIT",2015020678,16818,20152016,1,60,5,2,3,5.35470903285351,4.68138076796981,0.6733282648837,25,38,-13,30,52,-22,36,70,-34,3,4,0,0
"20294","STL","COL",2015020708,16822,20152016,0,65,1,1,0,3.63170863379491,6.56548733476666,-2.93377870097174,34,41,-7,48,55,-7,59,74,-15,2,3,0,0
"20295","STL","MIN",2015020782,16837,20152016,1,60,4,1,3,2.99176301781411,4.80468100942517,-1.81291799161106,24,39,-15,32,53,-21,37,63,-26,7,8,0,0
"20296","STL","WPG",2015020800,16840,20152016,1,65,1,1,0,3.78549422210894,4.51742559433181,-0.731931372222873,22,33,-11,33,49,-16,39,68,-29,3,5,0,0
"20297","STL","T.B",2015020838,16845,20152016,0,60,2,1,1,3.9292065858026,4.20105974408242,-0.271853158279817,21,38,-17,32,50,-18,44,69,-25,3,3,0,0
"20298","STL","DAL",2015020853,16847,20152016,1,61.1833333333333,2,1,1,4.57676933940778,2.52434922917746,2.05242011023032,22,18,4,38,32,6,46,48,-2,5,7,0,0
"20299","STL","NYR",2015020910,16856,20152016,1,60,1,2,-1,3.93956737595047,2.38499606441032,1.55457131154015,36,23,13,51,31,20,67,39,28,2,2,0,0
"20300","STL","MIN",2015020985,16866,20152016,0,60,4,2,2,7.95793261833751,3.3763153130173,4.58161730532021,35,32,3,51,40,11,59,63,-4,1,4,0,0
"20301","STL","ANA",2015021015,16871,20152016,1,60,5,2,3,2.92509701212839,3.82717873898946,-0.90208172686107,23,29,-6,30,38,-8,42,49,-7,4,4,0,0
"20302","STL","DAL",2015021025,16872,20152016,0,62.1833333333333,5,4,1,3.34288126108004,6.01060376076202,-2.66772249968199,36,38,-2,54,45,9,72,54,18,5,4,0,0
"20303","STL","EDM",2015021049,16876,20152016,0,60,4,6,-2,4.13891234836927,1.83250197966117,2.30641036870809,28,27,1,48,33,15,60,44,16,4,6,0,0
"20304","STL","COL",2015021145,16889,20152016,1,60,3,1,2,2.18357174707489,2.99052260548342,-0.806950858408527,27,21,6,41,31,10,55,45,10,4,2,0,0
"20305","STL","COL",2015021181,16894,20152016,0,60,5,1,4,4.97225436523199,5.40948817674002,-0.437233811508033,39,31,8,50,42,8,62,56,6,4,5,0,0
"20306","STL","DAL",2015030231,16920,20152016,0,60,1,2,-1,7.4971463949671,5.9354378846474,1.5617085103197,32,42,-10,46,61,-15,68,72,-4,3,4,0,0
"20307","STL","DAL",2015030232,16922,20152016,0,70.9666666666667,4,3,1,6.35538646648553,5.34734804744767,1.00803841903786,25,34,-9,35,47,-12,58,70,-12,5,4,0,0
"20308","STL","DAL",2015030233,16924,20152016,1,60,6,1,5,2.67228112289911,3.27080640655188,-0.598525283652771,39,26,13,51,38,13,59,53,6,8,5,0,0
"20309","STL","DAL",2015030234,16926,20152016,1,62.9666666666667,2,3,-1,3.75556088908343,4.89762210444098,-1.14206121535756,26,28,-2,40,36,4,44,44,0,4,4,0,0
"20310","STL","DAL",2015030235,16928,20152016,0,60,4,1,3,4.30854756454937,5.14061677581049,-0.832069211261114,22,28,-6,31,45,-14,46,65,-19,2,3,0,0
"20311","STL","DAL",2015030236,16930,20152016,1,60,2,3,-1,5.05569213305716,4.3679716661527,0.687720466904466,37,14,23,56,23,33,75,25,50,2,1,0,0
"20312","STL","DAL",2015030237,16932,20152016,0,60,6,1,5,4.38991867656637,6.16109531064285,-1.77117663407648,19,32,-13,33,53,-20,38,87,-49,2,3,0,0
"20313","STL","MIN",2016020011,17087,20162017,1,60,3,2,1,3.56943644140847,1.77062789892079,1.79880854248768,31,21,10,41,36,5,53,53,0,5,7,0,0
"20314","STL","NYR",2016020025,17089,20162017,1,60,3,2,1,1.49375813372899,3.19341923319551,-1.69966109946652,18,35,-17,23,49,-26,30,62,-32,5,2,0,0
"20315","STL","EDM",2016020060,17094,20162017,0,60,1,3,-2,3.85477589996376,5.37969302758574,-1.52491712762199,35,23,12,47,33,14,77,51,26,3,2,0,0
"20316","STL","NYR",2016020132,17106,20162017,0,60,0,5,-5,4.90051852354327,4.1541816310633,0.746336892479974,35,29,6,47,39,8,65,51,14,3,7,0,0
"20317","STL","DAL",2016020154,17108,20162017,0,60,2,6,-4,5.17541669837613,5.21649858658202,-0.0410818882058948,30,27,3,43,38,5,60,51,9,7,7,0,0
"20318","STL","COL",2016020175,17111,20162017,1,60,5,1,4,3.80132265821599,3.09258011146449,0.708742546751508,28,23,5,39,33,6,46,44,2,5,6,0,0
"20319","STL","MIN",2016020318,17131,20162017,1,65,3,3,0,6.29839933169569,4.35881462751422,1.93958470418147,38,31,7,53,43,10,64,60,4,2,2,0,0
"20320","STL","DAL",2016020329,17133,20162017,1,63.4,4,3,1,4.30663221153343,1.62432729720604,2.68230491432739,31,21,10,42,28,14,61,44,17,4,3,0,0
"20321","STL","T.B",2016020351,17136,20162017,1,60,5,4,1,4.03314892095341,3.13239458187309,0.900754339080322,26,26,0,40,38,2,49,50,-1,7,2,0,0
"20322","STL","WPG",2016020366,17138,20162017,1,60.2833333333333,2,3,-1,6.31623481080169,3.38117737265839,2.9350574381433,22,23,-1,34,31,3,46,42,4,5,2,0,0
"20323","STL","MTL",2016020386,17141,20162017,1,63.6333333333333,3,2,1,5.87403290666407,3.77374322715332,2.10028967951075,31,30,1,41,42,-1,51,57,-6,4,5,0,0
"20324","STL","NYI",2016020396,17143,20162017,0,60,2,3,-1,3.24236798971966,2.06830907263793,1.17405891708173,26,27,-1,39,35,4,61,52,9,0,3,0,0
"20325","STL","N.J",2016020407,17144,20162017,0,60,4,1,3,2.33809094925527,4.00432145304512,-1.66623050378985,32,21,11,40,33,7,46,40,6,3,3,0,0
"20326","STL","MIN",2016020424,17146,20162017,0,60,1,3,-2,2.75387039480847,3.81547351134941,-1.06160311654094,23,25,-2,34,33,1,51,42,9,3,3,0,0
"20327","STL","N.J",2016020449,17150,20162017,1,60,5,2,3,5.08588411394157,3.42240400795708,1.66348010598449,31,26,5,45,36,9,59,48,11,5,3,0,0
"20328","STL","EDM",2016020479,17154,20162017,1,62.9166666666667,2,3,-1,3.35152399466955,7.20784588678544,-3.85632189211589,27,35,-8,35,42,-7,49,57,-8,2,2,0,0
"20329","STL","DAL",2016020490,17155,20162017,0,61.9166666666667,3,2,1,4.62889349879697,5.56913743512558,-0.940243936328613,22,38,-16,29,55,-26,49,73,-24,2,4,0,0
"20330","STL","T.B",2016020500,17157,20162017,0,60,2,5,-3,3.40424391254783,5.65694947354496,-2.25270556099713,23,32,-9,31,43,-12,42,50,-8,2,3,0,0
"20331","STL","PHI",2016020530,17163,20162017,1,60,6,3,3,4.73697027950789,2.47535955491185,2.26161072459604,25,20,5,35,23,12,45,44,1,5,5,0,0
"20332","STL","DAL",2016020599,17173,20162017,1,60,4,3,1,3.50862835190492,3.21388874255354,0.294739609351382,22,28,-6,34,34,0,47,48,-1,4,5,0,0
"20333","STL","ANA",2016020655,17181,20162017,0,60.85,2,1,1,4.08785271726083,2.85628882768651,1.23156388957432,25,23,2,38,36,2,53,42,11,3,3,0,0
"20334","STL","WPG",2016020691,17187,20162017,0,60,3,5,-2,4.15938518585151,4.13422022755981,0.0251649582917022,37,29,8,46,37,9,55,48,7,4,5,0,0
"20335","STL","PIT",2016020717,17190,20162017,0,60,3,0,3,3.02675987610519,3.02380408158933,0.00295579451585581,28,34,-6,34,40,-6,49,58,-9,2,6,0,0
"20336","STL","MIN",2016020736,17192,20162017,0,60,1,5,-4,4.88186846298049,5.00903731328435,-0.12716885030386,25,33,-8,39,48,-9,57,60,-3,2,2,0,0
"20337","STL","WPG",2016020749,17197,20162017,1,60,3,5,-2,2.539898593619,2.6996812170255,-0.1597826234065,27,24,3,37,33,4,47,45,2,2,2,0,0
"20338","STL","TOR",2016020761,17199,20162017,1,60,5,1,4,2.77867166788785,3.25635486163083,-0.477683193742976,31,27,4,38,39,-1,44,60,-16,3,4,0,0
"20339","STL","PIT",2016020779,17201,20162017,1,60,1,4,-3,0,0,0,23,31,-8,36,43,-7,53,52,1,2,5,0,0
"20340","STL","PHI",2016020789,17203,20162017,0,60,2,0,2,1.06421139300801,3.61117449175799,-2.54696309874998,16,26,-10,23,38,-15,39,60,-21,3,6,0,0
"20341","STL","TOR",2016020808,17206,20162017,0,60.3333333333333,2,1,1,5.21065253007691,2.60022683619948,2.61042569387743,40,32,8,50,46,4,65,63,2,1,1,0,0
"20342","STL","MTL",2016020822,17208,20162017,0,60,4,2,2,5.45060769822666,5.65270759761916,-0.202099899392493,22,30,-8,30,42,-12,37,66,-29,1,1,0,0
"20343","STL","EDM",2016020928,17225,20162017,1,60,1,2,-1,3.53510098009428,5.79438372910954,-2.25928274901526,26,25,1,35,32,3,48,38,10,2,2,0,0
"20344","STL","WPG",2016020948,17228,20162017,0,60,0,3,-3,5.17834622578306,7.69673635205254,-2.51839012626948,29,40,-11,39,54,-15,57,65,-8,5,7,0,0
"20345","STL","COL",2016020966,17230,20162017,0,60,3,0,3,4.62701442593639,4.36718534516588,0.25982908077051,25,27,-2,32,39,-7,40,50,-10,4,1,0,0
"20346","STL","MIN",2016020977,17232,20162017,0,60,2,1,1,3.04606164907455,6.85143815488846,-3.80537650581391,20,33,-13,26,44,-18,34,58,-24,1,1,0,0
"20347","STL","ANA",2016020998,17235,20162017,1,60,4,3,1,7.7567808789463,4.52937561564613,3.22740526330017,35,26,9,43,39,4,57,52,5,3,2,0,0
"20348","STL","NYI",2016021007,17236,20162017,1,60,4,3,1,2.98710738175751,4.67091586237075,-1.68380848061324,24,24,0,30,40,-10,35,59,-24,1,3,0,0
"20349","STL","ANA",2016021036,17240,20162017,0,60,1,2,-1,4.52917667128949,5.13154451271443,-0.602367841424938,27,22,5,47,27,20,63,44,19,3,5,0,0
"20350","STL","COL",2016021085,17246,20162017,0,60,4,2,2,4.22744073280069,2.49072337972639,1.7367173530743,29,28,1,41,39,2,49,50,-1,3,3,0,0
"20351","STL","COL",2016021153,17256,20162017,0,65,1,1,0,4.30703099789522,4.55767318407311,-0.250642186177893,28,32,-4,33,44,-11,51,66,-15,3,2,0,0
"20352","STL","WPG",2016021184,17260,20162017,1,60,2,5,-3,2.71293557962417,5.50610412216799,-2.79316854254381,26,31,-5,35,39,-4,50,51,-1,1,1,0,0
"20353","STL","COL",2016021225,17265,20162017,1,60,3,2,1,4.69694410756347,4.75536141998418,-0.0584173124207155,27,34,-7,35,46,-11,51,57,-6,4,2,0,0
"20354","STL","MIN",2016030161,17268,20162017,0,77.8,2,1,1,5.62410602531545,11.1682638103069,-5.54415778499149,26,52,-26,40,69,-29,57,90,-33,4,3,0,0
"20355","STL","MIN",2016030162,17270,20162017,0,60,2,1,1,3.73615145301892,2.72743505436442,1.0087163986545,22,24,-2,31,40,-9,39,59,-20,3,4,0,0
"20356","STL","MIN",2016030163,17272,20162017,1,60,3,1,2,4.59433472636886,5.94421769838664,-1.34988297201778,31,41,-10,39,56,-17,46,79,-33,4,5,0,0
"20357","STL","MIN",2016030164,17275,20162017,1,60,0,2,-2,4.41765351694441,2.36260706862959,2.05504644831482,28,28,0,36,37,-1,50,49,1,3,3,0,0
"20358","STL","MIN",2016030165,17278,20162017,0,69.7,4,3,1,5.6119826522081,6.77664476215819,-1.16466210995009,27,37,-10,39,50,-11,54,72,-18,5,7,0,0
"20359","STL","PIT",2017020002,17443,20172018,0,61.25,5,4,1,4.12175841696444,5.90554050657556,-1.78378208961112,34,33,1,46,53,-7,56,72,-16,4,5,0,0
"20360","STL","DAL",2017020024,17446,20172018,1,60,4,2,2,1.62012250185384,4.15224739525001,-2.53212489339617,21,40,-19,26,44,-18,38,59,-21,3,5,0,0
"20361","STL","NYI",2017020033,17448,20172018,0,65,2,2,0,4.63235345873047,7.03492859236752,-2.40257513363705,35,42,-7,40,57,-17,53,70,-17,6,6,0,0
"20362","STL","NYR",2017020039,17449,20172018,0,60,3,1,2,4.64806629810482,3.83453977693352,0.813526521171298,23,33,-10,32,43,-11,42,63,-21,4,4,0,0
"20363","STL","T.B",2017020064,17453,20172018,0,60,1,2,-1,2.86782611402187,4.53254001599271,-1.66471390197084,29,27,2,42,38,4,49,64,-15,3,2,0,0
"20364","STL","COL",2017020101,17458,20172018,0,60,4,3,1,4.21872234513648,7.59542053017017,-3.37669818503369,28,41,-13,44,48,-4,55,56,-1,2,2,0,0
"20365","STL","VGK",2017020121,17460,20172018,0,64.6,2,3,-1,8.04154405314148,3.80464812805667,4.23689592508481,49,22,27,61,38,23,79,47,32,5,4,0,0
"20366","STL","PHI",2017020191,17472,20172018,1,60,0,2,-2,4.2387386681221,4.57829755343846,-0.339558885316364,33,23,10,48,35,13,68,39,29,3,3,0,0
"20367","STL","TOR",2017020205,17474,20172018,1,60,6,4,2,3.4436995308554,4.02408076921948,-0.580381238364083,32,31,1,48,41,7,68,52,16,4,3,0,0
"20368","STL","N.J",2017020224,17477,20172018,0,60,3,1,2,6.71867506731201,2.35303438530112,4.36564068201089,40,22,18,54,33,21,65,40,25,5,4,0,0
"20369","STL","NYI",2017020257,17481,20172018,1,60,2,5,-3,4.37634445249569,4.42265393459316,-0.0463094820974712,37,29,8,54,34,20,69,49,20,5,3,0,0
"20370","STL","EDM",2017020286,17486,20172018,0,60,4,1,3,5.27525629115444,3.54847660254745,1.72677968860699,39,30,9,41,41,0,55,54,1,6,5,0,0
"20371","STL","EDM",2017020317,17491,20172018,1,60,8,3,5,5.27227600916087,4.00425416189114,1.26802184726973,40,29,11,52,35,17,68,43,25,3,1,0,0
"20372","STL","MIN",2017020354,17495,20172018,1,60,6,3,3,6.06481357732332,6.37614543418624,-0.311331856862921,40,25,15,53,37,16,68,48,20,8,3,0,0
"20373","STL","ANA",2017020379,17499,20172018,1,60,2,3,-1,2.26134487706067,4.1887215432841,-1.92737666622344,39,30,9,50,34,16,71,46,25,4,5,0,0
"20374","STL","MIN",2017020397,17502,20172018,0,60.65,1,2,-1,5.74461280973628,3.38168382288541,2.36292898685087,42,25,17,58,35,23,75,40,35,5,3,0,0
"20375","STL","MTL",2017020418,17505,20172018,0,60,4,3,1,5.54757010073899,4.10753917958021,1.44003092115878,30,25,5,39,35,4,58,49,9,5,3,0,0
"20376","STL","DAL",2017020435,17507,20172018,1,60,3,0,3,5.70301839301828,4.33027301471157,1.37274537830672,27,29,-2,38,36,2,48,55,-7,7,2,0,0
"20377","STL","T.B",2017020471,17512,20172018,1,60,0,3,-3,7.20598685098958,6.35446166386828,0.851525187121297,32,25,7,48,37,11,57,61,-4,2,4,0,0
"20378","STL","ANA",2017020483,17514,20172018,1,60,1,3,-2,3.87700792377291,2.60335179065213,1.27365613312078,30,18,12,38,29,9,57,45,12,4,1,0,0
"20379","STL","WPG",2017020501,17516,20172018,1,60,2,0,2,2.41753680794355,6.33358331524147,-3.91604650729792,30,48,-18,39,65,-26,54,77,-23,5,5,0,0
"20380","STL","WPG",2017020507,17517,20172018,0,60,0,4,-4,4.10821896104608,4.98173825701267,-0.873519295966588,24,46,-22,32,62,-30,48,81,-33,4,4,0,0
"20381","STL","EDM",2017020536,17521,20172018,0,60,2,3,-1,2.52754989464224,4.16242609795881,-1.63487620331658,36,35,1,47,48,-1,59,66,-7,2,3,0,0
"20382","STL","DAL",2017020583,17529,20172018,0,60,2,4,-2,3.73149209378416,4.91361651986934,-1.18212442608518,37,31,6,49,52,-3,67,79,-12,5,5,0,0
"20383","STL","N.J",2017020607,17533,20172018,1,65,2,2,0,3.79309429598652,4.43337041480299,-0.640276118816473,29,26,3,47,40,7,60,53,7,4,2,0,0
"20384","STL","VGK",2017020621,17535,20172018,1,60,2,1,1,5.13268404061819,4.26351719524246,0.86916684537573,39,33,6,51,43,8,67,68,-1,2,1,0,0
"20385","STL","PHI",2017020633,17537,20172018,0,60,3,6,-3,7.78705833640432,4.7986469473326,2.98841138907172,31,39,-8,48,48,0,57,68,-11,1,4,0,0
"20386","STL","TOR",2017020687,17547,20172018,0,61.7166666666667,2,1,1,4.08072819438193,3.57697470507992,0.503753489302012,42,31,11,53,38,15,67,60,7,2,1,0,0
"20387","STL","COL",2017020753,17556,20172018,1,60,3,1,2,2.71215818931909,4.70234403779614,-1.99018584847705,34,37,-3,44,46,-2,62,60,2,3,2,0,0
"20388","STL","MTL",2017020767,17561,20172018,1,60,3,1,2,5.39615517692886,3.6268825272582,1.76927264967065,31,34,-3,42,45,-3,63,65,-2,3,1,0,0
"20389","STL","MIN",2017020819,17568,20172018,1,60,2,6,-4,7.72007087922101,4.2945173344342,3.42555354478681,37,20,17,50,28,22,69,42,27,4,4,0,0
"20390","STL","COL",2017020831,17570,20172018,1,60,6,1,5,5.24295723542103,3.24752344121225,1.99543379420878,31,24,7,44,33,11,54,51,3,2,5,0,0
"20391","STL","WPG",2017020840,17571,20172018,0,60,5,2,3,3.55355915987001,2.50433370727114,1.04922545259887,27,22,5,37,31,6,54,43,11,2,4,0,0
"20392","STL","PIT",2017020853,17573,20172018,1,60,1,4,-3,2.2581816065358,5.30053617277537,-3.04235456623957,34,23,11,47,30,17,57,38,19,3,2,0,0
"20393","STL","DAL",2017020893,17578,20172018,0,60,1,2,-1,2.73252884334813,2.23143293047095,0.501095912877175,29,16,13,42,24,18,65,37,28,6,4,0,0
"20394","STL","WPG",2017020943,17585,20172018,1,60,0,4,-4,3.14208763981924,3.94733525007541,-0.805247610256174,34,23,11,48,33,15,65,49,16,5,6,0,0
"20395","STL","MIN",2017020973,17589,20172018,0,60,3,8,-5,4.58628434607239,6.44423121774685,-1.85794687167446,25,33,-8,40,42,-2,56,51,5,6,5,0,0
"20396","STL","DAL",2017021001,17593,20172018,0,63.0666666666667,2,3,-1,0,0,0,37,34,3,46,48,-2,59,61,-2,5,2,0,0
"20397","STL","ANA",2017021068,17602,20172018,0,60,4,2,2,3.78803956123893,4.9701755185888,-1.18213595734987,23,22,1,34,34,0,45,54,-9,1,1,0,0
"20398","STL","COL",2017021088,17605,20172018,1,60,1,4,-3,6.18663668044502,4.36841041461889,1.81822626582613,45,23,22,67,29,38,82,42,40,2,1,0,0
"20399","STL","NYR",2017021105,17607,20172018,1,61.0333333333333,4,3,1,6.50090445535978,2.53974165173713,3.96116280362265,33,20,13,47,26,21,62,43,19,3,2,0,0
"20400","STL","VGK",2017021205,17620,20172018,0,60.3666666666667,3,4,-1,4.62727120798081,2.45797495717125,2.16929625080957,24,26,-2,34,33,1,53,49,4,2,1,0,0
"20401","STL","COL",2017021266,17628,20172018,0,60,2,5,-3,5.91878216632091,6.88655904424377,-0.967776877922859,34,39,-5,41,52,-11,64,67,-3,3,4,0,0
"20402","STL","WPG",2018020011,17808,20182019,1,60,1,5,-4,6.61101802660414,2.10081865353277,4.51019937307137,42,25,17,58,36,22,69,49,20,4,2,0,0
"20403","STL","ANA",2018020072,17818,20182019,1,60,2,3,-1,3.20149871567264,2.93435214736655,0.267146568306089,31,31,0,45,39,6,63,51,12,3,2,0,0
"20404","STL","MTL",2018020086,17821,20182019,0,60,2,3,-1,4.03245806206152,3.71476026906053,0.317697793000987,25,23,2,36,33,3,55,56,-1,5,4,0,0
"20405","STL","TOR",2018020106,17824,20182019,0,60,4,1,3,4.0843070509145,4.07460534470116,0.00970170621333999,25,23,2,39,41,-2,53,64,-11,4,4,0,0
"20406","STL","WPG",2018020120,17826,20182019,0,62.9,4,5,-1,3.41266729878687,5.61155766600859,-2.19889036722172,34,36,-2,43,52,-9,53,67,-14,3,6,0,0
"20407","STL","VGK",2018020186,17836,20182019,1,60,5,3,2,2.23236850589751,3.78408061775281,-1.5517121118553,26,34,-8,33,48,-15,45,72,-27,4,4,0,0
"20408","STL","MIN",2018020201,17838,20182019,1,60,1,5,-4,3.11740255539371,4.06959257960261,-0.952190024208903,16,45,-29,23,59,-36,38,72,-34,2,5,0,0
"20409","STL","MIN",2018020253,17846,20182019,1,60,2,3,-1,3.72830902900937,1.76089903571847,1.96740999329091,31,18,13,40,25,15,63,33,30,3,3,0,0
"20410","STL","VGK",2018020290,17851,20182019,0,60,4,1,3,3.99968399980571,4.94176909720039,-0.942085097394681,35,33,2,47,50,-3,58,68,-10,5,4,0,0
"20411","STL","WPG",2018020354,17859,20182019,1,60,4,8,-4,4.38096811082701,6.6937235164587,-2.31275540563169,27,36,-9,40,51,-11,52,65,-13,4,6,0,0
"20412","STL","COL",2018020393,17865,20182019,0,61.5666666666667,3,2,1,4.31853631032462,2.26669388006849,2.05184243025613,37,29,8,44,34,10,67,51,16,3,5,0,0
"20413","STL","EDM",2018020426,17870,20182019,1,65,2,2,0,2.3085029939283,3.77727315334778,-1.46877015941948,30,36,-6,37,55,-18,45,72,-27,2,5,0,0
"20414","STL","WPG",2018020441,17872,20182019,0,60,1,0,1,2.37653896210577,2.74042251100764,-0.363883548901867,27,26,1,31,37,-6,37,59,-22,3,7,0,0
"20415","STL","COL",2018020492,17879,20182019,1,62.0833333333333,4,3,1,7.45631276978714,4.88387758681477,2.57243518297237,28,42,-14,40,53,-13,55,68,-13,3,5,0,0
"20416","STL","EDM",2018020524,17883,20182019,0,60,4,1,3,3.89371331108123,4.2754040210275,-0.38169070994627,30,23,7,40,30,10,51,48,3,1,6,0,0
"20417","STL","PIT",2018020592,17894,20182019,1,60,1,6,-5,4.85528037747804,4.80321630350586,0.0520640739721756,31,30,1,51,38,13,74,43,31,2,4,0,0
"20418","STL","NYR",2018020605,17896,20182019,1,60,1,2,-1,5.5293743690379,2.59974001414889,2.929634354889,40,23,17,56,28,28,79,34,45,4,3,0,0
"20419","STL","NYI",2018020642,17901,20182019,1,60,3,4,-1,4.06747830986569,4.84491024471876,-0.77743193485307,32,14,18,45,29,16,59,44,15,5,2,0,0
"20420","STL","PHI",2018020653,17903,20182019,0,60,3,0,3,3.67024006621796,4.33418364142562,-0.663943575207668,37,25,12,45,34,11,56,49,7,2,1,0,0
"20421","STL","DAL",2018020664,17904,20182019,1,60,1,3,-2,3.2986250521717,2.77871226996649,0.519912782205211,27,17,10,41,27,14,64,37,27,2,2,0,0
"20422","STL","MTL",2018020677,17906,20182019,1,60,4,1,3,5.8208932171774,3.35316687652039,2.46772634065701,30,29,1,45,45,0,52,62,-10,6,7,0,0
"20423","STL","DAL",2018020695,17908,20182019,0,60,3,1,2,2.3611310878623,1.71843547612661,0.642695611735689,28,22,6,33,26,7,46,39,7,2,1,0,0
"20424","STL","NYI",2018020711,17911,20182019,0,61.6166666666667,1,2,-1,2.71088168727874,2.86833815320279,-0.157456465924042,31,25,6,46,32,14,63,42,21,3,3,0,0
"20425","STL","ANA",2018020769,17919,20182019,0,60,5,1,4,4.65482253041682,2.8631992493174,1.79162328109942,32,13,19,56,30,26,68,46,22,0,1,0,0
"20426","STL","T.B",2018020831,17934,20182019,0,64.0166666666667,1,0,1,4.4217394763723,4.60465978112758,-0.182920304755285,39,32,7,48,49,-1,55,64,-9,4,3,0,0
"20427","STL","N.J",2018020869,17939,20182019,1,60,8,3,5,4.46039654084598,2.58609087398145,1.87430566686453,39,23,16,50,26,24,70,35,35,3,3,0,0
"20428","STL","COL",2018020894,17943,20182019,0,60,3,0,3,4.51100207405398,2.93416823211825,1.57683384193573,33,32,1,43,43,0,59,55,4,5,5,0,0
"20429","STL","MIN",2018020905,17944,20182019,0,60,4,0,4,5.29699079468763,6.90198156711995,-1.60499077243232,30,31,-1,36,47,-11,49,61,-12,5,5,0,0
"20430","STL","TOR",2018020921,17946,20182019,1,60.5666666666667,3,2,1,5.22546879897345,5.1162782982484,0.109190500725056,41,33,8,55,50,5,65,67,-2,3,0,0,0
"20431","STL","DAL",2018020937,17948,20182019,0,60,2,5,-3,8.08413706579785,5.96561926830327,2.11851779749458,45,25,20,55,29,26,75,42,33,4,4,0,0
"20432","STL","MIN",2018020960,17951,20182019,0,62.4833333333333,1,2,-1,4.58016360543843,4.28086999833249,0.299293607105938,28,35,-7,41,46,-5,51,58,-7,2,3,0,0
"20433","STL","DAL",2018021006,17957,20182019,1,60,1,4,-3,4.45734791741779,1.92751623844561,2.52983167897219,30,21,9,39,27,12,52,40,12,3,1,0,0
"20434","STL","ANA",2018021031,17961,20182019,0,60,5,4,1,4.67429139227286,4.56815818172288,0.106133210549981,33,27,6,49,41,8,60,58,2,5,4,0,0
"20435","STL","PIT",2018021099,17971,20182019,0,60,5,1,4,4.32759439735673,6.28599460397982,-1.95840020662308,26,41,-15,38,50,-12,45,66,-21,2,4,0,0
"20436","STL","EDM",2018021127,17974,20182019,1,60,7,2,5,7.48347228852799,1.8420214402222,5.64145084830579,44,17,27,53,23,30,65,33,32,4,1,0,0
"20437","STL","T.B",2018021159,17978,20182019,1,60,4,3,1,3.86380987674934,5.55544145883927,-1.69163158208993,26,42,-16,34,60,-26,48,74,-26,2,3,0,0
"20438","STL","VGK",2018021173,17980,20182019,1,60,3,1,2,5.35018081178146,2.81752768389197,2.5326531278895,22,25,-3,33,41,-8,41,59,-18,1,1,0,0
"20439","STL","NYR",2018021197,17984,20182019,0,60,2,4,-2,7.41949368875066,3.90924531252344,3.51024837622722,46,25,21,65,33,32,78,43,35,1,2,0,0
"20440","STL","N.J",2018021207,17985,20182019,0,64.95,3,2,1,3.59406834891291,4.99247546808328,-1.39840711917037,27,27,0,42,45,-3,66,61,5,1,3,0,0
"20441","STL","COL",2018021225,17987,20182019,1,65,2,2,0,2.39906085579412,2.74721992167179,-0.348159065877667,27,26,1,37,39,-2,56,48,8,1,1,0,0
"20442","STL","PHI",2018021248,17990,20182019,1,60,7,3,4,3.58845024013499,1.13512282594456,2.45332741419043,35,29,6,42,39,3,54,42,12,5,5,0,0
"20443","STL","WPG",2018030161,17996,20182019,0,60,2,1,1,3.38218195010535,2.48641186633641,0.895770083768943,26,25,1,42,33,9,55,49,6,3,1,0,0
"20444","STL","WPG",2018030162,17998,20182019,0,60,4,3,1,3.26332360549473,3.73250330146705,-0.469179695972315,32,29,3,38,42,-4,50,54,-4,4,3,0,0
"20445","STL","WPG",2018030163,18000,20182019,1,60,3,6,-3,4.65065823709122,5.82697772534448,-1.17631948825325,29,29,0,42,44,-2,54,61,-7,7,7,0,0
"20446","STL","WPG",2018030164,18002,20182019,1,66.0333333333333,1,2,-1,4.61368790300185,6.45693029765971,-1.84324239465786,32,39,-7,45,54,-9,59,69,-10,2,1,0,0
"20447","STL","WPG",2018030165,18004,20182019,0,60,3,2,1,3.27471073737252,4.32585735778354,-1.05114662041102,29,31,-2,45,40,5,59,49,10,1,2,0,0
"20448","STL","WPG",2018030166,18006,20182019,1,60,3,2,1,5.3898022780777,2.52949684049236,2.86030543758534,36,20,16,44,34,10,60,49,11,3,1,0,0
"20449","STL","DAL",2018030231,18011,20182019,1,60,3,2,1,3.46242091194108,4.13814321017708,-0.675722298235996,20,29,-9,28,43,-15,41,59,-18,5,5,0,0
"20450","STL","DAL",2018030232,18013,20182019,1,60,2,4,-2,5.22010018976266,4.87001855912968,0.350081630632985,34,35,-1,49,43,6,67,48,19,7,4,0,0
"20451","STL","DAL",2018030233,18015,20182019,0,60,4,3,1,3.97631147009088,4.28806485695532,-0.311753386864439,34,31,3,44,40,4,60,68,-8,3,5,0,0
"20452","STL","DAL",2018030234,18017,20182019,0,60,2,4,-2,3.30550932232291,3.47065627440285,-0.165146952079947,29,31,-2,43,40,3,63,50,13,4,3,0,0
"20453","STL","DAL",2018030235,18019,20182019,1,60,1,2,-1,5.31920106709003,3.5260523092421,1.79314875784793,39,27,12,46,38,8,65,46,19,4,2,0,0
"20454","STL","DAL",2018030236,18021,20182019,0,60,4,1,3,3.57449494901994,2.51378572248359,1.06070922653635,25,23,2,37,33,4,46,43,3,4,3,0,0
"20455","STL","DAL",2018030237,18023,20182019,1,80,1,1,0,6.25133751872454,3.19123835122446,3.06009916750008,52,27,25,71,40,31,99,48,51,2,0,0,0
"20456","T.B","NYR",2008020001,14156,20082009,1,60,1,2,-1,0,0,0,21,41,-20,31,53,-22,37,66,-29,4,7,0,0
"20457","T.B","NYR",2008020003,14157,20082009,0,60,1,2,-1,0,0,0,19,39,-20,32,52,-20,44,72,-28,5,4,0,0
"20458","T.B","CAR",2008020023,14163,20082009,1,64.6,3,4,-1,0,0,0,29,46,-17,41,59,-18,51,71,-20,7,9,0,0
"20459","T.B","NYI",2008020051,14168,20082009,1,60.85,3,4,-1,0,0,0,36,36,0,48,44,4,58,58,0,7,10,0,0
"20460","T.B","MIN",2008020071,14170,20082009,1,65,0,0,0,0,0,0,32,21,11,43,29,14,59,38,21,3,7,0,0
"20461","T.B","ATL",2008020085,14173,20082009,1,61.6833333333333,3,2,1,0,0,0,38,33,5,49,45,4,58,62,-4,5,3,0,0
"20462","T.B","S.J",2008020111,14177,20082009,1,60,0,3,-3,0,0,0,22,45,-23,25,58,-33,33,69,-36,2,6,0,0
"20463","T.B","TOR",2008020128,14180,20082009,0,60,3,2,1,0,0,0,25,39,-14,34,58,-24,45,75,-30,5,6,0,0
"20464","T.B","BUF",2008020136,14182,20082009,0,60,5,2,3,0,0,0,40,31,9,50,40,10,59,46,13,4,6,0,0
"20465","T.B","OTT",2008020157,14184,20082009,1,65,2,2,0,0,0,0,34,31,3,44,48,-4,57,64,-7,4,3,0,0
"20466","T.B","N.J",2008020178,14188,20082009,0,65,3,3,0,0,0,0,27,38,-11,34,46,-12,46,61,-15,3,2,0,0
"20467","T.B","NYR",2008020182,14189,20082009,0,60,2,5,-3,0,0,0,38,35,3,48,52,-4,66,65,1,4,9,0,0
"20468","T.B","PHI",2008020199,14191,20082009,0,60,2,1,1,0,0,0,22,36,-14,31,48,-17,46,60,-14,6,5,0,0
"20469","T.B","WSH",2008020214,14193,20082009,0,60,2,4,-2,0,0,0,36,30,6,44,39,5,52,56,-4,5,4,0,0
"20470","T.B","FLA",2008020225,14195,20082009,0,60,0,4,-4,0,0,0,24,31,-7,36,41,-5,44,46,-2,5,6,0,0
"20471","T.B","DET",2008020231,14196,20082009,1,60,3,4,-1,0,0,0,18,39,-21,22,54,-32,29,66,-37,4,5,0,0
"20472","T.B","CAR",2008020252,14199,20082009,0,65,2,2,0,0,0,0,28,30,-2,41,46,-5,57,67,-10,6,5,0,0
"20473","T.B","FLA",2008020265,14201,20082009,1,65,3,3,0,0,0,0,52,36,16,65,46,19,74,55,19,2,5,0,0
"20474","T.B","NSH",2008020283,14204,20082009,1,60,4,1,3,0,0,0,24,35,-11,33,42,-9,44,55,-11,6,7,0,0
"20475","T.B","N.J",2008020298,14206,20082009,1,60,3,7,-4,0,0,0,29,45,-16,38,62,-24,49,70,-21,4,2,0,0
"20476","T.B","NYR",2008020314,14209,20082009,1,65,2,2,0,0,0,0,29,35,-6,43,46,-3,51,60,-9,7,7,0,0
"20477","T.B","MIN",2008020325,14211,20082009,0,60,2,4,-2,0,0,0,37,33,4,48,49,-1,61,58,3,5,3,0,0
"20478","T.B","COL",2008020343,14212,20082009,0,60,3,4,-1,0,0,0,20,31,-11,29,34,-5,50,40,10,5,4,0,0
"20479","T.B","PHI",2008020355,14215,20082009,0,62.0833333333333,3,4,-1,0,0,0,38,32,6,49,42,7,62,55,7,6,7,0,0
"20480","T.B","BOS",2008020370,14217,20082009,1,60,1,3,-2,0,0,0,31,26,5,43,37,6,60,47,13,3,1,0,0
"20481","T.B","BUF",2008020387,14219,20082009,1,60,3,4,-1,0,0,0,23,27,-4,35,35,0,46,52,-6,7,7,0,0
"20482","T.B","BOS",2008020397,14221,20082009,0,60,3,5,-2,0,0,0,29,24,5,35,37,-2,45,44,1,4,7,0,0
"20483","T.B","BUF",2008020405,14223,20082009,0,60,2,4,-2,0,0,0,28,37,-9,38,44,-6,43,61,-18,5,7,0,0
"20484","T.B","MTL",2008020416,14224,20082009,0,60,3,1,2,0,0,0,22,32,-10,32,37,-5,42,62,-20,4,7,0,0
"20485","T.B","OTT",2008020433,14226,20082009,0,60,0,2,-2,0,0,0,24,33,-9,34,42,-8,46,56,-10,5,8,0,0
"20486","T.B","COL",2008020465,14231,20082009,1,65,1,1,0,0,0,0,38,35,3,50,45,5,62,64,-2,2,5,0,0
"20487","T.B","ATL",2008020479,14233,20082009,0,60,3,4,-1,0,0,0,39,30,9,50,36,14,58,47,11,8,6,0,0
"20488","T.B","PIT",2008020500,14236,20082009,0,60,2,0,2,0,0,0,29,15,14,44,25,19,62,35,27,6,5,0,0
"20489","T.B","FLA",2008020511,14239,20082009,0,65,3,3,0,0,0,0,35,28,7,47,39,8,51,64,-13,5,5,0,0
"20490","T.B","FLA",2008020521,14240,20082009,1,60,6,4,2,0,0,0,42,29,13,52,38,14,66,49,17,6,8,0,0
"20491","T.B","MTL",2008020542,14243,20082009,1,65,1,1,0,0,0,0,22,30,-8,35,43,-8,49,53,-4,5,6,0,0
"20492","T.B","WSH",2008020557,14245,20082009,0,60,4,7,-3,0,0,0,27,35,-8,40,44,-4,58,66,-8,2,3,0,0
"20493","T.B","CAR",2008020570,14247,20082009,1,60,2,3,-1,0,0,0,19,28,-9,35,39,-4,45,50,-5,3,5,0,0
"20494","T.B","ATL",2008020577,14248,20082009,0,60,4,1,3,0,0,0,35,28,7,41,36,5,51,46,5,5,3,0,0
"20495","T.B","ARI",2008020607,14252,20082009,0,60,2,3,-1,0,0,0,24,27,-3,36,46,-10,53,60,-7,2,3,0,0
"20496","T.B","ANA",2008020613,14253,20082009,0,60,4,3,1,0,0,0,19,32,-13,29,45,-16,38,57,-19,3,4,0,0
"20497","T.B","L.A",2008020630,14256,20082009,0,60,3,1,2,0,0,0,22,30,-8,36,47,-11,44,56,-12,5,5,0,0
"20498","T.B","S.J",2008020641,14257,20082009,0,60,1,7,-6,0,0,0,25,42,-17,31,59,-28,41,75,-34,4,10,0,0
"20499","T.B","PHI",2008020649,14259,20082009,1,60,4,1,3,0,0,0,44,32,12,55,39,16,64,49,15,5,4,0,0
"20500","T.B","FLA",2008020667,14261,20082009,1,60,3,4,-1,0,0,0,33,21,12,46,27,19,57,35,22,4,2,0,0
"20501","T.B","DAL",2008020680,14263,20082009,1,60,4,2,2,0,0,0,20,25,-5,27,39,-12,39,52,-13,2,7,0,0
"20502","T.B","BUF",2008020696,14265,20082009,1,60,5,3,2,0,0,0,26,34,-8,39,44,-5,47,52,-5,5,6,0,0
"20503","T.B","MTL",2008020705,14271,20082009,1,60,5,3,2,0,0,0,24,34,-10,31,41,-10,38,54,-16,9,6,0,0
"20504","T.B","CAR",2008020717,14273,20082009,0,60,2,3,-1,0,0,0,29,31,-2,38,46,-8,52,57,-5,4,5,0,0
"20505","T.B","PHI",2008020727,14274,20082009,1,60,1,6,-5,0,0,0,42,32,10,54,41,13,68,50,18,12,8,0,0
"20506","T.B","NYI",2008020749,14278,20082009,0,60,1,3,-2,0,0,0,30,27,3,43,41,2,54,51,3,7,6,0,0
"20507","T.B","PIT",2008020761,14279,20082009,0,64.7333333333333,3,4,-1,0,0,0,24,35,-11,33,48,-15,44,60,-16,2,7,0,0
"20508","T.B","NYI",2008020785,14282,20082009,1,60,1,0,1,0,0,0,28,28,0,44,31,13,59,41,18,4,4,0,0
"20509","T.B","ATL",2008020798,14285,20082009,1,60,1,3,-2,0,0,0,41,24,17,53,35,18,64,51,13,5,3,0,0
"20510","T.B","TOR",2008020813,14287,20082009,1,60,6,4,2,0,0,0,31,25,6,44,38,6,51,51,0,4,2,0,0
"20511","T.B","WSH",2008020829,14289,20082009,1,60,1,5,-4,0,0,0,32,32,0,42,53,-11,54,66,-12,3,4,0,0
"20512","T.B","CHI",2008020849,14292,20082009,1,60,3,5,-2,0,0,0,23,49,-26,28,59,-31,34,73,-39,6,6,0,0
"20513","T.B","N.J",2008020864,14294,20082009,1,65,2,2,0,0,0,0,41,40,1,54,47,7,70,70,0,4,4,0,0
"20514","T.B","CAR",2008020872,14295,20082009,0,60,1,4,-3,0,0,0,13,41,-28,26,56,-30,37,73,-36,3,6,0,0
"20515","T.B","BOS",2008020889,14297,20082009,1,60,4,3,1,0,0,0,18,43,-25,30,60,-30,38,80,-42,6,5,0,0
"20516","T.B","EDM",2008020903,14299,20082009,0,60,3,5,-2,0,0,0,29,45,-16,33,57,-24,45,73,-28,5,8,0,0
"20517","T.B","VAN",2008020922,14302,20082009,0,60,1,2,-1,0,0,0,21,25,-4,32,35,-3,48,54,-6,2,5,0,0
"20518","T.B","CGY",2008020938,14304,20082009,0,60,8,6,2,0,0,0,32,39,-7,44,54,-10,58,65,-7,4,3,0,0
"20519","T.B","PIT",2008020947,14306,20082009,1,60,1,3,-2,0,0,0,33,33,0,50,44,6,60,55,5,2,4,0,0
"20520","T.B","STL",2008020967,14309,20082009,1,60.45,3,4,-1,0,0,0,23,36,-13,33,54,-21,42,63,-21,4,5,0,0
"20521","T.B","CAR",2008020977,14310,20082009,1,60,3,9,-6,0,0,0,25,37,-12,40,43,-3,59,57,2,5,6,0,0
"20522","T.B","OTT",2008021000,14314,20082009,0,62.6333333333333,2,3,-1,0,0,0,24,27,-3,31,36,-5,41,53,-12,7,8,0,0
"20523","T.B","TOR",2008021008,14315,20082009,0,60,4,1,3,0,0,0,30,21,9,46,37,9,55,52,3,4,3,0,0
"20524","T.B","FLA",2008021026,14317,20082009,0,65,3,3,0,0,0,0,27,37,-10,37,48,-11,51,62,-11,4,3,0,0
"20525","T.B","TOR",2008021044,14320,20082009,1,65,3,3,0,0,0,0,22,39,-17,36,51,-15,50,66,-16,6,5,0,0
"20526","T.B","WSH",2008021057,14322,20082009,1,60,2,5,-3,0,0,0,28,30,-2,41,43,-2,51,49,2,5,5,0,0
"20527","T.B","ATL",2008021076,14324,20082009,1,65,3,3,0,0,0,0,29,36,-7,43,44,-1,61,58,3,7,8,0,0
"20528","T.B","CBJ",2008021091,14327,20082009,1,63.0666666666667,2,1,1,0,0,0,17,34,-17,24,44,-20,41,52,-11,1,3,0,0
"20529","T.B","MTL",2008021105,14329,20082009,0,61.75,2,3,-1,0,0,0,19,36,-17,25,56,-31,34,90,-56,2,9,0,0
"20530","T.B","WSH",2008021110,14330,20082009,0,60,3,5,-2,0,0,0,36,39,-3,42,50,-8,49,68,-19,5,10,0,0
"20531","T.B","OTT",2008021129,14332,20082009,1,60,0,3,-3,0,0,0,20,30,-10,28,39,-11,45,52,-7,5,6,0,0
"20532","T.B","BOS",2008021137,14334,20082009,0,60,1,3,-2,0,0,0,25,39,-14,29,49,-20,41,53,-12,6,7,0,0
"20533","T.B","N.J",2008021158,14337,20082009,0,61.35,4,5,-1,0,0,0,22,39,-17,28,48,-20,35,66,-31,3,5,0,0
"20534","T.B","NYI",2008021168,14338,20082009,0,60,1,3,-2,0,0,0,30,21,9,37,31,6,56,41,15,4,6,0,0
"20535","T.B","PIT",2008021190,14341,20082009,1,60,4,6,-2,0,0,0,37,31,6,46,41,5,57,49,8,7,5,0,0
"20536","T.B","WSH",2008021205,14343,20082009,1,60,2,4,-2,0,0,0,24,33,-9,32,44,-12,44,63,-19,5,5,0,0
"20537","T.B","ATL",2008021222,14345,20082009,0,60,2,6,-4,0,0,0,35,26,9,45,43,2,52,62,-10,5,7,0,0
"20538","T.B","ATL",2009020016,14520,20092010,0,60,3,6,-3,0,0,0,39,28,11,50,41,9,64,48,16,7,8,0,0
"20539","T.B","CAR",2009020028,14523,20092010,0,65,1,1,0,0,0,0,30,28,2,44,36,8,55,52,3,8,5,0,0
"20540","T.B","N.J",2009020040,14525,20092010,1,65,3,3,0,0,0,0,44,34,10,58,49,9,72,63,9,4,2,0,0
"20541","T.B","CAR",2009020055,14527,20092010,1,60,5,2,3,0,0,0,39,26,13,48,41,7,64,55,9,7,6,0,0
"20542","T.B","FLA",2009020069,14529,20092010,1,60,3,2,1,0,0,0,31,33,-2,42,44,-2,56,53,3,6,5,0,0
"20543","T.B","OTT",2009020083,14532,20092010,0,60,1,7,-6,0,0,0,17,35,-18,33,46,-13,47,60,-13,8,8,0,0
"20544","T.B","PIT",2009020101,14534,20092010,0,60,1,4,-3,0,0,0,23,33,-10,31,48,-17,50,59,-9,7,7,0,0
"20545","T.B","S.J",2009020123,14539,20092010,1,60,5,2,3,0,0,0,25,34,-9,35,40,-5,40,52,-12,1,3,0,0
"20546","T.B","BUF",2009020137,14541,20092010,1,65,2,2,0,0,0,0,26,32,-6,38,40,-2,46,57,-11,3,4,0,0
"20547","T.B","OTT",2009020167,14546,20092010,1,60,5,2,3,0,0,0,27,23,4,36,32,4,45,42,3,8,5,0,0
"20548","T.B","N.J",2009020183,14548,20092010,1,65,1,1,0,0,0,0,19,38,-19,30,48,-18,43,59,-16,3,4,0,0
"20549","T.B","PHI",2009020196,14550,20092010,0,60,2,6,-4,0,0,0,28,31,-3,35,42,-7,46,54,-8,4,6,0,0
"20550","T.B","TOR",2009020199,14551,20092010,0,62.35,2,1,1,0,0,0,32,41,-9,40,57,-17,54,81,-27,5,9,0,0
"20551","T.B","OTT",2009020211,14553,20092010,0,64.2833333333333,2,3,-1,0,0,0,20,29,-9,29,43,-14,43,61,-18,7,6,0,0
"20552","T.B","MTL",2009020228,14555,20092010,0,60,3,1,2,0,0,0,21,37,-16,30,55,-25,40,75,-35,4,2,0,0
"20553","T.B","MIN",2009020257,14560,20092010,1,65,3,3,0,0,0,0,22,34,-12,32,44,-12,41,55,-14,5,5,0,0
"20554","T.B","L.A",2009020275,14562,20092010,1,65,1,1,0,0,0,0,29,30,-1,36,41,-5,48,59,-11,7,6,0,0
"20555","T.B","ARI",2009020288,14564,20092010,0,60,4,1,3,0,0,0,19,31,-12,27,38,-11,38,51,-13,4,3,0,0
"20556","T.B","ANA",2009020306,14567,20092010,0,60.8666666666667,3,4,-1,0,0,0,24,27,-3,31,37,-6,41,49,-8,4,6,0,0
"20557","T.B","CAR",2009020318,14569,20092010,0,60,1,3,-2,0,0,0,21,27,-6,33,43,-10,50,54,-4,4,5,0,0
"20558","T.B","ATL",2009020326,14570,20092010,0,62.9333333333333,4,3,1,0,0,0,40,31,9,53,37,16,64,45,19,7,5,0,0
"20559","T.B","TOR",2009020342,14573,20092010,1,60,3,4,-1,0,0,0,31,35,-4,40,46,-6,55,56,-1,3,3,0,0
"20560","T.B","NYR",2009020361,14575,20092010,1,60,5,1,4,0,0,0,31,27,4,37,39,-2,51,57,-6,6,6,0,0
"20561","T.B","DAL",2009020376,14576,20092010,0,62.2,3,4,-1,0,0,0,28,38,-10,36,49,-13,43,58,-15,4,7,0,0
"20562","T.B","COL",2009020387,14578,20092010,1,60,0,3,-3,0,0,0,33,29,4,51,38,13,67,44,23,7,5,0,0
"20563","T.B","BOS",2009020394,14580,20092010,0,60,1,4,-3,0,0,0,40,39,1,46,48,-2,55,55,0,6,3,0,0
"20564","T.B","N.J",2009020409,14582,20092010,0,60,2,3,-1,0,0,0,24,19,5,33,33,0,41,42,-1,4,4,0,0
"20565","T.B","NYI",2009020423,14583,20092010,1,60,4,0,4,0,0,0,25,30,-5,38,40,-2,51,58,-7,4,7,0,0
"20566","T.B","WSH",2009020433,14585,20092010,1,60,0,3,-3,0,0,0,26,34,-8,36,45,-9,51,51,0,6,8,0,0
"20567","T.B","EDM",2009020446,14587,20092010,1,60,2,3,-1,0,0,0,34,32,2,44,41,3,59,51,8,5,5,0,0
"20568","T.B","COL",2009020463,14589,20092010,0,65,1,1,0,0,0,0,22,34,-12,30,49,-19,38,60,-22,1,3,0,0
"20569","T.B","CHI",2009020478,14591,20092010,0,60,0,4,-4,0,0,0,18,29,-11,25,38,-13,34,53,-19,6,8,0,0
"20570","T.B","NSH",2009020490,14593,20092010,0,60,4,7,-3,0,0,0,34,27,7,47,38,9,57,54,3,4,3,0,0
"20571","T.B","DET",2009020507,14595,20092010,0,60,0,3,-3,0,0,0,30,22,8,47,29,18,58,36,22,6,3,0,0
"20572","T.B","STL",2009020514,14596,20092010,0,60,6,3,3,0,0,0,24,26,-2,33,44,-11,43,54,-11,5,7,0,0
"20573","T.B","NYI",2009020532,14599,20092010,0,60,4,2,2,0,0,0,28,38,-10,40,51,-11,52,67,-15,4,6,0,0
"20574","T.B","PHI",2009020552,14601,20092010,1,60,2,5,-3,0,0,0,33,36,-3,53,44,9,66,59,7,5,5,0,0
"20575","T.B","ATL",2009020563,14604,20092010,1,60,4,3,1,0,0,0,34,27,7,42,39,3,55,58,-3,4,6,0,0
"20576","T.B","BOS",2009020580,14606,20092010,1,60,2,1,1,0,0,0,39,32,7,49,42,7,55,55,0,7,4,0,0
"20577","T.B","MTL",2009020593,14608,20092010,1,63.5333333333333,1,2,-1,0,0,0,35,35,0,48,49,-1,61,65,-4,3,4,0,0
"20578","T.B","PIT",2009020613,14611,20092010,1,60,3,1,2,0,0,0,37,26,11,49,40,9,61,52,9,5,5,0,0
"20579","T.B","BUF",2009020639,14615,20092010,0,60,3,5,-2,0,0,0,39,35,4,49,44,5,61,58,3,4,4,0,0
"20580","T.B","N.J",2009020655,14617,20092010,0,60,4,2,2,0,0,0,14,35,-21,21,41,-20,28,54,-26,5,4,0,0
"20581","T.B","PHI",2009020665,14618,20092010,0,60,1,4,-3,0,0,0,18,31,-13,28,41,-13,42,48,-6,5,5,0,0
"20582","T.B","WSH",2009020685,14621,20092010,1,60,7,4,3,0,0,0,36,36,0,52,51,1,61,65,-4,10,6,0,0
"20583","T.B","FLA",2009020697,14623,20092010,1,60,2,3,-1,0,0,0,30,29,1,38,41,-3,52,51,1,3,4,0,0
"20584","T.B","FLA",2009020714,14625,20092010,0,60,2,5,-3,0,0,0,49,23,26,66,38,28,85,47,38,4,3,0,0
"20585","T.B","CAR",2009020725,14627,20092010,0,60,3,2,1,0,0,0,32,22,10,47,35,12,64,51,13,2,4,0,0
"20586","T.B","NYR",2009020733,14628,20092010,0,60,2,8,-6,0,0,0,23,31,-8,29,41,-12,35,59,-24,5,4,0,0
"20587","T.B","TOR",2009020749,14630,20092010,1,64.8333333333333,3,2,1,0,0,0,32,22,10,42,32,10,58,47,11,9,8,0,0
"20588","T.B","ATL",2009020767,14632,20092010,1,65,1,1,0,0,0,0,26,38,-12,36,60,-24,45,74,-29,6,8,0,0
"20589","T.B","MTL",2009020789,14636,20092010,1,60,3,0,3,0,0,0,30,33,-3,45,48,-3,53,57,-4,5,5,0,0
"20590","T.B","ANA",2009020804,14638,20092010,1,65,1,1,0,0,0,0,31,32,-1,43,47,-4,52,69,-17,5,5,0,0
"20591","T.B","WSH",2009020818,14640,20092010,0,60,2,3,-1,0,0,0,27,31,-4,36,42,-6,41,66,-25,2,3,0,0
"20592","T.B","ATL",2009020829,14642,20092010,0,60,2,1,1,0,0,0,24,27,-3,35,37,-2,45,59,-14,4,4,0,0
"20593","T.B","NYI",2009020845,14644,20092010,1,60,5,2,3,0,0,0,31,36,-5,37,50,-13,45,61,-16,3,4,0,0
"20594","T.B","CGY",2009020863,14646,20092010,1,61.9666666666667,2,1,1,0,0,0,23,26,-3,36,36,0,46,52,-6,6,5,0,0
"20595","T.B","VAN",2009020880,14649,20092010,1,60,3,1,2,0,0,0,19,40,-21,29,57,-28,36,74,-38,5,5,0,0
"20596","T.B","BOS",2009020893,14651,20092010,1,60,4,5,-1,0,0,0,35,36,-1,43,48,-5,54,65,-11,8,6,0,0
"20597","T.B","NYI",2009020905,14653,20092010,0,60,4,5,-1,0,0,0,42,33,9,50,43,7,64,51,13,5,4,0,0
"20598","T.B","NYR",2009020916,14654,20092010,0,60,2,5,-3,0,0,0,29,23,6,40,38,2,55,46,9,5,6,0,0
"20599","T.B","PHI",2009020930,14670,20092010,1,60,2,7,-5,0,0,0,38,34,4,48,40,8,60,54,6,7,9,0,0
"20600","T.B","WSH",2009020943,14672,20092010,0,60,4,5,-1,0,0,0,29,34,-5,43,44,-1,65,67,-2,6,4,0,0
"20601","T.B","ATL",2009020960,14674,20092010,1,60,6,2,4,0,0,0,30,31,-1,39,40,-1,49,56,-7,6,7,0,0
"20602","T.B","MTL",2009020979,14677,20092010,0,60,3,5,-2,0,0,0,31,28,3,46,35,11,67,45,22,4,2,0,0
"20603","T.B","TOR",2009020990,14679,20092010,0,63.55,3,4,-1,0,0,0,33,38,-5,49,55,-6,61,79,-18,3,3,0,0
"20604","T.B","WSH",2009021001,14680,20092010,0,60,3,2,1,0,0,0,27,30,-3,38,50,-12,48,70,-22,1,4,0,0
"20605","T.B","PIT",2009021020,14682,20092010,1,60,1,2,-1,0,0,0,22,39,-17,28,53,-25,35,69,-34,5,7,0,0
"20606","T.B","ARI",2009021032,14684,20092010,1,60,1,2,-1,0,0,0,28,28,0,41,35,6,51,46,5,4,3,0,0
"20607","T.B","BUF",2009021047,14686,20092010,1,60,2,6,-4,0,0,0,25,28,-3,36,37,-1,52,49,3,5,7,0,0
"20608","T.B","WSH",2009021063,14688,20092010,1,60,1,3,-2,0,0,0,34,28,6,47,39,8,58,47,11,6,5,0,0
"20609","T.B","FLA",2009021071,14689,20092010,0,60,2,5,-3,0,0,0,31,40,-9,42,45,-3,59,56,3,2,5,0,0
"20610","T.B","CAR",2009021084,14691,20092010,1,60.4833333333333,3,2,1,0,0,0,27,29,-2,45,41,4,70,56,14,3,0,0,0
"20611","T.B","BOS",2009021096,14693,20092010,0,60,5,3,2,0,0,0,18,50,-32,28,56,-28,32,69,-37,4,4,0,0
"20612","T.B","BUF",2009021112,14695,20092010,0,60,1,7,-6,0,0,0,23,26,-3,33,39,-6,45,53,-8,2,1,0,0
"20613","T.B","CBJ",2009021137,14698,20092010,0,60,2,3,-1,0,0,0,18,25,-7,26,33,-7,34,49,-15,4,6,0,0
"20614","T.B","PIT",2009021144,14699,20092010,0,60,2,0,2,0,0,0,17,27,-10,27,43,-16,33,64,-31,6,5,0,0
"20615","T.B","NYR",2009021159,14701,20092010,1,60,0,5,-5,0,0,0,30,22,8,45,29,16,54,37,17,4,3,0,0
"20616","T.B","CAR",2009021187,14705,20092010,1,60,5,8,-3,0,0,0,37,41,-4,53,49,4,68,62,6,3,4,0,0
"20617","T.B","OTT",2009021201,14707,20092010,1,65,3,3,0,0,0,0,29,38,-9,42,55,-13,52,68,-16,8,12,0,0
"20618","T.B","FLA",2009021218,14709,20092010,1,65,3,3,0,0,0,0,37,32,5,47,42,5,73,53,20,5,6,0,0
"20619","T.B","FLA",2009021229,14710,20092010,0,60,3,1,2,0,0,0,31,31,0,39,40,-1,49,50,-1,5,3,0,0
"20620","T.B","ATL",2010020018,14891,20102011,1,60,5,3,2,3.22710924497187,5.76435802354422,-2.53724877857235,36,30,6,44,51,-7,61,63,-2,6,7,0,0
"20621","T.B","MTL",2010020038,14895,20102011,0,64.15,4,3,1,6.18574050187478,3.59471889666218,2.5910216052126,48,27,21,68,41,27,85,55,30,6,5,0,0
"20622","T.B","PHI",2010020042,14896,20102011,0,60,3,2,1,5.50129675188509,4.45825861583262,1.04303813605247,24,26,-2,37,40,-3,53,59,-6,6,4,0,0
"20623","T.B","FLA",2010020059,14898,20102011,0,60,0,6,-6,3.18596633808469,3.3699810031394,-0.184014665054715,29,38,-9,48,45,3,58,58,0,2,4,0,0
"20624","T.B","DAL",2010020072,14900,20102011,1,60,5,4,1,3.1608460706193,2.20194305499535,0.958903015623946,44,19,25,54,26,28,68,45,23,5,5,0,0
"20625","T.B","NYI",2010020087,14903,20102011,1,61.9333333333333,2,3,-1,3.42104747143821,2.23577612376539,1.18527134767282,30,25,5,41,40,1,58,45,13,4,5,0,0
"20626","T.B","ATL",2010020095,14904,20102011,0,60,5,2,3,7.11799747503903,2.85949180234275,4.25850567269629,33,30,3,41,36,5,46,56,-10,8,9,0,0
"20627","T.B","NSH",2010020111,14906,20102011,1,60,3,4,-1,5.76898461846577,3.95414725023471,1.81483736823105,45,26,19,60,30,30,73,41,32,5,2,0,0
"20628","T.B","PIT",2010020126,14909,20102011,1,60,5,3,2,5.59541586072737,5.32514579382723,0.270270066900139,31,31,0,45,39,6,55,59,-4,9,6,0,0
"20629","T.B","ARI",2010020153,14912,20102011,0,60,3,0,3,3.69725853273667,1.73018371651415,1.96707481622252,23,23,0,35,34,1,44,53,-9,4,5,0,0
"20630","T.B","ANA",2010020172,14916,20102011,0,62.8833333333333,2,3,-1,5.29149787833376,5.17246664711274,0.119031231221015,34,30,4,44,43,1,55,57,-2,3,5,0,0
"20631","T.B","L.A",2010020178,14917,20102011,0,60,0,1,-1,3.42431690282219,2.15675237744586,1.26756452537633,24,26,-2,38,34,4,51,47,4,3,3,0,0
"20632","T.B","S.J",2010020198,14919,20102011,0,60,2,5,-3,3.46987686873035,4.14347765080993,-0.673600782079575,35,39,-4,46,57,-11,58,69,-11,4,6,0,0
"20633","T.B","TOR",2010020208,14922,20102011,1,60,4,0,4,2.40057219723167,2.12726382620167,0.273308371029998,25,28,-3,35,38,-3,51,60,-9,2,5,0,0
"20634","T.B","WSH",2010020219,14924,20102011,0,60,3,6,-3,3.14234808087349,3.77229318627795,-0.629945105404458,41,26,15,53,34,19,70,47,23,4,1,0,0
"20635","T.B","PIT",2010020228,14925,20102011,0,60,1,5,-4,3.16653554560617,3.7003716876352,-0.533836142029031,16,20,-4,25,31,-6,38,45,-7,7,5,0,0
"20636","T.B","MIN",2010020246,14927,20102011,1,60,1,4,-3,4.32185681325361,3.39301074540759,0.928846067846016,38,18,20,57,27,30,73,36,37,4,4,0,0
"20637","T.B","NYI",2010020257,14930,20102011,0,60,4,2,2,3.92364117652585,5.70749811240799,-1.78385693588214,40,36,4,50,45,5,61,66,-5,5,3,0,0
"20638","T.B","PHI",2010020271,14931,20102011,0,60,8,7,1,6.62530524726026,4.01468907556372,2.61061617169654,33,32,1,39,45,-6,52,69,-17,8,5,0,0
"20639","T.B","BUF",2010020284,14933,20102011,0,60,2,1,1,1.70500006206566,4.67391561926901,-2.96891555720335,22,30,-8,28,38,-10,42,49,-7,4,3,0,0
"20640","T.B","BOS",2010020304,14935,20102011,1,60,3,1,2,4.22747266027727,5.26589098157032,-1.03841832129305,36,27,9,50,41,9,59,54,5,3,2,0,0
"20641","T.B","NYR",2010020314,14937,20102011,1,60,5,3,2,3.9466455715301,2.65931723621645,1.28732833531365,34,20,14,43,27,16,54,45,9,8,6,0,0
"20642","T.B","WSH",2010020327,14939,20102011,0,60,0,6,-6,1.8869991938991,3.84001364175732,-1.95301444785822,17,29,-12,30,40,-10,49,58,-9,5,4,0,0
"20643","T.B","FLA",2010020338,14940,20102011,1,65,3,3,0,6.43382976393332,3.65809531183913,2.77573445209418,37,27,10,57,39,18,73,59,14,7,5,0,0
"20644","T.B","TOR",2010020353,14943,20102011,0,61.25,4,3,1,5.81744404471829,2.02562005742206,3.79182398729622,39,25,14,52,35,17,69,47,22,5,4,0,0
"20645","T.B","BOS",2010020365,14945,20102011,0,60,1,8,-7,5.67741438536905,5.78452393301995,-0.107109547650907,38,32,6,49,41,8,63,51,12,1,4,0,0
"20646","T.B","COL",2010020385,14947,20102011,1,60,6,5,1,3.61838784911379,2.54532568151626,1.07306216759753,39,24,15,48,33,15,67,45,22,6,4,0,0
"20647","T.B","CGY",2010020404,14950,20102011,0,60,2,4,-2,2.92481042845712,2.73691951433728,0.187890914119843,24,19,5,41,31,10,54,40,14,2,4,0,0
"20648","T.B","EDM",2010020423,14953,20102011,0,65,3,3,0,4.32693381351419,4.21661376535485,0.110320048159338,41,23,18,59,29,30,87,45,42,5,3,0,0
"20649","T.B","VAN",2010020435,14954,20102011,0,60.5666666666667,5,4,1,2.51584887894569,3.3287690429447,-0.81292016399901,23,27,-4,29,40,-11,41,56,-15,3,4,0,0
"20650","T.B","ATL",2010020455,14958,20102011,1,65,1,1,0,4.93816081703665,2.24391849689073,2.69424232014592,31,28,3,48,41,7,65,55,10,2,5,0,0
"20651","T.B","BUF",2010020479,14961,20102011,1,60,3,1,2,6.61621606146514,2.14634539105276,4.46987067041238,37,23,14,47,33,14,57,50,7,5,5,0,0
"20652","T.B","CAR",2010020492,14963,20102011,1,60,5,1,4,5.96289786421703,3.66706135039567,2.29583651382136,34,22,12,47,35,12,60,58,2,5,6,0,0
"20653","T.B","NYI",2010020502,14965,20102011,0,63.3833333333333,1,2,-1,2.88405321547179,6.09584679435033,-3.21179357887853,35,28,7,46,47,-1,64,60,4,6,2,0,0
"20654","T.B","NYR",2010020509,14966,20102011,0,65,3,3,0,3.06906079815235,5.56097449006484,-2.49191369191249,24,37,-13,37,56,-19,52,74,-22,1,1,0,0
"20655","T.B","ATL",2010020523,14969,20102011,0,61.2166666666667,3,2,1,4.62191654169328,3.2698958545756,1.35202068711768,34,28,6,44,34,10,58,53,5,5,3,0,0
"20656","T.B","BOS",2010020539,14971,20102011,1,60,3,4,-1,5.82279927726631,4.65641599682976,1.16638328043655,34,29,5,48,38,10,63,55,8,7,8,0,0
"20657","T.B","MTL",2010020553,14973,20102011,1,60,4,1,3,4.15924221077148,5.30799528790672,-1.14875307713524,23,28,-5,35,39,-4,48,59,-11,7,5,0,0
"20658","T.B","NYR",2010020570,14975,20102011,1,60.3166666666667,2,1,1,3.94584232544429,3.46389943722647,0.481942888217816,33,35,-2,41,44,-3,54,61,-7,3,2,0,0
"20659","T.B","WSH",2010020587,14978,20102011,0,62.9,1,0,1,4.984237227319,5.07055372995092,-0.0863165026319166,38,34,4,49,48,1,59,65,-6,3,3,0,0
"20660","T.B","PIT",2010020592,14979,20102011,0,60,1,8,-7,5.78291706706477,4.48795450653415,1.29496256053062,32,41,-9,41,51,-10,56,72,-16,6,7,0,0
"20661","T.B","OTT",2010020615,14982,20102011,0,60,2,1,1,7.67221096743738,5.42447071534116,2.24774025209622,27,32,-5,43,44,-1,52,59,-7,6,4,0,0
"20662","T.B","N.J",2010020624,14983,20102011,0,60,3,6,-3,5.17548807591129,6.5183494302624,-1.34286135435111,36,26,10,41,41,0,48,45,3,3,4,0,0
"20663","T.B","WSH",2010020643,14986,20102011,1,60,3,0,3,4.36245300175506,4.53045945306076,-0.1680064513057,38,23,15,57,32,25,68,47,21,8,4,0,0
"20664","T.B","N.J",2010020658,14988,20102011,1,60,2,5,-3,4.65898824330975,4.56413699680999,0.094851246499756,32,25,7,35,35,0,51,49,2,3,1,0,0
"20665","T.B","CAR",2010020664,14989,20102011,0,60,4,6,-2,6.0004190452164,5.20830787541229,0.792111169804116,34,31,3,60,43,17,80,58,22,5,6,0,0
"20666","T.B","CBJ",2010020688,14992,20102011,1,65,2,2,0,6.49958749493817,3.16919429882546,3.33039319611271,22,30,-8,37,45,-8,52,63,-11,4,4,0,0
"20667","T.B","ATL",2010020702,14994,20102011,0,65,2,2,0,0,0,0,31,29,2,40,35,5,50,47,3,3,3,0,0
"20668","T.B","FLA",2010020710,14995,20102011,0,65,1,1,0,2.97973219181711,4.42125433788169,-1.44152214606459,21,30,-9,34,53,-19,53,67,-14,3,7,0,0
"20669","T.B","ATL",2010020726,14997,20102011,1,60,7,1,6,5.5163555659783,3.63357167822662,1.88278388775168,39,22,17,54,33,21,70,43,27,3,3,0,0
"20670","T.B","TOR",2010020739,14999,20102011,1,60,2,0,2,5.50022776634432,4.84444408616657,0.65578368017775,31,26,5,39,37,2,59,57,2,6,3,0,0
"20671","T.B","PHI",2010020758,15006,20102011,1,60,4,0,4,3.84923541408513,4.31478433170416,-0.465548917619026,22,38,-16,32,51,-19,43,67,-24,2,4,0,0
"20672","T.B","WSH",2010020779,15009,20102011,1,60,2,5,-3,2.93080479477067,4.26213364401656,-1.33132884924589,25,36,-11,37,50,-13,50,64,-14,5,5,0,0
"20673","T.B","STL",2010020795,15011,20102011,1,64.8833333333333,4,3,1,4.52073375728833,5.50760848023921,-0.986874722950887,40,32,8,53,49,4,65,65,0,5,4,0,0
"20674","T.B","BUF",2010020806,15013,20102011,1,60,4,7,-3,3.70031237637208,4.23990192629972,-0.539589549927645,34,28,6,50,33,17,68,49,19,8,8,0,0
"20675","T.B","CAR",2010020832,15017,20102011,1,61.5333333333333,4,3,1,5.447345308683,3.38459569876971,2.06274960991329,41,34,7,50,47,3,64,67,-3,7,8,0,0
"20676","T.B","PHI",2010020851,15020,20102011,1,65,3,3,0,2.37435546184133,2.99295836015334,-0.618602898312009,27,29,-2,37,42,-5,54,56,-2,5,5,0,0
"20677","T.B","DET",2010020865,15022,20102011,1,60,2,6,-4,7.61665218527196,3.11207758460695,4.50457460066501,40,31,9,53,43,10,66,54,12,4,3,0,0
"20678","T.B","FLA",2010020881,15024,20102011,1,65,2,2,0,6.92533118814754,4.86753025353892,2.05780093460862,36,26,10,57,38,19,69,54,15,6,3,0,0
"20679","T.B","ARI",2010020905,15028,20102011,1,60,8,3,5,4.54958662416902,3.54860789026134,1.00097873390769,39,28,11,55,43,12,66,59,7,5,3,0,0
"20680","T.B","N.J",2010020920,15030,20102011,1,60,2,1,1,3.03233529336285,3.08225511343335,-0.0499198200704996,30,20,10,39,29,10,53,43,10,2,1,0,0
"20681","T.B","NYR",2010020932,15032,20102011,0,60,2,1,1,3.13461889354949,2.5264938840279,0.608125009521586,19,23,-4,26,34,-8,35,49,-14,6,4,0,0
"20682","T.B","N.J",2010020953,15035,20102011,0,60,1,2,-1,3.07472513748507,3.27674408658339,-0.202018949098317,16,27,-11,18,35,-17,25,42,-17,2,2,0,0
"20683","T.B","BOS",2010020957,15036,20102011,0,60,1,2,-1,5.12842102418654,3.83171255359593,1.2967084705906,28,28,0,35,37,-2,49,44,5,4,3,0,0
"20684","T.B","MTL",2010020979,15038,20102011,1,60,2,4,-2,4.94862532237312,2.28278261936444,2.66584270300868,45,23,22,57,37,20,81,51,30,6,4,0,0
"20685","T.B","WSH",2010020989,15040,20102011,1,65,1,1,0,4.4911855548271,6.21509256062564,-1.72390700579854,28,30,-2,39,44,-5,53,69,-16,5,4,0,0
"20686","T.B","CHI",2010021005,15042,20102011,1,65,3,3,0,3.60986038496048,6.65626310944208,-3.0464027244816,30,31,-1,41,40,1,49,50,-1,2,1,0,0
"20687","T.B","OTT",2010021020,15044,20102011,1,60,1,2,-1,3.76044023829309,3.17072099350116,0.589719244791922,35,22,13,47,32,15,71,45,26,5,6,0,0
"20688","T.B","FLA",2010021028,15045,20102011,0,64.7333333333333,3,4,-1,5.8180750813172,4.01068769651465,1.80738738480255,38,27,11,57,32,25,70,40,30,7,4,0,0
"20689","T.B","TOR",2010021038,15047,20102011,0,60,6,2,4,5.65746443592796,5.73309533606516,-0.075630900137206,36,32,4,50,46,4,65,60,5,2,5,0,0
"20690","T.B","MTL",2010021057,15050,20102011,0,65,2,2,0,7.10345332763973,5.15444953656697,1.94900379107276,37,29,8,54,41,13,82,60,22,5,2,0,0
"20691","T.B","OTT",2010021073,15052,20102011,0,63.4666666666667,2,3,-1,7.09474126383429,6.55468823069441,0.540053033139884,37,34,3,50,47,3,64,70,-6,3,2,0,0
"20692","T.B","NYI",2010021093,15055,20102011,1,60,2,5,-3,4.12525847495999,4.39746667317789,-0.2722081982179,38,28,10,50,34,16,72,44,28,8,6,0,0
"20693","T.B","CAR",2010021115,15058,20102011,1,60,3,4,-1,3.76082511879304,2.40738049306104,1.353444625732,21,39,-18,34,50,-16,47,65,-18,6,7,0,0
"20694","T.B","CAR",2010021121,15059,20102011,0,60,4,2,2,8.09347330058517,4.71804828060869,3.37542501997648,32,35,-3,41,43,-2,51,67,-16,4,5,0,0
"20695","T.B","OTT",2010021140,15062,20102011,1,60,5,2,3,5.00430486040489,5.32279796496791,-0.318493104563025,31,33,-2,45,51,-6,51,62,-11,4,2,0,0
"20696","T.B","PIT",2010021154,15064,20102011,1,60,2,1,1,5.22798653007146,4.84479267991702,0.383193850154443,24,37,-13,35,50,-15,46,72,-26,6,7,0,0
"20697","T.B","MIN",2010021165,15066,20102011,0,60,3,1,2,5.66142197115551,4.17919414424517,1.48222782691033,23,30,-7,33,40,-7,43,53,-10,4,4,0,0
"20698","T.B","CHI",2010021179,15067,20102011,0,60,2,0,2,3.54501036379952,2.319018297443,1.22599206635652,15,31,-16,25,42,-17,33,63,-30,5,4,0,0
"20699","T.B","BUF",2010021184,15069,20102011,0,60,2,4,-2,3.88732074914151,4.83520614863707,-0.947885399495561,25,24,1,35,35,0,46,47,-1,2,3,0,0
"20700","T.B","FLA",2010021209,15072,20102011,1,60,4,2,2,4.20578817939026,4.20810016731275,-0.00231198792249465,34,25,9,45,42,3,59,52,7,5,5,0,0
"20701","T.B","CAR",2010021219,15073,20102011,0,60,6,2,4,7.65238684722863,5.0952278287441,2.55715901848453,35,44,-9,46,61,-15,61,82,-21,1,7,0,0
"20702","T.B","PIT",2010030141,15077,20102011,0,60,0,3,-3,3.16478961036773,6.80355417951193,-3.6387645691442,32,40,-8,45,55,-10,58,77,-19,3,7,0,0
"20703","T.B","PIT",2010030142,15079,20102011,0,60,5,1,4,3.85377672067125,3.65821050677914,0.195566213892107,21,36,-15,27,52,-25,38,66,-28,6,7,0,0
"20704","T.B","PIT",2010030143,15082,20102011,1,60,2,3,-1,4.70232496796234,6.58415702385844,-1.8818320558961,27,30,-3,36,44,-8,52,59,-7,4,2,0,0
"20705","T.B","PIT",2010030144,15084,20102011,1,80,2,2,0,7.18754925753456,7.43238734595521,-0.24483808842065,30,51,-21,54,71,-17,72,93,-21,4,3,0,0
"20706","T.B","PIT",2010030145,15087,20102011,0,60,8,2,6,2.88420481554931,5.85887152534633,-2.97466670979702,25,33,-8,33,45,-12,40,67,-27,7,7,0,0
"20707","T.B","PIT",2010030146,15089,20102011,1,60,4,2,2,4.87224438701571,4.68221896199975,0.190025425015961,21,29,-8,32,38,-6,45,64,-19,4,7,0,0
"20708","T.B","PIT",2010030147,15091,20102011,0,60,1,0,1,5.40796543040778,6.266766350127,-0.858800919719215,23,36,-13,34,57,-23,45,79,-34,3,6,0,0
"20709","T.B","WSH",2010030211,15093,20102011,0,60,4,2,2,0,0,0,24,28,-4,34,38,-4,49,61,-12,4,5,0,0
"20710","T.B","WSH",2010030212,15095,20102011,0,66.3166666666667,3,2,1,2.25331618481351,5.18581953039393,-2.93250334558042,23,37,-14,35,52,-17,56,76,-20,5,6,0,0
"20711","T.B","WSH",2010030213,15097,20102011,1,60,4,3,1,8.33350171762089,2.42230846912093,5.91119324849996,30,32,-2,42,39,3,50,58,-8,4,5,0,0
"20712","T.B","WSH",2010030214,15098,20102011,1,60,5,3,2,4.98963764507789,5.20723234033721,-0.217594695259322,37,36,1,43,56,-13,54,78,-24,5,3,0,0
"20713","T.B","BOS",2010030311,15108,20102011,0,60,5,2,3,7.80809993802046,6.24671643812098,1.56138349989948,34,33,1,45,49,-4,54,66,-12,5,4,0,0
"20714","T.B","BOS",2010030312,15111,20102011,0,60,5,6,-1,5.7126092528341,5.4717962420375,0.240813010796598,41,35,6,52,50,2,64,67,-3,6,8,0,0
"20715","T.B","BOS",2010030313,15113,20102011,1,60,0,2,-2,4.52929120429326,3.40635729125052,1.12293391304274,31,25,6,43,31,12,57,40,17,4,4,0,0
"20716","T.B","BOS",2010030314,15115,20102011,1,60,5,3,2,6.8156519268391,4.09988519057515,2.71576673626395,37,30,7,53,38,15,71,57,14,3,3,0,0
"20717","T.B","BOS",2010030315,15117,20102011,0,60,1,3,-2,4.7667095756995,3.85880289462287,0.907906681076632,34,20,14,42,31,11,54,39,15,5,5,0,0
"20718","T.B","BOS",2010030316,15119,20102011,1,60,5,4,1,0,0,0,26,20,6,39,30,9,50,46,4,5,5,0,0
"20719","T.B","BOS",2010030317,15121,20102011,0,60,0,1,-1,2.03424074337818,6.46460478939116,-4.43036404601298,24,38,-14,30,56,-26,47,73,-26,0,0,0,0
"20720","T.B","CAR",2011020004,15254,20112012,0,60,5,1,4,7.47769303830137,6.56641479863687,0.911278239664497,34,33,1,43,46,-3,60,69,-9,6,5,0,0
"20721","T.B","BOS",2011020010,15255,20112012,0,60,1,4,-3,2.66918622695626,6.38340968784264,-3.71422346088638,26,42,-16,37,63,-26,46,85,-39,8,8,0,0
"20722","T.B","WSH",2011020029,15257,20112012,0,65,5,5,0,4.37022280487508,4.62628715080875,-0.256064345933664,28,43,-15,41,62,-21,54,85,-31,5,7,0,0
"20723","T.B","NYI",2011020038,15260,20112012,0,60,1,5,-4,3.10533569630472,4.79272425926213,-1.6873885629574,35,34,1,46,44,2,61,57,4,4,5,0,0
"20724","T.B","FLA",2011020056,15262,20112012,0,65,2,2,0,4.73680041730404,3.29422401243426,1.44257640486978,30,38,-8,42,54,-12,53,65,-12,4,8,0,0
"20725","T.B","FLA",2011020065,15264,20112012,1,60,4,7,-3,8.26466749063668,5.91331923286683,2.35134825776985,39,33,6,48,48,0,56,60,-4,3,9,0,0
"20726","T.B","NYI",2011020084,15267,20112012,1,60,4,1,3,4.98936091020551,2.23173412507595,2.75762678512956,30,17,13,46,29,17,69,39,30,4,3,0,0
"20727","T.B","BUF",2011020104,15269,20112012,1,60,3,0,3,4.77061306558971,2.88070293262354,1.88991013296618,26,21,5,34,33,1,40,55,-15,2,4,0,0
"20728","T.B","BUF",2011020113,15272,20112012,0,60,4,3,1,4.66897378065914,3.90200676694803,0.76696701371111,23,39,-16,28,47,-19,35,61,-26,4,4,0,0
"20729","T.B","NSH",2011020131,15274,20112012,0,60,3,5,-2,7.00043892976828,1.90717789103655,5.09326103873173,32,27,5,44,36,8,62,46,16,3,4,0,0
"20730","T.B","WPG",2011020146,15276,20112012,1,60,1,0,1,3.38290073424287,5.20557400520568,-1.82267327096281,27,28,-1,39,37,2,52,51,1,4,2,0,0
"20731","T.B","CAR",2011020162,15279,20112012,0,60,2,4,-2,5.39652967296876,3.98030728247249,1.41622239049626,30,31,-1,52,43,9,72,55,17,3,2,0,0
"20732","T.B","CHI",2011020181,15282,20112012,1,64.1,5,4,1,5.55376792698235,3.46357984042264,2.09018808655971,32,32,0,41,46,-5,54,67,-13,1,2,0,0
"20733","T.B","FLA",2011020196,15284,20112012,0,65,3,3,0,3.50684234857908,4.81773716284806,-1.31089481426898,37,41,-4,43,53,-10,52,64,-12,3,2,0,0
"20734","T.B","PHI",2011020212,15287,20112012,1,62.5,2,1,1,5.49909317654874,3.2846016600775,2.21449151647124,24,15,9,44,34,10,59,45,14,7,5,0,0
"20735","T.B","STL",2011020236,15290,20112012,0,60,0,3,-3,2.94651901884936,3.30910167918773,-0.362582660338376,19,24,-5,26,38,-12,35,58,-23,6,5,0,0
"20736","T.B","WPG",2011020246,15292,20112012,0,60,2,5,-3,5.25473287728892,4.76968454005818,0.48504833723074,32,39,-7,44,53,-9,55,57,-2,7,3,0,0
"20737","T.B","PIT",2011020263,15295,20112012,1,60,4,1,3,1.3779753887793,4.15640779986479,-2.77843241108549,18,34,-16,22,50,-28,31,75,-44,7,8,0,0
"20738","T.B","N.J",2011020280,15297,20112012,1,60,2,4,-2,4.41273216620903,2.92589672144669,1.48683544476233,23,24,-1,29,26,3,45,36,9,6,8,0,0
"20739","T.B","TOR",2011020297,15300,20112012,1,60,1,7,-6,4.31704355686088,2.86925441098174,1.44778914587914,28,26,2,42,35,7,55,50,5,8,6,0,0
"20740","T.B","FLA",2011020322,15303,20112012,0,62.4833333333333,2,1,1,3.2865702509489,3.47807170135638,-0.191501450407479,31,24,7,38,38,0,51,49,2,2,4,0,0
"20741","T.B","FLA",2011020332,15304,20112012,1,60,5,1,4,4.75688344493401,3.41899662552169,1.33788681941232,34,25,9,41,36,5,55,51,4,2,6,0,0
"20742","T.B","MIN",2011020341,15306,20112012,0,60,1,3,-2,5.41030314023297,3.6654936382547,1.74480950197826,33,24,9,54,34,20,77,46,31,2,2,0,0
"20743","T.B","DET",2011020354,15308,20112012,0,60,2,4,-2,3.07097548388026,3.69007240883211,-0.619096924951854,23,35,-12,30,43,-13,49,57,-8,4,4,0,0
"20744","T.B","NYR",2011020377,15311,20112012,1,60,2,4,-2,2.81685581442389,5.1583739767666,-2.34151816234271,26,36,-10,33,47,-14,43,56,-13,1,2,0,0
"20745","T.B","OTT",2011020389,15313,20112012,0,60,2,4,-2,4.01908787123466,4.47170041984828,-0.452612548613615,33,31,2,44,45,-1,65,55,10,3,3,0,0
"20746","T.B","NYI",2011020393,15314,20112012,0,60,1,5,-4,2.48148134721907,3.71849432802048,-1.23701298080141,24,34,-10,31,42,-11,48,60,-12,3,5,0,0
"20747","T.B","NYR",2011020408,15316,20112012,0,65,2,2,0,8.51343044212105,2.57500138436851,5.93842905775254,31,30,1,45,39,6,63,62,1,10,12,0,0
"20748","T.B","PHI",2011020425,15318,20112012,0,60,2,5,-3,3.87012756860349,5.75748841448932,-1.88736084588583,19,32,-13,27,41,-14,43,67,-24,4,5,0,0
"20749","T.B","N.J",2011020435,15320,20112012,1,60,4,5,-1,0,0,0,36,22,14,53,31,22,64,42,22,5,3,0,0
"20750","T.B","CGY",2011020455,15323,20112012,1,60.5,5,4,1,4.14975108962972,3.12352532821961,1.0262257614101,34,27,7,41,45,-4,50,63,-13,2,4,0,0
"20751","T.B","CBJ",2011020472,15325,20112012,0,60,3,2,1,0,0,0,28,28,0,38,44,-6,38,56,-18,3,5,0,0
"20752","T.B","S.J",2011020499,15329,20112012,0,60,2,7,-5,3.36649970721919,3.14187699697504,0.224622710244148,24,43,-19,37,57,-20,57,72,-15,4,4,0,0
"20753","T.B","COL",2011020515,15331,20112012,0,63.6333333333333,1,2,-1,3.82622956969135,4.06864843916219,-0.242418869470839,30,29,1,38,43,-5,51,57,-6,3,3,0,0
"20754","T.B","PHI",2011020532,15335,20112012,1,60,5,1,4,2.35937341977842,4.16976723080597,-1.81039381102755,16,32,-16,25,51,-26,32,73,-41,6,5,0,0
"20755","T.B","MTL",2011020545,15337,20112012,1,60,4,3,1,2.75683982839109,5.0018244765257,-2.2449846481346,22,34,-12,28,45,-17,40,69,-29,3,3,0,0
"20756","T.B","CAR",2011020558,15339,20112012,1,60,5,2,3,4.49962546216542,3.70158627898491,0.798039183180514,32,26,6,47,42,5,62,55,7,5,6,0,0
"20757","T.B","TOR",2011020575,15342,20112012,0,60,3,7,-4,3.92668310840418,4.35711954447127,-0.430436436067088,24,42,-18,43,55,-12,62,68,-6,8,9,0,0
"20758","T.B","OTT",2011020588,15344,20112012,0,60,1,4,-3,4.2357263492213,5.99996013590135,-1.76423378668005,36,24,12,56,36,20,74,53,21,3,2,0,0
"20759","T.B","MTL",2011020604,15346,20112012,0,60,1,3,-2,4.42033338127658,5.61583157730547,-1.19549819602889,24,28,-4,33,44,-11,52,60,-8,1,2,0,0
"20760","T.B","VAN",2011020623,15349,20112012,1,65,4,4,0,3.99840677116299,5.07778330220481,-1.07937653104182,31,28,3,47,38,9,61,54,7,3,4,0,0
"20761","T.B","CAR",2011020634,15351,20112012,1,60,2,5,-3,4.98864151474118,3.60571571340552,1.38292580133566,36,32,4,44,43,1,57,60,-3,2,1,0,0
"20762","T.B","WSH",2011020642,15352,20112012,0,60,3,4,-1,6.92046027625324,5.00416669226252,1.91629358399072,31,20,11,49,28,21,64,38,26,6,5,0,0
"20763","T.B","BOS",2011020677,15356,20112012,1,60,5,3,2,4.16869982372737,5.10205973674778,-0.933359913020413,31,29,2,41,41,0,55,58,-3,5,4,0,0
"20764","T.B","DAL",2011020698,15359,20112012,0,60,2,1,1,3.9457680139385,3.03959269501502,0.906175318923488,22,28,-6,37,41,-4,54,52,2,3,4,0,0
"20765","T.B","ARI",2011020709,15360,20112012,0,60,4,3,1,1.2123599170518,3.56809595888444,-2.35573604183264,21,36,-15,26,54,-28,36,74,-38,2,4,0,0
"20766","T.B","CBJ",2011020726,15363,20112012,1,60,4,2,2,4.38064608478453,3.42154982856545,0.959096256219084,31,24,7,41,40,1,53,54,-1,4,2,0,0
"20767","T.B","WSH",2011020742,15370,20112012,1,62.75,4,3,1,6.59950850206224,3.55125257413602,3.04825592792622,31,30,1,39,38,1,54,52,2,1,2,0,0
"20768","T.B","WPG",2011020757,15372,20112012,1,63.2333333333333,1,2,-1,6.3934138100373,2.29077583459773,4.10263797543957,31,24,7,41,34,7,57,51,6,3,3,0,0
"20769","T.B","FLA",2011020774,15374,20112012,1,60,6,3,3,4.27847850284888,3.02346884731014,1.25500965553874,34,20,14,42,33,9,54,55,-1,3,3,0,0
"20770","T.B","L.A",2011020792,15377,20112012,1,60,1,3,-2,3.00983632646967,2.00203091394366,1.00780541252601,25,20,5,42,33,9,56,45,11,3,2,0,0
"20771","T.B","NYR",2011020803,15379,20112012,0,62.6166666666667,3,4,-1,1.80668165256156,2.7075130858866,-0.900831433325038,17,31,-14,26,41,-15,42,62,-20,3,4,0,0
"20772","T.B","BUF",2011020821,15381,20112012,0,60,2,1,1,6.50601118808845,4.0648729617643,2.44113822632415,28,27,1,38,43,-5,55,59,-4,3,1,0,0
"20773","T.B","OTT",2011020840,15384,20112012,1,60,0,4,-4,5.61368148995098,5.76601501437835,-0.152333524427377,28,27,1,42,36,6,51,48,3,2,3,0,0
"20774","T.B","S.J",2011020853,15386,20112012,1,64.45,6,5,1,2.83163817332684,5.25274510611962,-2.42110693279278,25,50,-25,31,66,-35,43,76,-33,1,3,0,0
"20775","T.B","WSH",2011020869,15388,20112012,1,60,2,1,1,2.84108412054775,5.34481408155989,-2.50372996101214,23,24,-1,34,34,0,46,57,-11,5,2,0,0
"20776","T.B","ANA",2011020890,15391,20112012,1,60,3,2,1,2.92294576723361,3.18724064569853,-0.264294878464912,16,30,-14,23,43,-20,33,59,-26,2,2,0,0
"20777","T.B","WPG",2011020904,15393,20112012,0,60,3,4,-1,4.81737654280238,3.67305359162856,1.14432295117382,25,34,-9,35,45,-10,56,54,2,7,5,0,0
"20778","T.B","N.J",2011020925,15396,20112012,0,60,4,3,1,1.45329490059521,3.12915512000473,-1.67586021940951,16,22,-6,19,29,-10,25,44,-19,3,4,0,0
"20779","T.B","MTL",2011020942,15398,20112012,1,60,2,1,1,3.88587181185721,3.83998873086782,0.0458830809893982,22,24,-2,32,43,-11,41,62,-21,4,3,0,0
"20780","T.B","NYR",2011020961,15401,20112012,1,61.9666666666667,4,3,1,5.07348026371938,4.0274074357003,1.04607282801908,31,19,12,50,27,23,63,42,21,4,3,0,0
"20781","T.B","CAR",2011020967,15402,20112012,0,62.6833333333333,4,3,1,3.95835574575881,2.84838726866292,1.10996847709589,23,28,-5,34,37,-3,49,50,-1,4,2,0,0
"20782","T.B","OTT",2011020989,15405,20112012,1,60,3,7,-4,4.18023163245516,5.70804552236223,-1.52781388990707,28,35,-7,36,46,-10,44,55,-11,3,3,0,0
"20783","T.B","WSH",2011021001,15407,20112012,0,64.15,2,3,-1,0,0,0,26,32,-6,31,49,-18,45,68,-23,3,2,0,0
"20784","T.B","CAR",2011021019,15409,20112012,1,60,2,4,-2,4.14470729682944,4.50430377101293,-0.35959647418349,38,26,12,50,42,8,63,58,5,4,3,0,0
"20785","T.B","BOS",2011021040,15412,20112012,1,60,6,1,5,2.13899774363381,3.4010173495044,-1.26201960587059,17,34,-17,24,49,-25,34,60,-26,3,3,0,0
"20786","T.B","TOR",2011021056,15414,20112012,1,60,1,3,-2,4.4104058729772,2.30012247327249,2.11028339970471,35,28,7,44,34,10,54,50,4,7,8,0,0
"20787","T.B","STL",2011021071,15416,20112012,1,60,1,3,-2,5.44824187853737,2.84321838465985,2.60502349387752,23,21,2,39,28,11,55,38,17,3,2,0,0
"20788","T.B","BUF",2011021084,15418,20112012,1,60,3,7,-4,2.44442992975564,6.11622523819096,-3.67179530843532,27,38,-11,35,52,-17,45,73,-28,2,4,0,0
"20789","T.B","EDM",2011021104,15421,20112012,1,65,2,2,0,2.04838040556092,3.01944076971267,-0.971060364151754,21,36,-15,31,47,-16,46,61,-15,4,1,0,0
"20790","T.B","NYI",2011021122,15423,20112012,1,60,4,3,1,0,0,0,26,37,-11,32,47,-15,41,72,-31,3,3,0,0
"20791","T.B","PHI",2011021134,15425,20112012,0,60,5,3,2,3.68100415490215,5.07309612551944,-1.39209197061729,15,38,-23,22,56,-34,29,81,-52,3,6,0,0
"20792","T.B","BOS",2011021140,15426,20112012,0,60,2,5,-3,2.61201685952084,4.49528092916012,-1.88326406963928,18,38,-20,27,46,-19,33,63,-30,5,6,0,0
"20793","T.B","N.J",2011021156,15428,20112012,0,60,4,6,-2,1.00990270643706,5.69875496203895,-4.68885225560189,20,38,-18,20,55,-35,23,69,-46,3,4,0,0
"20794","T.B","WPG",2011021174,15430,20112012,1,60.75,3,2,1,6.36731046653586,2.4406057304177,3.92670473611815,39,28,11,52,39,13,70,53,17,9,4,0,0
"20795","T.B","WSH",2011021187,15432,20112012,1,60,4,2,2,6.54722573360459,5.15771133314158,1.38951440046301,27,33,-6,39,49,-10,55,61,-6,4,2,0,0
"20796","T.B","MTL",2011021199,15434,20112012,0,60,2,5,-3,3.74799570127493,4.77176759256326,-1.02377189128833,16,25,-9,26,31,-5,41,53,-12,4,5,0,0
"20797","T.B","TOR",2011021201,15435,20112012,0,64.0166666666667,2,3,-1,0,0,0,37,31,6,52,40,12,64,54,10,0,2,0,0
"20798","T.B","WPG",2011021223,15437,20112012,0,61.1333333333333,4,3,1,4.64208793609578,5.64430479610746,-1.00221686001169,25,31,-6,37,46,-9,59,60,-1,3,2,0,0
"20799","T.B","WSH",2012020007,15724,20122013,1,60,6,3,3,3.97882713462604,5.32460193784488,-1.34577480321884,34,30,4,41,42,-1,51,50,1,8,5,0,0
"20800","T.B","NYI",2012020021,15726,20122013,0,60,3,4,-1,2.98084036782141,5.76473156199791,-2.78389119417649,26,44,-18,36,56,-20,44,66,-22,4,8,0,0
"20801","T.B","CAR",2012020028,15727,20122013,0,60,4,1,3,4.31248065805994,5.23819122514335,-0.92571056708341,26,36,-10,34,51,-17,45,74,-29,8,7,0,0
"20802","T.B","OTT",2012020053,15730,20122013,1,60,6,4,2,7.20943619325226,4.87316918131251,2.33626701193975,31,36,-5,45,50,-5,59,69,-10,7,6,0,0
"20803","T.B","PHI",2012020068,15732,20122013,1,60,5,1,4,1.95120769213918,3.89910427542259,-1.94789658328341,26,25,1,32,41,-9,40,67,-27,6,7,0,0
"20804","T.B","FLA",2012020084,15734,20122013,1,60,5,2,3,5.27818764157146,3.54339659746856,1.7347910441029,33,28,5,43,38,5,50,48,2,6,5,0,0
"20805","T.B","WPG",2012020103,15737,20122013,1,60,8,3,5,3.47744077816606,4.37248062969567,-0.895039851529617,25,29,-4,31,43,-12,40,58,-18,5,5,0,0
"20806","T.B","NYR",2012020113,15738,20122013,1,60,2,3,-1,4.26235416009403,5.18081637535943,-0.918462215265393,32,30,2,42,47,-5,52,55,-3,1,2,0,0
"20807","T.B","PHI",2012020133,15741,20122013,0,60,1,2,-1,3.41781572700711,2.7086391676421,0.709176559365005,22,24,-2,35,36,-1,53,58,-5,5,3,0,0
"20808","T.B","N.J",2012020142,15743,20122013,0,60,2,4,-2,1.74839346983936,5.37318044270069,-3.62478697286133,19,27,-8,22,42,-20,30,47,-17,5,5,0,0
"20809","T.B","BOS",2012020154,15820,20122013,0,60,0,2,-2,3.11098490469158,4.014258836748,-0.903273932056428,30,24,6,38,36,2,53,49,4,3,1,0,0
"20810","T.B","NYR",2012020169,15746,20122013,0,60,1,5,-4,3.56446332236681,4.66319523798302,-1.09873191561621,20,32,-12,29,49,-20,37,65,-28,2,3,0,0
"20811","T.B","MTL",2012020181,15748,20122013,1,65,3,3,0,3.38890233754557,3.26079368178034,0.128108655765232,24,34,-10,32,47,-15,47,58,-11,6,8,0,0
"20812","T.B","WSH",2012020193,15750,20122013,1,60,3,4,-1,5.79137576479116,5.62553738273982,0.165838382051334,30,39,-9,40,53,-13,49,71,-22,3,2,0,0
"20813","T.B","FLA",2012020208,15752,20122013,0,61.3166666666667,6,5,1,4.40064025466563,4.74783704009639,-0.347196785430754,36,30,6,52,47,5,59,54,5,4,3,0,0
"20814","T.B","TOR",2012020229,15755,20122013,1,60,4,2,2,1.96684202374377,4.66755295265466,-2.70071092891089,19,25,-6,35,40,-5,45,59,-14,6,3,0,0
"20815","T.B","BOS",2012020243,15757,20122013,1,60,2,4,-2,4.35587891394971,3.84193180815782,0.513947105791885,26,26,0,38,33,5,50,43,7,3,1,0,0
"20816","T.B","CAR",2012020257,15759,20122013,0,60,5,2,3,8.24979060710757,5.00223945546895,3.24755115163862,39,34,5,49,47,2,61,63,-2,3,3,0,0
"20817","T.B","BUF",2012020279,15762,20122013,1,60,1,2,-1,3.17127971519949,2.17258160747588,0.998698107723612,31,21,10,45,28,17,59,36,23,6,1,0,0
"20818","T.B","NYR",2012020290,15764,20122013,0,60,1,4,-3,3.31004840189553,5.10335555730853,-1.793307155413,25,42,-17,34,46,-12,47,69,-22,3,4,0,0
"20819","T.B","BOS",2012020303,15766,20122013,0,60,2,3,-1,4.7829316968855,2.72314461268252,2.05978708420298,22,27,-5,35,40,-5,46,54,-8,8,5,0,0
"20820","T.B","N.J",2012020324,15769,20122013,0,60,5,2,3,0,0,0,25,27,-2,26,41,-15,31,49,-18,3,3,0,0
"20821","T.B","WPG",2012020346,15771,20122013,1,60,1,2,-1,5.19964752843953,3.09469871916735,2.10494880927217,29,28,1,40,39,1,53,54,-1,5,2,0,0
"20822","T.B","MTL",2012020361,15773,20122013,1,60,3,4,-1,3.24109639567905,5.21629209015191,-1.97519569447286,23,29,-6,27,43,-16,41,55,-14,3,4,0,0
"20823","T.B","FLA",2012020381,15776,20122013,0,60,3,2,1,5.04129354122051,4.9696659569745,0.0716275842460163,13,39,-26,22,55,-33,33,68,-35,2,4,0,0
"20824","T.B","NYI",2012020395,15778,20122013,1,60,0,2,-2,3.82575296431241,3.28254294146609,0.543210022846324,18,29,-11,31,37,-6,46,49,-3,2,1,0,0
"20825","T.B","CAR",2012020411,15780,20122013,1,60,4,1,3,2.47623272700082,3.34755437285639,-0.871321645855573,26,22,4,35,38,-3,45,59,-14,1,2,0,0
"20826","T.B","PHI",2012020423,15782,20122013,1,60,4,2,2,4.92775591550162,3.81340452981772,1.1143513856839,27,30,-3,43,45,-2,56,58,-2,4,4,0,0
"20827","T.B","TOR",2012020438,15784,20122013,0,60,2,4,-2,4.24589424746227,6.42348913749447,-2.1775948900322,28,26,2,40,39,1,58,53,5,5,3,0,0
"20828","T.B","OTT",2012020456,15787,20122013,0,60,3,5,-2,0,0,0,32,32,0,38,42,-4,56,55,1,5,3,0,0
"20829","T.B","WPG",2012020468,15788,20122013,0,60,2,3,-1,3.7530119039161,2.98047460741691,0.772537296499195,25,24,1,37,36,1,48,51,-3,4,4,0,0
"20830","T.B","BUF",2012020484,15790,20122013,1,60,2,1,1,2.61035975714913,2.12123283516848,0.489126921980642,25,14,11,34,25,9,43,42,1,6,5,0,0
"20831","T.B","N.J",2012020502,15793,20122013,1,65,4,4,0,4.24689437170116,3.29082781943725,0.956066552263906,25,25,0,35,40,-5,44,52,-8,3,6,0,0
"20832","T.B","FLA",2012020535,15797,20122013,1,65,2,2,0,5.34374143640622,3.98344337931485,1.36029805709137,41,25,16,56,37,19,70,49,21,3,3,0,0
"20833","T.B","CAR",2012020546,15799,20122013,0,60,5,0,5,6.06715522180821,9.71131664974382,-3.64416142793561,30,45,-15,44,68,-24,55,89,-34,1,3,0,0
"20834","T.B","NYI",2012020564,15801,20122013,0,60,2,4,-2,4.23426582053071,4.68709971996577,-0.452833899435063,21,28,-7,30,40,-10,53,61,-8,3,1,0,0
"20835","T.B","WSH",2012020573,15802,20122013,0,60,2,4,-2,5.26502224151045,5.88647979160305,-0.6214575500926,30,38,-8,38,48,-10,56,60,-4,3,3,0,0
"20836","T.B","OTT",2012020586,15804,20122013,1,60,3,2,1,3.11077827445843,6.32423892711682,-3.2134606526584,24,33,-9,33,50,-17,38,72,-34,9,6,0,0
"20837","T.B","WSH",2012020614,15808,20122013,0,62.9833333333333,5,6,-1,4.80632890065635,5.22659335384378,-0.420264453187428,40,38,2,48,46,2,67,57,10,2,5,0,0
"20838","T.B","BUF",2012020622,15809,20122013,0,60,1,3,-2,3.23238146821903,1.72754239180358,1.50483907641545,33,22,11,48,29,19,56,39,17,1,3,0,0
"20839","T.B","WPG",2012020636,15811,20122013,0,65,3,3,0,3.5712149424653,7.32688020722043,-3.75566526475512,27,36,-9,37,55,-18,53,69,-16,1,3,0,0
"20840","T.B","MTL",2012020646,15813,20122013,0,60,2,3,-1,4.26958675530041,3.62386807108851,0.6457186842119,34,35,-1,49,47,2,62,64,-2,2,6,0,0
"20841","T.B","CAR",2012020669,15816,20122013,1,60,2,3,-1,4.25469127728195,4.54482963813643,-0.290138360854485,37,28,9,53,40,13,63,48,15,2,4,0,0
"20842","T.B","TOR",2012020690,15819,20122013,1,60,5,2,3,5.01654283786547,3.41664526850218,1.59989756936329,26,28,-2,40,42,-2,56,56,0,2,2,0,0
"20843","T.B","FLA",2012020712,15822,20122013,1,60,3,5,-2,3.93112291992657,5.17227573474884,-1.24115281482227,31,32,-1,42,43,-1,54,54,0,4,2,0,0
"20844","T.B","BOS",2013020007,15981,20132014,0,60,1,3,-2,5.01215193414828,3.65235767658144,1.35979425756684,33,25,8,41,38,3,53,54,-1,5,4,0,0
"20845","T.B","CHI",2013020026,15983,20132014,0,65,2,2,0,3.77173676667735,4.35181295336224,-0.580076186684892,16,39,-23,26,55,-29,43,72,-29,1,5,0,0
"20846","T.B","BUF",2013020041,15986,20132014,0,61.8333333333333,3,2,1,4.87178948443034,4.72200010542292,0.149789379007416,34,23,11,43,35,8,57,46,11,3,4,0,0
"20847","T.B","FLA",2013020052,15988,20132014,1,60,7,2,5,2.59707874556625,3.38323046087316,-0.786151715306914,28,21,7,37,30,7,53,39,14,6,6,0,0
"20848","T.B","L.A",2013020088,15993,20132014,1,60,5,1,4,5.19692723933986,4.29505662793423,0.901870611405627,25,31,-6,33,49,-16,46,66,-20,3,5,0,0
"20849","T.B","MIN",2013020102,15995,20132014,1,60,3,1,2,4.63173821698001,2.74790147470776,1.88383674227225,30,26,4,43,34,9,52,46,6,8,4,0,0
"20850","T.B","BOS",2013020114,15997,20132014,1,60,0,5,-5,2.6996778511857,3.14417034457438,-0.44449249338868,23,22,1,34,31,3,42,45,-3,5,5,0,0
"20851","T.B","CHI",2013020143,16002,20132014,1,61.2666666666667,6,5,1,2.07875635640494,6.43909607463866,-4.36033971823372,25,44,-19,33,57,-24,40,73,-33,4,6,0,0
"20852","T.B","BUF",2013020159,16004,20132014,1,60,3,2,1,4.77316679049642,3.19415250918678,1.57901428130964,39,22,17,50,29,21,60,37,23,6,3,0,0
"20853","T.B","FLA",2013020167,16005,20132014,0,65,3,3,0,4.2935260216817,4.50414544105104,-0.21061941936934,28,32,-4,39,46,-7,49,61,-12,4,5,0,0
"20854","T.B","N.J",2013020179,16007,20132014,0,60,1,2,-1,3.42699723510304,2.92236949395738,0.504627741145669,17,22,-5,22,28,-6,27,34,-7,5,3,0,0
"20855","T.B","CAR",2013020193,16010,20132014,0,60,3,0,3,4.97013697313852,3.8253406936783,1.14479627946022,32,31,1,47,44,3,62,68,-6,4,5,0,0
"20856","T.B","STL",2013020202,16011,20132014,1,60,4,2,2,6.1908943002818,2.8115771718345,3.37931712844729,25,30,-5,38,42,-4,54,59,-5,3,4,0,0
"20857","T.B","EDM",2013020237,16016,20132014,1,60,4,2,2,4.19326261267997,4.19456986848704,-0.00130725580706326,26,40,-14,34,49,-15,51,59,-8,3,3,0,0
"20858","T.B","DET",2013020248,16018,20132014,0,63.85,3,2,1,4.93736344860736,2.57513195657702,2.36223149203033,34,27,7,50,34,16,62,51,11,3,3,0,0
"20859","T.B","BOS",2013020262,16020,20132014,0,60,0,3,-3,4.13362999734818,3.2267098479536,0.90692014939458,28,26,2,44,39,5,58,44,14,4,1,0,0
"20860","T.B","MTL",2013020268,16021,20132014,0,65,1,1,0,6.55951625380358,3.30488182738191,3.25463442642168,45,29,16,55,46,9,80,61,19,4,3,0,0
"20861","T.B","ANA",2013020279,16023,20132014,1,60,5,1,4,4.38934199555661,2.40310336556286,1.98623862999375,20,25,-5,37,32,5,47,43,4,5,5,0,0
"20862","T.B","ARI",2013020300,16025,20132014,0,60,3,6,-3,5.44397098838817,6.05054237491277,-0.606571386524593,30,30,0,45,37,8,56,46,10,2,3,0,0
"20863","T.B","L.A",2013020321,16028,20132014,0,60,2,5,-3,5.52665758956573,7.93465755721627,-2.40799996765054,21,31,-10,32,49,-17,36,57,-21,3,4,0,0
"20864","T.B","S.J",2013020335,16030,20132014,0,60,1,5,-4,6.11877785503202,4.58063491297071,1.53814294206131,37,36,1,53,54,-1,70,65,5,1,2,0,0
"20865","T.B","ANA",2013020340,16031,20132014,0,64.9,0,1,-1,5.26583201100584,6.5659231674297,-1.30009115642386,31,42,-11,46,53,-7,56,63,-7,8,5,0,0
"20866","T.B","NYR",2013020358,16034,20132014,1,60,5,0,5,2.62425479098715,3.09043871492031,-0.466183923933158,25,37,-12,32,50,-18,39,74,-35,3,6,0,0
"20867","T.B","PHI",2013020371,16036,20132014,1,60,4,2,2,7.31426067158463,3.3321143467109,3.98214632487374,35,21,14,48,31,17,58,43,15,6,5,0,0
"20868","T.B","CBJ",2013020413,16042,20132014,0,60,0,1,-1,5.90222338623425,5.05203204571444,0.850191340519814,26,21,5,33,34,-1,42,44,-2,2,1,0,0
"20869","T.B","OTT",2013020426,16044,20132014,1,60,3,1,2,2.43514837532712,5.76830700000028,-3.33315862467316,22,34,-12,32,49,-17,39,65,-26,4,5,0,0
"20870","T.B","WPG",2013020442,16046,20132014,1,61.0666666666667,1,2,-1,5.53735065825458,4.93656295555411,0.600787702700472,29,36,-7,47,48,-1,58,57,1,3,5,0,0
"20871","T.B","WSH",2013020459,16049,20132014,0,65,5,5,0,8.91215326565725,4.53255996211566,4.3795933035416,42,31,11,57,43,14,77,51,26,5,2,0,0
"20872","T.B","DET",2013020476,16051,20132014,1,65,1,1,0,2.96479842128929,3.20642790388973,-0.241629482600445,27,29,-2,46,45,1,59,58,1,4,4,0,0
"20873","T.B","N.J",2013020492,16053,20132014,0,60,0,3,-3,5.93386866449146,1.97756789674168,3.95630076774978,33,19,14,45,29,16,53,38,15,3,2,0,0
"20874","T.B","DET",2013020500,16054,20132014,0,60,3,0,3,7.44244435435394,3.77177553992078,3.67066881443316,27,28,-1,39,40,-1,50,55,-5,3,3,0,0
"20875","T.B","NYI",2013020512,16056,20132014,0,65,2,2,0,4.97861279656587,3.58159558751504,1.39701720905083,36,34,2,46,41,5,73,50,23,1,2,0,0
"20876","T.B","NSH",2013020529,16058,20132014,1,60,4,2,2,4.68823401336704,3.55074407435899,1.13748993900805,33,30,3,44,43,1,61,51,10,4,5,0,0
"20877","T.B","CAR",2013020543,16060,20132014,1,62.2666666666667,3,2,1,4.48271083034342,5.63373979390599,-1.15102896356257,50,27,23,58,39,19,72,53,19,5,2,0,0
"20878","T.B","FLA",2013020559,16062,20132014,0,60,6,1,5,4.76119756623231,2.57348464216557,2.18771292406674,36,29,7,52,32,20,64,37,27,4,3,0,0
"20879","T.B","MTL",2013020578,16067,20132014,1,65,1,1,0,3.84105521661695,3.89980662119342,-0.0587514045764692,24,21,3,38,41,-3,55,51,4,3,3,0,0
"20880","T.B","NYR",2013020591,16068,20132014,1,60,3,4,-1,4.86414118652465,3.8153949517,1.04874623482465,40,29,11,49,33,16,64,45,19,2,3,0,0
"20881","T.B","VAN",2013020611,16071,20132014,0,60,4,2,2,2.07262604113203,2.70099393630392,-0.628367895171891,33,30,3,42,51,-9,57,61,-4,3,2,0,0
"20882","T.B","CGY",2013020624,16073,20132014,0,60,2,0,2,3.29866455629417,3.4121468772646,-0.113482320970434,29,19,10,42,33,9,55,54,1,6,6,0,0
"20883","T.B","EDM",2013020641,16075,20132014,0,60,3,5,-2,5.5317287753569,3.62593197647948,1.90579679887742,27,26,1,46,35,11,58,47,11,2,3,0,0
"20884","T.B","WPG",2013020651,16077,20132014,0,60,4,2,2,3.89261994447947,2.61455229762942,1.27806764685006,33,14,19,49,22,27,66,36,30,9,9,0,0
"20885","T.B","WSH",2013020663,16079,20132014,1,60,3,4,-1,5.43425753249176,4.3153226384311,1.11893489406066,36,20,16,46,39,7,58,57,1,1,3,0,0
"20886","T.B","PHI",2013020675,16081,20132014,0,60,6,3,3,4.07758829388058,6.23058329438616,-2.15299500050558,25,38,-13,34,58,-24,41,77,-36,5,6,0,0
"20887","T.B","CBJ",2013020693,16083,20132014,0,60,2,3,-1,6.0282243287561,2.56137095637874,3.46685337237735,28,28,0,35,45,-10,44,61,-17,4,6,0,0
"20888","T.B","NYR",2013020697,16084,20132014,0,60,2,1,1,3.26455821447598,4.52242587990511,-1.25786766542913,25,34,-9,32,46,-14,51,66,-15,2,2,0,0
"20889","T.B","NYI",2013020713,16086,20132014,1,65,1,1,0,0,0,0,30,30,0,44,42,2,56,57,-1,3,4,0,0
"20890","T.B","S.J",2013020724,16088,20132014,1,60,4,5,-1,3.84662802137245,4.62985654364456,-0.783228522272111,29,32,-3,44,42,2,57,57,0,5,3,0,0
"20891","T.B","CAR",2013020737,16089,20132014,0,60,5,3,2,4.05235255963635,7.99065484080529,-3.93830228116894,24,51,-27,29,69,-40,40,97,-57,2,5,0,0
"20892","T.B","OTT",2013020762,16093,20132014,1,65,3,3,0,3.15094401789247,6.65545987093719,-3.50451585304472,38,36,2,45,54,-9,49,80,-31,2,3,0,0
"20893","T.B","COL",2013020778,16095,20132014,1,60,5,2,3,4.91490809737161,6.84737750826753,-1.93246941089592,29,27,2,45,41,4,61,55,6,3,3,0,0
"20894","T.B","TOR",2013020796,16098,20132014,0,60,2,3,-1,6.7434165549075,4.12381099760329,2.61960555730422,42,26,16,61,40,21,74,58,16,3,3,0,0
"20895","T.B","OTT",2013020812,16100,20132014,0,60,3,5,-2,6.60946815108036,8.06533336635201,-1.45586521527164,38,28,10,50,40,10,63,56,7,2,2,0,0
"20896","T.B","MTL",2013020825,16102,20132014,0,64.6,2,1,1,6.77144865400442,5.6457040688706,1.12574458513382,36,29,7,48,42,6,67,54,13,6,6,0,0
"20897","T.B","MIN",2013020851,16105,20132014,0,60,1,2,-1,6.66103259552619,2.95933899284591,3.70169360268028,35,26,9,48,35,13,58,45,13,3,3,0,0
"20898","T.B","TOR",2013020862,16107,20132014,1,60,1,4,-3,3.84976804596477,3.73460437572794,0.115163670236825,34,36,-2,57,48,9,75,56,19,3,3,0,0
"20899","T.B","DET",2013020877,16109,20132014,1,60,4,2,2,6.54561423413907,3.97867828773451,2.56693594640456,28,33,-5,37,47,-10,48,60,-12,3,3,0,0
"20900","T.B","NSH",2013020893,16128,20132014,0,60,2,3,-1,2.32310628279811,4.19634296471866,-1.87323668192055,16,29,-13,24,40,-16,36,55,-19,4,5,0,0
"20901","T.B","DAL",2013020907,16130,20132014,0,60,4,2,2,5.39449794902288,2.52479467383819,2.86970327518469,21,41,-20,31,58,-27,40,83,-43,3,4,0,0
"20902","T.B","COL",2013020917,16131,20132014,0,60,3,6,-3,7.12382361106114,7.7306993813377,-0.606875770276556,34,35,-1,45,47,-2,54,66,-12,2,4,0,0
"20903","T.B","STL",2013020928,16133,20132014,0,60,2,4,-2,1.98915704007959,3.81564498303357,-1.82648794295398,17,29,-12,29,41,-12,39,58,-19,4,2,0,0
"20904","T.B","BUF",2013020941,16135,20132014,1,60,1,3,-2,4.51061291665451,2.60460918136414,1.90600373529037,44,21,23,64,32,32,85,38,47,4,3,0,0
"20905","T.B","BOS",2013020956,16137,20132014,1,65,3,3,0,4.39755542864978,7.66223322425503,-3.26467779560525,20,32,-12,29,49,-20,37,65,-28,1,3,0,0
"20906","T.B","ARI",2013020970,16139,20132014,1,65,3,3,0,4.74826382826945,3.36141423604568,1.38684959222378,31,20,11,46,36,10,66,52,14,4,3,0,0
"20907","T.B","FLA",2013020992,16142,20132014,1,60,5,4,1,3.19613005816791,2.37192421290092,0.824205845266988,28,27,1,41,38,3,55,46,9,4,2,0,0
"20908","T.B","N.J",2013021007,16144,20132014,1,60,3,0,3,3.93419359926943,3.3101116680773,0.624081931192137,32,23,9,39,33,6,47,41,6,4,4,0,0
"20909","T.B","VAN",2013021023,16146,20132014,1,60,4,3,1,4.36738006243831,4.48907154973131,-0.121691487292992,30,28,2,43,42,1,58,56,2,5,4,0,0
"20910","T.B","TOR",2013021038,16148,20132014,0,60,5,3,2,5.32429872843204,6.49289287592264,-1.16859414749059,30,39,-9,48,52,-4,64,66,-2,6,1,0,0
"20911","T.B","OTT",2013021045,16149,20132014,0,60,5,4,1,3.78562000324018,5.21538324111316,-1.42976323787298,28,31,-3,30,45,-15,37,61,-24,7,6,0,0
"20912","T.B","OTT",2013021076,16153,20132014,1,65,3,3,0,7.72891028947197,4.25162499929866,3.47728529017331,38,32,6,55,46,9,62,67,-5,9,5,0,0
"20913","T.B","NYI",2013021096,16156,20132014,1,65,2,2,0,4.4874522305613,2.30216996913077,2.18528226143053,31,27,4,43,35,8,56,53,3,3,3,0,0
"20914","T.B","BUF",2013021110,16158,20132014,0,61.8833333333333,4,3,1,4.45565309902304,4.45126353718177,0.00438956184126482,33,29,4,46,38,8,60,52,8,4,3,0,0
"20915","T.B","DET",2013021120,16159,20132014,0,60,2,3,-1,4.63083895658201,4.15582479997829,0.47501415660372,28,30,-2,37,36,1,46,44,2,4,3,0,0
"20916","T.B","MTL",2013021135,16161,20132014,1,60,3,1,2,2.98605193087519,3.59521439701348,-0.609162466138287,33,26,7,47,37,10,63,46,17,8,5,0,0
"20917","T.B","CGY",2013021147,16163,20132014,1,60,1,4,-3,3.21400890873338,4.2365262049625,-1.02251729622913,32,25,7,45,32,13,69,42,27,3,2,0,0
"20918","T.B","DAL",2013021165,16165,20132014,1,60,2,5,-3,2.10571458105654,3.63033752511546,-1.52462294405893,29,28,1,44,37,7,52,50,2,4,3,0,0
"20919","T.B","TOR",2013021184,16168,20132014,1,60,3,0,3,7.10900496051181,5.42329411185347,1.68571084865835,34,28,6,51,41,10,63,55,8,1,3,0,0
"20920","T.B","PHI",2013021198,16170,20132014,1,60,4,2,2,3.61337098605873,5.05859971260452,-1.44522872654579,30,36,-6,39,46,-7,48,62,-14,3,3,0,0
"20921","T.B","CBJ",2013021207,16171,20132014,1,60,3,2,1,5.05816312341267,4.08058044559814,0.977582677814524,22,38,-16,38,49,-11,45,68,-23,4,4,0,0
"20922","T.B","WSH",2013021223,16173,20132014,0,65,0,0,0,3.55033011240084,3.24470511093386,0.305625001466979,32,18,14,48,32,16,65,45,20,1,1,0,0
"20923","T.B","MTL",2013030121,16176,20132014,1,78.1333333333333,4,5,-1,4.88293936394621,7.25740269123025,-2.37446332728405,25,44,-19,41,61,-20,52,74,-22,3,3,0,0
"20924","T.B","MTL",2013030122,16178,20132014,1,60,1,4,-3,3.86458846075402,4.49740704279975,-0.632818582045729,27,26,1,37,38,-1,51,47,4,5,5,0,0
"20925","T.B","MTL",2013030123,16180,20132014,0,60,2,3,-1,5.31224089565585,4.6603737634141,0.65186713224175,29,31,-2,32,45,-13,53,60,-7,3,5,0,0
"20926","T.B","MTL",2013030124,16182,20132014,0,60,3,4,-1,3.95106170605868,5.36877398774959,-1.41771228169091,23,37,-14,40,49,-9,63,66,-3,1,2,0,0
"20927","T.B","FLA",2014020010,16352,20142015,1,61.1833333333333,3,2,1,6.84960889229842,3.68256501341239,3.16704387888603,32,21,11,44,26,18,57,36,21,10,5,0,0
"20928","T.B","OTT",2014020021,16354,20142015,1,65,2,2,0,4.13945337964021,4.24076648952905,-0.10131310988884,40,34,6,53,44,9,63,59,4,4,4,0,0
"20929","T.B","N.J",2014020044,16357,20142015,1,60,1,2,-1,3.08092133502865,2.74991068255622,0.331010652472429,27,25,2,37,35,2,51,43,8,4,4,0,0
"20930","T.B","VAN",2014020073,16361,20142015,0,60,4,2,2,2.23300515724623,4.55432604930667,-2.32132089206044,24,32,-8,31,40,-9,40,58,-18,7,8,0,0
"20931","T.B","EDM",2014020078,16363,20142015,0,60,2,3,-1,3.55878683777701,4.77916625124635,-1.22037941346935,24,23,1,29,39,-10,43,50,-7,3,4,0,0
"20932","T.B","CGY",2014020088,16364,20142015,0,63,2,1,1,2.72208417328709,3.01686541029267,-0.29478123700558,22,22,0,31,34,-3,49,42,7,0,2,0,0
"20933","T.B","WPG",2014020102,16367,20142015,0,60,4,2,2,3.56001337262569,4.11209621789749,-0.552082845271798,27,42,-15,34,50,-16,45,64,-19,4,5,0,0
"20934","T.B","MIN",2014020114,16368,20142015,0,60,2,7,-5,3.10100853703261,2.8806804328924,0.220328104140208,19,22,-3,37,29,8,51,37,14,4,1,0,0
"20935","T.B","ARI",2014020130,16371,20142015,1,60,7,3,4,6.1141918564681,5.37237704542349,0.741814811044605,35,25,10,50,36,14,63,52,11,3,0,0,0
"20936","T.B","PHI",2014020142,16373,20142015,1,60,4,3,1,2.03337674079921,2.20063674001653,-0.167259999217322,32,27,5,39,38,1,53,48,5,7,4,0,0
"20937","T.B","WSH",2014020155,16375,20142015,1,60,4,3,1,4.02724387294438,2.84213964656132,1.18510422638307,28,38,-10,36,48,-12,46,57,-11,3,3,0,0
"20938","T.B","CGY",2014020190,16380,20142015,1,60,5,2,3,4.03518955696808,3.86588207399473,0.169307482973354,33,31,2,48,40,8,60,59,1,3,6,0,0
"20939","T.B","CBJ",2014020208,16382,20142015,0,60,7,4,3,5.27060000749771,6.25553985612351,-0.9849398486258,38,32,6,52,42,10,61,63,-2,5,6,0,0
"20940","T.B","DET",2014020214,16383,20142015,0,65,3,3,0,2.78407596994657,3.5161396212643,-0.732063651317731,30,20,10,40,28,12,50,44,6,5,4,0,0
"20941","T.B","CHI",2014020228,16385,20142015,0,65,2,2,0,3.87091927268071,5.3010600778216,-1.43014080514089,27,39,-12,36,46,-10,50,69,-19,5,8,0,0
"20942","T.B","S.J",2014020236,16387,20142015,1,60,1,2,-1,3.08897976330991,4.16524503212702,-1.07626526881711,33,39,-6,42,54,-12,54,71,-17,4,3,0,0
"20943","T.B","NYI",2014020253,16389,20142015,1,60,5,2,3,3.14635052141966,2.75348980076058,0.392860720659079,28,27,1,33,39,-6,41,51,-10,4,5,0,0
"20944","T.B","NYR",2014020266,16391,20142015,0,60,5,1,4,3.92914190523629,2.25436918194754,1.67477272328875,30,16,14,39,29,10,55,50,5,3,3,0,0
"20945","T.B","NYI",2014020269,16392,20142015,0,60,2,5,-3,2.66715893948276,3.4062259736238,-0.739067034141044,28,36,-8,35,45,-10,52,61,-9,4,7,0,0
"20946","T.B","TOR",2014020281,16394,20142015,0,60,2,5,-3,2.80297236877959,4.62632922106422,-1.82335685228463,28,21,7,46,36,10,63,54,9,3,3,0,0
"20947","T.B","MIN",2014020298,16396,20142015,1,60,2,1,1,3.35116568877129,3.86135567021275,-0.510189981441457,28,31,-3,42,44,-2,57,62,-5,2,3,0,0
"20948","T.B","NYR",2014020326,16400,20142015,1,60,4,3,1,3.40133238959243,5.27121980306929,-1.86988741347687,29,19,10,42,31,11,49,44,5,4,3,0,0
"20949","T.B","OTT",2014020346,16403,20142015,1,60,4,1,3,4.81196102176909,5.86791919596555,-1.05595817419646,32,27,5,42,39,3,59,50,9,3,2,0,0
"20950","T.B","NYR",2014020357,16405,20142015,0,60,6,3,3,4.41453879074834,4.69181926321471,-0.277280472466373,21,35,-14,31,47,-16,49,66,-17,5,4,0,0
"20951","T.B","BUF",2014020362,16406,20142015,0,65,1,1,0,3.22817884839606,3.94844967366953,-0.720270825273474,27,22,5,47,34,13,69,45,24,2,2,0,0
"20952","T.B","BUF",2014020381,16408,20142015,1,60,5,0,5,4.91444446047535,1.55889624030052,3.35554822017484,35,13,22,51,22,29,68,29,39,9,6,0,0
"20953","T.B","CBJ",2014020394,16410,20142015,1,60,1,3,-2,2.96828527521575,2.10616769711487,0.862117578100879,34,20,14,45,27,18,58,38,20,5,7,0,0
"20954","T.B","WSH",2014020414,16413,20142015,1,60,3,5,-2,5.60951388347894,5.01019858219524,0.599315301283696,36,35,1,49,46,3,60,57,3,4,3,0,0
"20955","T.B","CAR",2014020426,16415,20142015,1,60,2,1,1,1.87929892213764,3.96999502560357,-2.09069610346593,27,30,-3,43,41,2,57,50,7,3,5,0,0
"20956","T.B","WSH",2014020440,16417,20142015,0,60,2,4,-2,7.69651716641216,3.38697526429314,4.30954190211902,28,28,0,46,34,12,64,49,15,5,5,0,0
"20957","T.B","PHI",2014020453,16420,20142015,0,60,3,1,2,4.66998474788852,5.49578810831758,-0.825803360429057,23,24,-1,33,36,-3,40,52,-12,4,3,0,0
"20958","T.B","N.J",2014020474,16423,20142015,0,65,2,2,0,3.83191295087454,2.42704025609419,1.40487269478035,28,18,10,38,20,18,57,24,33,5,4,0,0
"20959","T.B","NYI",2014020484,16424,20142015,0,60,1,3,-2,3.13916744949529,7.11953845309881,-3.98037100360352,21,48,-27,33,59,-26,48,76,-28,2,3,0,0
"20960","T.B","CAR",2014020516,16431,20142015,1,60,2,1,1,6.54813118162565,3.28594177193008,3.26218940969557,38,26,12,57,34,23,74,40,34,7,4,0,0
"20961","T.B","TOR",2014020534,16433,20142015,1,60,3,2,1,4.79426629692898,2.65814539338442,2.13612090354457,41,23,18,54,34,20,67,46,21,4,2,0,0
"20962","T.B","BUF",2014020546,16435,20142015,0,60,5,1,4,6.07713241752936,1.37420849641785,4.70292392111151,25,11,14,33,20,13,48,31,17,3,2,0,0
"20963","T.B","OTT",2014020578,16439,20142015,0,60,4,2,2,4.47082812207584,1.44146642386268,3.02936169821316,30,22,8,40,30,10,60,42,18,9,4,0,0
"20964","T.B","MTL",2014020586,16441,20142015,0,60,4,2,2,4.79434955663601,2.31738023981387,2.47696931682214,36,22,14,47,31,16,64,44,20,6,3,0,0
"20965","T.B","BUF",2014020610,16444,20142015,1,60,2,1,1,4.07274642470293,3.0085157185631,1.06423070613982,47,21,26,63,28,35,75,39,36,4,3,0,0
"20966","T.B","PHI",2014020627,16447,20142015,0,60,3,7,-4,6.81636733002961,4.37241411197465,2.44395321805496,24,25,-1,41,31,10,50,44,6,3,3,0,0
"20967","T.B","BOS",2014020630,16448,20142015,0,60,3,4,-1,2.12756622140296,4.79588848745715,-2.66832226605419,19,34,-15,25,50,-25,34,60,-26,9,7,0,0
"20968","T.B","EDM",2014020648,16450,20142015,1,60,3,2,1,2.59907144664612,3.55119094445013,-0.952119497804006,19,32,-13,30,41,-11,44,56,-12,1,4,0,0
"20969","T.B","COL",2014020665,16452,20142015,1,65,2,2,0,3.39163614174686,4.04485649074195,-0.653220348995092,31,42,-11,41,54,-13,51,69,-18,1,3,0,0
"20970","T.B","VAN",2014020688,16455,20142015,1,60,4,1,3,5.10857928870246,5.64623104804195,-0.537651759339496,26,28,-2,31,39,-8,49,56,-7,5,7,0,0
"20971","T.B","CAR",2014020700,16462,20142015,0,60,2,4,-2,5.02204622328281,1.41755857067619,3.60448765260662,30,22,8,42,30,12,57,41,16,3,3,0,0
"20972","T.B","DET",2014020716,16464,20142015,1,60,5,1,4,5.58450515783625,3.53354945735191,2.05095570048434,32,28,4,44,41,3,55,49,6,3,3,0,0
"20973","T.B","CBJ",2014020735,16466,20142015,1,60,3,1,2,0,0,0,34,35,-1,45,46,-1,63,55,8,6,5,0,0
"20974","T.B","STL",2014020750,16469,20142015,0,61.2666666666667,1,2,-1,3.58070889715759,2.50628772407799,1.0744211730796,31,18,13,46,37,9,56,48,8,4,3,0,0
"20975","T.B","DAL",2014020764,16471,20142015,0,60,5,3,2,5.17264984665235,6.94296057670726,-1.77031073005492,29,36,-7,43,63,-20,68,74,-6,4,5,0,0
"20976","T.B","L.A",2014020774,16473,20142015,1,60,2,4,-2,4.35139891751516,3.58161864604335,0.769780271471802,28,29,-1,44,39,5,58,47,11,5,5,0,0
"20977","T.B","ANA",2014020788,16474,20142015,1,60,5,3,2,0,0,0,23,28,-5,31,45,-14,40,66,-26,6,6,0,0
"20978","T.B","NSH",2014020804,16476,20142015,0,64.45,2,3,-1,6.14059729684232,7.0152588958008,-0.874661598958483,32,29,3,46,40,6,68,52,16,3,3,0,0
"20979","T.B","STL",2014020813,16478,20142015,1,60,3,6,-3,1.75919568611425,4.71183517170721,-2.95263948559295,29,44,-15,41,49,-8,54,58,-4,3,3,0,0
"20980","T.B","S.J",2014020837,16481,20142015,0,60,5,2,3,4.43266278345273,6.62958753530984,-2.19692475185711,33,35,-2,43,54,-11,50,66,-16,2,4,0,0
"20981","T.B","L.A",2014020845,16482,20142015,0,60,2,3,-1,3.67597357746126,3.44349310338809,0.232480474073171,23,28,-5,34,39,-5,45,52,-7,2,3,0,0
"20982","T.B","ANA",2014020858,16484,20142015,0,60,4,1,3,4.82207185380685,3.74925231776433,1.07281953604252,32,25,7,41,45,-4,52,62,-10,3,2,0,0
"20983","T.B","ARI",2014020882,16487,20142015,0,60,4,2,2,4.79567007120932,7.83601237533216,-3.04034230412285,27,24,3,45,40,5,65,52,13,5,1,0,0
"20984","T.B","COL",2014020889,16488,20142015,0,60,4,5,-1,3.57610992495029,1.85728476831947,1.71882515663081,32,18,14,46,30,16,65,44,21,3,1,0,0
"20985","T.B","CHI",2014020920,16493,20142015,1,60,4,0,4,2.2517977236439,3.49658919787758,-1.24479147423368,29,28,1,44,36,8,61,50,11,6,3,0,0
"20986","T.B","FLA",2014020934,16495,20142015,0,60,3,4,-1,4.35552842906691,3.97031972345576,0.385208705611149,23,26,-3,39,40,-1,45,55,-10,6,7,0,0
"20987","T.B","BUF",2014020945,16497,20142015,1,60,3,0,3,3.91761303427456,4.28251958228066,-0.364906548006095,35,28,7,46,37,9,63,49,14,2,2,0,0
"20988","T.B","TOR",2014020959,16499,20142015,1,60,4,2,2,1.97353061137255,4.23998873744858,-2.26645812607603,31,27,4,40,38,2,54,59,-5,4,4,0,0
"20989","T.B","DAL",2014020972,16501,20142015,1,60,5,4,1,3.70801197557012,3.8780959378345,-0.170083962264385,28,35,-7,38,45,-7,51,55,-4,4,2,0,0
"20990","T.B","MTL",2014020994,16504,20142015,0,61.05,1,0,1,4.08478697351529,4.51552662758331,-0.43073965406802,36,19,17,43,24,19,75,38,37,4,1,0,0
"20991","T.B","BOS",2014021002,16506,20142015,0,65,2,2,0,5.18212341305957,5.05797410279047,0.124149310269104,37,30,7,48,47,1,59,56,3,3,5,0,0
"20992","T.B","WPG",2014021022,16508,20142015,1,60,1,2,-1,2.07843143017351,3.94704709425423,-1.86861566408072,16,29,-13,22,40,-18,40,49,-9,4,4,0,0
"20993","T.B","MTL",2014021038,16510,20142015,1,60,4,2,2,5.58305875718309,5.15870898176217,0.424349775420911,34,34,0,45,45,0,56,57,-1,5,5,0,0
"20994","T.B","DET",2014021064,16514,20142015,1,60,3,1,2,4.88567906990102,4.45674098748714,0.428938082413879,32,31,1,40,41,-1,51,47,4,4,4,0,0
"20995","T.B","BOS",2014021080,16516,20142015,1,60,5,3,2,1.96716631551681,2.60029728146037,-0.633130965943565,19,28,-9,25,35,-10,43,56,-13,2,3,0,0
"20996","T.B","FLA",2014021095,16518,20142015,1,60,4,3,1,1.76100228320593,5.49230392387835,-3.73130164067243,25,36,-11,33,44,-11,43,56,-13,0,2,0,0
"20997","T.B","NSH",2014021109,16520,20142015,1,60,2,3,-1,4.12646188662893,3.51520713263959,0.611254753989343,30,19,11,39,27,12,55,36,19,5,6,0,0
"20998","T.B","DET",2014021120,16522,20142015,0,60,0,4,-4,4.07477449820726,4.39750924908731,-0.322734750880045,23,23,0,35,38,-3,45,48,-3,7,5,0,0
"20999","T.B","MTL",2014021136,16524,20142015,0,60,5,3,2,5.29800597951726,3.67541786597576,1.6225881135415,44,28,16,53,37,16,66,58,8,6,4,0,0
"21000","T.B","TOR",2014021145,16525,20142015,0,60,1,3,-2,5.24066084333158,2.84939868916263,2.39126215416895,41,28,13,54,41,13,68,50,18,3,3,0,0
"21001","T.B","OTT",2014021155,16527,20142015,0,64.7166666666667,1,2,-1,3.40141987246079,6.31068895802309,-2.9092690855623,29,34,-5,44,45,-1,56,64,-8,5,6,0,0
"21002","T.B","FLA",2014021172,16529,20142015,0,60,4,0,4,2.74087065481823,6.85968519150629,-4.11881453668806,22,34,-12,34,52,-18,43,64,-21,1,4,0,0
"21003","T.B","MTL",2014021194,16356,20142015,1,60,7,1,6,6.58237516482907,3.92988229889306,2.65249286593601,41,17,24,51,30,21,60,48,12,7,6,0,0
"21004","T.B","N.J",2014021206,16534,20142015,1,61.3666666666667,4,3,1,3.32448372250656,1.49510739071944,1.82937633178712,31,24,7,42,31,11,64,48,16,8,3,0,0
"21005","T.B","BOS",2014021225,16536,20142015,1,65,2,2,0,5.32881510678271,3.89840592033966,1.43040918644305,25,38,-13,36,51,-15,47,75,-28,2,4,0,0
"21006","T.B","DET",2014030121,16541,20142015,1,60,2,3,-1,5.61902792713954,2.9926472754305,2.62638065170904,46,14,32,55,20,35,68,28,40,7,4,0,0
"21007","T.B","DET",2014030122,16543,20142015,1,60,5,1,4,3.67348214029334,2.60980155791503,1.06368058237831,30,24,6,38,37,1,48,58,-10,6,6,0,0
"21008","T.B","DET",2014030123,16546,20142015,0,60,0,3,-3,2.56540800095536,3.71621492190752,-1.15080692095216,22,21,1,31,29,2,41,34,7,7,5,0,0
"21009","T.B","DET",2014030124,16548,20142015,0,62.4166666666667,3,2,1,3.97260291831057,3.30010549814815,0.672497420162419,29,24,5,36,32,4,46,44,2,6,6,0,0
"21010","T.B","DET",2014030125,16550,20142015,1,60,0,4,-4,3.71035613166168,5.05608854512684,-1.34573241346516,28,30,-2,45,36,9,59,46,13,4,4,0,0
"21011","T.B","DET",2014030126,16552,20142015,0,60,5,2,3,4.15625622710832,4.0142318324506,0.14202439465771,28,24,4,35,40,-5,43,53,-10,6,11,0,0
"21012","T.B","DET",2014030127,16554,20142015,1,60,2,0,2,2.36475934928475,1.65712895914476,0.707630390139997,17,31,-14,25,40,-15,33,56,-23,5,4,0,0
"21013","T.B","MTL",2014030211,16556,20142015,0,80,1,1,0,5.68957837222842,10.0433503160748,-4.35377194384637,33,44,-11,41,56,-15,75,82,-7,4,3,0,0
"21014","T.B","MTL",2014030212,16558,20142015,0,60,6,2,4,3.66970146227115,5.48112794540498,-1.81142648313383,24,29,-5,25,38,-13,35,54,-19,9,4,0,0
"21015","T.B","MTL",2014030213,16561,20142015,1,60,2,1,1,4.29341584100621,5.64089974598028,-1.34748390497407,19,31,-12,31,52,-21,41,69,-28,3,2,0,0
"21016","T.B","MTL",2014030214,16562,20142015,1,60,2,6,-4,2.1978730604751,4.49508498137584,-2.29721192090074,24,40,-16,30,46,-16,41,56,-15,4,4,0,0
"21017","T.B","MTL",2014030215,16564,20142015,0,60,1,2,-1,4.75074309094634,5.89678231324069,-1.14603922229435,25,29,-4,35,45,-10,54,62,-8,4,6,0,0
"21018","T.B","MTL",2014030216,16567,20142015,1,60,4,1,3,6.33458884999527,3.11550664086826,3.21908220912701,28,19,9,35,29,6,47,40,7,2,2,0,0
"21019","T.B","NYR",2014030311,16571,20142015,0,60,1,2,-1,1.75338550437823,4.78279995801859,-3.02941445364036,24,30,-6,35,44,-9,50,61,-11,4,2,0,0
"21020","T.B","NYR",2014030312,16573,20142015,0,60,6,2,4,0,0,0,26,37,-11,31,46,-15,41,63,-22,6,6,0,0
"21021","T.B","NYR",2014030313,16575,20142015,1,63.55,6,5,1,6.18095610385678,3.32008766906802,2.86086843478877,40,28,12,50,45,5,64,58,6,3,5,0,0
"21022","T.B","NYR",2014030314,16577,20142015,1,60,1,5,-4,3.91291411113343,1.67790363889935,2.23501047223408,39,24,15,52,33,19,61,42,19,8,8,0,0
"21023","T.B","NYR",2014030315,16579,20142015,0,60,2,0,2,2.99478359262214,1.81046053469252,1.18432305792962,22,26,-4,31,34,-3,42,58,-16,4,5,0,0
"21024","T.B","NYR",2014030316,16581,20142015,1,60,3,7,-4,4.86016180553725,7.50158956153899,-2.64142775600175,39,34,5,48,43,5,65,55,10,4,4,0,0
"21025","T.B","NYR",2014030317,16584,20142015,0,60,2,0,2,3.49844614771428,3.47205524728633,0.0263909004279412,25,22,3,32,33,-1,44,53,-9,0,2,0,0
"21026","T.B","CHI",2014030411,16589,20142015,1,60,1,2,-1,4.06384769629221,3.05653861819883,1.00730907809339,23,21,2,34,37,-3,45,52,-7,2,3,0,0
"21027","T.B","CHI",2014030412,16592,20142015,1,60,4,3,1,1.81365973702941,5.46990353584988,-3.65624379882047,24,29,-5,36,40,-4,48,49,-1,3,3,0,0
"21028","T.B","CHI",2014030413,16594,20142015,0,60,3,2,1,5.57656384682923,5.88450596208077,-0.307942115251535,32,38,-6,37,48,-11,51,67,-16,3,3,0,0
"21029","T.B","CHI",2014030414,16596,20142015,0,60,1,2,-1,3.55211690050783,2.07787842125981,1.47423847924802,25,19,6,38,28,10,61,45,16,4,3,0,0
"21030","T.B","CHI",2014030415,16599,20142015,1,60,1,2,-1,6.21799716673518,4.75049657642376,1.46750059031142,32,29,3,43,40,3,61,56,5,1,2,0,0
"21031","T.B","CHI",2014030416,16601,20142015,0,60,0,2,-2,5.5245464678826,5.0149532277137,0.509593240168897,25,32,-7,35,46,-11,60,58,2,1,3,0,0
"21032","T.B","PHI",2015020007,16716,20152016,1,62.2833333333333,3,2,1,5.78601300620176,3.11363595425202,2.67237705194974,32,25,7,44,37,7,50,51,-1,3,5,0,0
"21033","T.B","BUF",2015020017,16718,20152016,0,60,4,1,3,0,0,0,31,25,6,44,38,6,54,51,3,3,2,0,0
"21034","T.B","BOS",2015020032,16720,20152016,0,60,6,3,3,4.61401972810563,4.2180321252672,0.395987602838431,23,30,-7,39,39,0,48,49,-1,4,4,0,0
"21035","T.B","DET",2015020042,16721,20152016,0,60,1,3,-2,3.59693738802889,5.8811122461334,-2.28417485810451,21,24,-3,34,40,-6,44,57,-13,3,3,0,0
"21036","T.B","DAL",2015020054,16723,20152016,1,60,3,5,-2,4.18447632336814,1.95706698174763,2.22740934162051,33,22,11,56,29,27,70,37,33,3,2,0,0
"21037","T.B","BUF",2015020067,16725,20152016,1,60,2,1,1,4.98305422749507,2.77065921492399,2.21239501257108,22,32,-10,43,39,4,55,47,8,4,3,0,0
"21038","T.B","NSH",2015020086,16728,20152016,0,65,4,4,0,5.46102035895456,6.38786876616541,-0.926848407210855,29,33,-4,41,47,-6,58,61,-3,2,3,0,0
"21039","T.B","WPG",2015020102,16731,20152016,0,60.6,4,3,1,3.97565234913054,9.57216506521218,-5.59651271608163,31,36,-5,40,55,-15,54,67,-13,4,3,0,0
"21040","T.B","CHI",2015020114,16732,20152016,0,60.2833333333333,0,1,-1,3.09064455414773,4.07266866521331,-0.982024111065584,21,32,-11,30,44,-14,51,66,-15,4,3,0,0
"21041","T.B","STL",2015020129,16735,20152016,0,60,0,2,-2,2.42252145317616,3.21259563670174,-0.790074183525576,26,24,2,36,35,1,53,45,8,1,3,0,0
"21042","T.B","COL",2015020140,16737,20152016,1,60,1,2,-1,4.8944035326452,3.55584822346282,1.33855530918238,35,26,9,46,36,10,66,43,23,5,7,0,0
"21043","T.B","BOS",2015020159,16739,20152016,1,60,1,3,-2,4.86264840466902,4.53386323100676,0.328785173662254,22,34,-12,37,44,-7,51,53,-2,5,3,0,0
"21044","T.B","CAR",2015020165,16740,20152016,0,60,4,3,1,6.14613615952726,6.8626283070771,-0.716492147549843,31,35,-4,48,50,-2,57,62,-5,4,2,0,0
"21045","T.B","DET",2015020176,16742,20152016,0,60,1,2,-1,5.07748069474474,3.807164542377,1.27031615236774,30,29,1,36,34,2,49,40,9,5,4,0,0
"21046","T.B","BUF",2015020185,16744,20152016,0,60,4,1,3,3.53709479016834,1.91346475846537,1.62363003170297,22,31,-9,30,44,-14,38,62,-24,3,2,0,0
"21047","T.B","MIN",2015020207,16746,20152016,0,60,0,1,-1,5.02125101867034,5.3117217473191,-0.290470728648756,31,25,6,45,41,4,53,48,5,2,3,0,0
"21048","T.B","BUF",2015020221,16749,20152016,1,60,1,4,-3,4.05483303685722,3.36451987710461,0.690313159752611,31,27,4,47,32,15,67,45,22,5,3,0,0
"21049","T.B","CGY",2015020235,16751,20152016,1,60,3,1,2,3.69453964332206,4.62726565229241,-0.932726008970349,29,31,-2,40,46,-6,61,58,3,2,4,0,0
"21050","T.B","FLA",2015020251,16753,20152016,1,65,4,4,0,4.17573249063207,4.33540584900766,-0.159673358375585,28,23,5,48,33,15,56,49,7,5,7,0,0
"21051","T.B","FLA",2015020265,16755,20152016,0,60,0,1,-1,3.73266536348956,4.36559381736515,-0.632928453875593,39,20,19,49,31,18,59,42,17,4,4,0,0
"21052","T.B","NYR",2015020284,16758,20152016,1,60,2,1,1,1.91989221281256,2.84034400599194,-0.920451793179382,28,21,7,36,30,6,52,46,6,5,6,0,0
"21053","T.B","ANA",2015020295,16760,20152016,1,60,5,0,5,4.95962755015353,5.44671169448611,-0.487084144332578,24,30,-6,41,44,-3,56,53,3,7,4,0,0
"21054","T.B","L.A",2015020326,16764,20152016,1,65,1,1,0,2.65249338610738,3.99150167830521,-1.33900829219783,30,38,-8,43,48,-5,58,64,-6,3,0,0,0
"21055","T.B","WSH",2015020334,16766,20152016,0,60,2,4,-2,6.33765675974428,5.09376973009785,1.24388702964643,34,37,-3,40,50,-10,56,62,-6,3,5,0,0
"21056","T.B","NYI",2015020345,16767,20152016,1,60,2,3,-1,2.85049896744391,1.37784937023685,1.47264959720707,31,22,9,44,30,14,59,36,23,5,3,0,0
"21057","T.B","ANA",2015020372,16771,20152016,0,60,2,1,1,3.17060209214105,4.11322472883569,-0.942622636694637,22,33,-11,36,46,-10,48,64,-16,4,4,0,0
"21058","T.B","S.J",2015020397,16774,20152016,0,60,4,3,1,2.76531347594836,6.21604675101116,-3.4507332750628,20,34,-14,25,45,-20,38,69,-31,4,8,0,0
"21059","T.B","L.A",2015020404,16775,20152016,0,60,1,3,-2,2.95206115971041,6.52207406079364,-3.57001290108323,25,28,-3,33,41,-8,45,54,-9,7,5,0,0
"21060","T.B","OTT",2015020422,16779,20152016,1,60,4,1,3,6.20208460362186,2.59191091312096,3.61017369050091,30,31,-1,38,45,-7,48,58,-10,4,4,0,0
"21061","T.B","WSH",2015020438,16781,20152016,1,60,1,2,-1,4.20811477169627,1.89697856173468,2.31113620996159,36,20,16,54,39,15,77,49,28,4,2,0,0
"21062","T.B","CBJ",2015020450,16783,20152016,0,60,2,1,1,0,0,0,29,26,3,36,40,-4,54,57,-3,2,2,0,0
"21063","T.B","TOR",2015020457,16784,20152016,0,62.0166666666667,5,4,1,5.41183855739655,6.59795917599695,-1.1861206186004,27,37,-10,44,57,-13,55,77,-22,3,3,0,0
"21064","T.B","WSH",2015020478,16787,20152016,0,60,3,5,-2,3.21737911878154,6.04440540339196,-2.82702628461042,19,23,-4,35,38,-3,56,52,4,4,5,0,0
"21065","T.B","OTT",2015020495,16789,20152016,1,60,5,2,3,5.14701411289343,3.5382399373193,1.60877417557413,35,25,10,44,29,15,60,40,20,2,6,0,0
"21066","T.B","VAN",2015020510,16791,20152016,1,60,1,2,-1,2.45146456159091,3.30248990555306,-0.851025343962153,27,19,8,47,30,17,65,34,31,12,3,0,0
"21067","T.B","CBJ",2015020518,16795,20152016,1,60,5,2,3,5.77970272316452,2.38274456536805,3.39695815779647,25,32,-7,36,40,-4,53,51,2,6,4,0,0
"21068","T.B","MTL",2015020536,16797,20152016,1,65,3,3,0,3.55271357319725,3.82582249910577,-0.27310892590852,39,34,5,52,46,6,68,51,17,3,1,0,0
"21069","T.B","NYR",2015020554,16799,20152016,1,60,2,5,-3,4.89467794777011,5.65716390789021,-0.762485960120102,22,26,-4,36,36,0,51,52,-1,5,3,0,0
"21070","T.B","MIN",2015020571,16802,20152016,1,65,2,2,0,5.70955719168705,3.15048373339232,2.55907345829473,30,32,-2,47,40,7,54,57,-3,1,4,0,0
"21071","T.B","CGY",2015020595,16805,20152016,0,60,1,3,-2,4.88097422354622,5.57885550387437,-0.697881280328147,31,24,7,42,44,-2,59,58,1,0,1,0,0
"21072","T.B","EDM",2015020612,16808,20152016,0,60,3,2,1,3.75812811870337,2.65693706586899,1.10119105283438,27,26,1,36,40,-4,55,53,2,3,3,0,0
"21073","T.B","VAN",2015020622,16809,20152016,0,63.85,3,2,1,4.05533241729427,2.85083661883275,1.20449579846152,35,23,12,50,36,14,59,47,12,3,2,0,0
"21074","T.B","COL",2015020640,16812,20152016,0,60,4,0,4,8.53345121220627,4.65972959855571,3.87372161365056,38,21,17,59,28,31,73,42,31,4,2,0,0
"21075","T.B","PIT",2015020657,16815,20152016,1,62.1833333333333,5,4,1,2.49661722924429,4.22799386963015,-1.73137664038586,25,40,-15,31,54,-23,45,73,-28,5,4,0,0
"21076","T.B","FLA",2015020672,16817,20152016,1,60,3,1,2,5.15532824982836,5.94865372776985,-0.793325477941496,32,27,5,44,40,4,55,50,5,2,5,0,0
"21077","T.B","EDM",2015020687,16819,20152016,1,60,6,4,2,3.20417172880824,4.17531532341728,-0.971143594609036,31,26,5,42,37,5,51,45,6,3,5,0,0
"21078","T.B","CHI",2015020698,16821,20152016,1,60,2,1,1,3.33662687218748,3.20243692190373,0.13418995028375,33,18,15,45,30,15,56,36,20,4,3,0,0
"21079","T.B","FLA",2015020714,16823,20152016,0,60,2,5,-3,5.15028507420357,5.56109958201341,-0.410814507809846,40,35,5,48,41,7,57,48,9,5,4,0,0
"21080","T.B","TOR",2015020740,16827,20152016,1,60,1,0,1,2.87713398820779,3.18494507122494,-0.307811083017157,29,30,-1,40,42,-2,52,58,-6,7,4,0,0
"21081","T.B","DET",2015020757,16834,20152016,1,60,3,1,2,2.63541654020082,3.7296703827451,-1.09425384254428,23,25,-2,36,39,-3,43,55,-12,5,4,0,0
"21082","T.B","PIT",2015020771,16836,20152016,1,60,6,3,3,4.43796090531674,3.19591251795646,1.24204838736028,29,30,-1,37,43,-6,49,55,-6,2,3,0,0
"21083","T.B","OTT",2015020792,16839,20152016,0,60,1,5,-4,5.15515005699066,4.2377948918147,0.917355165175962,32,29,3,42,38,4,59,49,10,4,7,0,0
"21084","T.B","MTL",2015020799,16840,20152016,0,60,2,4,-2,5.75998818760854,5.56517778220586,0.194810405402677,39,27,12,57,39,18,79,50,29,3,2,0,0
"21085","T.B","NSH",2015020822,16843,20152016,1,61.0666666666667,4,3,1,4.37557793816086,3.66364012773583,0.711937810425027,28,30,-2,40,35,5,51,40,11,3,2,0,0
"21086","T.B","STL",2015020838,16845,20152016,1,60,1,2,-1,4.20105974408242,3.9292065858026,0.271853158279817,38,21,17,50,32,18,69,44,25,3,3,0,0
"21087","T.B","S.J",2015020852,16847,20152016,1,60,2,4,-2,6.94001454190584,3.89052163175074,3.0494929101551,30,31,-1,46,42,4,58,55,3,2,3,0,0
"21088","T.B","WPG",2015020862,16849,20152016,1,65,5,5,0,4.22122003124241,6.02998466229838,-1.80876463105596,26,41,-15,41,50,-9,53,61,-8,8,6,0,0
"21089","T.B","PIT",2015020874,16851,20152016,0,60,4,2,2,4.65602036373457,4.66127430519368,-0.00525394145910774,20,39,-19,25,54,-29,35,67,-32,8,7,0,0
"21090","T.B","CAR",2015020886,16852,20152016,0,60,4,2,2,4.08298169308546,5.33374878708129,-1.25076709399583,18,31,-13,28,43,-15,45,57,-12,5,3,0,0
"21091","T.B","ARI",2015020897,16854,20152016,1,60,2,1,1,1.83321217593038,5.63294910534751,-3.79973692941712,36,30,6,44,41,3,66,57,9,4,3,0,0
"21092","T.B","N.J",2015020916,16857,20152016,0,60,4,0,4,6.65829646547627,3.45584217942087,3.2024542860554,36,21,15,44,29,15,55,35,20,7,2,0,0
"21093","T.B","BOS",2015020933,16859,20152016,0,60,4,1,3,2.48919144376785,3.43075470465286,-0.941563260885005,30,33,-3,40,43,-3,47,62,-15,5,7,0,0
"21094","T.B","TOR",2015020940,16860,20152016,0,60,2,1,1,3.21666556609853,4.60498767415993,-1.3883221080614,28,32,-4,37,54,-17,54,70,-16,2,3,0,0
"21095","T.B","OTT",2015020959,16863,20152016,0,60,4,1,3,5.20524509620736,5.89705316371601,-0.691808067508646,29,34,-5,39,51,-12,54,71,-17,2,5,0,0
"21096","T.B","CAR",2015020975,16865,20152016,1,64.2833333333333,4,3,1,4.19239802742959,3.28117302436646,0.911225003063131,30,27,3,44,36,8,56,49,7,4,3,0,0
"21097","T.B","PHI",2015020986,16867,20152016,0,60,2,4,-2,3.56414216442499,7.44714297307655,-3.88300080865156,18,40,-22,33,58,-25,44,90,-46,2,5,0,0
"21098","T.B","BOS",2015020998,16868,20152016,1,60.1666666666667,0,1,-1,4.93829457723768,3.29337109066864,1.64492348656904,42,33,9,57,35,22,74,42,32,5,1,0,0
"21099","T.B","PHI",2015021014,16871,20152016,1,60,1,3,-2,1.61485276393068,2.42868182662642,-0.813829062695731,19,23,-4,30,33,-3,50,41,9,2,4,0,0
"21100","T.B","CBJ",2015021031,16873,20152016,0,60,4,0,4,3.14483226749554,4.50851855036308,-1.36368628286754,37,37,0,40,51,-11,51,60,-9,6,6,0,0
"21101","T.B","TOR",2015021042,16875,20152016,0,60,1,4,-3,3.66898545171489,5.34022671825174,-1.67124126653685,27,24,3,48,36,12,71,57,14,5,5,0,0
"21102","T.B","DAL",2015021058,16877,20152016,0,60,3,4,-1,3.05707620381145,6.18032461043913,-3.12324840662768,20,33,-13,34,48,-14,54,58,-4,1,1,0,0
"21103","T.B","ARI",2015021076,16879,20152016,0,60,2,0,2,5.22356415222022,3.56113221832345,1.66243193389677,36,32,4,48,44,4,65,55,10,6,7,0,0
"21104","T.B","DET",2015021093,16882,20152016,1,60,6,2,4,4.72944847820327,2.68307062408712,2.04637785411614,34,25,9,48,35,13,51,49,2,6,3,0,0
"21105","T.B","NYI",2015021113,16885,20152016,1,60,7,4,3,5.33323938393733,2.63213818112854,2.70110120280879,42,31,11,51,34,17,67,49,18,3,3,0,0
"21106","T.B","FLA",2015021122,16886,20152016,1,60,2,5,-3,2.24449170154261,3.17795350635424,-0.933461804811628,35,27,8,44,38,6,58,49,9,6,5,0,0
"21107","T.B","TOR",2015021135,16888,20152016,1,60,3,0,3,1.20693009252864,3.71880528739712,-2.51187519486848,18,34,-16,29,49,-20,36,63,-27,5,10,0,0
"21108","T.B","MTL",2015021156,16891,20152016,1,60,0,3,-3,2.6900539034611,3.15823371130591,-0.46817980784481,26,24,2,39,35,4,57,46,11,4,1,0,0
"21109","T.B","N.J",2015021171,16893,20152016,1,60,3,1,2,4.25172691208547,2.69316597046486,1.55856094162061,36,26,10,48,38,10,68,49,19,8,7,0,0
"21110","T.B","NYI",2015021183,16895,20152016,0,60,2,5,-3,4.24632376048248,5.47487638150897,-1.22855262102648,34,36,-2,45,45,0,64,53,11,5,3,0,0
"21111","T.B","NYR",2015021190,16896,20152016,0,60,2,3,-1,5.42748686653067,3.11685270412863,2.31063416240204,41,28,13,54,39,15,69,50,19,6,6,0,0
"21112","T.B","N.J",2015021203,16898,20152016,0,60,4,2,2,3.217054245295,5.68773917739122,-2.47068493209622,22,22,0,30,32,-2,41,39,2,4,3,0,0
"21113","T.B","MTL",2015021220,16900,20152016,0,60,2,5,-3,3.2197288008465,5.44328283327542,-2.22355403242892,23,29,-6,32,43,-11,49,53,-4,2,7,0,0
"21114","T.B","DET",2015030121,16904,20152016,1,60,3,2,1,2.98645151379606,4.29669838330241,-1.31024686950636,34,36,-2,46,46,0,56,61,-5,9,9,0,0
"21115","T.B","DET",2015030122,16906,20152016,1,60,5,2,3,4.40902824337172,3.30837136578339,1.10065687758834,31,32,-1,44,36,8,58,51,7,9,8,0,0
"21116","T.B","DET",2015030123,16908,20152016,0,60,0,2,-2,1.45697866009505,4.48245757693076,-3.02547891683571,16,30,-14,22,45,-23,36,63,-27,5,10,0,0
"21117","T.B","DET",2015030124,16910,20152016,0,60,3,2,1,6.14082669757772,3.3646694323761,2.77615726520162,33,28,5,46,37,9,58,52,6,6,5,0,0
"21118","T.B","DET",2015030125,16912,20152016,1,60,1,0,1,4.54558245372027,4.17530630449266,0.370276149227607,24,34,-10,39,47,-8,51,66,-15,4,4,0,0
"21119","T.B","NYI",2015030211,16918,20152016,1,60,3,5,-2,7.83958609533001,2.56845681142295,5.27112928390706,36,22,14,50,34,16,65,44,21,2,4,0,0
"21120","T.B","NYI",2015030212,16921,20152016,1,60,4,1,3,4.59430397327484,2.33838220626352,2.25592176701131,31,20,11,45,32,13,59,39,20,9,8,0,0
"21121","T.B","NYI",2015030213,16924,20152016,0,62.8,5,4,1,3.3455042891218,4.5368037922928,-1.191299503171,41,39,2,50,47,3,73,59,14,5,5,0,0
"21122","T.B","NYI",2015030214,16927,20152016,0,61.5666666666667,2,1,1,3.49401092351764,4.69377812949369,-1.19976720597606,24,28,-4,35,45,-10,45,67,-22,3,3,0,0
"21123","T.B","NYI",2015030215,16929,20152016,1,60,4,0,4,2.90983529287041,3.54089566918365,-0.631060376313242,25,28,-3,41,42,-1,57,51,6,7,4,0,0
"21124","T.B","PIT",2015030311,16934,20152016,0,60,3,1,2,3.5968352547934,7.61042097256723,-4.01358571777382,20,35,-15,31,50,-19,41,70,-29,3,3,0,0
"21125","T.B","PIT",2015030312,16937,20152016,0,60.6666666666667,2,3,-1,4.63792985060718,5.40049709903542,-0.76256724842824,21,41,-20,31,52,-21,44,69,-25,1,2,0,0
"21126","T.B","PIT",2015030313,16939,20152016,1,60,2,4,-2,2.72033966913477,3.91711379593471,-1.19677412679994,28,48,-20,38,65,-27,50,78,-28,3,5,0,0
"21127","T.B","PIT",2015030314,16941,20152016,1,60,4,3,1,3.00379403739601,4.70891798290154,-1.70512394550553,37,38,-1,42,51,-9,48,65,-17,6,6,0,0
"21128","T.B","PIT",2015030315,16943,20152016,0,60.8833333333333,4,3,1,2.57140130227764,4.14380598528078,-1.57240468300314,25,34,-9,34,46,-12,56,54,2,3,4,0,0
"21129","T.B","PIT",2015030316,16945,20152016,1,60,2,5,-3,7.70856511702004,8.25922388094659,-0.550658763926549,31,34,-3,45,47,-2,60,55,5,1,3,0,0
"21130","T.B","PIT",2015030317,16947,20152016,0,60,1,2,-1,2.07695781174698,4.49484753631987,-2.41788972457289,17,39,-22,25,49,-24,42,64,-22,3,6,0,0
"21131","T.B","DET",2016020009,17087,20162017,1,60,6,4,2,6.62145291393972,3.31833235718659,3.30312055675313,36,32,4,54,38,16,74,47,27,9,5,0,0
"21132","T.B","N.J",2016020019,17089,20162017,1,60,3,2,1,4.42460019034684,3.25054511860071,1.17405507174612,34,34,0,47,42,5,59,53,6,4,5,0,0
"21133","T.B","FLA",2016020042,17092,20162017,1,65,3,3,0,3.63268053789773,4.63455839572907,-1.00187785783135,28,31,-3,36,46,-10,43,53,-10,4,4,0,0
"21134","T.B","COL",2016020055,17094,20162017,1,60,0,4,-4,3.58431644110988,2.55018636291879,1.03413007819108,27,16,11,41,29,12,60,36,24,3,2,0,0
"21135","T.B","OTT",2016020066,17096,20162017,0,60,4,1,3,4.38957074974314,4.10216384955129,0.287406900191854,35,28,7,44,34,10,59,51,8,4,3,0,0
"21136","T.B","TOR",2016020087,17099,20162017,0,60,7,3,4,3.60949801036622,4.71990080355317,-1.11040279318695,24,43,-19,31,57,-26,40,70,-30,3,4,0,0
"21137","T.B","MTL",2016020102,17101,20162017,0,60,1,3,-2,6.35974119714228,5.67226519688847,0.68747600025381,31,26,5,43,32,11,61,45,16,3,3,0,0
"21138","T.B","N.J",2016020116,17103,20162017,0,60,1,3,-2,3.87305033934535,4.2635041832109,-0.390453843865544,33,23,10,47,30,17,55,32,23,4,1,0,0
"21139","T.B","NYR",2016020127,17104,20162017,0,60,1,6,-5,5.28117969620507,4.50930415249331,0.771875543711758,32,37,-5,45,53,-8,60,70,-10,4,5,0,0
"21140","T.B","NYI",2016020131,17106,20162017,0,60,6,1,5,4.10333530566717,3.99711120939673,0.106224096270438,36,27,9,45,35,10,58,49,9,7,6,0,0
"21141","T.B","BOS",2016020151,17108,20162017,1,65,3,3,0,5.57001027523074,3.65274942375254,1.9172608514782,30,31,-1,38,38,0,52,55,-3,4,4,0,0
"21142","T.B","N.J",2016020166,17110,20162017,1,60,4,1,3,6.3814278690711,5.18928807909833,1.19213978997277,35,38,-3,43,51,-8,60,64,-4,5,5,0,0
"21143","T.B","FLA",2016020182,17112,20162017,0,60,1,3,-2,6.88748112831627,5.9630258360412,0.92445529227507,35,32,3,52,42,10,61,58,3,3,4,0,0
"21144","T.B","NYI",2016020201,17115,20162017,1,60,4,1,3,2.68526191171259,5.1100230340145,-2.42476112230192,28,32,-4,39,43,-4,59,58,1,6,1,0,0
"21145","T.B","S.J",2016020213,17117,20162017,1,60,1,3,-2,4.36336312860658,3.20202445390169,1.16133867470489,26,20,6,39,30,9,55,39,16,2,2,0,0
"21146","T.B","NYI",2016020229,17119,20162017,0,60,4,0,4,4.60897436452797,5.89765777438879,-1.28868340986082,31,34,-3,39,46,-7,55,64,-9,4,4,0,0
"21147","T.B","DET",2016020235,17120,20162017,0,60,4,3,1,3.12305224165902,5.53454108290969,-2.41148884125067,22,28,-6,32,40,-8,38,50,-12,4,5,0,0
"21148","T.B","BUF",2016020245,17122,20162017,0,60,4,1,3,5.37233657405068,4.65649823971034,0.715838334340333,38,33,5,43,39,4,55,49,6,4,6,0,0
"21149","T.B","PHI",2016020260,17124,20162017,0,60,3,0,3,1.45345143789018,3.96767137981553,-2.51421994192535,18,32,-14,23,49,-26,29,70,-41,3,6,0,0
"21150","T.B","NSH",2016020279,17126,20162017,0,60,1,3,-2,3.15363935905043,4.20233389710484,-1.04869453805441,25,30,-5,36,40,-4,43,47,-4,3,6,0,0
"21151","T.B","PHI",2016020294,17128,20162017,1,60,4,2,2,4.42021291358571,6.42122784377058,-2.00101493018487,29,31,-2,43,43,0,64,56,8,7,4,0,0
"21152","T.B","CBJ",2016020309,17130,20162017,1,60,3,5,-2,4.95202908208012,8.44442206982058,-3.49239298774046,28,38,-10,44,49,-5,54,63,-9,3,4,0,0
"21153","T.B","BOS",2016020322,17132,20162017,0,60,1,4,-3,6.07643534688395,3.75533586684162,2.32109948004234,31,30,1,51,43,8,63,50,13,3,2,0,0
"21154","T.B","CBJ",2016020332,17134,20162017,0,60,1,5,-4,4.69676208472811,7.44907993235191,-2.7523178476238,27,38,-11,40,51,-11,55,60,-5,1,1,0,0
"21155","T.B","STL",2016020351,17136,20162017,0,60,4,5,-1,3.13239458187309,4.03314892095341,-0.900754339080322,26,26,0,38,40,-2,50,49,1,2,7,0,0
"21156","T.B","WSH",2016020364,17138,20162017,1,65,1,1,0,4.71037839169147,6.32961897832408,-1.61924058663261,33,35,-2,40,48,-8,45,63,-18,3,6,0,0
"21157","T.B","CAR",2016020371,17139,20162017,0,61.4333333333333,0,1,-1,6.89772097712607,4.18848439373596,2.7092365833901,30,30,0,43,46,-3,55,64,-9,5,4,0,0
"21158","T.B","VAN",2016020399,17143,20162017,1,60,1,5,-4,6.01306335508534,4.45716143850586,1.55590191657947,41,30,11,56,41,15,74,50,24,3,3,0,0
"21159","T.B","PIT",2016020415,17145,20162017,1,60,3,4,-1,2.27589076274307,3.19831623830211,-0.922425475559036,23,37,-14,31,43,-12,40,55,-15,5,6,0,0
"21160","T.B","CGY",2016020443,17149,20162017,0,60,6,3,3,6.16230521773597,1.17778584090833,4.98451937682764,35,22,13,47,29,18,58,46,12,6,5,0,0
"21161","T.B","VAN",2016020459,17151,20162017,0,60,2,4,-2,1.96629808639409,6.74128042045049,-4.7749823340564,27,24,3,35,33,2,41,51,-10,2,2,0,0
"21162","T.B","EDM",2016020469,17152,20162017,0,65,2,2,0,5.97147616496659,5.3069506914045,0.664525473562094,33,32,1,48,45,3,64,58,6,4,6,0,0
"21163","T.B","DET",2016020486,17155,20162017,1,60,4,1,3,3.94054173292193,2.14657918106195,1.79396255185998,31,27,4,42,36,6,53,48,5,7,6,0,0
"21164","T.B","STL",2016020500,17157,20162017,1,60,5,2,3,5.65694947354496,3.40424391254783,2.25270556099713,32,23,9,43,31,12,50,42,8,3,2,0,0
"21165","T.B","WSH",2016020508,17158,20162017,0,60,0,4,-4,3.53421088348841,4.59895454560779,-1.06474366211938,23,27,-4,34,43,-9,53,52,1,3,2,0,0
"21166","T.B","MTL",2016020529,17163,20162017,1,61.6,4,3,1,4.25483505276497,2.85103295178851,1.40380210097646,30,22,8,37,30,7,51,39,12,3,2,0,0
"21167","T.B","TOR",2016020535,17164,20162017,1,63.6166666666667,2,3,-1,4.26974248520522,3.26881527460864,1.00092721059658,27,35,-8,45,51,-6,63,63,0,5,5,0,0
"21168","T.B","CAR",2016020551,17166,20162017,1,60,3,1,2,3.26486362286596,2.80683565320214,0.458027969663817,25,27,-2,35,37,-2,47,52,-5,3,4,0,0
"21169","T.B","WPG",2016020569,17169,20162017,1,60,4,6,-2,5.01507108134319,5.26358302993685,-0.248511948593659,36,34,2,45,45,0,57,62,-5,7,6,0,0
"21170","T.B","NSH",2016020580,17171,20162017,1,60,1,6,-5,4.9795613326828,3.10374411684259,1.87581721584021,28,19,9,45,29,16,69,35,34,6,5,0,0
"21171","T.B","PHI",2016020592,17173,20162017,0,60,2,4,-2,4.76405043661362,3.38905340418341,1.3749970324302,26,44,-18,34,54,-20,50,67,-17,3,3,0,0
"21172","T.B","PIT",2016020603,17174,20162017,0,60,2,6,-4,5.51858171218191,4.05483511760488,1.46374659457703,30,40,-10,43,49,-6,61,63,-2,4,3,0,0
"21173","T.B","BUF",2016020626,17178,20162017,1,60,4,2,2,4.27042571264246,4.0223287352419,0.248096977400564,29,26,3,37,34,3,52,45,7,5,4,0,0
"21174","T.B","CBJ",2016020635,17179,20162017,1,60,1,3,-2,3.34422657372005,7.08219391657622,-3.73796734285616,32,31,1,45,41,4,63,50,13,3,4,0,0
"21175","T.B","L.A",2016020659,17182,20162017,0,60,2,1,1,4.6215562150901,3.91934127945569,0.702214935634402,29,32,-3,47,50,-3,58,70,-12,2,3,0,0
"21176","T.B","ANA",2016020671,17183,20162017,0,60.9,1,2,-1,3.45535122937508,2.88658740739981,0.568763821975275,28,21,7,42,31,11,64,49,15,3,5,0,0
"21177","T.B","S.J",2016020684,17185,20162017,0,60,1,2,-1,4.29770228685811,4.74507867440116,-0.447376387543045,25,24,1,39,37,2,56,50,6,4,2,0,0
"21178","T.B","ARI",2016020698,17187,20162017,0,60,3,5,-2,4.70738324493868,3.52212772848009,1.1852555164586,48,23,25,68,38,30,88,47,41,5,3,0,0
"21179","T.B","CHI",2016020722,17190,20162017,0,60,5,2,3,8.85386913631058,4.58636194687125,4.26750718943933,36,36,0,49,40,9,59,57,2,2,3,0,0
"21180","T.B","FLA",2016020734,17192,20162017,0,61.8166666666667,1,2,-1,6.10878075956134,7.3777161938915,-1.26893543433016,32,37,-5,41,47,-6,54,54,0,5,4,0,0
"21181","T.B","BOS",2016020747,17197,20162017,1,60,3,4,-1,2.63426091731526,4.98042666498804,-2.34616574767279,21,35,-14,33,48,-15,45,57,-12,4,3,0,0
"21182","T.B","OTT",2016020760,17199,20162017,1,60,2,5,-3,4.90150683058891,4.3951491190237,0.506357711565215,21,30,-9,34,43,-9,50,63,-13,3,5,0,0
"21183","T.B","ANA",2016020776,17201,20162017,1,65,2,2,0,7.67079092935747,2.41246599180158,5.25832493755589,37,16,21,61,27,34,82,39,43,8,7,0,0
"21184","T.B","L.A",2016020797,17204,20162017,1,60,5,0,5,3.10060407567653,2.74847256031353,0.352131515362998,21,28,-7,33,41,-8,44,57,-13,4,4,0,0
"21185","T.B","MIN",2016020813,17207,20162017,0,65,1,1,0,5.99493474993687,5.70944191519811,0.285492834738761,27,38,-11,43,48,-5,63,57,6,3,4,0,0
"21186","T.B","WPG",2016020825,17208,20162017,0,60,4,1,3,4.06084054600797,5.46150239007761,-1.40066184406965,30,33,-3,37,46,-9,47,59,-12,3,4,0,0
"21187","T.B","DAL",2016020864,17215,20162017,0,63.7833333333333,3,4,-1,4.57773861463972,5.15998896176461,-0.582250347124889,37,28,9,56,44,12,79,57,22,2,2,0,0
"21188","T.B","COL",2016020876,17216,20162017,0,62.45,3,2,1,2.38721195349087,5.28984848855544,-2.90263653506456,40,29,11,52,46,6,64,61,3,2,4,0,0
"21189","T.B","EDM",2016020887,17218,20162017,1,60,4,1,3,4.83608367183479,2.62570367514854,2.21037999668624,28,21,7,39,31,8,57,41,16,2,2,0,0
"21190","T.B","CGY",2016020896,17220,20162017,1,60,2,3,-1,1.96246351143054,3.51317675826294,-1.5507132468324,25,25,0,36,37,-1,46,47,-1,3,4,0,0
"21191","T.B","OTT",2016020920,17224,20162017,1,60,5,1,4,4.14862444496248,5.15562204501856,-1.00699760005608,34,40,-6,49,43,6,58,54,4,7,9,0,0
"21192","T.B","CAR",2016020934,17226,20162017,1,60.7666666666667,4,3,1,4.03261364405625,1.76217477450166,2.2704388695546,16,31,-15,39,43,-4,51,56,-5,4,2,0,0
"21193","T.B","PIT",2016020946,17228,20162017,0,60,2,5,-3,3.55841908727598,6.65875478832005,-3.10033570104407,29,35,-6,34,53,-19,57,64,-7,3,3,0,0
"21194","T.B","BUF",2016020953,17229,20162017,0,65,1,1,0,4.83698548987741,2.27697228131001,2.5600132085674,32,32,0,46,41,5,59,50,9,2,3,0,0
"21195","T.B","NYR",2016020971,17231,20162017,1,63.9333333333333,0,1,-1,4.46924016363019,5.18505138243199,-0.715811218801804,38,34,4,53,43,10,66,47,19,7,5,0,0
"21196","T.B","MIN",2016020987,17234,20162017,1,60,4,1,3,3.54060527221549,4.80070134823461,-1.26009607601912,29,33,-4,36,47,-11,47,55,-8,3,4,0,0
"21197","T.B","FLA",2016021003,17236,20162017,1,60,3,2,1,6.20109532878269,3.79184963279658,2.4092456959861,34,34,0,47,41,6,57,51,6,6,5,0,0
"21198","T.B","NYR",2016021017,17238,20162017,0,60,3,2,1,4.33818793507817,4.43574369447015,-0.0975557593919802,16,28,-12,30,41,-11,40,55,-15,2,1,0,0
"21199","T.B","OTT",2016021028,17239,20162017,0,64.1,2,1,1,6.80569218005985,4.69190518473488,2.11378699532497,37,32,5,51,45,6,75,64,11,1,2,0,0
"21200","T.B","TOR",2016021043,17241,20162017,1,60,0,5,-5,2.56227319019922,3.31609617255162,-0.753822982352403,33,21,12,52,33,19,69,42,27,7,5,0,0
"21201","T.B","WSH",2016021057,17243,20162017,1,60,3,5,-2,5.56228132965043,5.85244212869293,-0.290160799042496,29,35,-6,41,47,-6,52,65,-13,3,4,0,0
"21202","T.B","ARI",2016021080,17246,20162017,1,60,3,5,-2,4.50173742920742,4.21154600579757,0.290191423409851,39,35,4,55,39,16,80,45,35,5,4,0,0
"21203","T.B","BOS",2016021089,17248,20162017,0,60,6,3,3,4.1608899241,2.92275012737923,1.23813979672077,29,31,-2,35,34,1,47,47,0,7,6,0,0
"21204","T.B","DET",2016021102,17249,20162017,0,63.4666666666667,2,1,1,4.84757349499586,3.80102601148701,1.04654748350885,32,30,2,46,37,9,55,51,4,6,7,0,0
"21205","T.B","CHI",2016021124,17252,20162017,1,64.4166666666667,5,4,1,3.44302456657499,2.4916879972443,0.951336569330692,30,32,-2,51,34,17,74,44,30,3,3,0,0
"21206","T.B","DET",2016021145,17255,20162017,1,60,5,3,2,5.66400417888781,5.17330850870349,0.490695670184323,32,34,-2,43,54,-11,50,62,-12,3,3,0,0
"21207","T.B","MTL",2016021160,17257,20162017,1,60.85,1,2,-1,5.58569687654381,3.95765962576843,1.62803725077538,22,36,-14,39,55,-16,55,67,-12,2,2,0,0
"21208","T.B","DAL",2016021168,17258,20162017,1,60,6,3,3,4.42522797640413,2.48946332815103,1.9357646482531,25,26,-1,40,33,7,55,51,4,3,2,0,0
"21209","T.B","BOS",2016021179,17260,20162017,0,60,0,4,-4,2.32816608791472,5.28607019430274,-2.95790410638801,28,38,-10,36,51,-15,49,64,-15,1,2,0,0
"21210","T.B","TOR",2016021198,17262,20162017,0,60,4,1,3,2.89309727931585,2.11151918914402,0.78157809017183,30,27,3,44,47,-3,53,66,-13,3,4,0,0
"21211","T.B","MTL",2016021206,17263,20162017,0,60,4,2,2,3.7269486535634,6.68663202921016,-2.95968337564676,22,29,-7,30,43,-13,35,59,-24,2,4,0,0
"21212","T.B","BUF",2016021222,17265,20162017,1,60,4,2,2,4.00830653004589,4.70497723622248,-0.696670706176583,37,28,9,45,38,7,57,48,9,3,1,0,0
"21213","T.B","FLA",2017020014,17445,20172018,1,60,5,3,2,4.17761705723798,6.8594470747048,-2.68183001746682,25,36,-11,32,50,-18,44,67,-23,3,4,0,0
"21214","T.B","FLA",2017020018,17446,20172018,0,60,4,5,-1,0,0,0,30,48,-18,43,60,-17,56,73,-17,9,7,0,0
"21215","T.B","WSH",2017020036,17448,20172018,1,63.1333333333333,4,3,1,6.13337704397691,2.19014687341897,3.94323017055794,40,26,14,66,35,31,83,48,35,7,6,0,0
"21216","T.B","PIT",2017020051,17451,20172018,1,60,5,4,1,4.49723967013003,3.0479745939283,1.44926507620173,34,40,-6,47,55,-8,63,65,-2,5,5,0,0
"21217","T.B","STL",2017020064,17453,20172018,1,60,2,1,1,4.53254001599271,2.86782611402187,1.66471390197084,27,29,-2,38,42,-4,64,49,15,2,3,0,0
"21218","T.B","DET",2017020080,17455,20172018,0,60,3,2,1,4.40128647969604,3.47618381384001,0.925102665856031,26,31,-5,34,44,-10,40,54,-14,5,7,0,0
"21219","T.B","N.J",2017020081,17456,20172018,0,65,4,4,0,5.18728307395349,5.38693975756655,-0.199656683613057,37,34,3,60,51,9,73,65,8,5,4,0,0
"21220","T.B","CBJ",2017020098,17458,20172018,0,60,2,0,2,2.71674658741755,4.87237060408417,-2.15562401666662,21,43,-22,41,52,-11,50,64,-14,2,3,0,0
"21221","T.B","PIT",2017020114,17460,20172018,1,60,7,1,6,3.05545429699487,4.32182062475476,-1.2663663277599,32,29,3,42,42,0,61,58,3,6,5,0,0
"21222","T.B","CAR",2017020129,17463,20172018,0,60,5,1,4,6.43926158500835,3.10766128241085,3.33160030259751,29,32,-3,40,55,-15,46,77,-31,2,5,0,0
"21223","T.B","DET",2017020144,17465,20172018,1,60,3,2,1,5.80613003784674,2.95897412644331,2.84715591140343,38,31,7,55,37,18,69,46,23,7,6,0,0
"21224","T.B","ANA",2017020159,17467,20172018,1,60,1,4,-3,5.86304940213449,3.27612755304278,2.58692184909171,32,21,11,47,27,20,62,43,19,4,2,0,0
"21225","T.B","FLA",2017020174,17469,20172018,0,60,8,5,3,6.08490020595491,3.39630195271457,2.68859825324034,38,23,15,49,33,16,61,48,13,5,3,0,0
"21226","T.B","NYR",2017020189,17472,20172018,1,61.3166666666667,1,2,-1,3.83634986839024,3.44414605517522,0.392203813215019,28,35,-7,45,41,4,60,52,8,3,3,0,0
"21227","T.B","CBJ",2017020202,17474,20172018,1,65,4,4,0,2.81178443604434,3.14858410342276,-0.336799667378427,36,34,2,49,45,4,68,57,11,3,4,0,0
"21228","T.B","S.J",2017020234,17478,20172018,0,60,5,1,4,4.73748390996901,3.92917270969491,0.808311200274095,30,33,-3,45,46,-1,56,68,-12,4,2,0,0
"21229","T.B","L.A",2017020241,17479,20172018,0,60,5,2,3,5.13238240306055,3.55535758170299,1.57702482135755,43,24,19,51,40,11,64,47,17,7,5,0,0
"21230","T.B","ANA",2017020263,17482,20172018,0,60,2,1,1,5.29447088806774,5.59155368874781,-0.297082800680073,37,29,8,57,43,14,76,65,11,2,1,0,0
"21231","T.B","DAL",2017020282,17486,20172018,1,60,6,1,5,3.72028587566456,3.5462643992505,0.174021476414055,28,28,0,34,35,-1,46,51,-5,4,3,0,0
"21232","T.B","NYI",2017020299,17488,20172018,1,60,3,5,-2,6.06915916015141,5.31322643862222,0.755932721529188,39,32,7,56,41,15,73,56,17,1,2,0,0
"21233","T.B","CHI",2017020328,17492,20172018,1,63.4166666666667,3,2,1,4.81842276008319,2.80463977332693,2.01378298675627,38,31,7,58,40,18,66,56,10,6,4,0,0
"21234","T.B","WSH",2017020338,17494,20172018,0,60,1,3,-2,2.97851052637239,5.90103445126442,-2.92252392489203,26,38,-12,43,50,-7,68,64,4,3,3,0,0
"21235","T.B","PIT",2017020353,17495,20172018,0,60,2,5,-3,4.7880786926637,7.0657842054595,-2.27770551279579,35,34,1,48,47,1,68,55,13,5,4,0,0
"21236","T.B","BUF",2017020367,17498,20172018,0,60,2,0,2,5.51220924553402,3.33474257402122,2.1774666715128,26,34,-8,40,47,-7,49,58,-9,3,3,0,0
"21237","T.B","BOS",2017020377,17499,20172018,0,60,2,3,-1,2.43012949181139,4.33042528113583,-1.90029578932445,21,36,-15,34,53,-19,49,64,-15,5,5,0,0
"21238","T.B","S.J",2017020399,17502,20172018,1,60,5,2,3,4.27586366874675,3.27799893141128,0.997864737335476,43,27,16,51,37,14,71,54,17,2,1,0,0
"21239","T.B","NYI",2017020420,17505,20172018,1,60,6,2,4,4.48275926723676,3.56586306045119,0.916896206785566,34,31,3,47,38,9,68,46,22,4,2,0,0
"21240","T.B","COL",2017020433,17507,20172018,1,60,5,2,3,3.00139811453118,1.89299057193057,1.10840754260062,32,30,2,47,37,10,66,46,20,5,3,0,0
"21241","T.B","WPG",2017020447,17509,20172018,1,60.6,4,3,1,2.49317509448156,2.75410900770402,-0.260933913222459,28,20,8,40,30,10,54,44,10,4,2,0,0
"21242","T.B","STL",2017020471,17512,20172018,0,60,3,0,3,6.35446166386828,7.20598685098958,-0.851525187121297,25,32,-7,37,48,-11,61,57,4,4,2,0,0
"21243","T.B","ARI",2017020489,17514,20172018,0,60,4,1,3,6.81678902620191,4.60017434704059,2.21661467916132,48,33,15,67,45,22,80,61,19,5,5,0,0
"21244","T.B","COL",2017020505,17516,20172018,0,60,6,5,1,5.67566362640355,5.25667610256642,0.418987523837131,31,37,-6,41,43,-2,50,61,-11,3,8,0,0
"21245","T.B","VGK",2017020525,17519,20172018,0,60,3,4,-1,5.89707148382149,5.08184183281264,0.815229651008849,38,36,2,46,49,-3,63,68,-5,4,5,0,0
"21246","T.B","OTT",2017020533,17521,20172018,1,65,3,3,0,4.5645921434043,2.80290325256647,1.76168889083783,38,21,17,57,25,32,77,28,49,4,4,0,0
"21247","T.B","MIN",2017020545,17523,20172018,1,60,3,0,3,5.07490869695837,2.510412730393,2.56449596656537,31,22,9,53,27,26,72,38,34,6,6,0,0
"21248","T.B","MTL",2017020570,17528,20172018,1,60,3,1,2,4.97711154131684,2.5357772551678,2.44133428614904,34,32,2,47,45,2,62,61,1,7,4,0,0
"21249","T.B","PHI",2017020579,17529,20172018,1,60,3,5,-2,3.39591629744973,4.20358460490115,-0.807668307451422,27,38,-11,38,49,-11,59,61,-2,3,6,0,0
"21250","T.B","CBJ",2017020594,17531,20172018,0,60,5,0,5,4.48169139740639,2.63764310526858,1.84404829213781,35,21,14,45,34,11,62,43,19,5,4,0,0
"21251","T.B","TOR",2017020602,17533,20172018,0,60,2,0,2,4.0950563973319,2.67028389696745,1.42477250036445,36,29,7,51,39,12,65,54,11,4,3,0,0
"21252","T.B","MTL",2017020620,17535,20172018,0,65,1,1,0,5.85000848214267,5.0102223226786,0.839786159464069,45,38,7,54,44,10,73,73,0,2,2,0,0
"21253","T.B","OTT",2017020638,17537,20172018,0,60,3,6,-3,7.29416923306723,4.80015783375711,2.49401139931012,48,33,15,71,43,28,93,55,38,7,5,0,0
"21254","T.B","DET",2017020649,17538,20172018,0,60,5,2,3,3.62909175502136,5.88771586306393,-2.25862410804257,24,36,-12,33,52,-19,46,68,-22,1,5,0,0
"21255","T.B","CAR",2017020656,17540,20172018,1,60,5,4,1,3.2494326356973,2.94616099225823,0.303271643439075,34,32,2,44,40,4,58,59,-1,0,4,0,0
"21256","T.B","CGY",2017020664,17542,20172018,1,60,1,5,-4,5.0412218751153,3.55012326415181,1.49109861096349,34,24,10,49,30,19,69,44,25,4,1,0,0
"21257","T.B","VGK",2017020701,17549,20172018,1,60,1,4,-3,4.99170529268791,5.00844792989665,-0.0167426372087363,29,30,-1,36,45,-9,45,62,-17,5,4,0,0
"21258","T.B","MIN",2017020719,17551,20172018,0,60,2,5,-3,4.57302184237051,5.90059974499599,-1.32757790262549,23,35,-12,41,39,2,59,55,4,5,4,0,0
"21259","T.B","CHI",2017020729,17553,20172018,0,60,2,0,2,4.30403200716107,3.46316735696746,0.840864650193609,31,40,-9,40,46,-6,52,70,-18,2,6,0,0
"21260","T.B","NSH",2017020737,17554,20172018,0,61.75,4,3,1,4.35275578603,5.47788927721223,-1.12513349118223,31,33,-2,37,40,-3,54,59,-5,2,3,0,0
"21261","T.B","PHI",2017020747,17556,20172018,0,60,5,1,4,3.61392203314344,3.60988089529565,0.0040411378477927,22,37,-15,31,48,-17,43,68,-25,1,4,0,0
"21262","T.B","WPG",2017020769,17561,20172018,0,60,1,3,-2,4.11222976230783,4.51655059578479,-0.404320833476959,24,37,-13,36,44,-8,54,60,-6,4,4,0,0
"21263","T.B","CGY",2017020784,17563,20172018,0,60,7,4,3,7.10779897379689,6.39557428623084,0.712224687566049,31,46,-15,49,63,-14,63,78,-15,4,2,0,0
"21264","T.B","VAN",2017020803,17565,20172018,0,60,4,2,2,1.68489057046827,3.63833152419066,-1.95344095372239,28,33,-5,32,42,-10,39,55,-16,6,4,0,0
"21265","T.B","EDM",2017020811,17567,20172018,0,60,2,6,-4,0,0,0,34,35,-1,44,48,-4,63,59,4,4,5,0,0
"21266","T.B","VAN",2017020830,17570,20172018,1,60,5,2,3,6.41066128482635,5.14886844610852,1.26179283871783,36,29,7,53,42,11,65,54,11,3,3,0,0
"21267","T.B","L.A",2017020846,17572,20172018,1,60,4,3,1,2.96234798856312,4.93225239923581,-1.96990441067268,28,47,-19,43,58,-15,58,71,-13,3,4,0,0
"21268","T.B","TOR",2017020861,17574,20172018,0,60,3,4,-1,4.26659058336656,3.38187393981207,0.884716643554498,34,23,11,52,35,17,67,46,21,2,1,0,0
"21269","T.B","BUF",2017020865,17575,20172018,0,60,3,5,-2,5.33995789848268,6.97125203754001,-1.63129413905733,29,33,-4,40,47,-7,48,59,-11,5,3,0,0
"21270","T.B","DET",2017020883,17577,20172018,1,60,4,1,3,3.55209451382906,4.69429814963223,-1.14220363580317,32,39,-7,46,46,0,62,55,7,4,3,0,0
"21271","T.B","N.J",2017020898,17579,20172018,1,60,3,4,-1,3.86543514927452,2.01927885599752,1.84615629327701,51,28,23,64,36,28,80,39,41,7,4,0,0
"21272","T.B","WSH",2017020921,17582,20172018,0,60,4,2,2,1.53422169625992,4.07284873904428,-2.53862704278436,19,37,-18,33,50,-17,46,69,-23,2,2,0,0
"21273","T.B","OTT",2017020934,17584,20172018,0,60,4,3,1,1.71431139463154,7.14923305631521,-5.43492166168367,24,36,-12,34,48,-14,48,76,-28,3,5,0,0
"21274","T.B","MTL",2017020949,17586,20172018,0,65,3,3,0,6.67041299419662,6.79102877585683,-0.120615781660211,39,32,7,62,45,17,83,62,21,6,5,0,0
"21275","T.B","TOR",2017020966,17588,20172018,1,65,3,3,0,5.20451481564669,2.85987820991841,2.34463660572828,42,30,12,55,42,13,69,55,14,4,5,0,0
"21276","T.B","BUF",2017020979,17590,20172018,1,61.4333333333333,1,2,-1,2.48354285311871,3.86847963956825,-1.38493678644954,22,34,-12,34,49,-15,50,62,-12,1,4,0,0
"21277","T.B","DAL",2017020986,17591,20172018,0,64.3166666666667,5,4,1,1.87810404033371,4.05719055930967,-2.17908651897596,25,35,-10,34,55,-21,51,68,-17,3,3,0,0
"21278","T.B","PHI",2017021000,17593,20172018,1,65,6,6,0,4.21479421350887,4.68808679664653,-0.473292583137663,35,43,-8,43,51,-8,54,62,-8,2,6,0,0
"21279","T.B","FLA",2017021024,17596,20172018,1,62.8166666666667,5,4,1,3.9743243316982,5.40922182009672,-1.43489748839852,33,49,-16,46,67,-21,60,79,-19,0,2,0,0
"21280","T.B","NYR",2017021037,17598,20172018,1,60,5,3,2,6.2015839209198,3.04191783649185,3.15966608442795,45,30,15,56,40,16,72,50,22,4,3,0,0
"21281","T.B","MTL",2017021050,17600,20172018,1,65,2,2,0,5.08239779734868,5.09367720386945,-0.0112794065207709,34,29,5,52,39,13,66,53,13,5,4,0,0
"21282","T.B","OTT",2017021073,17603,20172018,1,60,4,7,-3,4.68036979865428,4.80434728773253,-0.123977489078243,46,33,13,60,38,22,76,47,29,4,2,0,0
"21283","T.B","BOS",2017021102,17607,20172018,1,60,0,3,-3,4.18043825172936,3.46313727011899,0.717300981610364,23,27,-4,46,37,9,62,46,16,4,4,0,0
"21284","T.B","TOR",2017021127,17610,20172018,1,60,4,3,1,1.63444255873258,2.77991876348096,-1.14547620474838,25,30,-5,32,41,-9,42,56,-14,2,4,0,0
"21285","T.B","NYI",2017021136,17612,20172018,0,60,7,6,1,3.23097707427223,4.71346689142229,-1.48248981715005,36,41,-5,45,50,-5,58,68,-10,4,5,0,0
"21286","T.B","N.J",2017021157,17614,20172018,0,60,1,2,-1,3.62628072448751,5.41482762072701,-1.7885468962395,36,31,5,52,41,11,70,49,21,3,2,0,0
"21287","T.B","ARI",2017021173,17616,20172018,1,60,1,4,-3,3.6730520221754,4.78622398387233,-1.11317196169693,20,35,-15,34,42,-8,43,56,-13,2,4,0,0
"21288","T.B","BOS",2017021190,17619,20172018,0,60,2,4,-2,5.57112738684373,5.51208643824793,0.0590409485957935,28,30,-2,44,43,1,61,56,5,9,8,0,0
"21289","T.B","NYR",2017021201,17620,20172018,0,60,7,3,4,7.62525904721406,4.69048527732957,2.93477376988449,50,31,19,63,38,25,72,49,23,6,6,0,0
"21290","T.B","NSH",2017021219,17622,20172018,1,60,1,4,-3,1.80017581515131,2.94225778442342,-1.14208196927211,30,25,5,39,34,5,59,46,13,5,2,0,0
"21291","T.B","BOS",2017021233,17624,20172018,1,60,4,0,4,4.88247646007221,3.85679014190586,1.02568631816635,36,33,3,45,48,-3,51,60,-9,4,2,0,0
"21292","T.B","BUF",2017021254,17627,20172018,1,60,7,5,2,4.67117265013803,3.43897604935592,1.23219660078212,34,32,2,44,41,3,55,52,3,3,5,0,0
"21293","T.B","CAR",2017021263,17628,20172018,0,60.8166666666667,2,3,-1,4.20238333740417,7.29572038480546,-3.09333704740129,34,42,-8,38,53,-15,47,71,-24,1,2,0,0
"21294","T.B","N.J",2017030111,17633,20172018,1,60,5,2,3,5.88276260573912,4.32607751415344,1.55668509158568,32,31,1,49,43,6,65,58,7,1,2,0,0
"21295","T.B","N.J",2017030112,17635,20172018,1,60,5,3,2,6.3737705957974,5.70873862237204,0.665031973425357,26,44,-18,44,54,-10,55,64,-9,5,5,0,0
"21296","T.B","N.J",2017030113,17637,20172018,0,60,2,5,-3,3.95467205349504,6.56164815524991,-2.60697610175487,36,41,-5,44,50,-6,53,58,-5,7,9,0,0
"21297","T.B","N.J",2017030114,17639,20172018,0,60,3,1,2,6.1243331183469,3.47951156343333,2.64482155491357,37,28,9,52,39,13,62,49,13,6,7,0,0
"21298","T.B","N.J",2017030115,17642,20172018,1,60,3,1,2,5.91458162449999,4.13463223103645,1.77994939346354,38,27,11,51,34,17,59,47,12,5,1,0,0
"21299","T.B","BOS",2017030211,17649,20172018,1,60,2,6,-4,5.04927433752164,4.11140041204635,0.937873925475287,36,24,12,57,31,26,78,37,41,3,1,0,0
"21300","T.B","BOS",2017030212,17651,20172018,1,60,4,2,2,5.10118113440694,2.83481100541873,2.26637012898821,31,20,11,41,30,11,54,38,16,7,6,0,0
"21301","T.B","BOS",2017030213,17653,20172018,0,60,4,1,3,4.33124763169326,3.9662158057934,0.365031825899864,37,29,8,47,46,1,59,65,-6,6,2,0,0
"21302","T.B","BOS",2017030214,17655,20172018,0,63.3,4,3,1,5.55531960528509,5.29835425858096,0.256965346704133,28,32,-4,43,44,-1,62,68,-6,4,4,0,0
"21303","T.B","BOS",2017030215,17657,20172018,1,60,3,1,2,6.62892031192314,3.54670413002386,3.08221618189928,22,28,-6,37,36,1,49,53,-4,4,4,0,0
"21304","T.B","WSH",2017030311,17662,20172018,1,60,2,4,-2,3.63684230818612,4.90139025676581,-1.26454794857969,21,32,-11,33,48,-15,52,58,-6,3,4,0,0
"21305","T.B","WSH",2017030312,17664,20172018,1,60,2,6,-4,3.55319289085674,3.77637183146726,-0.223178940610524,35,37,-2,44,48,-4,60,58,2,7,6,0,0
"21306","T.B","WSH",2017030313,17666,20172018,0,60,4,2,2,4.72757037951442,6.35660718032159,-1.62903680080717,23,38,-15,40,51,-11,47,69,-22,6,4,0,0
"21307","T.B","WSH",2017030314,17668,20172018,0,60,4,2,2,4.43107880407479,8.26849572021456,-3.83741691613977,20,38,-18,27,49,-22,45,65,-20,2,4,0,0
"21308","T.B","WSH",2017030315,17670,20172018,1,60,3,2,1,1.43907246626623,3.8656666544266,-2.42659418816038,22,30,-8,37,40,-3,48,59,-11,1,0,0,0
"21309","T.B","WSH",2017030316,17672,20172018,0,60,0,3,-3,3.62748238891793,4.35973703330819,-0.73225464439026,24,34,-10,39,48,-9,59,61,-2,2,1,0,0
"21310","T.B","WSH",2017030317,17674,20172018,1,60,0,4,-4,3.68410461100575,4.11842444317881,-0.43431983217306,29,23,6,45,32,13,60,38,22,2,3,0,0
"21311","T.B","FLA",2018020019,17810,20182019,1,65,1,1,0,4.31919864433004,3.20036501799041,1.11883362633964,29,43,-14,40,56,-16,53,65,-12,3,5,0,0
"21312","T.B","VAN",2018020053,17815,20182019,1,60,1,4,-3,4.28387009288417,4.33773623320371,-0.053866140319542,34,28,6,53,36,17,75,49,26,5,4,0,0
"21313","T.B","CBJ",2018020063,17817,20182019,1,60,8,2,6,5.57169399398572,3.2153039043842,2.35639008960152,31,32,-1,39,45,-6,56,57,-1,8,6,0,0
"21314","T.B","CAR",2018020082,17820,20182019,1,60,4,2,2,6.67220709958002,3.99102057539858,2.68118652418144,27,40,-13,37,50,-13,50,70,-20,1,4,0,0
"21315","T.B","DET",2018020093,17822,20182019,1,60,3,1,2,6.1784794087507,1.69097496921057,4.48750443954013,31,30,1,46,37,9,65,52,13,5,6,0,0
"21316","T.B","MIN",2018020110,17824,20182019,0,63.7166666666667,4,5,-1,5.58223910999368,5.39411557596068,0.188123534032997,31,34,-3,55,46,9,65,60,5,6,3,0,0
"21317","T.B","CHI",2018020116,17825,20182019,0,60,6,3,3,6.89129196372232,5.16916522440727,1.72212673931506,55,36,19,60,48,12,73,66,7,4,5,0,0
"21318","T.B","COL",2018020132,17828,20182019,0,60,1,0,1,3.66626944115202,2.47394533160112,1.1923241095509,24,22,2,33,36,-3,51,44,7,3,4,0,0
"21319","T.B","VGK",2018020144,17830,20182019,0,60,3,2,1,2.01945645934824,4.37445867004917,-2.35500221070093,23,31,-8,30,47,-17,45,74,-29,2,4,0,0
"21320","T.B","ARI",2018020157,17831,20182019,0,60,1,7,-6,3.58071610827016,3.77206570394765,-0.191349595677484,31,30,1,43,45,-2,56,55,1,5,4,0,0
"21321","T.B","N.J",2018020172,17834,20182019,1,60,8,3,5,4.53741626012197,5.57050056682783,-1.03308430670586,44,30,14,51,42,9,65,55,10,3,3,0,0
"21322","T.B","NSH",2018020185,17836,20182019,1,60,1,4,-3,7.55245306587312,3.83352571279102,3.71892735308211,43,24,19,53,32,21,66,41,25,2,1,0,0
"21323","T.B","MTL",2018020196,17838,20182019,0,60,4,1,3,3.5005019720993,5.915297814121,-2.4147958420217,36,35,1,47,54,-7,64,77,-13,3,4,0,0
"21324","T.B","OTT",2018020207,17839,20182019,0,60.2333333333333,4,3,1,6.14474750298541,4.8176096456009,1.32713785738451,45,25,20,61,33,28,85,54,31,3,3,0,0
"21325","T.B","EDM",2018020220,17841,20182019,1,60,5,2,3,3.03326217265567,3.04346811051801,-0.010205937862338,35,35,0,47,45,2,57,58,-1,7,5,0,0
"21326","T.B","NYI",2018020232,17843,20182019,1,60,4,2,2,3.97049160905641,3.0126849131193,0.957806695937109,27,37,-10,33,47,-14,45,62,-17,4,5,0,0
"21327","T.B","OTT",2018020247,17845,20182019,1,60,4,6,-2,4.90793077203853,3.20777087475881,1.70015989727972,28,34,-6,41,45,-4,61,54,7,3,4,0,0
"21328","T.B","BUF",2018020264,17848,20182019,0,60,1,2,-1,4.6146115718002,3.84640460612718,0.768206965673016,30,19,11,48,27,21,65,36,29,2,2,0,0
"21329","T.B","PIT",2018020279,17850,20182019,0,60,4,3,1,4.87923068957753,4.30452038497832,0.574710304599202,26,31,-5,33,39,-6,46,53,-7,9,6,0,0
"21330","T.B","PHI",2018020293,17852,20182019,0,61.7833333333333,6,5,1,5.74369916424621,3.85954927130184,1.88414989294436,26,45,-19,42,55,-13,61,75,-14,5,6,0,0
"21331","T.B","NSH",2018020314,17854,20182019,0,60,2,3,-1,6.64673040028696,2.77819492125127,3.86853547903569,31,34,-3,42,47,-5,50,63,-13,2,3,0,0
"21332","T.B","FLA",2018020325,17856,20182019,1,60,7,3,4,4.6914002156991,5.05163105761585,-0.360230841916746,33,43,-10,45,53,-8,62,60,2,4,4,0,0
"21333","T.B","CHI",2018020341,17858,20182019,1,60,4,2,2,2.46269412420224,4.8774749661716,-2.41478084196936,29,32,-3,47,46,1,56,60,-4,3,2,0,0
"21334","T.B","N.J",2018020359,17860,20182019,1,60,5,2,3,2.13223818791693,4.20885445340537,-2.07661626548844,36,35,1,44,49,-5,55,59,-4,3,2,0,0
"21335","T.B","ANA",2018020370,17862,20182019,1,60,1,3,-2,1.95621142833625,2.145896552267,-0.189685123930758,35,22,13,49,34,15,62,42,20,4,3,0,0
"21336","T.B","BUF",2018020385,17864,20182019,1,60,5,4,1,3.32343450393091,2.70754877070794,0.615885733222967,37,22,15,49,31,18,59,39,20,4,2,0,0
"21337","T.B","FLA",2018020399,17866,20182019,0,63.2,5,4,1,5.20552279473536,5.03030325028158,0.175219544453786,39,27,12,49,35,14,64,53,11,4,5,0,0
"21338","T.B","N.J",2018020413,17868,20182019,0,60,5,1,4,3.77369398117918,4.0679600332478,-0.294266052068622,26,27,-1,40,36,4,48,43,5,4,5,0,0
"21339","T.B","DET",2018020422,17869,20182019,0,65,5,5,0,6.29439087748415,3.35509188543074,2.93929899205341,35,24,11,57,31,26,68,41,27,3,3,0,0
"21340","T.B","BOS",2018020434,17871,20182019,1,60,3,2,1,3.05503896347727,3.59923019558119,-0.544191232103913,30,35,-5,38,46,-8,54,62,-8,1,2,0,0
"21341","T.B","COL",2018020449,17873,20182019,1,60,7,1,6,3.06636194640305,2.07867563886657,0.987686307536478,38,30,8,51,37,14,67,50,17,4,3,0,0
"21342","T.B","NYR",2018020463,17875,20182019,1,60,6,3,3,3.94331578076526,1.8084376401539,2.13487814061136,36,26,10,53,35,18,64,46,18,6,1,0,0
"21343","T.B","TOR",2018020482,17878,20182019,1,60,4,1,3,1.45427188825886,4.52722995962932,-3.07295807137046,21,49,-28,32,58,-26,48,81,-33,4,7,0,0
"21344","T.B","WPG",2018020510,17881,20182019,0,64.3,4,5,-1,7.2423621873872,6.3600698828086,0.882292304578598,47,42,5,65,54,11,86,68,18,2,1,0,0
"21345","T.B","VAN",2018020526,17883,20182019,0,60,5,2,3,5.49189536314952,4.62069646242104,0.871198900728481,37,38,-1,47,46,1,63,63,0,6,8,0,0
"21346","T.B","CGY",2018020537,17885,20182019,0,65,4,4,0,4.43342781115472,4.65359597210136,-0.220168160946638,36,37,-1,47,49,-2,61,60,1,4,1,0,0
"21347","T.B","EDM",2018020557,17887,20182019,0,60,6,3,3,7.22821172245312,4.02570509750694,3.20250662494618,45,28,17,52,39,13,64,55,9,5,6,0,0
"21348","T.B","PHI",2018020571,17892,20182019,1,60.3,6,5,1,4.02002633116759,4.60900892829522,-0.588982597127631,37,33,4,46,46,0,56,65,-9,4,3,0,0
"21349","T.B","MTL",2018020590,17894,20182019,1,60,6,5,1,5.10038796261688,5.82102458556983,-0.720636622952952,32,38,-6,44,51,-7,59,65,-6,3,3,0,0
"21350","T.B","ANA",2018020611,17896,20182019,0,60.5833333333333,2,1,1,4.97952365890956,6.27834625512041,-1.29882259621085,35,36,-1,43,50,-7,55,60,-5,4,2,0,0
"21351","T.B","L.A",2018020628,17899,20182019,0,60,6,2,4,6.95611905556609,4.57607562753358,2.38004342803251,33,30,3,51,42,9,59,56,3,5,7,0,0
"21352","T.B","S.J",2018020644,17901,20182019,0,60,2,5,-3,2.92366440023761,5.94396821026658,-3.02030381002896,20,33,-13,33,45,-12,46,60,-14,2,3,0,0
"21353","T.B","CBJ",2018020663,17904,20182019,1,60,4,0,4,2.82784629439567,3.17346775546457,-0.345621461068902,22,31,-9,33,41,-8,41,63,-22,1,1,0,0
"21354","T.B","CAR",2018020676,17906,20182019,1,60,3,1,2,5.33481047677105,2.39907365114277,2.93573682562828,30,27,3,39,34,5,51,47,4,6,4,0,0
"21355","T.B","BUF",2018020689,17908,20182019,0,60,5,3,2,4.17751129576936,3.20862616180425,0.968885133965117,30,33,-3,44,45,-1,51,55,-4,3,4,0,0
"21356","T.B","NYI",2018020702,17909,20182019,0,60,1,5,-4,4.58194749930408,4.88347690909344,-0.301529409789364,39,28,11,55,35,20,81,44,37,3,1,0,0
"21357","T.B","DAL",2018020719,17911,20182019,0,60,2,0,2,3.92410362395458,4.38204219174077,-0.457938567786186,21,35,-14,32,49,-17,40,67,-27,4,7,0,0
"21358","T.B","TOR",2018020729,17913,20182019,1,60,2,4,-2,4.98605403406509,5.85017437729562,-0.864120343230525,38,31,7,50,47,3,71,55,16,4,2,0,0
"21359","T.B","S.J",2018020744,17915,20182019,1,60,6,3,3,2.21063426753062,5.06533372116564,-2.85469945363502,26,39,-13,36,56,-20,48,78,-30,4,3,0,0
"21360","T.B","PIT",2018020776,17926,20182019,0,60,2,4,-2,3.15331617453558,4.55041418131441,-1.39709800677883,35,22,13,49,32,17,66,48,18,4,5,0,0
"21361","T.B","NYI",2018020783,17928,20182019,0,65,0,0,0,5.89213280309923,3.75990399520379,2.13222880789544,41,36,5,48,44,4,64,60,4,1,4,0,0
"21362","T.B","NYR",2018020795,17929,20182019,0,60,3,2,1,3.51202603681122,4.01705309974204,-0.505027062930822,23,33,-10,30,42,-12,38,56,-18,1,4,0,0
"21363","T.B","VGK",2018020816,17932,20182019,1,65,2,2,0,3.80190025874475,3.862837563491,-0.060937304746254,26,37,-11,38,47,-9,53,60,-7,5,3,0,0
"21364","T.B","STL",2018020831,17934,20182019,1,64.0166666666667,0,1,-1,4.60465978112758,4.4217394763723,0.182920304755285,32,39,-7,49,48,1,64,55,9,3,4,0,0
"21365","T.B","PIT",2018020847,17936,20182019,1,60,5,4,1,4.32512878635316,3.81720216114627,0.507926625206892,34,32,2,45,44,1,60,58,2,2,2,0,0
"21366","T.B","FLA",2018020858,17937,20182019,0,60,5,2,3,5.00593802670483,3.57257614035731,1.43336188634751,23,27,-4,34,41,-7,44,52,-8,5,5,0,0
"21367","T.B","CGY",2018020868,17939,20182019,1,60,6,3,3,3.96044981716841,3.60175803923199,0.358691777936425,27,22,5,39,35,4,53,51,2,4,4,0,0
"21368","T.B","DAL",2018020880,17941,20182019,1,60,6,0,6,3.8145416379557,3.30120963604983,0.513332001905872,26,32,-6,36,46,-10,47,55,-8,6,3,0,0
"21369","T.B","MTL",2018020895,17943,20182019,1,60,3,0,3,4.41119041610653,1.83412706613308,2.57706334997345,37,20,17,47,26,21,61,39,22,5,3,0,0
"21370","T.B","CBJ",2018020911,17945,20182019,0,60,5,1,4,1.99678401096025,2.81632421569794,-0.819540204737681,20,40,-20,23,47,-24,31,58,-27,4,4,0,0
"21371","T.B","PHI",2018020918,17946,20182019,0,60,5,2,3,5.57082369507407,3.93116597528569,1.63965771978837,33,30,3,46,41,5,61,60,1,5,4,0,0
"21372","T.B","BUF",2018020935,17948,20182019,1,65,1,1,0,4.79414112377796,3.40055454485992,1.39358657891805,40,30,10,50,38,12,62,49,13,5,5,0,0
"21373","T.B","L.A",2018020964,17952,20182019,1,65,3,3,0,4.86596974796487,4.23307414370356,0.632895604261307,34,33,1,57,42,15,66,54,12,4,4,0,0
"21374","T.B","NYR",2018020981,17954,20182019,0,63.4166666666667,4,3,1,4.11529198202327,5.58834992157063,-1.47305793954736,30,36,-6,44,53,-9,64,70,-6,3,6,0,0
"21375","T.B","BOS",2018020984,17955,20182019,0,60,1,4,-3,3.98446344619473,4.21548862362397,-0.231025177429235,21,41,-20,38,50,-12,50,66,-16,3,3,0,0
"21376","T.B","OTT",2018021004,17957,20182019,1,60,5,1,4,5.66655205578263,2.21321122794423,3.4533408278384,34,37,-3,52,42,10,67,57,10,4,5,0,0
"21377","T.B","WPG",2018021023,17960,20182019,1,60,5,2,3,4.38330059805594,2.65176963876002,1.73153095929592,38,32,6,48,41,7,57,54,3,6,5,0,0
"21378","T.B","MIN",2018021037,17962,20182019,1,60,0,3,-3,1.88250549542136,4.86769845538947,-2.98519295996812,25,30,-5,35,38,-3,53,59,-6,2,4,0,0
"21379","T.B","DET",2018021051,17964,20182019,1,60,3,2,1,5.82556607056087,2.28734957455612,3.53821649600475,33,24,9,47,33,14,59,43,16,4,6,0,0
"21380","T.B","TOR",2018021065,17966,20182019,0,60,6,2,4,5.75612548366189,5.51481149934989,0.241313984312001,42,28,14,53,40,13,60,48,12,1,2,0,0
"21381","T.B","DET",2018021087,17969,20182019,0,60,5,4,1,5.60742708825273,5.16018962248563,0.447237465767103,39,27,12,58,35,23,76,50,26,3,3,0,0
"21382","T.B","WSH",2018021105,17971,20182019,1,60,6,3,3,5.36259641204106,3.76634532679545,1.5962510852456,35,34,1,42,51,-9,50,63,-13,4,4,0,0
"21383","T.B","ARI",2018021118,17973,20182019,1,60,4,1,3,3.37320412790381,4.08144404074756,-0.708239912843741,24,29,-5,31,39,-8,43,51,-8,2,3,0,0
"21384","T.B","WSH",2018021133,17975,20182019,0,63.0166666666667,5,4,1,2.6166856639533,6.12672731436987,-3.51004165041657,28,58,-30,36,72,-36,51,86,-35,5,8,0,0
"21385","T.B","CAR",2018021138,17976,20182019,0,60,6,3,3,7.43970123765757,3.44695633441734,3.99274490324024,32,28,4,44,41,3,61,55,6,7,3,0,0
"21386","T.B","STL",2018021159,17978,20182019,0,60,3,4,-1,5.55544145883927,3.86380987674934,1.69163158208993,42,26,16,60,34,26,74,48,26,3,2,0,0
"21387","T.B","BOS",2018021172,17980,20182019,1,60,5,4,1,3.55453604419289,1.8249445541951,1.72959148999779,28,17,11,42,29,13,52,40,12,5,3,0,0
"21388","T.B","WSH",2018021206,17985,20182019,1,60,3,6,-3,4.19995011633728,3.70802165173518,0.491928464602097,28,35,-7,36,45,-9,49,55,-6,3,5,0,0
"21389","T.B","OTT",2018021224,17987,20182019,0,60,5,2,3,4.676082840655,3.90058861534635,0.775494225308648,26,24,2,36,32,4,56,42,14,3,4,0,0
"21390","T.B","MTL",2018021232,17988,20182019,0,60,2,4,-2,4.9157351606118,9.00834462173043,-4.09260946111863,24,45,-21,37,68,-31,52,92,-40,1,3,0,0
"21391","T.B","TOR",2018021243,17990,20182019,0,60,3,1,2,5.61228847540293,4.67556683667863,0.9367216387243,29,30,-1,45,45,0,55,59,-4,1,2,0,0
"21392","T.B","BOS",2018021257,17992,20182019,0,60,6,3,3,3.17848562590696,4.14429402163172,-0.965808395724761,22,33,-11,24,49,-25,33,57,-24,3,3,0,0
"21393","T.B","CBJ",2018030111,17996,20182019,1,60,3,4,-1,2.95102594181662,4.07007492409321,-1.11904898227658,29,26,3,36,33,3,50,49,1,3,3,0,0
"21394","T.B","CBJ",2018030112,17998,20182019,1,60,1,5,-4,3.99536594449544,2.33475900412304,1.6606069403724,24,27,-3,36,34,2,52,43,9,3,4,0,0
"21395","T.B","CBJ",2018030113,18000,20182019,0,60,1,3,-2,2.92651426943485,4.93354145635385,-2.007027186919,31,30,1,37,35,2,54,50,4,2,4,0,0
"21396","T.B","CBJ",2018030114,18002,20182019,0,60,3,7,-4,5.22133644571295,5.08423815155038,0.13709829416257,33,25,8,43,36,7,58,45,13,1,2,0,0
"21397","TOR","DET",2008020005,14161,20082009,0,60,3,2,1,0,0,0,29,37,-8,33,49,-16,42,60,-18,2,3,0,0
"21398","TOR","MTL",2008020016,14163,20082009,1,60,1,6,-5,0,0,0,25,34,-9,42,51,-9,51,71,-20,5,8,0,0
"21399","TOR","STL",2008020032,14165,20082009,1,65,4,4,0,0,0,0,39,26,13,59,39,20,79,56,23,7,5,0,0
"21400","TOR","NYR",2008020057,14169,20082009,0,65,0,0,0,0,0,0,21,32,-11,33,57,-24,43,76,-33,4,8,0,0
"21401","TOR","PIT",2008020066,14170,20082009,0,60,1,4,-3,0,0,0,27,25,2,40,36,4,59,51,8,6,4,0,0
"21402","TOR","ANA",2008020083,14173,20082009,1,65,2,2,0,0,0,0,38,21,17,63,32,31,83,52,31,4,1,0,0
"21403","TOR","BOS",2008020092,14175,20082009,0,60,4,2,2,0,0,0,37,28,9,47,39,8,57,58,-1,7,4,0,0
"21404","TOR","OTT",2008020106,14177,20082009,1,60,3,2,1,0,0,0,38,24,14,49,32,17,64,48,16,6,2,0,0
"21405","TOR","T.B",2008020128,14180,20082009,1,60,2,3,-1,0,0,0,39,25,14,58,34,24,75,45,30,6,5,0,0
"21406","TOR","N.J",2008020133,14181,20082009,0,65,5,5,0,0,0,0,48,31,17,57,45,12,71,59,12,4,3,0,0
"21407","TOR","NYR",2008020153,14184,20082009,1,60,5,2,3,0,0,0,35,20,15,52,31,21,69,46,23,5,2,0,0
"21408","TOR","CAR",2008020163,14185,20082009,0,60,4,6,-2,0,0,0,33,30,3,46,52,-6,58,67,-9,2,6,0,0
"21409","TOR","CAR",2008020172,14187,20082009,1,61.8666666666667,4,5,-1,0,0,0,42,24,18,63,32,31,83,57,26,3,2,0,0
"21410","TOR","BOS",2008020181,14189,20082009,0,60,2,5,-3,0,0,0,36,35,1,44,45,-1,55,53,2,4,3,0,0
"21411","TOR","MTL",2008020197,14191,20082009,1,60,6,3,3,0,0,0,41,20,21,58,28,30,76,44,32,7,7,0,0
"21412","TOR","CGY",2008020218,14194,20082009,0,60,3,4,-1,0,0,0,32,32,0,43,48,-5,57,65,-8,4,1,0,0
"21413","TOR","EDM",2008020234,14196,20082009,0,60,5,2,3,0,0,0,28,25,3,32,37,-5,40,49,-9,4,4,0,0
"21414","TOR","VAN",2008020246,14198,20082009,0,60,2,4,-2,0,0,0,30,15,15,42,28,14,53,41,12,9,6,0,0
"21415","TOR","CHI",2008020288,14205,20082009,1,60.8166666666667,4,5,-1,0,0,0,38,36,2,54,52,2,65,64,1,3,3,0,0
"21416","TOR","ATL",2008020307,14208,20082009,1,60,3,6,-3,0,0,0,35,30,5,56,41,15,70,54,16,8,7,0,0
"21417","TOR","OTT",2008020321,14210,20082009,0,65,1,1,0,0,0,0,26,35,-9,35,45,-10,54,55,-1,6,3,0,0
"21418","TOR","PHI",2008020337,14212,20082009,1,60,4,2,2,0,0,0,27,30,-3,46,52,-6,57,71,-14,4,4,0,0
"21419","TOR","L.A",2008020354,14214,20082009,0,60,3,1,2,0,0,0,30,33,-3,40,51,-11,53,71,-18,6,5,0,0
"21420","TOR","S.J",2008020360,14215,20082009,0,60,2,5,-3,0,0,0,31,30,1,38,46,-8,50,66,-16,5,4,0,0
"21421","TOR","ARI",2008020374,14217,20082009,0,60,3,6,-3,0,0,0,18,26,-8,30,43,-13,48,62,-14,5,5,0,0
"21422","TOR","WSH",2008020380,14219,20082009,1,60,1,2,-1,0,0,0,20,30,-10,30,48,-18,47,65,-18,4,3,0,0
"21423","TOR","NYI",2008020398,14221,20082009,1,60,4,2,2,0,0,0,37,28,9,47,36,11,68,51,17,4,3,0,0
"21424","TOR","BUF",2008020424,14225,20082009,0,60,2,1,1,0,0,0,33,25,8,40,39,1,47,53,-6,4,4,0,0
"21425","TOR","N.J",2008020449,14229,20082009,1,65,2,2,0,0,0,0,27,27,0,41,48,-7,59,69,-10,2,3,0,0
"21426","TOR","BOS",2008020460,14231,20082009,0,60,5,8,-3,0,0,0,36,27,9,42,35,7,53,44,9,6,7,0,0
"21427","TOR","PIT",2008020478,14233,20082009,0,60,7,3,4,0,0,0,40,23,17,57,35,22,72,43,29,8,5,0,0
"21428","TOR","ATL",2008020491,14235,20082009,0,60,6,2,4,0,0,0,38,21,17,45,32,13,62,47,15,5,2,0,0
"21429","TOR","DAL",2008020499,14236,20082009,1,60,2,8,-6,0,0,0,22,37,-15,32,50,-18,48,58,-10,2,4,0,0
"21430","TOR","NYI",2008020508,14239,20082009,0,60,1,4,-3,0,0,0,29,31,-2,38,38,0,61,53,8,4,3,0,0
"21431","TOR","WSH",2008020530,14241,20082009,0,60,1,4,-3,0,0,0,24,29,-5,35,42,-7,57,66,-9,5,4,0,0
"21432","TOR","ATL",2008020540,14243,20082009,1,60.55,4,3,1,0,0,0,47,32,15,66,46,20,86,65,21,4,5,0,0
"21433","TOR","BUF",2008020556,14245,20082009,1,60,1,4,-3,0,0,0,28,20,8,43,34,9,61,43,18,5,4,0,0
"21434","TOR","OTT",2008020568,14247,20082009,1,60,3,1,2,0,0,0,30,31,-1,43,45,-2,59,62,-3,12,12,0,0
"21435","TOR","FLA",2008020589,14250,20082009,1,60,2,4,-2,0,0,0,26,34,-8,45,40,5,65,54,11,4,4,0,0
"21436","TOR","MTL",2008020601,14252,20082009,0,60,2,6,-4,0,0,0,32,29,3,51,40,11,72,53,19,9,11,0,0
"21437","TOR","PHI",2008020618,14254,20082009,0,60,1,4,-3,0,0,0,42,30,12,49,37,12,68,50,18,4,4,0,0
"21438","TOR","NSH",2008020636,14257,20082009,1,60,0,2,-2,0,0,0,17,23,-6,36,39,-3,49,50,-1,5,4,0,0
"21439","TOR","CAR",2008020647,14259,20082009,0,60,6,4,2,0,0,0,24,32,-8,36,48,-12,45,66,-21,3,4,0,0
"21440","TOR","ATL",2008020658,14260,20082009,0,63.85,3,4,-1,0,0,0,17,38,-21,30,44,-14,43,53,-10,4,4,0,0
"21441","TOR","CAR",2008020679,14263,20082009,1,60,0,2,-2,0,0,0,35,34,1,50,51,-1,70,70,0,3,5,0,0
"21442","TOR","BOS",2008020695,14265,20082009,1,65,3,3,0,0,0,0,34,30,4,50,45,5,73,56,17,4,4,0,0
"21443","TOR","MIN",2008020707,14271,20082009,0,60,1,6,-5,0,0,0,28,21,7,45,31,14,62,42,20,1,4,0,0
"21444","TOR","COL",2008020722,14273,20082009,0,60,7,4,3,0,0,0,30,20,10,42,34,8,56,51,5,3,1,0,0
"21445","TOR","PIT",2008020734,14275,20082009,1,60,5,4,1,0,0,0,26,26,0,36,38,-2,46,49,-3,5,4,0,0
"21446","TOR","FLA",2008020752,14278,20082009,1,63.5,3,4,-1,0,0,0,34,31,3,51,46,5,60,65,-5,2,1,0,0
"21447","TOR","BUF",2008020760,14279,20082009,0,60,0,5,-5,0,0,0,16,32,-16,23,41,-18,37,53,-16,5,11,0,0
"21448","TOR","MTL",2008020780,14282,20082009,0,60,5,2,3,0,0,0,41,33,8,48,46,2,57,63,-6,8,11,0,0
"21449","TOR","FLA",2008020799,14285,20082009,0,61.1333333333333,4,5,-1,0,0,0,39,38,1,46,53,-7,55,67,-12,4,3,0,0
"21450","TOR","T.B",2008020813,14287,20082009,0,60,4,6,-2,0,0,0,25,31,-6,38,44,-6,51,51,0,2,4,0,0
"21451","TOR","PIT",2008020827,14289,20082009,1,60,6,2,4,0,0,0,41,27,14,62,37,25,84,49,35,5,3,0,0
"21452","TOR","BUF",2008020848,14292,20082009,1,60,1,4,-3,0,0,0,28,30,-2,37,40,-3,51,53,-2,2,4,0,0
"21453","TOR","CBJ",2008020862,14294,20082009,1,65,3,3,0,0,0,0,35,34,1,52,42,10,77,53,24,5,2,0,0
"21454","TOR","VAN",2008020880,14296,20082009,1,65,2,2,0,0,0,0,38,37,1,53,49,4,69,69,0,8,7,0,0
"21455","TOR","NYR",2008020890,14297,20082009,0,63,3,2,1,0,0,0,26,41,-15,41,51,-10,48,63,-15,6,4,0,0
"21456","TOR","NYR",2008020905,14300,20082009,1,65,1,1,0,0,0,0,24,32,-8,36,54,-18,50,75,-25,4,4,0,0
"21457","TOR","NYI",2008020910,14301,20082009,0,65,4,4,0,0,0,0,33,44,-11,45,58,-13,57,89,-32,4,8,0,0
"21458","TOR","OTT",2008020927,14303,20082009,0,60.55,4,3,1,0,0,0,38,32,6,54,39,15,66,52,14,4,2,0,0
"21459","TOR","N.J",2008020945,14306,20082009,1,64.8,2,3,-1,0,0,0,32,52,-20,47,70,-23,61,100,-39,4,4,0,0
"21460","TOR","WSH",2008020958,14308,20082009,0,60,2,1,1,0,0,0,29,38,-9,38,47,-9,49,71,-22,4,4,0,0
"21461","TOR","EDM",2008020972,14310,20082009,1,60,1,4,-3,0,0,0,40,18,22,51,26,25,64,37,27,5,5,0,0
"21462","TOR","OTT",2008020987,14312,20082009,0,60,1,2,-1,0,0,0,26,26,0,32,43,-11,48,55,-7,4,5,0,0
"21463","TOR","NYI",2008020992,14313,20082009,1,60.8333333333333,3,2,1,0,0,0,28,30,-2,41,54,-13,56,73,-17,2,5,0,0
"21464","TOR","T.B",2008021008,14315,20082009,1,60,1,4,-3,0,0,0,21,30,-9,37,46,-9,52,55,-3,3,4,0,0
"21465","TOR","CGY",2008021023,14317,20082009,1,60,8,6,2,0,0,0,30,35,-5,43,56,-13,52,77,-25,6,6,0,0
"21466","TOR","T.B",2008021044,14320,20082009,0,65,3,3,0,0,0,0,39,22,17,51,36,15,66,50,16,5,6,0,0
"21467","TOR","FLA",2008021058,14322,20082009,0,60,1,3,-2,0,0,0,38,42,-4,51,58,-7,62,76,-14,4,2,0,0
"21468","TOR","MTL",2008021071,14324,20082009,0,60,5,2,3,0,0,0,37,28,9,51,43,8,63,60,3,7,5,0,0
"21469","TOR","WSH",2008021088,14327,20082009,1,65,2,2,0,0,0,0,29,45,-16,43,57,-14,67,76,-9,3,2,0,0
"21470","TOR","BUF",2008021111,14330,20082009,0,60,3,5,-2,0,0,0,36,24,12,44,38,6,63,47,16,5,2,0,0
"21471","TOR","BOS",2008021117,14331,20082009,1,60,5,7,-2,0,0,0,38,31,7,54,48,6,67,57,10,2,2,0,0
"21472","TOR","PHI",2008021146,14335,20082009,1,60,3,2,1,0,0,0,38,34,4,51,51,0,61,70,-9,4,4,0,0
"21473","TOR","PHI",2008021159,14337,20082009,0,60,5,8,-3,0,0,0,32,35,-3,52,47,5,76,62,14,3,5,0,0
"21474","TOR","MTL",2008021166,14338,20082009,1,60,2,6,-4,0,0,0,36,29,7,54,47,7,71,65,6,7,8,0,0
"21475","TOR","N.J",2008021184,14341,20082009,0,60,4,1,3,0,0,0,18,48,-30,22,70,-48,27,89,-62,2,5,0,0
"21476","TOR","BUF",2008021197,14342,20082009,1,60,1,3,-2,0,0,0,33,29,4,54,42,12,75,54,21,6,2,0,0
"21477","TOR","OTT",2008021220,14345,20082009,1,60,5,2,3,0,0,0,30,39,-9,48,54,-6,67,62,5,7,6,0,0
"21478","TOR","MTL",2009020002,14518,20092010,1,64.7833333333333,3,4,-1,0,0,0,46,27,19,67,49,18,92,64,28,5,5,0,0
"21479","TOR","PIT",2009020050,14527,20092010,1,60,2,5,-3,0,0,0,20,33,-13,33,47,-14,51,58,-7,3,6,0,0
"21480","TOR","NYR",2009020066,14529,20092010,0,60,2,7,-5,0,0,0,29,33,-4,35,49,-14,49,58,-9,5,7,0,0
"21481","TOR","COL",2009020075,14530,20092010,1,60,1,4,-3,0,0,0,31,28,3,45,45,0,65,58,7,4,6,0,0
"21482","TOR","NYR",2009020094,14534,20092010,1,60,1,4,-3,0,0,0,35,28,7,55,42,13,70,57,13,6,4,0,0
"21483","TOR","ANA",2009020151,14543,20092010,0,60,6,3,3,0,0,0,39,28,11,52,42,10,68,49,19,15,8,0,0
"21484","TOR","DAL",2009020162,14545,20092010,0,62.95,3,4,-1,0,0,0,36,36,0,52,46,6,65,61,4,2,3,0,0
"21485","TOR","T.B",2009020199,14551,20092010,1,62.35,1,2,-1,0,0,0,41,32,9,57,40,17,81,54,27,9,5,0,0
"21486","TOR","DET",2009020227,14555,20092010,1,60,5,1,4,0,0,0,28,36,-8,41,57,-16,58,75,-17,4,5,0,0
"21487","TOR","MIN",2009020242,14558,20092010,1,60,2,5,-3,0,0,0,39,31,8,52,36,16,71,50,21,4,4,0,0
"21488","TOR","CHI",2009020267,14561,20092010,0,60,2,3,-1,0,0,0,31,34,-3,35,46,-11,45,60,-15,3,5,0,0
"21489","TOR","CGY",2009020268,14562,20092010,1,60,2,5,-3,0,0,0,40,22,18,62,44,18,81,67,14,5,2,0,0
"21490","TOR","OTT",2009020291,14565,20092010,0,60,2,3,-1,0,0,0,32,21,11,42,27,15,59,42,17,1,4,0,0
"21491","TOR","CAR",2009020299,14567,20092010,0,65,5,5,0,0,0,0,32,45,-13,42,62,-20,56,86,-30,4,5,0,0
"21492","TOR","WSH",2009020314,14569,20092010,1,65,1,1,0,0,0,0,39,32,7,62,44,18,86,57,29,2,4,0,0
"21493","TOR","NYI",2009020329,14571,20092010,1,64.2833333333333,3,4,-1,0,0,0,61,21,40,88,41,47,116,56,60,6,2,0,0
"21494","TOR","T.B",2009020342,14573,20092010,0,60,4,3,1,0,0,0,35,31,4,46,40,6,56,55,1,3,3,0,0
"21495","TOR","FLA",2009020362,14575,20092010,0,60,6,4,2,0,0,0,33,30,3,41,49,-8,61,65,-4,5,4,0,0
"21496","TOR","BUF",2009020382,14578,20092010,1,60,0,3,-3,0,0,0,38,31,7,60,51,9,79,64,15,4,2,0,0
"21497","TOR","MTL",2009020390,14579,20092010,0,60,3,0,3,0,0,0,31,26,5,46,41,5,65,61,4,2,2,0,0
"21498","TOR","CBJ",2009020402,14581,20092010,0,60,6,3,3,0,0,0,25,36,-11,33,45,-12,38,56,-18,4,6,0,0
"21499","TOR","BOS",2009020416,14583,20092010,0,60,2,7,-5,0,0,0,33,33,0,44,37,7,57,57,0,5,7,0,0
"21500","TOR","ATL",2009020430,14585,20092010,1,60,5,2,3,0,0,0,28,24,4,48,34,14,64,47,17,4,2,0,0
"21501","TOR","NYI",2009020443,14587,20092010,1,60,3,2,1,0,0,0,35,32,3,49,40,9,69,55,14,6,5,0,0
"21502","TOR","BOS",2009020452,14588,20092010,0,60,2,5,-3,0,0,0,34,34,0,45,50,-5,53,54,-1,3,4,0,0
"21503","TOR","WSH",2009020466,14590,20092010,1,60,6,3,3,0,0,0,36,37,-1,50,51,-1,64,69,-5,4,3,0,0
"21504","TOR","OTT",2009020481,14592,20092010,1,60,3,2,1,0,0,0,24,24,0,37,38,-1,54,53,1,2,4,0,0
"21505","TOR","ARI",2009020497,14594,20092010,1,60,3,6,-3,0,0,0,30,29,1,49,42,7,75,54,21,5,2,0,0
"21506","TOR","BUF",2009020512,14596,20092010,0,60,2,5,-3,0,0,0,42,27,15,52,37,15,63,48,15,1,2,0,0
"21507","TOR","BOS",2009020521,14597,20092010,1,60,2,0,2,0,0,0,31,25,6,47,35,12,66,56,10,5,3,0,0
"21508","TOR","BUF",2009020531,14599,20092010,1,63.5833333333333,2,3,-1,0,0,0,36,30,6,46,50,-4,64,65,-1,0,1,0,0
"21509","TOR","NYI",2009020546,14601,20092010,0,60,1,3,-2,0,0,0,27,23,4,37,38,-1,66,53,13,2,4,0,0
"21510","TOR","MTL",2009020558,14604,20092010,1,60.5666666666667,2,3,-1,0,0,0,49,23,26,76,31,45,94,43,51,4,2,0,0
"21511","TOR","PIT",2009020573,14605,20092010,0,60,4,3,1,0,0,0,27,24,3,34,37,-3,53,53,0,4,2,0,0
"21512","TOR","EDM",2009020596,14608,20092010,0,60,1,3,-2,0,0,0,28,23,5,54,37,17,76,53,23,3,3,0,0
"21513","TOR","CGY",2009020617,14611,20092010,0,60,1,3,-2,0,0,0,25,35,-10,36,46,-10,51,61,-10,5,4,0,0
"21514","TOR","FLA",2009020629,14614,20092010,1,60,3,2,1,0,0,0,31,31,0,46,42,4,65,58,7,3,3,0,0
"21515","TOR","PHI",2009020641,14615,20092010,0,60,2,6,-4,0,0,0,32,32,0,41,37,4,64,54,10,4,6,0,0
"21516","TOR","BUF",2009020657,14617,20092010,0,60,2,3,-1,0,0,0,50,31,19,67,47,20,79,58,21,4,3,0,0
"21517","TOR","PIT",2009020662,14618,20092010,1,60,1,4,-3,0,0,0,43,39,4,61,51,10,95,58,37,4,3,0,0
"21518","TOR","CAR",2009020680,14621,20092010,1,60,2,4,-2,0,0,0,40,18,22,52,30,22,64,44,20,3,2,0,0
"21519","TOR","PHI",2009020693,14623,20092010,1,60,4,0,4,0,0,0,35,38,-3,51,49,2,67,67,0,5,5,0,0
"21520","TOR","WSH",2009020705,14624,20092010,0,60,1,6,-5,0,0,0,29,24,5,41,36,5,55,61,-6,9,7,0,0
"21521","TOR","NSH",2009020729,14627,20092010,0,60,4,3,1,0,0,0,22,30,-8,31,45,-14,36,62,-26,3,2,0,0
"21522","TOR","ATL",2009020736,14628,20092010,0,60,3,4,-1,0,0,0,40,32,8,51,39,12,67,46,21,6,8,0,0
"21523","TOR","T.B",2009020749,14630,20092010,0,64.8333333333333,2,3,-1,0,0,0,22,32,-10,32,42,-10,47,58,-11,8,9,0,0
"21524","TOR","FLA",2009020765,14632,20092010,0,60,0,2,-2,0,0,0,39,22,17,57,30,27,72,36,36,4,3,0,0
"21525","TOR","L.A",2009020778,14635,20092010,1,60,3,5,-2,0,0,0,28,33,-5,36,45,-9,53,64,-11,1,2,0,0
"21526","TOR","N.J",2009020801,14638,20092010,0,64.2333333333333,4,5,-1,0,0,0,29,31,-2,39,37,2,52,48,4,2,2,0,0
"21527","TOR","VAN",2009020809,14639,20092010,1,60,3,5,-2,0,0,0,21,36,-15,30,59,-29,40,79,-39,5,6,0,0
"21528","TOR","N.J",2009020828,14642,20092010,1,60,3,0,3,0,0,0,26,30,-4,40,41,-1,55,58,-3,4,2,0,0
"21529","TOR","N.J",2009020850,14645,20092010,0,60,3,4,-1,0,0,0,20,28,-8,25,35,-10,28,42,-14,4,3,0,0
"21530","TOR","OTT",2009020859,14646,20092010,1,60,5,0,5,0,0,0,37,30,7,50,48,2,69,60,9,6,4,0,0
"21531","TOR","S.J",2009020871,14648,20092010,1,60,2,3,-1,0,0,0,34,26,8,49,36,13,68,50,18,3,2,0,0
"21532","TOR","STL",2009020902,14652,20092010,0,60,0,4,-4,0,0,0,30,33,-3,44,40,4,54,53,1,9,4,0,0
"21533","TOR","CAR",2009020924,14670,20092010,1,60,1,5,-4,0,0,0,33,30,3,53,38,15,66,53,13,3,1,0,0
"21534","TOR","BOS",2009020941,14672,20092010,0,65,2,2,0,0,0,0,26,31,-5,33,43,-10,42,52,-10,5,4,0,0
"21535","TOR","OTT",2009020957,14674,20092010,0,65,1,1,0,0,0,0,31,23,8,39,36,3,56,49,7,8,6,0,0
"21536","TOR","PHI",2009020970,14675,20092010,0,60,1,3,-2,0,0,0,28,25,3,41,46,-5,55,61,-6,7,9,0,0
"21537","TOR","BOS",2009020976,14677,20092010,1,64.1666666666667,4,3,1,0,0,0,30,29,1,47,42,5,69,61,8,3,2,0,0
"21538","TOR","T.B",2009020990,14679,20092010,1,63.55,4,3,1,0,0,0,38,33,5,55,49,6,79,61,18,3,3,0,0
"21539","TOR","EDM",2009021007,14681,20092010,1,60,6,4,2,0,0,0,47,29,18,68,43,25,84,51,33,11,9,0,0
"21540","TOR","NYI",2009021018,14682,20092010,0,60,1,4,-3,0,0,0,27,32,-5,36,45,-9,52,58,-6,9,8,0,0
"21541","TOR","OTT",2009021031,14684,20092010,0,60,4,1,3,0,0,0,30,31,-1,38,43,-5,54,63,-9,8,6,0,0
"21542","TOR","N.J",2009021046,14686,20092010,1,65,1,1,0,0,0,0,26,25,1,47,37,10,70,59,11,3,4,0,0
"21543","TOR","MTL",2009021059,14688,20092010,1,65,2,2,0,0,0,0,33,27,6,43,46,-3,60,68,-8,1,5,0,0
"21544","TOR","FLA",2009021080,14691,20092010,1,60,1,4,-3,0,0,0,43,29,14,63,42,21,88,52,36,6,3,0,0
"21545","TOR","ATL",2009021101,14693,20092010,0,60.65,2,1,1,0,0,0,30,20,10,48,32,16,63,52,11,5,5,0,0
"21546","TOR","NYR",2009021113,14695,20092010,1,60.65,3,2,1,0,0,0,32,38,-6,47,43,4,63,63,0,2,2,0,0
"21547","TOR","PIT",2009021123,14696,20092010,0,65,4,4,0,0,0,0,29,45,-16,39,55,-16,55,63,-8,5,3,0,0
"21548","TOR","ATL",2009021133,14698,20092010,1,60,2,3,-1,0,0,0,29,25,4,41,36,5,58,50,8,2,2,0,0
"21549","TOR","BUF",2009021150,14700,20092010,1,60,4,2,2,0,0,0,34,24,10,46,29,17,66,45,21,6,2,0,0
"21550","TOR","BOS",2009021167,14702,20092010,1,63.4166666666667,1,2,-1,0,0,0,28,30,-2,40,49,-9,60,71,-11,3,2,0,0
"21551","TOR","PHI",2009021183,14705,20092010,1,60,0,2,-2,0,0,0,23,23,0,40,41,-1,58,54,4,9,8,0,0
"21552","TOR","NYR",2009021193,14706,20092010,0,60,1,5,-4,0,0,0,27,32,-5,42,42,0,58,52,6,6,6,0,0
"21553","TOR","MTL",2009021214,14709,20092010,0,62.1,4,3,1,0,0,0,28,37,-9,32,56,-24,46,74,-28,2,6,0,0
"21554","TOR","MTL",2010020001,14889,20102011,1,60,3,2,1,3.87501285829785,5.33678685064097,-1.46177399234312,24,28,-4,33,43,-10,54,65,-11,5,3,0,0
"21555","TOR","OTT",2010020014,14891,20102011,1,60,5,1,4,5.4228861954932,2.35643679366058,3.06644940183263,38,18,20,50,27,23,61,41,20,5,4,0,0
"21556","TOR","PIT",2010020039,14895,20102011,0,60,4,3,1,1.67317789222579,5.40015165822115,-3.72697376599535,14,25,-11,22,40,-18,32,60,-28,3,3,0,0
"21557","TOR","NYR",2010020049,14897,20102011,0,63.1333333333333,4,3,1,2.512337925976,3.00983769823506,-0.497499772259062,38,24,14,49,45,4,61,52,9,8,6,0,0
"21558","TOR","NYI",2010020069,14900,20102011,1,63.4333333333333,1,2,-1,5.28994970997684,2.7326668676203,2.55728284235654,30,20,10,51,28,23,74,38,36,3,3,0,0
"21559","TOR","NYR",2010020083,14903,20102011,1,60,1,2,-1,3.66091646224959,3.23101826860714,0.429898193642445,25,32,-7,34,43,-9,64,55,9,5,2,0,0
"21560","TOR","PHI",2010020101,14905,20102011,0,60,2,5,-3,2.69517156560323,4.64289635126534,-1.9477247856621,14,40,-26,22,55,-33,40,68,-28,5,6,0,0
"21561","TOR","FLA",2010020117,14908,20102011,1,60,3,1,2,4.01124751020689,7.1696246159845,-3.15837710577762,27,22,5,37,38,-1,58,65,-7,2,3,0,0
"21562","TOR","BOS",2010020129,14910,20102011,0,60,0,2,-2,2.60787335742498,5.46930959759758,-2.8614362401726,20,32,-12,35,46,-11,48,57,-9,5,3,0,0
"21563","TOR","NYR",2010020143,14912,20102011,1,60,0,2,-2,5.73278724929644,3.34402709361166,2.38876015568478,36,24,12,57,29,28,92,35,57,3,2,0,0
"21564","TOR","OTT",2010020160,14915,20102011,1,60,2,3,-1,4.58213875253023,3.75885054300255,0.823288209527681,35,24,11,54,38,16,72,47,25,5,5,0,0
"21565","TOR","WSH",2010020165,14916,20102011,0,65,4,4,0,5.22030144271639,4.44481447961914,0.775486963097248,28,30,-2,39,44,-5,56,64,-8,4,4,0,0
"21566","TOR","BUF",2010020189,14919,20102011,1,65,2,2,0,5.76716801753354,4.43879891790129,1.32836909963224,25,31,-6,44,50,-6,59,73,-14,2,3,0,0
"21567","TOR","T.B",2010020208,14922,20102011,0,60,0,4,-4,2.12726382620167,2.40057219723167,-0.273308371029998,28,25,3,38,35,3,60,51,9,5,2,0,0
"21568","TOR","FLA",2010020214,14923,20102011,0,60,1,4,-3,4.07884332067624,4.60453948589566,-0.525696165219415,33,28,5,45,40,5,59,47,12,5,5,0,0
"21569","TOR","VAN",2010020235,14926,20102011,1,60,3,5,-2,4.03637418347368,5.6660585380922,-1.62968435461852,32,32,0,48,47,1,60,59,1,5,4,0,0
"21570","TOR","NSH",2010020254,14929,20102011,1,60,5,4,1,4.88979558745632,4.68862947937481,0.201166108081509,33,34,-1,45,44,1,67,62,5,8,2,0,0
"21571","TOR","N.J",2010020270,14931,20102011,1,60,3,1,2,2.99057506723329,4.45891516999109,-1.46834010275779,27,30,-3,35,47,-12,43,70,-27,3,2,0,0
"21572","TOR","MTL",2010020285,14933,20102011,0,60,0,2,-2,2.99687452564103,2.87424840104495,0.122626124596081,30,39,-9,41,51,-10,54,70,-16,3,1,0,0
"21573","TOR","DAL",2010020298,14935,20102011,1,60,4,1,3,5.01703825961704,3.85546382528264,1.1615744343344,26,22,4,40,40,0,58,67,-9,1,2,0,0
"21574","TOR","BUF",2010020329,14939,20102011,0,60,1,3,-2,4.57463136834917,2.88001206331455,1.69461930503462,36,28,8,45,33,12,57,42,15,7,5,0,0
"21575","TOR","OTT",2010020337,14940,20102011,0,60,0,3,-3,2.83953535032492,4.56625386838277,-1.72671851805785,29,28,1,42,39,3,63,53,10,3,1,0,0
"21576","TOR","T.B",2010020353,14943,20102011,1,61.25,3,4,-1,2.02562005742206,5.81744404471829,-3.79182398729622,25,39,-14,35,52,-17,47,69,-22,4,5,0,0
"21577","TOR","EDM",2010020366,14945,20102011,1,60,0,5,-5,3.10151290619574,2.53207284820382,0.569440057991919,33,19,14,42,24,18,63,39,24,5,4,0,0
"21578","TOR","BOS",2010020381,14947,20102011,1,65,2,2,0,4.19864508737621,2.66905342732207,1.52959166005414,40,27,13,57,41,16,74,62,12,5,3,0,0
"21579","TOR","WSH",2010020397,14949,20102011,0,65,4,4,0,3.80021620479874,5.26604412816232,-1.46582792336358,28,36,-8,37,47,-10,52,60,-8,4,3,0,0
"21580","TOR","PIT",2010020407,14951,20102011,0,60,2,5,-3,3.34038847184274,3.86687663342332,-0.526488161580573,25,26,-1,34,41,-7,52,57,-5,9,6,0,0
"21581","TOR","PHI",2010020413,14952,20102011,1,60,1,4,-3,5.6854131425124,6.17061332054436,-0.485200178031963,32,28,4,49,36,13,71,54,17,4,4,0,0
"21582","TOR","MTL",2010020427,14954,20102011,1,60,3,1,2,6.3585033917916,4.44370834512745,1.91479504666415,24,23,1,42,39,3,67,56,11,5,3,0,0
"21583","TOR","EDM",2010020448,14957,20102011,0,60,4,1,3,3.26378179333892,1.92524830541981,1.33853348791911,34,24,10,51,35,16,68,49,19,5,4,0,0
"21584","TOR","CGY",2010020467,14959,20102011,0,60,2,5,-3,5.50175139028579,4.59948633913882,0.902265051146969,19,33,-14,32,50,-18,53,70,-17,2,5,0,0
"21585","TOR","VAN",2010020483,14961,20102011,0,60,1,4,-3,5.08879013966178,6.06620459875558,-0.977414459093794,28,29,-1,39,41,-2,50,55,-5,4,6,0,0
"21586","TOR","ATL",2010020489,14963,20102011,1,60,3,6,-3,5.61691906127817,6.10594981282142,-0.489030751543254,40,23,17,58,38,20,91,51,40,4,1,0,0
"21587","TOR","N.J",2010020520,14969,20102011,0,60,4,1,3,3.64658844717633,5.5180750201107,-1.87148657293437,22,30,-8,31,44,-13,47,52,-5,5,5,0,0
"21588","TOR","CAR",2010020536,14971,20102011,1,60,3,4,-1,4.2198558990541,5.3931113387704,-1.17325543971629,37,27,10,51,40,11,69,59,10,7,5,0,0
"21589","TOR","CBJ",2010020551,14973,20102011,1,60,2,3,-1,4.57854421321139,6.1206838535727,-1.54213964036131,22,32,-10,37,49,-12,47,74,-27,1,2,0,0
"21590","TOR","OTT",2010020568,14975,20102011,0,60,5,1,4,4.04682023509599,5.5866192689391,-1.53979903384311,21,33,-12,34,43,-9,48,58,-10,8,8,0,0
"21591","TOR","BOS",2010020581,14977,20102011,1,60,1,2,-1,5.35052805561494,3.95784367294982,1.39268438266512,37,33,4,53,47,6,71,73,-2,2,2,0,0
"21592","TOR","STL",2010020598,14980,20102011,1,65,5,5,0,4.70461570052794,6.15986352985308,-1.45524782932515,31,44,-13,44,55,-11,68,74,-6,2,1,0,0
"21593","TOR","ATL",2010020605,14981,20102011,0,60,9,3,6,3.22283656439049,6.57832536640763,-3.35548880201713,34,44,-10,40,52,-12,49,65,-16,3,4,0,0
"21594","TOR","L.A",2010020631,14984,20102011,0,60,3,2,1,2.70117758694141,9.38729471398983,-6.68611712704842,28,32,-4,36,48,-12,42,65,-23,2,4,0,0
"21595","TOR","S.J",2010020641,14985,20102011,0,60,4,2,2,4.5513345246317,7.39441277022706,-2.84307824559536,26,42,-16,32,65,-33,44,73,-29,4,4,0,0
"21596","TOR","ARI",2010020651,14987,20102011,0,60,1,5,-4,2.5943727218023,3.66691169163096,-1.07253896982866,29,21,8,43,33,10,54,41,13,8,8,0,0
"21597","TOR","CGY",2010020661,14989,20102011,1,65,1,1,0,3.86897476528065,3.54929571659886,0.319679048681792,33,33,0,50,54,-4,72,66,6,3,3,0,0
"21598","TOR","NYR",2010020693,14993,20102011,0,60,0,7,-7,5.03306948527552,3.22191426597789,1.81115521929763,22,28,-6,37,30,7,57,39,18,4,4,0,0
"21599","TOR","ANA",2010020697,14994,20102011,1,60,5,2,3,3.44795432611014,5.8171618974884,-2.36920757137826,37,28,9,46,44,2,66,59,7,2,2,0,0
"21600","TOR","WSH",2010020715,14996,20102011,1,60,1,4,-3,4.81752982273925,5.02488334287897,-0.207353520139716,36,31,5,49,41,8,76,51,25,3,2,0,0
"21601","TOR","CAR",2010020729,14998,20102011,0,60,4,6,-2,4.95838043298843,5.3106963000441,-0.352315867055662,30,28,2,49,50,-1,64,68,-4,6,10,0,0
"21602","TOR","T.B",2010020739,14999,20102011,0,60,0,2,-2,4.84444408616657,5.50022776634432,-0.65578368017775,26,31,-5,37,39,-2,57,59,-2,3,6,0,0
"21603","TOR","FLA",2010020751,15006,20102011,1,65,3,3,0,4.54387802749989,4.01656356209112,0.527314465408762,25,33,-8,40,45,-5,55,69,-14,4,4,0,0
"21604","TOR","CAR",2010020771,15008,20102011,1,60,3,0,3,5.26159020722844,6.49751976761036,-1.23592956038192,41,27,14,56,42,14,69,70,-1,4,4,0,0
"21605","TOR","BUF",2010020785,15010,20102011,0,60,2,6,-4,3.24927256462787,7.94174428376937,-4.69247171914149,25,43,-18,32,48,-16,48,66,-18,4,5,0,0
"21606","TOR","ATL",2010020796,15012,20102011,1,60,5,4,1,6.0489154781517,3.9457378195948,2.1031776585569,32,34,-2,48,50,-2,70,63,7,5,7,0,0
"21607","TOR","NYI",2010020803,15013,20102011,0,60,5,3,2,3.91910490356341,4.2324506354596,-0.313345731896195,26,34,-8,38,43,-5,49,63,-14,5,4,0,0
"21608","TOR","N.J",2010020816,15015,20102011,1,64.6,1,2,-1,2.77812429097729,8.97626885927457,-6.19814456829728,32,39,-7,47,60,-13,63,83,-20,7,5,0,0
"21609","TOR","MTL",2010020831,15017,20102011,0,60,0,3,-3,2.3826948874048,3.26937209439717,-0.886677206992375,27,39,-12,33,48,-15,52,68,-16,5,6,0,0
"21610","TOR","BOS",2010020848,15020,20102011,0,60,4,3,1,6.51695773459823,7.15210488507,-0.63514715047177,28,35,-7,36,54,-18,49,70,-21,3,4,0,0
"21611","TOR","BUF",2010020855,15021,20102011,0,60,2,1,1,5.72449227738244,5.45505159797904,0.269440679403402,30,24,6,46,38,8,64,45,19,4,5,0,0
"21612","TOR","OTT",2010020878,15024,20102011,1,65,0,0,0,6.1742274948881,1.86452956709548,4.30969792779262,47,22,25,58,32,26,74,44,30,6,3,0,0
"21613","TOR","NYI",2010020894,15027,20102011,1,60,2,1,1,3.57006111582114,4.98554728916497,-1.41548617334383,25,29,-4,39,40,-1,57,52,5,5,7,0,0
"21614","TOR","MTL",2010020911,15029,20102011,0,60,5,4,1,1.50011256129646,6.2942460122662,-4.79413345096974,28,35,-7,32,52,-20,44,69,-25,8,7,0,0
"21615","TOR","PIT",2010020927,15031,20102011,1,65,5,5,0,5.8617765592935,4.45634589143447,1.40543066785904,31,40,-9,42,51,-9,56,68,-12,7,3,0,0
"21616","TOR","ATL",2010020934,15032,20102011,0,62.5166666666667,2,3,-1,2.4518689410761,7.38349175944607,-4.93162281836997,24,43,-19,30,63,-33,41,83,-42,4,4,0,0
"21617","TOR","PIT",2010020952,15035,20102011,1,60.7,3,2,1,3.14118736273667,4.1405903323141,-0.999402969577423,20,29,-9,39,45,-6,51,71,-20,5,3,0,0
"21618","TOR","PHI",2010020959,15036,20102011,0,60,3,2,1,4.25933563055878,4.25341167759513,0.00592395296365389,33,30,3,42,43,-1,60,60,0,8,3,0,0
"21619","TOR","CHI",2010020977,15038,20102011,1,60,3,5,-2,3.33089821563618,4.25714837856158,-0.926250162925399,33,25,8,46,34,12,65,45,20,5,4,0,0
"21620","TOR","NYI",2010020993,15041,20102011,0,64.0333333333333,3,4,-1,4.2894744129444,7.32157719894944,-3.03210278600504,27,40,-13,38,52,-14,55,66,-11,4,2,0,0
"21621","TOR","PHI",2010021009,15043,20102011,1,60,2,3,-1,4.31454765758826,6.00234882594668,-1.68780116835842,29,33,-4,44,49,-5,61,62,-1,6,4,0,0
"21622","TOR","BUF",2010021024,15045,20102011,1,60,4,3,1,5.4378055461566,7.16693650427987,-1.72913095812328,29,42,-13,44,55,-11,66,68,-2,2,1,0,0
"21623","TOR","T.B",2010021038,15047,20102011,1,60,2,6,-4,5.73309533606516,5.65746443592796,0.075630900137206,32,36,-4,46,50,-4,60,65,-5,5,2,0,0
"21624","TOR","CAR",2010021051,15049,20102011,0,60,3,1,2,3.46960797962782,5.76086542123812,-2.2912574416103,19,37,-18,28,52,-24,36,84,-48,3,5,0,0
"21625","TOR","FLA",2010021059,15050,20102011,0,60,0,4,-4,3.4282616575365,3.94848130468745,-0.520219647150952,24,26,-2,36,40,-4,51,50,1,5,2,0,0
"21626","TOR","BOS",2010021072,15052,20102011,1,60,5,2,3,4.92993204202503,5.00252756576356,-0.0725955237385278,29,37,-8,46,61,-15,60,83,-23,2,2,0,0
"21627","TOR","MIN",2010021095,15055,20102011,0,60,3,0,3,2.68492169284491,4.12663582427558,-1.44171413143067,17,29,-12,25,41,-16,38,58,-20,7,8,0,0
"21628","TOR","COL",2010021108,15057,20102011,0,60,4,3,1,3.23852599243401,3.04078800563093,0.197737986803077,27,28,-1,35,39,-4,54,50,4,3,2,0,0
"21629","TOR","DET",2010021122,15059,20102011,0,60,2,4,-2,3.76036341304462,6.17241756990438,-2.41205415685977,24,29,-5,35,40,-5,43,60,-17,4,2,0,0
"21630","TOR","BUF",2010021135,15062,20102011,1,60,4,3,1,3.8152552471729,3.32454084652954,0.490714400643355,35,31,4,50,41,9,60,61,-1,7,4,0,0
"21631","TOR","BOS",2010021150,15064,20102011,0,65,3,3,0,5.56373411337046,3.78586991357543,1.77786419979503,31,38,-7,45,52,-7,61,75,-14,6,6,0,0
"21632","TOR","OTT",2010021168,15066,20102011,0,60,4,2,2,3.88775761811121,4.66112345681233,-0.773365838701125,30,25,5,41,39,2,58,50,8,2,3,0,0
"21633","TOR","WSH",2010021185,15069,20102011,1,65,2,2,0,2.48494021380611,6.65149287435634,-4.16655266055022,21,41,-20,30,60,-30,48,78,-30,2,3,0,0
"21634","TOR","N.J",2010021194,15070,20102011,0,60,2,4,-2,3.78623272359408,4.5587823530368,-0.772549629442722,24,33,-9,28,39,-11,32,52,-20,1,5,0,0
"21635","TOR","MTL",2010021217,15073,20102011,1,60,1,4,-3,4.54959501710128,5.53810810120942,-0.988513084108142,28,34,-6,41,52,-11,59,63,-4,5,3,0,0
"21636","TOR","MTL",2011020002,15253,20112012,1,60,2,0,2,2.23819226528576,4.14950016102592,-1.91130789574016,18,32,-14,36,41,-5,48,61,-13,4,5,0,0
"21637","TOR","OTT",2011020011,15255,20112012,1,60,6,5,1,4.28069484033079,5.72885885003456,-1.44816400970377,35,32,3,50,49,1,58,65,-7,9,9,0,0
"21638","TOR","CGY",2011020049,15262,20112012,1,60,3,2,1,2.75401636391316,2.5532397224066,0.200776641506561,25,32,-7,37,45,-8,60,65,-5,4,4,0,0
"21639","TOR","COL",2011020064,15264,20112012,1,61.1833333333333,2,3,-1,5.02498012443539,2.85620196856871,2.16877815586668,29,24,5,46,36,10,69,56,13,4,2,0,0
"21640","TOR","WPG",2011020079,15266,20112012,1,65,3,3,0,2.95595580421559,5.61628796355217,-2.66033215933658,23,29,-6,33,45,-12,48,59,-11,4,4,0,0
"21641","TOR","BOS",2011020080,15267,20112012,0,60,2,6,-4,4.51106503148912,5.47332195762699,-0.962256926137862,28,43,-15,34,52,-18,53,72,-19,4,6,0,0
"21642","TOR","MTL",2011020098,15269,20112012,0,61.3833333333333,5,4,1,4.04110784791163,2.21340370565269,1.82770414225894,27,28,-1,39,37,2,54,54,0,7,4,0,0
"21643","TOR","PHI",2011020110,15271,20112012,0,60,2,4,-2,5.74332914262777,2.85065248553872,2.89267665708906,26,30,-4,33,41,-8,43,54,-11,4,5,0,0
"21644","TOR","NYR",2011020127,15274,20112012,0,60,4,2,2,3.35021509642115,4.33903542024473,-0.988820323823575,36,30,6,47,36,11,66,45,21,5,4,0,0
"21645","TOR","PIT",2011020142,15276,20112012,1,60,4,3,1,4.14650180751677,6.79398924711859,-2.64748743960182,29,37,-8,39,53,-14,49,70,-21,3,5,0,0
"21646","TOR","OTT",2011020154,15277,20112012,0,60,2,3,-1,3.21768718372914,3.55096951088157,-0.333282327152432,25,30,-5,33,45,-12,52,63,-11,6,4,0,0
"21647","TOR","N.J",2011020166,15280,20112012,0,60,5,3,2,3.59266480139922,2.6698385241325,0.922826277266722,23,22,1,34,28,6,40,38,2,2,2,0,0
"21648","TOR","CBJ",2011020171,15281,20112012,0,60,4,1,3,3.39163151546381,10.2556968700992,-6.86406535463539,18,39,-21,24,52,-28,33,70,-37,2,4,0,0
"21649","TOR","BOS",2011020184,15283,20112012,1,60,0,7,-7,4.8989355644153,2.46865904129186,2.43027652312344,25,20,5,39,29,10,60,53,7,4,2,0,0
"21650","TOR","FLA",2011020203,15286,20112012,1,60,1,5,-4,4.31129925212008,4.15473144920543,0.156567802914651,39,28,11,49,37,12,67,57,10,2,2,0,0
"21651","TOR","STL",2011020216,15288,20112012,0,65,2,2,0,2.3832628093582,6.4464518444729,-4.0631890351147,22,40,-18,33,56,-23,40,77,-37,4,6,0,0
"21652","TOR","OTT",2011020230,15290,20112012,1,60,2,5,-3,5.93068879972878,6.37970025788526,-0.449011458156477,33,24,9,45,38,7,74,47,27,6,3,0,0
"21653","TOR","ARI",2011020248,15293,20112012,1,65,2,2,0,8.69648071079834,3.47389269282576,5.22258801797259,37,35,2,54,50,4,74,62,12,2,2,0,0
"21654","TOR","NSH",2011020265,15295,20112012,0,60,1,4,-3,3.32179083501773,5.31634554523043,-1.99455471021271,39,22,17,50,33,17,68,41,27,2,3,0,0
"21655","TOR","WSH",2011020277,15297,20112012,1,60,7,1,6,5.97362213928477,5.99022611797959,-0.0166039786948211,29,41,-12,47,55,-8,57,68,-11,7,7,0,0
"21656","TOR","CAR",2011020286,15298,20112012,0,60,2,3,-1,5.57690274348097,6.32117250518058,-0.744269761699615,25,41,-16,35,60,-25,47,79,-32,4,7,0,0
"21657","TOR","T.B",2011020297,15300,20112012,0,60,7,1,6,2.86925441098174,4.31704355686088,-1.44778914587914,26,28,-2,35,42,-7,50,55,-5,6,8,0,0
"21658","TOR","DAL",2011020324,15303,20112012,0,65,3,3,0,3.8143395591178,4.42568850006,-0.611348940942197,23,29,-6,36,56,-20,55,71,-16,4,4,0,0
"21659","TOR","ANA",2011020340,15305,20112012,0,60,5,2,3,5.88077600424731,3.26585360460012,2.61492239964718,28,28,0,44,41,3,55,52,3,4,2,0,0
"21660","TOR","BOS",2011020353,15308,20112012,1,60,3,6,-3,5.71632993797357,8.21819931536447,-2.5018693773909,37,40,-3,49,53,-4,67,72,-5,2,5,0,0
"21661","TOR","BOS",2011020373,15311,20112012,0,60,1,4,-3,2.51433767139679,5.10860427421974,-2.59426660282296,22,30,-8,29,40,-11,42,55,-13,4,2,0,0
"21662","TOR","NYR",2011020387,15313,20112012,0,60,4,2,2,2.72725644030288,4.95590158650884,-2.22864514620596,30,32,-2,38,45,-7,55,59,-4,4,5,0,0
"21663","TOR","N.J",2011020392,15314,20112012,1,62.6666666666667,2,3,-1,4.69604638417155,3.99560947611462,0.700436908056929,31,26,5,43,38,5,55,54,1,2,4,0,0
"21664","TOR","WSH",2011020417,15317,20112012,0,60,2,4,-2,5.06088359974092,3.25460550020216,1.80627809953876,28,25,3,39,32,7,55,42,13,4,8,0,0
"21665","TOR","CAR",2011020438,15321,20112012,1,60.7333333333333,2,1,1,4.96995320834685,2.86303106816899,2.10692214017786,38,19,19,59,30,29,76,46,30,3,3,0,0
"21666","TOR","BUF",2011020462,15324,20112012,0,60,4,5,-1,4.09003730318545,4.44673519186472,-0.356697888679264,33,29,4,45,39,6,60,52,8,2,4,0,0
"21667","TOR","VAN",2011020467,15325,20112012,1,60,3,5,-2,4.42042809443046,5.22230682705413,-0.801878732623663,29,36,-7,42,52,-10,52,77,-25,2,2,0,0
"21668","TOR","L.A",2011020482,15327,20112012,1,65,2,2,0,3.06173852421439,7.65680401129748,-4.59506548708309,33,42,-9,47,64,-17,61,88,-27,6,6,0,0
"21669","TOR","BUF",2011020500,15330,20112012,1,60,3,2,1,3.5798653626116,4.44563917382623,-0.865773811214626,31,42,-11,40,55,-15,58,71,-13,7,7,0,0
"21670","TOR","NYI",2011020510,15331,20112012,0,60,5,3,2,4.93557248392608,7.34143420972396,-2.40586172579788,27,33,-6,37,45,-8,52,58,-6,4,5,0,0
"21671","TOR","FLA",2011020533,15335,20112012,0,60,3,5,-2,4.26618969865376,3.77742446266604,0.488765235987717,32,26,6,42,37,5,58,45,13,4,3,0,0
"21672","TOR","CAR",2011020544,15337,20112012,0,63.15,3,4,-1,3.30638919665944,5.21833765416523,-1.91194845750579,24,34,-10,42,43,-1,60,54,6,6,4,0,0
"21673","TOR","WPG",2011020562,15339,20112012,0,60,2,3,-1,1.95413173719394,2.65640527156211,-0.702273534368172,24,35,-11,40,45,-5,61,55,6,3,6,0,0
"21674","TOR","T.B",2011020575,15342,20112012,1,60,7,3,4,4.35711954447127,3.92668310840418,0.430436436067088,42,24,18,55,43,12,68,62,6,9,8,0,0
"21675","TOR","WPG",2011020585,15344,20112012,1,60,4,0,4,3.81016837537754,3.21098580242688,0.599182572950667,25,24,1,42,49,-7,69,65,4,3,1,0,0
"21676","TOR","DET",2011020603,15346,20112012,1,60,4,3,1,1.79291412804559,3.77918473765021,-1.98627060960462,18,40,-22,28,65,-37,39,85,-46,1,1,0,0
"21677","TOR","BUF",2011020617,15349,20112012,1,60,2,0,2,4.69369722774718,4.74795615959175,-0.0542589318445739,28,32,-4,35,42,-7,48,60,-12,6,2,0,0
"21678","TOR","BUF",2011020644,15352,20112012,0,60,2,3,-1,1.55431164376205,2.75415344124081,-1.19984179747876,26,25,1,33,29,4,44,39,5,4,2,0,0
"21679","TOR","NYR",2011020649,15353,20112012,1,60,0,3,-3,2.57645716461695,3.79741834155908,-1.22096117694212,20,30,-10,30,42,-12,53,63,-10,2,2,0,0
"21680","TOR","OTT",2011020670,15356,20112012,1,60,2,3,-1,8.1147108564046,3.09305248365854,5.02165837274606,39,21,18,64,34,30,77,57,20,2,1,0,0
"21681","TOR","MIN",2011020685,15358,20112012,1,60,4,1,3,5.69843611882243,5.67566387234077,0.0227722464816535,33,21,12,49,36,13,67,55,12,6,2,0,0
"21682","TOR","MTL",2011020702,15360,20112012,1,60,1,3,-2,4.60812455153291,4.04556730018033,0.562557251352581,33,23,10,49,33,16,68,48,20,3,3,0,0
"21683","TOR","NYI",2011020716,15362,20112012,1,60,3,0,3,5.24167033877166,3.99618085388647,1.24548948488518,35,25,10,53,35,18,73,53,20,2,0,0,0
"21684","TOR","NYI",2011020723,15363,20112012,0,62.1,4,3,1,3.00170328101376,4.00379235257788,-1.00208907156411,21,32,-11,32,50,-18,62,61,1,3,1,0,0
"21685","TOR","OTT",2011020771,15374,20112012,0,60,5,0,5,5.20867715783041,6.5162147041774,-1.30753754634699,40,49,-9,57,60,-3,65,80,-15,5,3,0,0
"21686","TOR","EDM",2011020783,15376,20112012,1,60,6,3,3,6.88447461655596,4.59183590749308,2.29263870906289,31,30,1,50,44,6,61,68,-7,0,0,0,0
"21687","TOR","WPG",2011020794,15377,20112012,0,60,1,2,-1,4.54880102316383,3.2393153994696,1.30948562369423,18,29,-11,31,36,-5,46,49,-3,2,2,0,0
"21688","TOR","PHI",2011020804,15379,20112012,0,60,3,4,-1,5.0295870307018,4.77784061903094,0.251746411670865,27,39,-12,38,46,-8,57,73,-16,4,4,0,0
"21689","TOR","MTL",2011020822,15381,20112012,1,60,0,5,-5,4.31214096494659,2.99587364324179,1.3162673217048,32,18,14,55,31,24,76,44,32,5,2,0,0
"21690","TOR","CGY",2011020845,15384,20112012,0,60,1,5,-4,5.16960818789455,4.46089912323805,0.708709064656503,42,34,8,56,44,12,71,49,22,3,3,0,0
"21691","TOR","EDM",2011020849,15385,20112012,0,61.65,4,3,1,3.93040587150608,5.33212665313476,-1.40172078162868,26,32,-6,36,49,-13,56,64,-8,3,2,0,0
"21692","TOR","VAN",2011020870,15388,20112012,0,60,2,6,-4,6.16477614658652,5.22251527541084,0.942260871175677,26,36,-10,37,48,-11,58,60,-2,2,2,0,0
"21693","TOR","N.J",2011020886,15391,20112012,1,61.3,3,4,-1,5.02130373200634,3.01114311908422,2.01016061292213,32,32,0,49,49,0,62,53,9,2,3,0,0
"21694","TOR","S.J",2011020899,15393,20112012,1,60,1,2,-1,3.55882566981822,3.25607589562424,0.302749774193982,30,25,5,41,43,-2,56,58,-2,0,2,0,0
"21695","TOR","WSH",2011020918,15395,20112012,1,60,2,4,-2,4.25308871220477,4.65868418052014,-0.405595468315369,30,36,-6,45,44,1,70,54,16,5,2,0,0
"21696","TOR","FLA",2011020938,15398,20112012,1,60,3,5,-2,3.61390178391263,3.60592055605957,0.00798122785305644,31,23,8,47,33,14,64,40,24,5,4,0,0
"21697","TOR","CHI",2011020947,15399,20112012,0,60,4,5,-1,5.1001350285951,4.49656796111958,0.603567067475524,34,35,-1,44,46,-2,64,55,9,4,3,0,0
"21698","TOR","MTL",2011020966,15402,20112012,0,60,3,1,2,7.46009229272022,2.25126643525417,5.20882585746605,42,22,20,52,30,22,70,43,27,4,3,0,0
"21699","TOR","BOS",2011020984,15405,20112012,1,60,4,5,-1,3.91611706935441,4.76319679265725,-0.847079723302841,29,33,-4,31,46,-15,47,64,-17,6,3,0,0
"21700","TOR","PHI",2011021016,15409,20112012,1,65,0,0,0,3.40119285637047,3.82758844530053,-0.426395588930063,29,27,2,48,43,5,71,52,19,4,1,0,0
"21701","TOR","WSH",2011021025,15410,20112012,0,60,0,2,-2,2.14332470257068,3.56270280649187,-1.41937810392119,23,23,0,31,31,0,52,45,7,1,1,0,0
"21702","TOR","FLA",2011021041,15412,20112012,0,60,2,5,-3,1.9697870479431,3.05869277764577,-1.08890572970267,28,27,1,40,39,1,53,47,6,2,4,0,0
"21703","TOR","T.B",2011021056,15414,20112012,0,60,3,1,2,2.30012247327249,4.4104058729772,-2.11028339970471,28,35,-7,34,44,-10,50,54,-4,8,7,0,0
"21704","TOR","OTT",2011021069,15416,20112012,0,60,3,1,2,2.47597060205393,5.82477936777286,-3.34880876571893,18,30,-12,24,49,-25,34,76,-42,7,6,0,0
"21705","TOR","BOS",2011021082,15418,20112012,0,60,0,8,-8,2.01485868712189,4.03118941458524,-2.01633072746336,13,24,-11,22,32,-10,33,40,-7,2,2,0,0
"21706","TOR","NYI",2011021088,15419,20112012,1,60,2,5,-3,3.73290509410435,6.06616339076027,-2.33325829665591,14,34,-20,21,48,-27,34,66,-32,1,4,0,0
"21707","TOR","N.J",2011021110,15422,20112012,0,65,3,3,0,2.22884891775902,8.19282883585765,-5.96397991809863,17,46,-29,20,56,-36,24,64,-40,0,2,0,0
"21708","TOR","NYR",2011021119,15423,20112012,1,65,3,3,0,4.46731161402614,2.45351274845598,2.01379886557016,25,33,-8,39,47,-8,59,58,1,3,2,0,0
"21709","TOR","CAR",2011021141,15426,20112012,1,60,0,3,-3,2.39359215868171,1.56099169756635,0.832600461115362,30,22,8,41,34,7,56,42,14,2,2,0,0
"21710","TOR","PHI",2011021155,15428,20112012,1,60,1,7,-6,1.79906586408583,5.5743448963907,-3.77527903230487,17,30,-13,29,46,-17,45,56,-11,6,6,0,0
"21711","TOR","BUF",2011021171,15430,20112012,1,60,4,3,1,3.37625525105977,5.38819695985876,-2.01194170879899,29,32,-3,42,55,-13,57,76,-19,2,3,0,0
"21712","TOR","BUF",2011021190,15433,20112012,0,63.4833333333333,5,6,-1,3.79310442690621,4.41514258566315,-0.622038158756936,25,45,-20,33,51,-18,41,66,-25,1,5,0,0
"21713","TOR","T.B",2011021201,15435,20112012,1,64.0166666666667,3,2,1,0,0,0,31,37,-6,40,52,-12,54,64,-10,2,0,0,0
"21714","TOR","MTL",2011021222,15437,20112012,0,60,1,4,-3,3.59612441106377,8.56033502414357,-4.9642106130798,31,27,4,43,40,3,64,47,17,6,4,0,0
"21715","TOR","MTL",2012020005,15724,20122013,0,60,2,1,1,4.38014957054111,4.68317480461033,-0.303025234069228,26,22,4,33,34,-1,43,48,-5,5,5,0,0
"21716","TOR","BUF",2012020023,15726,20122013,1,60,1,2,-1,5.55972727003973,3.42391128565941,2.13581598438032,35,20,15,55,30,25,73,38,35,9,5,0,0
"21717","TOR","NYI",2012020040,15729,20122013,1,60,4,7,-3,4.84823980145437,4.22403355210554,0.624206249348831,43,34,9,53,44,9,69,50,19,5,2,0,0
"21718","TOR","NYR",2012020058,15731,20122013,0,60,2,5,-3,2.30156914105937,5.19982452536351,-2.89825538430414,17,42,-25,26,53,-27,39,68,-29,4,4,0,0
"21719","TOR","BUF",2012020079,15734,20122013,0,64.9666666666667,4,3,1,4.7153087972838,7.0786984754377,-2.36338967815391,24,32,-8,35,42,-7,49,58,-9,3,2,0,0
"21720","TOR","WSH",2012020093,15736,20122013,1,60,3,2,1,0,0,0,40,22,18,62,34,28,84,46,38,8,3,0,0
"21721","TOR","BOS",2012020111,15738,20122013,1,60,0,1,-1,2.47994467170793,3.44352024432737,-0.963575572619447,21,34,-13,31,45,-14,53,57,-4,4,3,0,0
"21722","TOR","CAR",2012020123,15740,20122013,1,60,1,4,-3,0,0,0,42,39,3,60,48,12,77,57,20,5,4,0,0
"21723","TOR","WSH",2012020130,15741,20122013,0,60,3,2,1,3.39148443023441,4.1591728773783,-0.767688447143883,21,26,-5,33,42,-9,42,64,-22,3,3,0,0
"21724","TOR","WPG",2012020148,15743,20122013,0,60,3,2,1,2.56205138127393,2.61607144664049,-0.0540200653665579,18,25,-7,25,37,-12,43,51,-8,4,4,0,0
"21725","TOR","MTL",2012020160,15745,20122013,0,60,6,0,6,3.19395517764497,6.70567090528141,-3.51171572763644,28,37,-9,37,51,-14,55,67,-12,10,8,0,0
"21726","TOR","PHI",2012020172,15747,20122013,1,60,5,2,3,3.54816130525433,4.60316236643063,-1.0550010611763,24,46,-22,38,55,-17,56,74,-18,6,3,0,0
"21727","TOR","CAR",2012020192,15750,20122013,0,60,1,3,-2,3.25510196742835,5.11179115584151,-1.85668918841317,23,33,-10,35,50,-15,51,69,-18,2,3,0,0
"21728","TOR","OTT",2012020205,15752,20122013,1,60,3,0,3,6.76183912614943,3.95474151366198,2.80709761248744,29,34,-5,40,49,-9,50,68,-18,2,4,0,0
"21729","TOR","FLA",2012020223,15754,20122013,0,60,3,0,3,2.26003302503932,5.04626517181202,-2.7862321467727,33,37,-4,41,46,-5,49,53,-4,4,5,0,0
"21730","TOR","T.B",2012020229,15755,20122013,0,60,2,4,-2,4.66755295265466,1.96684202374377,2.70071092891089,25,19,6,40,35,5,59,45,14,3,6,0,0
"21731","TOR","BUF",2012020237,15757,20122013,1,60,3,1,2,4.55998350643131,7.20228454706012,-2.64230104062881,36,32,4,52,46,6,69,66,3,6,4,0,0
"21732","TOR","OTT",2012020256,15759,20122013,0,60,2,3,-1,3.80473492279998,5.16956896390184,-1.36483404110186,28,35,-7,38,43,-5,56,65,-9,2,1,0,0
"21733","TOR","PHI",2012020270,15761,20122013,0,60,4,2,2,4.36430144169776,4.55306249088608,-0.188761049188315,22,25,-3,35,39,-4,51,51,0,3,6,0,0
"21734","TOR","MTL",2012020284,15763,20122013,1,60,2,5,-3,5.63915791967884,8.34074756409973,-2.70158964442089,23,40,-17,38,56,-18,56,74,-18,1,0,0,0
"21735","TOR","NYI",2012020289,15764,20122013,0,61.1833333333333,5,4,1,3.28578426811146,3.18202860833844,0.103755659773014,28,27,1,38,38,0,52,54,-2,0,0,0,0
"21736","TOR","N.J",2012020320,15768,20122013,1,60,4,2,2,1.93538988077773,5.78248231553897,-3.84709243476124,23,30,-7,32,51,-19,48,71,-23,4,4,0,0
"21737","TOR","OTT",2012020335,15770,20122013,1,60,5,4,1,2.07599265612589,7.51168240206619,-5.43568974594029,28,43,-15,40,71,-31,52,97,-45,2,1,0,0
"21738","TOR","BOS",2012020339,15771,20122013,0,60,2,4,-2,4.51865037390962,5.97485765062856,-1.45620727671894,27,25,2,39,36,3,50,48,2,4,4,0,0
"21739","TOR","WPG",2012020382,15776,20122013,0,60,2,5,-3,3.46646661881823,2.85075898273499,0.615707636083243,26,34,-8,34,45,-11,46,68,-22,5,6,0,0
"21740","TOR","WPG",2012020409,15780,20122013,1,65,4,4,0,5.19379879569439,3.70030885445885,1.49348994123554,32,33,-1,42,51,-9,60,77,-17,4,4,0,0
"21741","TOR","T.B",2012020438,15784,20122013,1,60,4,2,2,6.42348913749447,4.24589424746227,2.1775948900322,26,28,-2,39,40,-1,53,58,-5,3,5,0,0
"21742","TOR","BUF",2012020443,15785,20122013,0,65,4,4,0,5.75300416743016,6.19002090524737,-0.437016737817203,34,36,-2,48,48,0,56,64,-8,5,6,0,0
"21743","TOR","BOS",2012020459,15787,20122013,1,60,3,2,1,2.90550531249028,6.96538186544421,-4.05987655295394,13,33,-20,24,49,-25,38,80,-42,2,1,0,0
"21744","TOR","BOS",2012020472,15789,20122013,0,65,2,2,0,2.36098097271612,3.90502820827179,-1.54404723555567,25,29,-4,30,50,-20,38,69,-31,4,2,0,0
"21745","TOR","FLA",2012020479,15790,20122013,1,60,3,2,1,4.48866382052711,6.29706813215876,-1.80840431163165,31,42,-11,39,56,-17,54,76,-22,3,1,0,0
"21746","TOR","CAR",2012020492,15792,20122013,1,60,6,3,3,4.91785877286271,5.8593074732089,-0.941448700346193,36,22,14,48,40,8,66,57,9,4,3,0,0
"21747","TOR","OTT",2012020513,15794,20122013,0,60,4,0,4,4.09670250751248,6.64644040738222,-2.54973789986973,23,31,-8,30,45,-15,43,63,-20,6,6,0,0
"21748","TOR","PHI",2012020544,15799,20122013,1,60,3,5,-2,7.5387751366361,6.68915250175633,0.849622634879779,28,31,-3,46,45,1,64,58,6,2,4,0,0
"21749","TOR","N.J",2012020563,15801,20122013,0,60,2,1,1,1.97136905851403,2.09930474726826,-0.127935688754235,18,28,-10,26,35,-9,36,51,-15,6,6,0,0
"21750","TOR","NYR",2012020578,15803,20122013,1,60,4,3,1,3.87030748117832,7.33544720360078,-3.46513972242246,28,34,-6,38,56,-18,54,74,-20,2,2,0,0
"21751","TOR","NYR",2012020592,15805,20122013,0,65,2,2,0,4.20319992647273,4.31179995840648,-0.108600031933747,25,28,-3,37,40,-3,43,60,-17,2,3,0,0
"21752","TOR","MTL",2012020612,15808,20122013,1,60,5,1,4,5.57665937556885,3.70473968230152,1.87191969326733,28,37,-9,39,55,-16,49,77,-28,6,5,0,0
"21753","TOR","N.J",2012020625,15810,20122013,1,60,2,0,2,2.85107507591601,4.28169355379259,-1.43061847787658,13,32,-19,20,51,-31,33,73,-40,4,5,0,0
"21754","TOR","WSH",2012020633,15811,20122013,0,60,1,5,-4,4.3544452568612,6.37006401006265,-2.01561875320145,30,37,-7,38,50,-12,47,65,-18,3,6,0,0
"21755","TOR","NYI",2012020644,15813,20122013,1,60,3,5,-2,4.17190931319783,6.95418330168468,-2.78227398848685,21,38,-17,36,52,-16,58,64,-6,4,5,0,0
"21756","TOR","OTT",2012020663,15815,20122013,0,60,4,1,3,3.82709682955488,8.09851027667355,-4.27141344711868,22,50,-28,29,63,-34,38,90,-52,4,3,0,0
"21757","TOR","T.B",2012020690,15819,20122013,0,60,2,5,-3,3.41664526850218,5.01654283786547,-1.59989756936329,28,26,2,42,40,2,56,56,0,2,2,0,0
"21758","TOR","FLA",2012020698,15820,20122013,0,60,4,0,4,1.51254615196376,3.36827138627996,-1.8557252343162,17,34,-17,24,47,-23,30,67,-37,3,5,0,0
"21759","TOR","MTL",2012020708,15822,20122013,1,60,1,4,-3,1.69191392728885,2.84224606189214,-1.15033213460329,17,28,-11,33,45,-12,48,62,-14,8,7,0,0
"21760","TOR","BOS",2012030141,15826,20122013,0,60,1,4,-3,3.64271025735558,5.02020061940448,-1.3774903620489,20,40,-20,25,55,-30,33,71,-38,4,7,0,0
"21761","TOR","BOS",2012030142,15829,20122013,0,60,4,2,2,1.7852935824485,5.47672472354557,-3.69143114109707,32,41,-9,40,53,-13,53,70,-17,4,1,0,0
"21762","TOR","BOS",2012030143,15831,20122013,1,60,2,5,-3,9.32943056402083,5.96462754873156,3.36480301528928,47,38,9,57,49,8,71,64,7,7,5,0,0
"21763","TOR","BOS",2012030144,15833,20122013,1,73.1,3,4,-1,7.33225025204592,9.86813166609426,-2.53588141404833,48,45,3,66,65,1,86,96,-10,4,5,0,0
"21764","TOR","BOS",2012030145,15835,20122013,0,60,2,1,1,3.77181468088793,5.08822609818162,-1.31641141729369,33,44,-11,42,59,-17,55,86,-31,2,3,0,0
"21765","TOR","BOS",2012030146,15837,20122013,1,60,2,1,1,2.82537251419853,5.27177311883133,-2.4464006046328,26,30,-4,38,53,-15,55,73,-18,1,2,0,0
"21766","TOR","BOS",2012030147,15838,20122013,0,66.0833333333333,4,5,-1,3.71115300542442,6.23521356087031,-2.52406055544589,28,35,-7,38,53,-15,45,68,-23,5,4,0,0
"21767","TOR","MTL",2013020001,15979,20132014,0,60,4,3,1,4.45449228904435,4.26553568610325,0.188956602941097,38,37,1,46,53,-7,61,70,-9,8,6,0,0
"21768","TOR","PHI",2013020004,15980,20132014,0,60,3,1,2,3.81429470159674,4.98511971722473,-1.170825015628,25,32,-7,31,53,-22,42,73,-31,3,9,0,0
"21769","TOR","OTT",2013020022,15983,20132014,1,65,4,4,0,5.24879071481701,4.39645216417827,0.852338550638734,42,36,6,61,51,10,80,68,12,7,2,0,0
"21770","TOR","COL",2013020037,15986,20132014,1,60,1,2,-1,3.42578784839134,2.98888273842749,0.436905109963845,28,33,-5,46,42,4,64,55,9,2,3,0,0
"21771","TOR","NSH",2013020053,15988,20132014,0,60,4,0,4,3.71971027713153,4.22146761999102,-0.501757342859491,26,36,-10,34,44,-10,47,56,-9,1,3,0,0
"21772","TOR","EDM",2013020064,15990,20132014,1,62.15,6,5,1,4.64409415941918,4.66419335221872,-0.0200991927995346,26,31,-5,40,41,-1,60,54,6,3,4,0,0
"21773","TOR","MIN",2013020082,15993,20132014,1,60,4,1,3,3.32164160907269,8.52034691215695,-5.19870530308426,14,37,-23,19,54,-35,30,68,-38,4,6,0,0
"21774","TOR","CAR",2013020097,15995,20132014,1,60,2,3,-1,2.59920718389459,6.54527748767782,-3.94607030378323,26,38,-12,36,54,-18,42,66,-24,4,4,0,0
"21775","TOR","CHI",2013020119,15997,20132014,0,60,1,3,-2,1.93939157131535,6.45611138583627,-4.51671981452091,20,40,-20,26,52,-26,40,67,-27,6,4,0,0
"21776","TOR","ANA",2013020129,16000,20132014,1,60,4,2,2,3.85406220989535,5.69825519657024,-1.8441929866749,23,25,-2,30,47,-17,44,68,-24,5,5,0,0
"21777","TOR","CBJ",2013020150,16003,20132014,0,60,2,5,-3,4.48501839861274,6.66459352942184,-2.1795751308091,25,36,-11,31,47,-16,39,56,-17,5,8,0,0
"21778","TOR","EDM",2013020182,16007,20132014,0,60,4,0,4,1.64768393072882,3.86221250781091,-2.21452857708209,26,43,-17,34,55,-21,49,76,-27,2,2,0,0
"21779","TOR","CGY",2013020185,16008,20132014,0,60,4,2,2,2.98376036096306,7.96073425232316,-4.9769738913601,22,43,-21,30,56,-26,43,74,-31,2,6,0,0
"21780","TOR","VAN",2013020208,16011,20132014,0,60,0,4,-4,2.15426601538638,8.12973727776807,-5.97547126238169,21,47,-26,30,63,-33,42,74,-32,6,10,0,0
"21781","TOR","N.J",2013020241,16017,20132014,1,65,1,1,0,4.18017985154938,5.44747896363901,-1.26729911208963,28,35,-7,42,47,-5,52,60,-8,5,3,0,0
"21782","TOR","BOS",2013020247,16018,20132014,0,60,1,3,-2,7.0196296160866,5.44861171324737,1.57101790283923,34,34,0,43,50,-7,58,67,-9,3,2,0,0
"21783","TOR","MIN",2013020274,16022,20132014,0,65,1,1,0,3.06006766247992,4.52417142051854,-1.46410375803862,23,34,-11,31,52,-21,43,70,-27,4,5,0,0
"21784","TOR","BUF",2013020284,16024,20132014,0,60,1,3,-2,2.83222310617566,4.04097738757264,-1.20875428139698,33,27,6,43,31,12,59,35,24,3,3,0,0
"21785","TOR","BUF",2013020294,16025,20132014,1,60,4,2,2,2.52345243433956,6.87289602497205,-4.34944359063249,22,35,-13,36,48,-12,46,65,-19,6,7,0,0
"21786","TOR","NYI",2013020313,16028,20132014,1,60,5,2,3,4.27739506992657,5.7375490359999,-1.46015396607334,24,37,-13,38,47,-9,54,66,-12,2,2,0,0
"21787","TOR","NSH",2013020327,16030,20132014,1,60,2,4,-2,5.43974439322483,3.77487330528675,1.66487108793808,26,28,-2,44,41,3,54,53,1,2,3,0,0
"21788","TOR","WSH",2013020343,16032,20132014,1,65,1,1,0,5.43798368552234,8.5914062877273,-3.15342260220496,28,50,-22,41,73,-32,54,101,-47,1,3,0,0
"21789","TOR","CBJ",2013020356,16034,20132014,1,60,0,6,-6,3.35969427169766,6.26198628224665,-2.90229201054899,18,22,-4,34,37,-3,54,52,2,1,4,0,0
"21790","TOR","BUF",2013020388,16038,20132014,0,60.6333333333333,2,3,-1,3.38220639180508,5.98034817355801,-2.59814178175293,24,29,-5,34,42,-8,45,68,-23,2,5,0,0
"21791","TOR","MTL",2013020394,16039,20132014,0,60,2,4,-2,0,0,0,36,39,-3,43,50,-7,61,61,0,5,3,0,0
"21792","TOR","S.J",2013020410,16042,20132014,1,60,2,4,-2,3.1333134243614,6.25975730038938,-3.12644387602798,30,41,-11,39,67,-28,48,86,-38,3,4,0,0
"21793","TOR","DAL",2013020423,16044,20132014,1,64.3,3,2,1,4.02526230667718,8.56635964326247,-4.5410973365853,24,50,-26,35,73,-38,45,95,-50,3,5,0,0
"21794","TOR","OTT",2013020440,16046,20132014,0,65,3,3,0,3.2988883946673,9.32042230261697,-6.02153390794967,31,50,-19,43,72,-29,51,90,-39,6,8,0,0
"21795","TOR","BOS",2013020450,16047,20132014,1,60,2,5,-3,3.48221325286431,6.97665175802604,-3.49443850516172,32,39,-7,52,53,-1,75,68,7,5,4,0,0
"21796","TOR","L.A",2013020470,16050,20132014,1,60,1,3,-2,4.44781838688072,4.95937112408907,-0.511552737208349,39,23,16,49,33,16,69,49,20,5,4,0,0
"21797","TOR","STL",2013020477,16051,20132014,0,60,3,6,-3,1.58486538892612,5.28954268261111,-3.70467729368499,22,36,-14,28,52,-24,40,61,-21,3,3,0,0
"21798","TOR","CHI",2013020490,16053,20132014,1,60,7,3,4,5.05424831152418,3.54777566384883,1.50647264767535,32,28,4,44,44,0,56,67,-11,4,2,0,0
"21799","TOR","FLA",2013020511,16056,20132014,1,60,1,3,-2,3.54929958982393,4.72756221303061,-1.17826262320668,29,23,6,44,41,3,61,53,8,2,2,0,0
"21800","TOR","ARI",2013020524,16058,20132014,1,65,1,1,0,5.33034640022322,6.53877303799479,-1.20842663777157,27,35,-8,36,57,-21,47,77,-30,3,2,0,0
"21801","TOR","DET",2013020542,16060,20132014,1,65,4,4,0,2.94933933671564,5.6012202726525,-2.65188093593686,23,38,-15,35,63,-28,43,78,-35,4,1,0,0
"21802","TOR","NYR",2013020554,16062,20132014,0,65,1,1,0,4.45170269088703,7.79231242730748,-3.34060973642045,26,43,-17,33,56,-23,42,66,-24,4,4,0,0
"21803","TOR","BUF",2013020568,16066,20132014,1,65,3,3,0,4.56205325407791,4.7329892317014,-0.170935977623486,42,35,7,55,49,6,71,60,11,3,1,0,0
"21804","TOR","CAR",2013020590,16068,20132014,1,60,5,2,3,5.48489183561469,4.2733202959875,1.21157153962719,27,43,-16,38,61,-23,49,75,-26,3,3,0,0
"21805","TOR","DET",2013020610,16071,20132014,0,65,2,2,0,3.68069909459155,4.9950196085847,-1.31432051399315,26,43,-17,32,52,-20,40,63,-23,2,4,0,0
"21806","TOR","NYR",2013020629,16074,20132014,1,60,1,7,-6,2.91928152242326,8.85383253273176,-5.9345510103085,26,50,-24,44,70,-26,53,85,-32,2,4,0,0
"21807","TOR","NYI",2013020648,16077,20132014,1,60,3,5,-2,3.65251845968305,5.77898350782652,-2.12646504814347,26,25,1,42,36,6,52,47,5,5,1,0,0
"21808","TOR","CAR",2013020662,16079,20132014,0,60,1,6,-5,6.45059257316825,6.74491010204747,-0.294317528879219,26,36,-10,41,51,-10,61,63,-2,2,6,0,0
"21809","TOR","WSH",2013020670,16080,20132014,0,60,2,3,-1,5.74862649489432,3.0536036295902,2.69502286530413,34,35,-1,50,48,2,66,68,-2,4,5,0,0
"21810","TOR","N.J",2013020687,16082,20132014,1,65,2,2,0,3.36620210902765,7.44263981820428,-4.07643770917663,25,38,-13,34,61,-27,48,83,-35,4,4,0,0
"21811","TOR","BOS",2013020696,16084,20132014,0,60,4,3,1,2.29202961243573,7.02245739195591,-4.73042777952018,26,41,-15,30,57,-27,40,76,-36,5,3,0,0
"21812","TOR","BUF",2013020707,16085,20132014,1,65,3,3,0,4.97574176419948,6.93745317508001,-1.96171141088053,39,30,9,50,44,6,67,59,8,3,3,0,0
"21813","TOR","MTL",2013020727,16088,20132014,1,60,5,3,2,6.14363183293608,5.05905228381744,1.08457954911864,30,33,-3,40,50,-10,53,67,-14,3,4,0,0
"21814","TOR","ARI",2013020744,16090,20132014,0,60,4,2,2,6.49268682788534,3.46112421275562,3.03156261512972,29,41,-12,36,62,-26,50,78,-28,6,4,0,0
"21815","TOR","COL",2013020753,16091,20132014,0,60,5,2,3,6.15196031978121,2.5542743464463,3.59768597333491,31,37,-6,39,48,-9,49,63,-14,4,4,0,0
"21816","TOR","DAL",2013020765,16093,20132014,0,60,1,7,-6,4.19280387321487,4.68352182498074,-0.490717951765873,25,28,-3,32,43,-11,46,55,-9,6,5,0,0
"21817","TOR","WPG",2013020780,16095,20132014,0,62.7333333333333,4,5,-1,5.21307322324719,7.13323563642018,-1.92016241317299,28,32,-4,43,47,-4,69,57,12,6,4,0,0
"21818","TOR","T.B",2013020796,16098,20132014,1,60,3,2,1,4.12381099760329,6.7434165549075,-2.61960555730422,26,42,-16,40,61,-21,58,74,-16,3,3,0,0
"21819","TOR","FLA",2013020810,16100,20132014,1,60,6,3,3,1.99302662053953,3.87545245414458,-1.88242583360505,32,38,-6,41,53,-12,51,66,-15,4,6,0,0
"21820","TOR","OTT",2013020828,16102,20132014,1,60,6,3,3,5.40442089973476,4.24715473598438,1.15726616375038,36,26,10,45,43,2,59,60,-1,6,3,0,0
"21821","TOR","FLA",2013020848,16105,20132014,0,60,1,4,-3,2.0865194698672,5.36769121036195,-3.28117174049476,21,48,-27,27,60,-33,41,71,-30,0,2,0,0
"21822","TOR","T.B",2013020862,16107,20132014,0,60,4,1,3,3.73460437572794,3.84976804596477,-0.115163670236825,36,34,2,48,57,-9,56,75,-19,3,3,0,0
"21823","TOR","VAN",2013020875,16109,20132014,1,60,3,1,2,4.69572877010796,4.55677882226756,0.138949947840402,24,33,-9,40,46,-6,62,57,5,5,4,0,0
"21824","TOR","NYI",2013020887,16128,20132014,0,61.9166666666667,4,5,-1,2.70890009222642,3.99387196081628,-1.28497186858986,22,35,-13,32,47,-15,51,55,-4,4,4,0,0
"21825","TOR","MTL",2013020909,16130,20132014,0,63.4666666666667,3,4,-1,3.49386559569393,5.91469811286943,-2.4208325171755,25,30,-5,32,45,-13,53,59,-6,4,6,0,0
"21826","TOR","CBJ",2013020920,16132,20132014,1,60,1,2,-1,0,0,0,29,33,-4,45,45,0,60,63,-3,2,1,0,0
"21827","TOR","NYR",2013020934,16134,20132014,0,61.85,3,2,1,4.23660421160093,5.08047721046023,-0.843872998859297,29,37,-8,37,58,-21,48,79,-31,4,2,0,0
"21828","TOR","PHI",2013020955,16137,20132014,1,62.35,4,3,1,2.88923576378147,6.51814084813951,-3.62890508435804,36,31,5,46,55,-9,58,85,-27,3,2,0,0
"21829","TOR","ANA",2013020975,16139,20132014,0,60,3,1,2,3.03381336125813,5.68038529138721,-2.64657193012908,23,44,-21,29,67,-38,41,91,-50,4,6,0,0
"21830","TOR","S.J",2013020984,16140,20132014,0,60,2,6,-4,4.11161227368672,5.56708410875581,-1.45547183506909,21,48,-27,28,65,-37,35,90,-55,2,6,0,0
"21831","TOR","L.A",2013020995,16142,20132014,0,60,3,2,1,2.58075179519801,8.30773795695859,-5.72698616176058,29,41,-12,37,67,-30,43,83,-40,3,4,0,0
"21832","TOR","WSH",2013021014,16145,20132014,0,60,2,4,-2,4.83012809512729,4.57109059405047,0.259037501076818,29,33,-4,35,44,-9,50,58,-8,3,4,0,0
"21833","TOR","DET",2013021032,16147,20132014,0,60,2,3,-1,6.97319894470274,3.8905558947758,3.08264304992694,33,31,2,43,45,-2,57,58,-1,4,4,0,0
"21834","TOR","T.B",2013021038,16148,20132014,1,60,3,5,-2,6.49289287592264,5.32429872843204,1.16859414749059,39,30,9,52,48,4,66,64,2,1,6,0,0
"21835","TOR","MTL",2013021060,16151,20132014,1,60,3,4,-1,6.48568918972887,7.61489516685833,-1.12920597712946,36,36,0,50,50,0,73,62,11,2,2,0,0
"21836","TOR","N.J",2013021068,16152,20132014,0,60,2,3,-1,2.72567907511257,2.92772156087449,-0.202042485761922,23,24,-1,33,35,-2,42,40,2,4,2,0,0
"21837","TOR","STL",2013021079,16154,20132014,1,60,3,5,-2,5.54273238015594,6.61024569346807,-1.06751331331213,25,49,-24,34,66,-32,45,80,-35,3,3,0,0
"21838","TOR","PHI",2013021102,16157,20132014,0,60,2,4,-2,4.08070353974472,3.71990396654232,0.360799573202395,34,29,5,38,46,-8,55,65,-10,6,7,0,0
"21839","TOR","DET",2013021111,16158,20132014,1,60,2,4,-2,3.11460475384433,4.82420404699224,-1.7095992931479,27,28,-1,38,38,0,51,54,-3,4,5,0,0
"21840","TOR","CGY",2013021130,16161,20132014,1,60,3,2,1,4.79968034284502,7.14983346757072,-2.35015312472569,23,24,-1,37,48,-11,53,60,-7,1,3,0,0
"21841","TOR","BOS",2013021144,16163,20132014,1,62.85,4,3,1,6.93908427697565,7.83972648373297,-0.900642206757315,31,38,-7,39,59,-20,46,80,-34,3,2,0,0
"21842","TOR","WPG",2013021163,16165,20132014,1,60,2,4,-2,4.78345614365634,6.46373322723684,-1.6802770835805,25,41,-16,36,58,-22,48,71,-23,4,2,0,0
"21843","TOR","T.B",2013021184,16168,20132014,0,60,0,3,-3,5.42329411185347,7.10900496051181,-1.68571084865835,28,34,-6,41,51,-10,55,63,-8,3,1,0,0
"21844","TOR","FLA",2013021199,16170,20132014,0,60,2,4,-2,4.58822188782506,4.8419620936038,-0.25374020577874,29,37,-8,37,52,-15,44,63,-19,3,4,0,0
"21845","TOR","OTT",2013021215,16172,20132014,0,60,0,1,-1,5.78536764636374,5.63262389582553,0.152743750538205,28,37,-9,41,49,-8,49,74,-25,4,3,0,0
"21846","TOR","MTL",2014020001,16351,20142015,1,60,3,4,-1,2.77634502560858,5.19061422754252,-2.41426920193394,27,32,-5,37,47,-10,57,58,-1,2,2,0,0
"21847","TOR","NYR",2014020033,16355,20142015,0,60,6,3,3,5.9375565823284,4.75436470143723,1.18319188089117,36,38,-2,50,51,-1,63,65,-2,4,2,0,0
"21848","TOR","COL",2014020043,16357,20142015,1,60.5666666666667,3,2,1,3.54161274374383,2.96384841451982,0.57776432922401,40,24,16,51,34,17,70,50,20,6,4,0,0
"21849","TOR","DET",2014020059,16360,20142015,1,60,1,4,-3,4.52993442063161,5.34829151257873,-0.818357091947121,24,35,-11,40,47,-7,48,66,-18,3,6,0,0
"21850","TOR","DET",2014020066,16361,20142015,0,64.8333333333333,0,1,-1,5.31255958245312,5.18089569550239,0.131663886950736,30,32,-2,45,47,-2,55,53,2,6,6,0,0
"21851","TOR","NYI",2014020081,16364,20142015,0,60,5,2,3,1.74737719436069,3.26040607631367,-1.51302888195298,28,36,-8,31,50,-19,43,61,-18,5,7,0,0
"21852","TOR","OTT",2014020089,16383,20142015,0,60,5,3,2,3.96844215994382,4.60925634261912,-0.6408141826753,30,41,-11,44,54,-10,50,71,-21,3,4,0,0
"21853","TOR","BOS",2014020107,16368,20142015,1,60,1,4,-3,3.49508634779585,3.55736494841403,-0.0622786006181784,33,33,0,43,48,-5,56,66,-10,4,5,0,0
"21854","TOR","BUF",2014020129,16371,20142015,1,60,4,0,4,5.24460116188129,2.0692427954823,3.175358366399,37,10,27,54,20,34,73,36,37,7,3,0,0
"21855","TOR","CBJ",2014020148,16374,20142015,0,60,4,1,3,2.25053602067055,5.47318748678663,-3.22265146611608,27,29,-2,34,37,-3,43,51,-8,2,4,0,0
"21856","TOR","CHI",2014020154,16375,20142015,1,60,3,2,1,2.58599155620323,8.09537480036083,-5.50938324415761,27,47,-20,34,68,-34,44,87,-43,3,4,0,0
"21857","TOR","ARI",2014020183,16378,20142015,0,60,2,3,-1,3.29449643445196,4.68490620801066,-1.39040977355869,30,33,-3,38,43,-5,50,59,-9,6,5,0,0
"21858","TOR","COL",2014020194,16380,20142015,0,65,3,3,0,6.0457552566131,5.18105037172791,0.864704884885192,38,34,4,51,47,4,73,69,4,3,4,0,0
"21859","TOR","NYR",2014020204,16382,20142015,1,60,5,4,1,4.70775654971658,4.72732108166091,-0.0195645319443347,31,35,-4,40,44,-4,53,60,-7,2,2,0,0
"21860","TOR","BOS",2014020231,16386,20142015,1,60,6,1,5,3.09168424292875,4.20755623758305,-1.1158719946543,33,26,7,46,41,5,55,68,-13,4,3,0,0
"21861","TOR","BUF",2014020251,16389,20142015,0,60,2,6,-4,4.73916655873416,5.26246689475101,-0.523300336016852,34,35,-1,54,39,15,69,45,24,5,4,0,0
"21862","TOR","NSH",2014020271,16392,20142015,1,60,2,9,-7,3.30359692713318,4.78083915444114,-1.47724222730796,31,37,-6,40,52,-12,56,66,-10,3,4,0,0
"21863","TOR","T.B",2014020281,16394,20142015,1,60,5,2,3,4.62632922106422,2.80297236877959,1.82335685228463,21,28,-7,36,46,-10,54,63,-9,3,3,0,0
"21864","TOR","DET",2014020297,16396,20142015,1,60,4,1,3,3.95136917836498,4.49129970848778,-0.539930530122792,28,27,1,37,44,-7,51,61,-10,4,3,0,0
"21865","TOR","WSH",2014020344,16403,20142015,1,60,6,2,4,5.14152325128089,5.35347280319547,-0.211949551914586,23,37,-14,38,56,-18,52,70,-18,4,3,0,0
"21866","TOR","DAL",2014020367,16406,20142015,1,60,5,3,2,5.41127075438999,4.88249598679484,0.528774767595152,40,38,2,57,55,2,67,71,-4,7,5,0,0
"21867","TOR","N.J",2014020378,16408,20142015,1,60,3,5,-2,5.65876228813025,1.80600619519828,3.85275609293197,32,26,6,48,37,11,60,44,16,2,3,0,0
"21868","TOR","VAN",2014020392,16410,20142015,1,60,5,2,3,5.85774337066094,6.15806518316458,-0.300321812503637,28,46,-18,37,67,-30,47,91,-44,4,6,0,0
"21869","TOR","CGY",2014020412,16413,20142015,1,60,4,1,3,6.50272551072439,3.68113028091022,2.82159522981417,29,33,-4,40,48,-8,51,77,-26,2,3,0,0
"21870","TOR","DET",2014020419,16414,20142015,0,65,1,1,0,3.39356491209708,7.76486858841599,-4.37130367631892,19,42,-23,25,62,-37,33,74,-41,4,4,0,0
"21871","TOR","DET",2014020438,16417,20142015,1,60,4,1,3,5.29756559372618,3.53542146119535,1.76214413253083,41,28,13,58,43,15,72,58,14,6,3,0,0
"21872","TOR","L.A",2014020448,16418,20142015,1,65,3,3,0,5.55985166244579,5.06962067255517,0.49023098989062,31,36,-5,41,56,-15,57,80,-23,4,3,0,0
"21873","TOR","ANA",2014020454,16420,20142015,1,60,6,2,4,2.82706443923234,6.57023245397886,-3.74316801474652,27,42,-15,43,72,-29,59,89,-30,6,5,0,0
"21874","TOR","CAR",2014020469,16422,20142015,0,60,1,4,-3,3.18329374976747,6.26954164530616,-3.08624789553869,26,37,-11,37,45,-8,44,60,-16,3,3,0,0
"21875","TOR","PHI",2014020481,16424,20142015,1,60,4,7,-3,4.21389242290331,4.86396740403211,-0.650074981128796,25,42,-17,38,57,-19,48,69,-21,4,3,0,0
"21876","TOR","CHI",2014020495,16425,20142015,0,60,0,4,-4,5.43036364405202,4.70166233658904,0.728701307462984,31,34,-3,40,41,-1,54,53,1,2,2,0,0
"21877","TOR","DAL",2014020512,16427,20142015,0,60,4,0,4,0,0,0,26,43,-17,35,69,-34,46,86,-40,8,7,0,0
"21878","TOR","FLA",2014020527,16432,20142015,0,60,4,6,-2,4.82413865847047,6.54319731006399,-1.71905865159351,22,34,-12,34,45,-11,44,50,-6,4,3,0,0
"21879","TOR","T.B",2014020534,16433,20142015,0,60,2,3,-1,2.65814539338442,4.79426629692898,-2.13612090354457,23,41,-18,34,54,-20,46,67,-21,2,4,0,0
"21880","TOR","BOS",2014020547,16435,20142015,0,65,3,3,0,5.04778076065122,5.96464748135259,-0.916866720701364,21,28,-7,36,43,-7,46,65,-19,4,3,0,0
"21881","TOR","MIN",2014020562,16437,20142015,0,60,1,3,-2,3.39103011094267,3.57406035251915,-0.183030241576489,35,29,6,46,39,7,57,53,4,5,4,0,0
"21882","TOR","WPG",2014020571,16438,20142015,0,60,1,5,-4,1.58276754431427,7.86307831213344,-6.28031076781917,21,40,-19,26,58,-32,36,70,-34,6,7,0,0
"21883","TOR","WSH",2014020594,16442,20142015,1,60,2,6,-4,3.5490493105608,7.33378519440443,-3.78473588384363,33,26,7,46,44,2,59,53,6,3,3,0,0
"21884","TOR","CBJ",2014020609,16444,20142015,1,60,5,2,3,8.11548917833716,5.03158160086852,3.08390757746864,32,20,12,45,41,4,58,53,5,4,2,0,0
"21885","TOR","L.A",2014020629,16447,20142015,0,60,0,2,-2,3.36640071366418,5.02274986400153,-1.65634915033735,19,20,-1,33,41,-8,46,48,-2,4,3,0,0
"21886","TOR","ANA",2014020642,16449,20142015,0,60,0,4,-4,3.47539456165396,5.38741817688742,-1.91202361523347,28,25,3,34,41,-7,45,49,-4,3,2,0,0
"21887","TOR","S.J",2014020653,16450,20142015,0,60,1,3,-2,3.49096876254953,5.48064800095744,-1.98967923840792,25,42,-17,36,50,-14,57,71,-14,3,3,0,0
"21888","TOR","STL",2014020667,16452,20142015,0,60,0,3,-3,0,0,0,27,33,-6,43,51,-8,56,65,-9,2,3,0,0
"21889","TOR","CAR",2014020677,16454,20142015,1,60,1,4,-3,3.66435875114985,5.40341006463859,-1.73905131348874,35,32,3,50,41,9,62,46,16,5,4,0,0
"21890","TOR","OTT",2014020691,16456,20142015,0,60,3,4,-1,4.89124169794442,4.65110116325447,0.240140534689949,40,26,14,54,36,18,66,49,17,4,3,0,0
"21891","TOR","N.J",2014020708,16463,20142015,0,65,1,1,0,3.66471311854571,2.73933605202811,0.925377066517598,30,23,7,36,30,6,46,35,11,6,4,0,0
"21892","TOR","ARI",2014020714,16464,20142015,1,60,1,3,-2,4.57179096636446,6.53959182587869,-1.96780085951423,25,45,-20,41,61,-20,56,71,-15,3,3,0,0
"21893","TOR","PHI",2014020733,16466,20142015,0,60,0,1,-1,6.39285549237684,4.63688089500647,1.75597459737037,30,18,12,39,29,10,60,42,18,1,2,0,0
"21894","TOR","NSH",2014020751,16469,20142015,0,60,3,4,-1,4.44060196494996,5.85702325816965,-1.41642129321968,28,32,-4,34,40,-6,51,56,-5,4,3,0,0
"21895","TOR","N.J",2014020768,16472,20142015,0,60,1,4,-3,4.79145196109312,2.92331195884617,1.86814000224695,34,17,17,42,24,18,50,26,24,3,2,0,0
"21896","TOR","EDM",2014020777,16473,20142015,1,60,5,1,4,5.62163033688999,4.91238527733367,0.709245059556324,28,32,-4,49,49,0,61,66,-5,3,2,0,0
"21897","TOR","NYR",2014020800,16476,20142015,1,60,4,5,-1,4.87731490960973,5.90486646471254,-1.02755155510281,34,39,-5,47,50,-3,59,63,-4,2,2,0,0
"21898","TOR","NYI",2014020809,16478,20142015,0,60,2,3,-1,2.93379820369335,4.68431747565046,-1.75051927195711,34,41,-7,47,48,-1,59,70,-11,3,3,0,0
"21899","TOR","MTL",2014020824,16480,20142015,0,65,1,1,0,3.90467846101021,7.16391867273205,-3.25924021172185,29,32,-3,35,45,-10,52,68,-16,5,4,0,0
"21900","TOR","FLA",2014020850,16483,20142015,1,60,2,3,-1,3.19247471306642,1.32333752412524,1.86913718894118,29,17,12,35,24,11,47,36,11,2,5,0,0
"21901","TOR","CAR",2014020868,16486,20142015,0,60,1,2,-1,3.03183240065073,4.08188458378817,-1.05005218313744,24,26,-2,36,36,0,55,52,3,4,2,0,0
"21902","TOR","WPG",2014020875,16487,20142015,1,63.7833333333333,4,3,1,4.29122812113613,6.12657245209127,-1.83534433095513,33,34,-1,44,47,-3,61,60,1,6,7,0,0
"21903","TOR","PHI",2014020911,16492,20142015,1,60,3,2,1,1.47419600377907,6.93019464423691,-5.45599864045784,17,49,-32,27,70,-43,37,89,-52,5,7,0,0
"21904","TOR","MTL",2014020928,16494,20142015,0,60,0,4,-4,0,0,0,30,23,7,41,37,4,60,49,11,4,4,0,0
"21905","TOR","WSH",2014020936,16495,20142015,0,60,0,4,-4,3.26275571501026,4.69850635950024,-1.43575064448999,32,32,0,45,45,0,63,60,3,6,4,0,0
"21906","TOR","FLA",2014020946,16497,20142015,0,60,3,2,1,2.74819779873724,5.02364818908973,-2.27545039035249,34,42,-8,39,51,-12,50,60,-10,2,3,0,0
"21907","TOR","T.B",2014020959,16499,20142015,0,60,2,4,-2,4.23998873744858,1.97353061137255,2.26645812607603,27,31,-4,38,40,-2,59,54,5,4,4,0,0
"21908","TOR","STL",2014020971,16501,20142015,1,60,1,6,-5,2.97324513725471,4.20156868210102,-1.22832354484631,24,44,-20,34,56,-22,41,65,-24,8,7,0,0
"21909","TOR","NYI",2014020986,16503,20142015,1,64.6333333333333,3,4,-1,4.76226071898418,8.07316306169378,-3.3109023427096,25,43,-18,35,59,-24,43,78,-35,4,5,0,0
"21910","TOR","BUF",2014020999,16505,20142015,1,65,3,3,0,7.1082540863824,3.30560834458856,3.80264574179384,34,33,1,49,47,2,63,58,5,5,2,0,0
"21911","TOR","CGY",2014021017,16507,20142015,0,60,3,6,-3,2.74527866439894,2.66925519260352,0.0760234717954216,28,28,0,39,37,2,67,44,23,4,3,0,0
"21912","TOR","VAN",2014021025,16508,20142015,0,60,1,4,-3,3.77196012734203,4.03775778095183,-0.265797653609803,29,35,-6,39,45,-6,61,56,5,9,4,0,0
"21913","TOR","EDM",2014021039,16510,20142015,0,60,1,4,-3,2.61295299263293,5.24170890171081,-2.62875590907788,29,32,-3,38,43,-5,45,53,-8,5,6,0,0
"21914","TOR","S.J",2014021053,16513,20142015,1,60,1,4,-3,3.23458478120891,6.7052643097941,-3.47067952858519,28,42,-14,36,64,-28,48,79,-31,3,6,0,0
"21915","TOR","OTT",2014021070,16515,20142015,0,60,3,5,-2,0,0,0,25,41,-16,32,48,-16,43,59,-16,1,5,0,0
"21916","TOR","MIN",2014021085,16517,20142015,1,60,1,2,-1,5.66052988704243,3.51615905930521,2.14437082773722,36,32,4,47,43,4,61,56,5,4,3,0,0
"21917","TOR","FLA",2014021106,16520,20142015,1,60,1,4,-3,2.8326739325638,5.33972725047965,-2.50705331791586,25,28,-3,43,43,0,56,56,0,5,3,0,0
"21918","TOR","OTT",2014021121,16522,20142015,1,63.2833333333333,4,3,1,6.87376308521198,3.4385739700313,3.43518911518068,31,25,6,50,39,11,67,52,15,4,1,0,0
"21919","TOR","T.B",2014021145,16525,20142015,1,60,3,1,2,2.84939868916263,5.24066084333158,-2.39126215416895,28,41,-13,41,54,-13,50,68,-18,3,3,0,0
"21920","TOR","BUF",2014021149,16526,20142015,0,60,3,4,-1,4.91666629059176,4.29639566690025,0.620270623691511,27,31,-4,37,45,-8,53,57,-4,4,5,0,0
"21921","TOR","BOS",2014021170,16529,20142015,0,65,1,1,0,2.9379201784181,8.56122161689325,-5.62330143847515,28,50,-22,32,57,-25,43,79,-36,2,3,0,0
"21922","TOR","OTT",2014021182,16530,20142015,1,65,2,2,0,4.26709677776876,9.05964712772038,-4.79255034995163,38,45,-7,47,69,-22,58,87,-29,3,6,0,0
"21923","TOR","CBJ",2014021200,16533,20142015,0,60,0,5,-5,3.41119324096495,3.09148708455541,0.319706156409538,35,33,2,44,41,3,56,47,9,4,2,0,0
"21924","TOR","MTL",2014021221,16536,20142015,1,65,3,3,0,3.96852187064724,5.48453761137887,-1.51601574073163,22,33,-11,37,49,-12,50,70,-20,7,5,0,0
"21925","TOR","MTL",2015020001,16715,20152016,1,60,1,3,-2,4.51718400196114,4.62512594097029,-0.107941939009152,37,29,8,51,45,6,66,54,12,4,2,0,0
"21926","TOR","DET",2015020014,16717,20152016,0,60,0,4,-4,4.29138581050938,4.44362809204904,-0.152242281539657,22,22,0,33,30,3,41,42,-1,4,5,0,0
"21927","TOR","OTT",2015020019,16718,20152016,1,65,4,4,0,4.5820106611076,4.44279576849658,0.139214892611018,41,33,8,58,46,12,77,62,15,5,7,0,0
"21928","TOR","CBJ",2015020059,16724,20152016,0,60,6,3,3,4.02933854312319,3.35968127049273,0.669657272630463,34,27,7,47,38,9,59,51,8,2,5,0,0
"21929","TOR","BUF",2015020088,16729,20152016,0,65,1,1,0,6.7532513599503,6.63602113694651,0.117230223003787,24,35,-11,36,42,-6,49,61,-12,1,4,0,0
"21930","TOR","MTL",2015020108,16732,20152016,0,60,3,5,-2,7.6565284120361,5.43308822956169,2.22344018247441,52,27,25,73,37,36,85,49,36,6,5,0,0
"21931","TOR","ARI",2015020122,16734,20152016,1,60,3,4,-1,3.64884077455554,4.33759889607609,-0.688758121520543,27,24,3,47,31,16,63,39,24,3,5,0,0
"21932","TOR","NYR",2015020146,16738,20152016,0,60,1,3,-2,2.94720310196863,4.86806010792498,-1.92085700595635,25,26,-1,38,38,0,51,49,2,0,3,0,0
"21933","TOR","DAL",2015020169,16741,20152016,1,60,4,1,3,3.54907758056652,3.47726527274566,0.0718123078208563,26,44,-18,47,60,-13,54,76,-22,5,3,0,0
"21934","TOR","WPG",2015020181,16743,20152016,1,60,2,4,-2,4.34976756054675,8.95160565275838,-4.60183809221163,26,34,-8,40,55,-15,57,69,-12,3,2,0,0
"21935","TOR","DET",2015020194,16745,20152016,1,62.2833333333333,1,2,-1,4.42442376009734,2.2982515883632,2.12617217173414,33,24,9,52,33,19,69,43,26,4,3,0,0
"21936","TOR","WSH",2015020203,16746,20152016,0,65,2,2,0,4.67394679867209,5.22392941309954,-0.549982614427449,25,31,-6,36,45,-9,44,61,-17,5,8,0,0
"21937","TOR","DAL",2015020225,16749,20152016,0,60,3,2,1,5.62303027376217,6.66893413488287,-1.04590386112071,30,38,-8,47,52,-5,55,67,-12,1,1,0,0
"21938","TOR","NSH",2015020237,16751,20152016,0,65,1,1,0,1.94738196695107,5.36260113975732,-3.41521917280625,23,22,1,32,42,-10,48,66,-18,3,4,0,0
"21939","TOR","VAN",2015020249,16753,20152016,1,60,4,2,2,4.16695439973162,6.81060622981022,-2.6436518300786,40,45,-5,48,58,-10,63,75,-12,6,4,0,0
"21940","TOR","NYR",2015020259,16754,20152016,0,60,3,4,-1,3.96678831003024,4.4330203908612,-0.46623208083096,26,30,-4,37,44,-7,55,50,5,3,2,0,0
"21941","TOR","COL",2015020272,16756,20152016,1,60,5,1,4,4.18394820117837,6.28007244120818,-2.0961242400298,30,35,-5,48,48,0,60,62,-2,5,4,0,0
"21942","TOR","CAR",2015020287,16759,20152016,0,65,1,1,0,4.76818330278911,7.5335078844073,-2.76532458161819,25,34,-9,45,49,-4,56,64,-8,6,4,0,0
"21943","TOR","BOS",2015020293,16760,20152016,0,60,0,2,-2,4.31536442540394,5.2787557200063,-0.96339129460236,22,37,-15,40,52,-12,60,67,-7,1,1,0,0
"21944","TOR","BOS",2015020312,16762,20152016,1,65,3,3,0,4.48617832732599,2.5509788047845,1.93519952254149,42,29,13,62,36,26,79,54,25,8,5,0,0
"21945","TOR","WSH",2015020343,16767,20152016,1,60,2,4,-2,2.99255493416422,5.38744296482764,-2.39488803066342,34,23,11,48,44,4,57,52,5,2,3,0,0
"21946","TOR","EDM",2015020357,16769,20152016,1,60,3,0,3,3.91453096797692,6.74472628368165,-2.83019531570473,26,24,2,40,40,0,59,57,2,3,3,0,0
"21947","TOR","WPG",2015020369,16771,20152016,0,60,1,6,-5,3.54276409288286,6.81514997611521,-3.27238588323235,33,35,-2,45,46,-1,61,54,7,3,5,0,0
"21948","TOR","MIN",2015020379,16772,20152016,0,60,0,1,-1,4.3378420877473,2.91402685388664,1.42381523386066,28,28,0,37,34,3,53,49,4,2,3,0,0
"21949","TOR","STL",2015020393,16774,20152016,0,60,4,1,3,3.69927262443525,3.51056620373424,0.18870642070101,29,28,1,37,40,-3,47,48,-1,5,3,0,0
"21950","TOR","N.J",2015020411,16777,20152016,1,65,2,2,0,5.94641186156543,4.62604617484612,1.32036568671931,37,27,10,56,39,17,73,47,26,5,5,0,0
"21951","TOR","T.B",2015020457,16784,20152016,1,62.0166666666667,4,5,-1,6.59795917599695,5.41183855739655,1.1861206186004,37,27,10,57,44,13,77,55,22,3,3,0,0
"21952","TOR","S.J",2015020469,16786,20152016,1,62.2166666666667,4,5,-1,4.93051733452012,6.55565187880711,-1.62513454428699,31,44,-13,48,56,-8,66,69,-3,3,4,0,0
"21953","TOR","L.A",2015020485,16788,20152016,1,60,5,0,5,3.23953488401185,3.6282861308282,-0.388751246816355,34,26,8,40,48,-8,52,64,-12,0,1,0,0
"21954","TOR","COL",2015020505,16790,20152016,0,60,7,4,3,3.50817185728301,2.71200353682798,0.796168320455028,22,28,-6,30,40,-10,46,49,-3,3,4,0,0
"21955","TOR","ARI",2015020515,16791,20152016,0,60,2,3,-1,4.33784882850209,5.94066920969635,-1.60282038119427,39,26,13,55,37,18,75,46,29,2,4,0,0
"21956","TOR","NYI",2015020528,16796,20152016,0,60,3,1,2,4.60593890954624,2.87399696922174,1.7319419403245,38,26,12,58,39,19,68,66,2,2,1,0,0
"21957","TOR","NYI",2015020542,16798,20152016,1,60,3,6,-3,0,0,0,33,21,12,54,31,23,75,42,33,4,4,0,0
"21958","TOR","PIT",2015020551,16799,20152016,0,65,2,2,0,4.06318696799387,6.57366414096776,-2.51047717297389,36,41,-5,44,51,-7,59,69,-10,5,8,0,0
"21959","TOR","STL",2015020570,16802,20152016,1,60,4,1,3,5.6134527407703,4.65028105973397,0.963171681036329,33,40,-7,43,56,-13,66,67,-1,5,2,0,0
"21960","TOR","ANA",2015020600,16806,20152016,0,60,4,0,4,0,0,0,38,39,-1,55,53,2,78,63,15,8,4,0,0
"21961","TOR","L.A",2015020606,16807,20152016,0,60,1,2,-1,4.71547945676139,6.98956259555416,-2.27408313879278,26,41,-15,39,59,-20,53,66,-13,5,2,0,0
"21962","TOR","S.J",2015020619,16809,20152016,0,60,0,7,-7,3.26345550000713,6.51408967014868,-3.25063417014155,28,31,-3,43,45,-2,60,65,-5,3,4,0,0
"21963","TOR","CBJ",2015020642,16813,20152016,1,60,1,3,-2,5.8657603824031,4.39498260487744,1.47077777752565,42,22,20,72,42,30,94,50,44,3,2,0,0
"21964","TOR","CHI",2015020655,16815,20152016,1,60,1,4,-3,3.35930377225407,4.59643298922969,-1.23712921697563,29,29,0,48,42,6,60,50,10,3,6,0,0
"21965","TOR","BOS",2015020662,16816,20152016,0,60,2,3,-1,7.21480409122887,5.12569733291083,2.08910675831804,29,45,-16,42,63,-21,56,73,-17,6,3,0,0
"21966","TOR","PHI",2015020684,16819,20152016,0,60,3,2,1,4.0373280881322,5.17001884091167,-1.13269075277947,35,33,2,46,50,-4,64,67,-3,4,4,0,0
"21967","TOR","CAR",2015020697,16821,20152016,1,62.9,0,1,-1,3.42141760226036,4.70952088136508,-1.28810327910472,32,41,-9,51,49,2,57,61,-4,3,5,0,0
"21968","TOR","MTL",2015020712,16823,20152016,1,65,2,2,0,2.43475696718087,5.69567639002344,-3.26091942284256,19,29,-10,32,53,-21,53,69,-16,2,4,0,0
"21969","TOR","FLA",2015020736,16826,20152016,0,60,1,5,-4,4.99963434034726,3.4126591269919,1.58697521335536,23,27,-4,33,40,-7,45,45,0,3,6,0,0
"21970","TOR","T.B",2015020740,16827,20152016,0,60,0,1,-1,3.18494507122494,2.87713398820779,0.307811083017157,30,29,1,42,40,2,58,52,6,4,7,0,0
"21971","TOR","BOS",2015020744,16833,20152016,0,63.1,4,3,1,5.96190034948813,6.03555727526054,-0.0736569257724113,35,42,-7,55,50,5,73,65,8,4,5,0,0
"21972","TOR","N.J",2015020762,16835,20152016,1,65,2,2,0,6.91962692519171,5.2529634393743,1.66666348581741,39,34,5,63,49,14,92,61,31,4,6,0,0
"21973","TOR","OTT",2015020780,16837,20152016,0,60,1,6,-5,0,0,0,27,25,2,38,31,7,54,42,12,6,5,0,0
"21974","TOR","CGY",2015020805,16840,20152016,0,60,3,4,-1,6.48394560911356,3.79817960229411,2.68576600681945,36,22,14,49,29,20,74,40,34,3,4,0,0
"21975","TOR","EDM",2015020816,16842,20152016,0,60,2,5,-3,6.73305471526692,5.14792279018729,1.58513192507962,36,35,1,52,38,14,75,51,24,6,6,0,0
"21976","TOR","VAN",2015020830,16844,20152016,0,60,5,2,3,6.18735919214396,1.91673725453438,4.27062193760958,38,19,19,49,26,23,61,37,24,6,5,0,0
"21977","TOR","CHI",2015020844,16846,20152016,0,60,2,7,-5,6.59963909274666,3.42582175439833,3.17381733834833,37,32,5,48,41,7,69,54,15,3,6,0,0
"21978","TOR","NYR",2015020860,16849,20152016,1,60,2,4,-2,4.56142454936824,2.93912218924717,1.62230236012107,37,20,17,53,27,26,73,37,36,8,2,0,0
"21979","TOR","PHI",2015020875,16851,20152016,1,60.4833333333333,4,5,-1,3.11910500581143,3.42775844783361,-0.308653442022177,24,28,-4,33,41,-8,50,51,-1,2,1,0,0
"21980","TOR","NSH",2015020895,16854,20152016,1,60,2,3,-1,4.11352501817964,1.51896395696791,2.59456106121173,27,26,1,47,31,16,73,39,34,4,2,0,0
"21981","TOR","CAR",2015020908,16856,20152016,1,60,3,1,2,4.93785356714909,5.12400912798489,-0.1861555608358,29,31,-2,40,46,-6,60,56,4,6,6,0,0
"21982","TOR","MTL",2015020926,16858,20152016,0,60,1,4,-3,6.24569648242525,4.71046209056436,1.53523439186088,32,36,-4,41,44,-3,56,64,-8,2,4,0,0
"21983","TOR","T.B",2015020940,16860,20152016,1,60,1,2,-1,4.60498767415993,3.21666556609853,1.3883221080614,32,28,4,54,37,17,70,54,16,3,2,0,0
"21984","TOR","WSH",2015020951,16862,20152016,0,60,2,3,-1,3.06022171064978,1.45049298046069,1.60972873018909,29,23,6,37,32,5,58,46,12,5,5,0,0
"21985","TOR","MIN",2015020958,16863,20152016,1,60,1,2,-1,5.08410136893508,5.58614208048675,-0.502040711551672,22,22,0,34,36,-2,56,48,8,0,4,0,0
"21986","TOR","OTT",2015020974,16865,20152016,1,60,2,3,-1,4.30737559668734,5.2261034627445,-0.918727866057168,43,31,12,59,43,16,81,57,24,3,1,0,0
"21987","TOR","BUF",2015020987,16867,20152016,1,65,3,3,0,3.94880834253854,3.17369067372056,0.775117668817984,33,27,6,50,35,15,67,48,19,6,7,0,0
"21988","TOR","NYI",2015021001,16869,20152016,1,65,3,3,0,6.73699090865921,3.91844531398965,2.81854559466956,36,27,9,52,38,14,65,48,17,4,3,0,0
"21989","TOR","OTT",2015021022,16872,20152016,0,60,0,4,-4,4.87072671691922,6.03434526912179,-1.16361855220256,29,17,12,44,26,18,66,36,30,5,3,0,0
"21990","TOR","DET",2015021032,16873,20152016,0,60,1,0,1,2.72067303798394,5.14520309569457,-2.42453005771063,27,38,-11,42,48,-6,47,60,-13,2,3,0,0
"21991","TOR","T.B",2015021042,16875,20152016,1,60,4,1,3,5.34022671825174,3.66898545171489,1.67124126653685,24,27,-3,36,48,-12,57,71,-14,5,5,0,0
"21992","TOR","FLA",2015021056,16877,20152016,1,60,1,4,-3,3.32871388084154,6.29727603189497,-2.96856215105343,33,32,1,51,51,0,74,65,9,2,4,0,0
"21993","TOR","BUF",2015021070,16879,20152016,1,60,4,1,3,5.02190564580033,3.88712592871161,1.13477971708872,31,21,10,50,34,16,63,46,17,4,5,0,0
"21994","TOR","CGY",2015021087,16881,20152016,1,60,5,2,3,6.79973537063415,3.00917643457069,3.79055893606346,26,25,1,44,34,10,67,47,20,7,3,0,0
"21995","TOR","ANA",2015021104,16884,20152016,1,60.6833333333333,6,5,1,6.42578173283255,4.30165274171596,2.12412899111659,26,38,-12,42,53,-11,52,63,-11,5,4,0,0
"21996","TOR","BOS",2015021119,16886,20152016,1,60,1,3,-2,4.24488164152216,2.88801726684324,1.35686437467893,26,33,-7,44,43,1,64,56,8,4,6,0,0
"21997","TOR","T.B",2015021135,16888,20152016,0,60,0,3,-3,3.71880528739712,1.20693009252864,2.51187519486848,34,18,16,49,29,20,63,36,27,10,5,0,0
"21998","TOR","FLA",2015021144,16889,20152016,0,60,5,2,3,5.07196184290478,3.99347338418011,1.07848845872468,29,34,-5,38,46,-8,45,50,-5,5,4,0,0
"21999","TOR","BUF",2015021152,16891,20152016,0,60,1,4,-3,6.226571472003,6.3501934800297,-0.1236220080267,26,37,-11,34,45,-11,56,53,3,4,5,0,0
"22000","TOR","DET",2015021170,16893,20152016,1,60,2,3,-1,5.08536771246526,3.43971275741751,1.64565495504775,34,26,8,53,42,11,83,53,30,4,4,0,0
"22001","TOR","FLA",2015021185,16895,20152016,1,60,3,4,-1,3.67090111220817,7.95954072908546,-4.28863961687729,26,36,-10,39,51,-12,46,68,-22,2,5,0,0
"22002","TOR","CBJ",2015021199,16897,20152016,1,60,1,5,-4,2.54834454028193,3.74784337176243,-1.1994988314805,27,32,-5,41,46,-5,62,59,3,2,2,0,0
"22003","TOR","PHI",2015021205,16898,20152016,0,62.85,4,3,1,4.32320211806729,10.0295122645584,-5.70631014649114,26,44,-18,31,64,-33,43,86,-43,2,3,0,0
"22004","TOR","N.J",2015021222,16900,20152016,0,60,1,5,-4,2.5879670599345,6.25443606360204,-3.66646900366754,20,36,-16,26,42,-16,38,47,-9,3,6,0,0
"22005","TOR","OTT",2016020001,17086,20162017,0,60.6166666666667,4,5,-1,6.09789219486993,4.32090159566227,1.77699059920766,38,30,8,56,42,14,81,51,30,5,3,0,0
"22006","TOR","BOS",2016020017,17089,20162017,1,60,4,1,3,3.44383896600911,4.04701943359495,-0.603180467585841,24,25,-1,37,40,-3,50,58,-8,4,4,0,0
"22007","TOR","WPG",2016020050,17093,20162017,0,62.6666666666667,4,5,-1,5.47676859161584,5.71751704020426,-0.24074844858842,40,34,6,48,54,-6,64,81,-17,2,3,0,0
"22008","TOR","MIN",2016020057,17094,20162017,0,60,2,3,-1,4.64479753264459,2.16012477932964,2.48467275331495,33,27,6,43,37,6,56,57,-1,3,3,0,0
"22009","TOR","CHI",2016020072,17096,20162017,0,65,4,4,0,4.81375760822357,7.51764047390316,-2.70388286567959,34,35,-1,41,49,-8,52,73,-21,2,6,0,0
"22010","TOR","T.B",2016020087,17099,20162017,1,60,3,7,-4,4.71990080355317,3.60949801036622,1.11040279318695,43,24,19,57,31,26,70,40,30,4,3,0,0
"22011","TOR","FLA",2016020101,17101,20162017,1,60,3,2,1,3.23723071095867,4.27283566165715,-1.03560495069848,28,31,-3,46,45,1,59,59,0,2,4,0,0
"22012","TOR","MTL",2016020114,17103,20162017,0,60,1,2,-1,4.03317698884348,3.96402448236635,0.0691525064771294,38,31,7,48,40,8,74,59,15,6,5,0,0
"22013","TOR","NYI",2016020126,17104,20162017,0,60,1,5,-4,4.95403323573737,3.69979784591123,1.25423538982614,34,35,-1,56,52,4,78,59,19,6,5,0,0
"22014","TOR","EDM",2016020134,17106,20162017,1,60.2,3,2,1,3.66322098993078,5.66694657337212,-2.00372558344134,31,46,-15,42,62,-20,58,76,-18,2,3,0,0
"22015","TOR","BUF",2016020146,17108,20162017,0,60,2,1,1,4.83255249436871,5.64265032531694,-0.810097830948223,29,43,-14,38,53,-15,46,70,-24,0,2,0,0
"22016","TOR","VAN",2016020163,17110,20162017,1,60,6,3,3,4.03247317653984,4.83709078103129,-0.804617604491455,42,29,13,56,41,15,72,54,18,8,5,0,0
"22017","TOR","L.A",2016020188,17113,20162017,1,60,0,7,-7,1.97251103744929,6.33187710495895,-4.35936606750965,19,43,-24,28,57,-29,38,75,-37,1,4,0,0
"22018","TOR","PHI",2016020207,17116,20162017,1,60,6,3,3,6.23158108891221,5.73362527950729,0.497955809404914,23,33,-10,42,47,-5,66,60,6,5,2,0,0
"22019","TOR","PIT",2016020217,17117,20162017,0,60,1,4,-3,5.08729144373137,5.89062853233486,-0.803337088603485,36,49,-13,49,62,-13,65,73,-8,2,3,0,0
"22020","TOR","NSH",2016020233,17120,20162017,1,60,6,2,4,4.25240377850423,4.46131389023611,-0.208910111731882,32,34,-2,47,56,-9,57,68,-11,1,1,0,0
"22021","TOR","FLA",2016020247,17122,20162017,1,60,6,1,5,4.90974821467455,3.93234721245878,0.977401002215771,30,27,3,43,41,2,50,59,-9,4,4,0,0
"22022","TOR","MTL",2016020264,17124,20162017,0,60,1,2,-1,4.56861804695141,4.98905213834951,-0.420434091398093,32,29,3,40,38,2,67,51,16,5,6,0,0
"22023","TOR","CAR",2016020284,17127,20162017,1,60,1,2,-1,2.56632575067116,2.81260105447821,-0.246275303807053,26,29,-3,40,38,2,55,56,-1,3,1,0,0
"22024","TOR","N.J",2016020289,17128,20162017,0,65,4,4,0,5.0651280170855,3.74892205315268,1.31620596393282,31,30,1,40,40,0,49,50,-1,4,4,0,0
"22025","TOR","WSH",2016020313,17131,20162017,1,60,4,2,2,4.2745082065787,5.80109524234608,-1.52658703576738,37,35,2,53,53,0,62,70,-8,5,4,0,0
"22026","TOR","EDM",2016020338,17134,20162017,0,60,4,2,2,2.0652352537727,4.57912100714748,-2.51388575337478,23,30,-7,31,42,-11,47,73,-26,6,8,0,0
"22027","TOR","CGY",2016020343,17135,20162017,0,60,0,3,-3,4.35464404310915,1.15283740196069,3.20180664114846,39,29,10,56,38,18,69,45,24,2,2,0,0
"22028","TOR","VAN",2016020367,17138,20162017,0,65,2,2,0,6.02055949787609,2.4105048878082,3.61005461006789,40,24,16,60,35,25,68,42,26,4,2,0,0
"22029","TOR","MIN",2016020391,17142,20162017,1,60,2,3,-1,4.0123991988512,2.43991836055648,1.57248083829472,37,20,17,63,29,34,87,41,46,2,1,0,0
"22030","TOR","BOS",2016020413,17145,20162017,0,60,4,1,3,3.68153798300773,5.52412789487835,-1.84258991187062,20,33,-13,33,48,-15,39,70,-31,2,1,0,0
"22031","TOR","COL",2016020425,17146,20162017,1,60,1,3,-2,8.50592781305508,4.32100124663208,4.184926566423,52,29,23,77,43,34,99,52,47,6,3,0,0
"22032","TOR","S.J",2016020435,17148,20162017,1,65,2,2,0,4.72621669549153,6.11954676325419,-1.39333006776266,31,42,-11,51,57,-6,60,78,-18,4,7,0,0
"22033","TOR","ARI",2016020447,17150,20162017,1,65,2,2,0,6.38237415866465,5.37921037944011,1.00316377922454,46,30,16,62,46,16,85,59,26,4,3,0,0
"22034","TOR","PIT",2016020462,17152,20162017,1,62,2,1,1,5.30982319138616,4.26685242455052,1.04297076683564,49,34,15,62,43,19,83,61,22,4,3,0,0
"22035","TOR","ANA",2016020478,17154,20162017,1,60,2,3,-1,7.03473160295025,3.85060487472219,3.18412672822805,35,28,7,44,39,5,60,54,6,3,5,0,0
"22036","TOR","COL",2016020503,17157,20162017,0,60,6,0,6,3.50616319250548,5.18892138420779,-1.68275819170231,31,38,-7,44,52,-8,56,65,-9,6,7,0,0
"22037","TOR","ARI",2016020515,17158,20162017,0,60,4,1,3,5.11017611964053,6.78144507302204,-1.67126895338151,32,32,0,44,61,-17,58,84,-26,1,4,0,0
"22038","TOR","FLA",2016020527,17163,20162017,0,65,2,2,0,3.01331298923469,6.97536048818506,-3.96204749895037,40,47,-7,47,68,-21,58,79,-21,5,7,0,0
"22039","TOR","T.B",2016020535,17164,20162017,0,63.6166666666667,3,2,1,3.26881527460864,4.26974248520522,-1.00092721059658,35,27,8,51,45,6,63,63,0,5,5,0,0
"22040","TOR","DET",2016020559,17167,20162017,1,63.6666666666667,5,4,1,4.59975482130413,7.01064650781336,-2.41089168650923,28,37,-9,47,47,0,60,62,-2,2,3,0,0
"22041","TOR","WSH",2016020566,17169,20162017,0,60.3666666666667,5,6,-1,4.67589564737864,3.00922602478112,1.66666962259752,25,29,-4,37,40,-3,50,56,-6,7,3,0,0
"22042","TOR","N.J",2016020586,17172,20162017,0,60,4,2,2,3.02752812299877,5.4308720830013,-2.40334396000253,14,32,-18,19,44,-25,32,48,-16,3,4,0,0
"22043","TOR","MTL",2016020594,17173,20162017,1,60,3,5,-2,3.93232927194725,5.04062988882652,-1.10830061687927,36,31,5,44,45,-1,67,49,18,8,10,0,0
"22044","TOR","NYR",2016020633,17179,20162017,0,60,4,2,2,5.9331526506503,3.07304979465243,2.86010285599787,27,36,-9,35,53,-18,51,67,-16,4,6,0,0
"22045","TOR","OTT",2016020643,17180,20162017,0,60,4,2,2,4.38095151860034,8.10727778408909,-3.72632626548875,27,37,-10,39,56,-17,54,77,-23,2,2,0,0
"22046","TOR","BUF",2016020665,17183,20162017,1,60,4,3,1,3.66699774179142,5.41792482760502,-1.7509270858136,32,27,5,44,37,7,61,46,15,1,1,0,0
"22047","TOR","NYR",2016020679,17185,20162017,1,60,2,5,-3,2.90413854728104,5.77992366016159,-2.87578511288056,25,41,-16,40,56,-16,58,65,-7,3,5,0,0
"22048","TOR","OTT",2016020693,17187,20162017,1,65,2,2,0,5.78615937626455,5.19443830583259,0.591721070431959,33,27,6,58,46,12,72,65,7,3,4,0,0
"22049","TOR","CGY",2016020710,17189,20162017,1,60,4,0,4,3.36087227874394,2.17432582070614,1.1865464580378,28,26,2,41,34,7,52,56,-4,8,8,0,0
"22050","TOR","DET",2016020724,17191,20162017,0,60,4,0,4,2.4940023305835,4.22402212159524,-1.73001979101174,28,22,6,34,34,0,45,46,-1,2,2,0,0
"22051","TOR","PHI",2016020731,17192,20162017,0,60,1,2,-1,3.21193994727946,6.04624395734845,-2.83430401006899,28,34,-6,41,48,-7,62,66,-4,2,1,0,0
"22052","TOR","DAL",2016020750,17197,20162017,0,60,3,6,-3,6.47114346880699,4.92757361880649,1.54356985000049,43,20,23,61,32,29,81,47,34,2,1,0,0
"22053","TOR","STL",2016020761,17199,20162017,0,60,1,5,-4,3.25635486163083,2.77867166788785,0.477683193742976,27,31,-4,39,38,1,60,44,16,4,3,0,0
"22054","TOR","BOS",2016020774,17201,20162017,0,60,6,5,1,4.10642926426544,6.34613959790357,-2.23971033363813,26,41,-15,31,60,-29,50,79,-29,3,6,0,0
"22055","TOR","NYI",2016020788,17203,20162017,0,62.7,5,6,-1,3.51367456295702,7.09995208008331,-3.58627751712629,32,34,-2,42,44,-2,55,65,-10,1,1,0,0
"22056","TOR","DAL",2016020794,17204,20162017,1,60,3,1,2,3.50181394874835,5.28830341832509,-1.78648946957674,34,40,-6,48,59,-11,62,75,-13,5,4,0,0
"22057","TOR","STL",2016020808,17206,20162017,1,60.3333333333333,1,2,-1,2.60022683619948,5.21065253007691,-2.61042569387743,32,40,-8,46,50,-4,63,65,-2,1,1,0,0
"22058","TOR","BUF",2016020821,17208,20162017,1,60,1,3,-2,5.72250388000975,2.11991458450211,3.60258929550764,44,23,21,62,33,29,82,44,38,4,2,0,0
"22059","TOR","NYI",2016020838,17211,20162017,1,60,7,1,6,4.56433513290212,4.80660990369126,-0.242274770789136,41,34,7,59,52,7,67,56,11,3,5,0,0
"22060","TOR","CBJ",2016020843,17212,20162017,0,60,2,5,-3,4.66404610190693,3.94955044763628,0.71449565427065,33,35,-2,45,39,6,64,49,15,3,5,0,0
"22061","TOR","OTT",2016020861,17215,20162017,1,60,3,6,-3,5.91691631858686,9.54973836462334,-3.63282204603648,37,42,-5,53,54,-1,71,65,6,5,5,0,0
"22062","TOR","CAR",2016020875,17216,20162017,0,60,4,0,4,7.0858719884418,4.24188915499326,2.84398283344854,31,37,-6,44,53,-9,57,70,-13,2,3,0,0
"22063","TOR","WPG",2016020885,17218,20162017,1,62.4833333333333,5,4,1,6.09917881792535,5.14384480053559,0.95533401738976,37,20,17,58,30,28,75,36,39,7,6,0,0
"22064","TOR","NYR",2016020894,17220,20162017,1,65,1,1,0,6.11232187726921,4.30522493299538,1.80709694427383,33,38,-5,44,59,-15,56,86,-30,3,2,0,0
"22065","TOR","MTL",2016020907,17222,20162017,1,61.1,2,3,-1,3.9648796071829,5.2112381826073,-1.24635857542441,34,28,6,45,45,0,57,60,-3,2,4,0,0
"22066","TOR","S.J",2016020933,17225,20162017,0,60,1,3,-2,4.43584423646051,6.98663650097308,-2.55079226451257,21,37,-16,35,53,-18,55,71,-16,3,2,0,0
"22067","TOR","L.A",2016020944,17227,20162017,0,65,2,2,0,7.22579256666359,5.08970825066615,2.13608431599744,31,35,-4,47,52,-5,61,66,-5,1,3,0,0
"22068","TOR","ANA",2016020951,17228,20162017,0,60,2,5,-3,5.15245190676069,8.12575241900049,-2.9733005122398,39,36,3,60,48,12,78,62,16,4,1,0,0
"22069","TOR","DET",2016020975,17232,20162017,1,60,3,2,1,3.68923107157138,4.60584054638639,-0.916609474815012,28,24,4,38,37,1,47,48,-1,4,2,0,0
"22070","TOR","PHI",2016020986,17234,20162017,1,60,4,2,2,3.7678603769873,3.97506341926055,-0.20720304227325,33,38,-5,45,50,-5,59,68,-9,2,3,0,0
"22071","TOR","CAR",2016021004,17236,20162017,0,62.2166666666667,3,2,1,5.38923467553104,7.67617168393917,-2.28693700840813,26,38,-12,40,56,-16,50,74,-24,2,2,0,0
"22072","TOR","FLA",2016021029,17239,20162017,0,60,2,7,-5,3.82440721482271,5.64416562771279,-1.81975841289008,30,32,-2,42,50,-8,54,59,-5,6,7,0,0
"22073","TOR","T.B",2016021043,17241,20162017,0,60,5,0,5,3.31609617255162,2.56227319019922,0.753822982352403,21,33,-12,33,52,-19,42,69,-27,5,7,0,0
"22074","TOR","CHI",2016021055,17243,20162017,1,64.7166666666667,1,2,-1,4.61204183124937,5.76631179793003,-1.15426996668066,26,39,-13,47,49,-2,65,66,-1,1,0,0,0
"22075","TOR","BOS",2016021070,17245,20162017,1,60,4,2,2,6.81969063566066,5.54665796835616,1.27303266730451,30,34,-4,50,52,-2,63,65,-2,5,3,0,0
"22076","TOR","CBJ",2016021086,17247,20162017,0,60,5,2,3,5.83896114263916,4.74684236637404,1.09211877626512,32,34,-2,44,44,0,55,65,-10,3,0,0,0
"22077","TOR","N.J",2016021091,17248,20162017,1,60,4,2,2,4.32546125689752,3.78712076542433,0.538340491473186,30,32,-2,44,44,0,57,51,6,4,6,0,0
"22078","TOR","BUF",2016021107,17250,20162017,0,60,2,5,-3,5.84576425458363,6.75916191336337,-0.913397658779743,34,38,-4,48,53,-5,63,61,2,4,3,0,0
"22079","TOR","FLA",2016021131,17253,20162017,1,60,3,2,1,4.9474790586072,2.42377975437466,2.52369930423254,25,27,-2,44,40,4,59,53,6,4,4,0,0
"22080","TOR","NSH",2016021146,17255,20162017,0,60,3,1,2,2.24895717611071,4.58971013713017,-2.34075296101946,17,30,-13,24,49,-25,35,62,-27,3,5,0,0
"22081","TOR","DET",2016021159,17257,20162017,0,60,5,4,1,2.33385149808601,5.13393703665497,-2.80008553856896,27,42,-15,34,52,-18,49,62,-13,2,2,0,0
"22082","TOR","BUF",2016021176,17259,20162017,0,60,4,2,2,8.49987488380759,3.51830824685749,4.98156663695011,45,22,23,57,36,21,69,50,19,5,3,0,0
"22083","TOR","WSH",2016021182,17260,20162017,1,60,1,4,-3,3.73511556067388,4.17353824906056,-0.43842268838668,28,38,-10,42,50,-8,55,58,-3,5,4,0,0
"22084","TOR","T.B",2016021198,17262,20162017,1,60,1,4,-3,2.11151918914402,2.89309727931585,-0.78157809017183,27,30,-3,47,44,3,66,53,13,4,3,0,0
"22085","TOR","PIT",2016021211,17264,20162017,1,60,5,3,2,5.89186012762366,4.70539280827506,1.18646731934859,30,18,12,51,35,16,71,47,24,3,2,0,0
"22086","TOR","CBJ",2016021224,17265,20162017,1,60,2,3,-1,4.63546749369135,5.9192567768862,-1.28378928319485,32,32,0,55,44,11,71,49,22,3,2,0,0
"22087","TOR","WSH",2016030131,17269,20162017,0,65.25,2,3,-1,8.30195521493442,7.9739436165255,0.328011598408921,37,44,-7,51,57,-6,62,74,-12,1,3,0,0
"22088","TOR","WSH",2016030132,17271,20162017,0,80,3,3,0,8.80800730411788,10.6532481809987,-1.84524087688085,44,44,0,57,68,-11,81,97,-16,6,6,0,0
"22089","TOR","WSH",2016030133,17273,20162017,1,61.6166666666667,4,3,1,4.65822624359033,4.1807958310431,0.477430412547225,28,26,2,47,41,6,71,52,19,6,6,0,0
"22090","TOR","WSH",2016030134,17275,20162017,1,60,4,5,-1,3.36049640527926,4.61982842805446,-1.2593320227752,34,27,7,45,39,6,67,56,11,4,1,0,0
"22091","TOR","WSH",2016030135,17277,20162017,0,61.0666666666667,1,2,-1,5.78070059389574,3.75645087647717,2.02424971741857,25,28,-3,41,42,-1,63,58,5,6,5,0,0
"22092","TOR","WSH",2016030136,17279,20162017,1,66.5166666666667,1,2,-1,7.17887943834008,5.62663374773911,1.55224569060097,38,36,2,45,50,-5,67,70,-3,2,3,0,0
"22093","TOR","WPG",2017020001,17443,20172018,0,60,7,2,5,5.32444614412679,4.53350199910943,0.790944145017352,31,37,-6,39,47,-8,53,71,-18,4,8,0,0
"22094","TOR","NYR",2017020016,17446,20172018,1,60,8,5,3,6.13799370935885,5.27370717749,0.864286531868856,42,35,7,57,49,8,75,56,19,6,3,0,0
"22095","TOR","CHI",2017020035,17448,20172018,1,63.7166666666667,4,3,1,5.19743751439091,1.62808877740099,3.56934873698992,43,21,22,60,32,28,75,44,31,6,7,0,0
"22096","TOR","N.J",2017020046,17450,20172018,1,60,3,6,-3,5.43412349158933,4.40602134659395,1.02810214499537,50,31,19,61,42,19,79,50,29,8,5,0,0
"22097","TOR","MTL",2017020063,17453,20172018,0,60.8,4,3,1,3.44406630905723,7.15337327588689,-3.70930696682966,22,34,-12,30,41,-11,57,55,2,2,2,0,0
"22098","TOR","WSH",2017020084,17456,20172018,0,60,2,0,2,6.37733407423366,3.82699359580147,2.55034047843219,30,30,0,48,39,9,57,56,1,2,3,0,0
"22099","TOR","DET",2017020092,17457,20172018,1,60,6,3,3,3.97306370778824,5.32671890713391,-1.35365519934567,26,33,-7,34,44,-10,38,56,-18,3,4,0,0
"22100","TOR","OTT",2017020113,17460,20172018,0,60,3,6,-3,6.46912020900527,5.93904357141582,0.53007663758945,31,35,-4,43,47,-4,66,58,8,2,2,0,0
"22101","TOR","L.A",2017020123,17462,20172018,1,60,3,2,1,4.45143337273066,3.44310769020827,1.00832568252239,34,38,-4,46,52,-6,59,64,-5,8,4,0,0
"22102","TOR","CAR",2017020139,17465,20172018,1,60,3,6,-3,6.80129191682499,4.75634864065614,2.04494327616885,34,38,-4,50,55,-5,64,71,-7,3,2,0,0
"22103","TOR","PHI",2017020157,17467,20172018,1,60,2,4,-2,3.53955506032798,4.71731273148921,-1.17775767116122,30,30,0,50,40,10,65,48,17,3,1,0,0
"22104","TOR","S.J",2017020177,17469,20172018,0,60,2,3,-1,3.82491998350179,4.58318970247637,-0.758269718974589,18,39,-21,30,50,-20,55,71,-16,0,4,0,0
"22105","TOR","ANA",2017020184,17471,20172018,0,60,3,1,2,4.93984201943385,4.50904288571981,0.430799133714048,29,29,0,39,42,-3,54,56,-2,2,4,0,0
"22106","TOR","L.A",2017020197,17472,20172018,0,60,3,5,-2,6.34248765041235,2.83573582771196,3.50675182270039,36,28,8,54,40,14,73,46,27,7,5,0,0
"22107","TOR","STL",2017020205,17474,20172018,0,60,4,6,-2,4.02408076921948,3.4436995308554,0.580381238364083,31,32,-1,41,48,-7,52,68,-16,3,4,0,0
"22108","TOR","VGK",2017020218,17476,20172018,1,65,3,3,0,4.25389398406821,7.59627977624348,-3.34238579217526,25,28,-3,33,47,-14,52,59,-7,4,3,0,0
"22109","TOR","MIN",2017020232,17478,20172018,1,60,4,2,2,4.11054865941696,4.70415851736919,-0.593609857952231,19,37,-18,27,53,-26,42,71,-29,2,4,0,0
"22110","TOR","BOS",2017020243,17480,20172018,1,61.1166666666667,3,2,1,6.55080780710614,3.66258908590437,2.88821872120177,33,35,-2,49,45,4,66,60,6,5,4,0,0
"22111","TOR","BOS",2017020250,17481,20172018,0,60,4,1,3,4.26699462748277,2.81559820963594,1.45139641784683,25,39,-14,32,50,-18,48,61,-13,4,5,0,0
"22112","TOR","N.J",2017020278,17486,20172018,1,64.95,1,0,1,5.3370028588688,6.09290706234606,-0.755904203477257,25,42,-17,42,58,-16,61,73,-12,2,3,0,0
"22113","TOR","MTL",2017020298,17488,20172018,0,60,6,0,6,7.13362113962648,4.36445847882715,2.76916266079934,31,33,-2,44,41,3,59,60,-1,6,4,0,0
"22114","TOR","ARI",2017020311,17490,20172018,1,60,1,4,-3,6.21076926758178,5.59886904218001,0.611900225401769,28,31,-3,45,42,3,62,51,11,1,4,0,0
"22115","TOR","FLA",2017020321,17492,20172018,0,65,1,1,0,7.80798270861851,6.89088509885124,0.917097609767268,44,43,1,53,56,-3,71,62,9,3,3,0,0
"22116","TOR","CAR",2017020343,17494,20172018,0,60,5,4,1,3.62808714729119,5.49626434306265,-1.86817719577146,25,47,-22,32,69,-37,39,91,-52,2,2,0,0
"22117","TOR","WSH",2017020348,17495,20172018,1,60,2,4,-2,4.95818940072786,3.55503796990734,1.40315143082052,29,21,8,44,31,13,56,43,13,1,3,0,0
"22118","TOR","CGY",2017020374,17498,20172018,0,60,4,1,3,4.77861786502763,3.87513565981499,0.90348220521264,30,20,10,41,34,7,62,51,11,2,3,0,0
"22119","TOR","EDM",2017020387,17500,20172018,0,60,6,4,2,4.47087626958182,5.21613631423907,-0.745260044657243,37,45,-8,51,59,-8,67,77,-10,2,2,0,0
"22120","TOR","VAN",2017020402,17502,20172018,0,60,1,2,-1,5.638172073639,3.84707273880485,1.79109933483414,36,26,10,47,37,10,66,47,19,2,1,0,0
"22121","TOR","CGY",2017020426,17506,20172018,1,65,1,1,0,4.74154012648796,9.7654930950257,-5.02395296853774,29,48,-19,50,65,-15,74,77,-3,4,2,0,0
"22122","TOR","PIT",2017020450,17509,20172018,0,60,4,3,1,5.09147052660046,4.95697401135112,0.134496515249339,25,36,-11,34,47,-13,44,70,-26,1,4,0,0
"22123","TOR","EDM",2017020456,17510,20172018,1,60,1,0,1,2.58433559860737,7.4364775453829,-4.85214194677553,23,41,-18,33,69,-36,47,89,-42,2,4,0,0
"22124","TOR","PHI",2017020468,17512,20172018,0,60,2,4,-2,5.57019688142464,6.9929675150197,-1.42277063359506,22,39,-17,34,48,-14,45,60,-15,1,1,0,0
"22125","TOR","MIN",2017020484,17514,20172018,0,60,0,2,-2,3.45665365003515,4.48859228449874,-1.03193863446359,28,26,2,49,36,13,70,44,26,5,2,0,0
"22126","TOR","DET",2017020494,17515,20172018,0,60,1,3,-2,2.9051920673428,2.68277423359905,0.222417833743748,26,29,-3,45,46,-1,59,52,7,3,4,0,0
"22127","TOR","CAR",2017020516,17519,20172018,1,60,8,1,7,0,0,0,36,33,3,50,51,-1,60,72,-12,4,5,0,0
"22128","TOR","CBJ",2017020526,17520,20172018,0,60,2,4,-2,4.06979751723793,4.56683040020289,-0.497032882964959,41,37,4,54,47,7,67,55,12,2,3,0,0
"22129","TOR","NYR",2017020548,17523,20172018,0,60,3,2,1,6.21981222041359,3.93876125380884,2.28105096660475,37,32,5,46,39,7,62,53,9,8,5,0,0
"22130","TOR","ARI",2017020572,17528,20172018,0,60,7,4,3,5.81610204519538,4.84118558408227,0.974916461113109,33,34,-1,45,57,-12,52,78,-26,3,8,0,0
"22131","TOR","COL",2017020584,17529,20172018,0,63.4166666666667,3,4,-1,5.59425151580945,3.88903464516625,1.7052168706432,34,28,6,41,44,-3,58,58,0,2,4,0,0
"22132","TOR","VGK",2017020593,17531,20172018,0,60,3,6,-3,4.73705969657749,5.12641811899084,-0.389358422413352,23,31,-8,41,40,1,59,55,4,3,3,0,0
"22133","TOR","T.B",2017020602,17533,20172018,1,60,0,2,-2,2.67028389696745,4.0950563973319,-1.42477250036445,29,36,-7,39,51,-12,54,65,-11,3,4,0,0
"22134","TOR","S.J",2017020617,17535,20172018,1,65,2,2,0,5.56258213709108,4.09856236894848,1.46401976814261,28,35,-7,46,49,-3,59,61,-2,3,5,0,0
"22135","TOR","VAN",2017020637,17537,20172018,1,65,2,2,0,5.67915044602705,9.57169753837115,-3.8925470923441,36,36,0,46,52,-6,67,57,10,4,3,0,0
"22136","TOR","CBJ",2017020652,17539,20172018,1,63.1833333333333,2,3,-1,5.66383318445878,4.52838475586395,1.13544842859483,37,33,4,47,49,-2,62,63,-1,2,3,0,0
"22137","TOR","OTT",2017020660,17541,20172018,1,60,3,4,-1,7.59848850831622,4.82641983996102,2.7720686683552,48,32,16,73,42,31,93,50,43,3,1,0,0
"22138","TOR","STL",2017020687,17547,20172018,1,61.7166666666667,1,2,-1,3.57697470507992,4.08072819438193,-0.503753489302012,31,42,-11,38,53,-15,60,67,-7,1,2,0,0
"22139","TOR","PHI",2017020698,17549,20172018,0,60.3,2,3,-1,2.4556273411219,5.44363770301124,-2.98801036188934,31,37,-6,39,51,-12,58,66,-8,2,2,0,0
"22140","TOR","OTT",2017020713,17551,20172018,0,60,4,3,1,3.26316634292016,3.07133682363098,0.191829519289179,33,18,15,41,28,13,57,53,4,4,3,0,0
"22141","TOR","COL",2017020726,17553,20172018,1,60,2,4,-2,2.9982036823294,5.40847675462514,-2.41027307229573,31,27,4,48,42,6,64,46,18,3,0,0,0
"22142","TOR","CHI",2017020744,17555,20172018,0,60.1,3,2,1,5.98795057818279,5.89662916113977,0.0913214170430194,36,36,0,53,48,5,68,68,0,5,4,0,0
"22143","TOR","DAL",2017020754,17556,20172018,0,60,4,1,3,4.28570805827443,7.50614834915905,-3.22044029088462,29,40,-11,41,59,-18,56,74,-18,2,3,0,0
"22144","TOR","NYI",2017020773,17562,20172018,1,60,5,0,5,6.9263298841106,4.87571573787818,2.05061414623242,50,28,22,69,42,27,85,62,23,2,1,0,0
"22145","TOR","NYR",2017020779,17563,20172018,0,60,4,0,4,6.98251789842709,2.43690780243924,4.54561009598785,32,25,7,43,38,5,63,44,19,1,3,0,0
"22146","TOR","BOS",2017020794,17565,20172018,0,60,1,4,-3,2.65807380399943,3.73860110031628,-1.08052729631686,24,30,-6,38,46,-8,47,61,-14,4,3,0,0
"22147","TOR","ANA",2017020808,17567,20172018,1,60,7,4,3,6.9767719448763,6.37361660513852,0.603155339737782,40,44,-4,52,61,-9,64,84,-20,3,3,0,0
"22148","TOR","NSH",2017020823,17569,20172018,1,65,2,2,0,4.77635768131586,5.04149747440533,-0.265139793089475,32,46,-14,43,66,-23,54,79,-25,2,2,0,0
"22149","TOR","OTT",2017020844,17572,20172018,1,60,6,3,3,4.86391910715611,2.6707442396073,2.19317486754881,41,25,16,57,35,22,74,48,26,5,2,0,0
"22150","TOR","T.B",2017020861,17574,20172018,1,60,4,3,1,3.38187393981207,4.26659058336656,-0.884716643554498,23,34,-11,35,52,-17,46,67,-21,1,2,0,0
"22151","TOR","CBJ",2017020876,17576,20172018,1,60,6,3,3,3.18481062659339,6.02325430774363,-2.83844368115024,28,57,-29,41,77,-36,56,91,-35,3,2,0,0
"22152","TOR","PIT",2017020899,17579,20172018,0,60,3,5,-2,4.22536494370434,5.34832455310971,-1.12295960940537,32,39,-7,42,47,-5,55,60,-5,2,1,0,0
"22153","TOR","DET",2017020909,17580,20172018,0,60,3,2,1,4.48138158233492,3.7482510318514,0.733130550483523,34,29,5,47,41,6,60,47,13,2,1,0,0
"22154","TOR","FLA",2017020918,17582,20172018,1,60,1,0,1,5.07315356456093,6.21207991984556,-1.13892635528464,31,40,-9,49,56,-7,61,70,-9,2,2,0,0
"22155","TOR","NYI",2017020930,17584,20172018,1,65,3,3,0,2.85358228586847,5.7855421545348,-2.93195986866633,31,35,-4,40,46,-6,59,60,-1,3,2,0,0
"22156","TOR","BOS",2017020948,17586,20172018,1,60,4,3,1,4.00970229115993,3.42201347943046,0.587688811729464,36,23,13,51,37,14,73,48,25,3,2,0,0
"22157","TOR","T.B",2017020966,17588,20172018,0,65,3,3,0,2.85987820991841,5.20451481564669,-2.34463660572828,30,42,-12,42,55,-13,55,69,-14,5,4,0,0
"22158","TOR","FLA",2017020972,17589,20172018,0,63.7833333333333,2,3,-1,7.13894001254711,4.27672331078611,2.862216701761,39,31,8,53,40,13,68,47,21,2,4,0,0
"22159","TOR","WSH",2017021005,17593,20172018,0,60,2,5,-3,5.95227678053197,4.68907708546612,1.26319969506585,29,34,-5,45,41,4,69,52,17,2,2,0,0
"22160","TOR","BUF",2017021015,17595,20172018,0,60,3,5,-2,5.89296510230633,4.12462270798278,1.76834239432355,41,24,17,52,35,17,65,40,25,2,2,0,0
"22161","TOR","PIT",2017021055,17600,20172018,1,60,5,2,3,3.11481195462509,5.98458343927632,-2.86977148465123,26,40,-14,31,52,-21,43,69,-26,3,4,0,0
"22162","TOR","DAL",2017021078,17604,20172018,1,65,5,5,0,6.835587283655,3.44230108754709,3.39328619610791,33,35,-2,53,44,9,70,58,12,2,2,0,0
"22163","TOR","BUF",2017021083,17605,20172018,0,60,5,2,3,5.32550878188324,5.19399806191768,0.131510719965566,39,40,-1,46,51,-5,55,69,-14,3,5,0,0
"22164","TOR","MTL",2017021101,17607,20172018,1,60,4,0,4,0,0,0,49,33,16,71,40,31,89,59,30,4,1,0,0
"22165","TOR","T.B",2017021127,17610,20172018,0,60,3,4,-1,2.77991876348096,1.63444255873258,1.14547620474838,30,25,5,41,32,9,56,42,14,4,2,0,0
"22166","TOR","NSH",2017021142,17612,20172018,0,60,5,2,3,2.77552869485226,5.21483945165528,-2.43931075680302,28,25,3,31,42,-11,45,55,-10,3,6,0,0
"22167","TOR","DET",2017021153,17614,20172018,1,60,4,3,1,4.50632192622288,4.64769938915158,-0.141377462928702,29,41,-12,46,54,-8,65,65,0,4,1,0,0
"22168","TOR","BUF",2017021168,17616,20172018,1,60,2,3,-1,3.93368103005923,3.65727547605275,0.276405554006487,41,27,14,67,33,34,86,41,45,1,0,0,0
"22169","TOR","FLA",2017021186,17618,20172018,1,60,4,3,1,3.22816754186306,4.95381850908541,-1.72565096722235,35,33,2,48,52,-4,66,74,-8,1,3,0,0
"22170","TOR","NYI",2017021200,17620,20172018,0,60,5,4,1,5.35121480457019,4.81375063890266,0.537464165667529,32,33,-1,45,50,-5,66,58,8,3,4,0,0
"22171","TOR","WPG",2017021209,17621,20172018,1,60,1,3,-2,1.92744465100741,4.11971245560969,-2.19226780460228,29,29,0,44,41,3,58,48,10,4,3,0,0
"22172","TOR","BUF",2017021223,17623,20172018,1,60,5,2,3,5.18110418412834,5.049936957721,0.131167226407342,36,34,2,44,53,-9,56,68,-12,3,4,0,0
"22173","TOR","N.J",2017021241,17626,20172018,0,60,1,2,-1,4.17779119469924,7.66006801468779,-3.48227681998856,32,39,-7,46,54,-8,58,63,-5,2,2,0,0
"22174","TOR","MTL",2017021259,17628,20172018,1,60,4,2,2,3.47658440035019,6.73983625972505,-3.26325185937486,30,33,-3,46,46,0,67,59,8,5,4,0,0
"22175","TOR","MTL",2018020001,17807,20182019,1,61.0166666666667,3,2,1,2.97456685151155,4.82973710649821,-1.85517025498666,26,36,-10,44,52,-8,60,76,-16,3,4,0,0
"22176","TOR","OTT",2018020018,17810,20182019,1,60,3,5,-2,4.0979571011776,2.73859265362262,1.35936444755498,37,24,13,53,32,21,80,40,40,3,2,0,0
"22177","TOR","CHI",2018020030,17811,20182019,0,60.3166666666667,7,6,1,3.79036789904058,3.84823923624936,-0.0578713372087805,34,31,3,42,40,2,56,69,-13,2,2,0,0
"22178","TOR","DAL",2018020041,17813,20182019,0,60,7,4,3,4.70263056448312,3.13334829953965,1.56928226494347,30,34,-4,51,45,6,66,56,10,3,1,0,0
"22179","TOR","DET",2018020052,17815,20182019,0,60,5,3,2,4.86539767332525,4.22431320526823,0.641084468057016,35,29,6,47,46,1,54,57,-3,5,4,0,0
"22180","TOR","WSH",2018020065,17817,20182019,0,60,4,2,2,4.52647659763182,4.67844818726007,-0.151971589628256,28,27,1,39,40,-1,57,59,-2,3,3,0,0
"22181","TOR","L.A",2018020074,17819,20182019,1,60,4,1,3,3.46497569339954,6.02979497605702,-2.56481928265748,25,34,-9,34,51,-17,55,72,-17,2,3,0,0
"22182","TOR","PIT",2018020090,17822,20182019,1,60,0,3,-3,5.12795008695684,9.05345515980298,-3.92550507284614,38,39,-1,59,66,-7,81,73,8,1,2,0,0
"22183","TOR","STL",2018020106,17824,20182019,1,60,1,4,-3,4.07460534470116,4.0843070509145,-0.00970170621333999,23,25,-2,41,39,2,64,53,11,4,4,0,0
"22184","TOR","WPG",2018020131,17828,20182019,0,60,4,2,2,6.93639273899068,3.84896584169837,3.0874268972923,39,40,-1,52,63,-11,68,79,-11,1,3,0,0
"22185","TOR","WPG",2018020153,17831,20182019,1,60,3,2,1,3.82979191868799,3.4787282069301,0.351063711757888,31,24,7,48,41,7,64,49,15,4,3,0,0
"22186","TOR","CGY",2018020165,17833,20182019,1,60,1,3,-2,3.93113881535828,5.16909549378761,-1.23795667842933,25,34,-9,45,46,-1,58,56,2,4,4,0,0
"22187","TOR","DAL",2018020179,17836,20182019,1,60,1,2,-1,4.0249405201921,1.68554257255164,2.33939794764046,32,19,13,51,30,21,64,39,25,5,2,0,0
"22188","TOR","PIT",2018020199,17838,20182019,0,60,5,0,5,4.06479861649015,3.71070978562062,0.354088830869525,33,31,2,46,42,4,59,54,5,3,5,0,0
"22189","TOR","VGK",2018020215,17841,20182019,1,60,3,1,2,4.45975583700056,6.12947308845105,-1.66971725145049,21,37,-16,29,62,-33,40,82,-42,1,3,0,0
"22190","TOR","N.J",2018020236,17844,20182019,1,60,6,1,5,3.47853606624994,6.29379779848801,-2.81526173223807,32,39,-7,42,53,-11,58,69,-11,4,3,0,0
"22191","TOR","BOS",2018020245,17845,20182019,0,60,1,5,-4,4.00509449762474,4.19267820561365,-0.187583707988906,41,34,7,52,45,7,64,57,7,3,3,0,0
"22192","TOR","L.A",2018020271,17848,20182019,0,60,5,1,4,6.88099954265383,5.45902235424555,1.42197718840828,35,23,12,50,35,15,65,50,15,5,2,0,0
"22193","TOR","S.J",2018020285,17850,20182019,0,60,5,3,2,7.12599297092422,7.0016023813108,0.124390589613414,34,45,-11,51,62,-11,71,72,-1,6,6,0,0
"22194","TOR","ANA",2018020291,17851,20182019,0,63.2833333333333,2,1,1,5.42602401453769,5.34133598546237,0.0846880290753154,35,39,-4,53,51,2,72,69,3,2,1,0,0
"22195","TOR","CBJ",2018020308,17854,20182019,1,60,4,2,2,5.6567826657556,7.01941550843912,-1.36263284268352,26,39,-13,41,52,-11,56,60,-4,0,0,0,0
"22196","TOR","CAR",2018020323,17856,20182019,0,60,2,5,-3,6.24319232237758,9.53164649184328,-3.28845416946569,32,45,-13,54,65,-11,69,77,-8,3,2,0,0
"22197","TOR","CBJ",2018020339,17858,20182019,0,60,2,4,-2,6.40157436841333,2.98319396866688,3.41838039974645,34,24,10,51,35,16,66,43,23,3,2,0,0
"22198","TOR","PHI",2018020348,17859,20182019,1,60,6,0,6,4.75028326759639,7.13433718233136,-2.38405391473498,41,34,7,51,48,3,68,58,10,0,0,0,0
"22199","TOR","BOS",2018020362,17861,20182019,1,60,4,2,2,5.02769907569746,7.03487307554878,-2.00717399985133,31,40,-9,47,67,-20,64,89,-25,1,2,0,0
"22200","TOR","S.J",2018020379,17863,20182019,1,60,5,3,2,4.86434349458409,5.97868819124415,-1.11434469666005,29,41,-12,42,56,-14,50,74,-24,4,3,0,0
"22201","TOR","MIN",2018020403,17866,20182019,0,60,5,3,2,3.596794084066,6.38201961570303,-2.78522553163702,23,41,-18,37,56,-19,49,72,-23,1,3,0,0
"22202","TOR","BUF",2018020416,17869,20182019,0,64.95,4,3,1,4.01857717022358,4.50517130619846,-0.486594135974883,30,41,-11,41,49,-8,63,60,3,2,2,0,0
"22203","TOR","DET",2018020429,17871,20182019,1,62.8,4,5,-1,5.54719223629218,5.73898931183794,-0.191797075545765,31,32,-1,52,48,4,82,60,22,4,2,0,0
"22204","TOR","BOS",2018020446,17873,20182019,0,60,3,6,-3,6.97196089536749,3.97842927966121,2.99353161570627,32,32,0,49,40,9,62,48,14,4,5,0,0
"22205","TOR","CAR",2018020468,17876,20182019,0,60,4,1,3,5.51856834797945,6.70221112726722,-1.18364277928777,29,30,-1,45,49,-4,62,68,-6,4,4,0,0
"22206","TOR","T.B",2018020482,17878,20182019,0,60,1,4,-3,4.52722995962932,1.45427188825886,3.07295807137046,49,21,28,58,32,26,81,48,33,7,4,0,0
"22207","TOR","FLA",2018020497,17880,20182019,0,63.4,3,4,-1,5.22997085718089,5.63983182764827,-0.409860970467378,32,33,-1,52,41,11,74,53,21,4,5,0,0
"22208","TOR","N.J",2018020518,17883,20182019,0,60,7,2,5,4.14994594438804,3.80684453375579,0.343101410632244,31,29,2,50,41,9,56,50,6,3,3,0,0
"22209","TOR","FLA",2018020531,17885,20182019,1,60,6,1,5,2.88677275290055,3.37843163500656,-0.491658882106009,26,26,0,44,44,0,66,57,9,3,3,0,0
"22210","TOR","NYR",2018020552,17887,20182019,1,60,5,3,2,7.02694185990777,5.16738610101515,1.85955575889261,36,28,8,54,47,7,69,59,10,2,2,0,0
"22211","TOR","DET",2018020563,17888,20182019,1,61.8833333333333,5,4,1,5.05218191051245,3.78047055989737,1.27171135061508,24,30,-6,44,44,0,53,52,1,2,3,0,0
"22212","TOR","CBJ",2018020582,17893,20182019,0,60,4,2,2,3.53838764282489,3.50894036961108,0.0294472732138078,29,29,0,39,48,-9,51,65,-14,3,3,0,0
"22213","TOR","NYI",2018020588,17894,20182019,1,60,0,4,-4,4.06157102045836,4.28151473019133,-0.219943709732974,36,28,8,51,44,7,70,55,15,2,3,0,0
"22214","TOR","MIN",2018020621,17899,20182019,1,60,3,4,-1,6.60618791571788,2.47489594538638,4.1312919703315,41,34,7,62,40,22,80,53,27,5,2,0,0
"22215","TOR","VAN",2018020639,17901,20182019,1,60,5,0,5,4.29445549274169,3.65235395377385,0.642101538967836,34,28,6,50,40,10,69,58,11,0,3,0,0
"22216","TOR","NSH",2018020652,17903,20182019,1,60,0,4,-4,2.09685296447424,3.69796132381452,-1.60110835934029,18,32,-14,38,44,-6,61,59,2,3,2,0,0
"22217","TOR","N.J",2018020672,17906,20182019,0,60,4,2,2,7.19152216899822,3.75156194303418,3.43996022596404,43,29,14,60,44,16,69,52,17,3,4,0,0
"22218","TOR","BOS",2018020690,17908,20182019,1,60,2,3,-1,4.35252412922523,2.54002170327294,1.81250242595229,32,29,3,53,44,9,73,55,18,2,2,0,0
"22219","TOR","COL",2018020706,17910,20182019,1,60,3,6,-3,3.06599324918352,7.20216595388998,-4.13617270470646,20,38,-18,28,52,-24,42,66,-24,3,3,0,0
"22220","TOR","T.B",2018020729,17913,20182019,0,60,4,2,2,5.85017437729562,4.98605403406509,0.864120343230525,31,38,-7,47,50,-3,55,71,-16,2,4,0,0
"22221","TOR","FLA",2018020733,17914,20182019,0,60,1,3,-2,5.05740846158005,5.03567630401812,0.021732157561928,21,29,-8,30,40,-10,41,48,-7,1,3,0,0
"22222","TOR","ARI",2018020754,17916,20182019,1,60,2,4,-2,4.46752750615751,6.3005521716841,-1.83302466552659,26,31,-5,45,40,5,75,51,24,1,4,0,0
"22223","TOR","WSH",2018020765,17919,20182019,1,60,6,3,3,6.34281440085761,5.31298403069377,1.02983037016384,37,44,-7,56,59,-3,78,68,10,1,1,0,0
"22224","TOR","DET",2018020786,17928,20182019,0,62.6833333333333,2,3,-1,3.72319616636202,4.943450835524,-1.22025466916199,21,33,-12,32,41,-9,45,49,-4,5,4,0,0
"22225","TOR","PIT",2018020791,17929,20182019,1,60,3,2,1,5.21686387201771,4.16917797415026,1.04768589786745,33,30,3,54,45,9,76,64,12,2,1,0,0
"22226","TOR","ANA",2018020805,17931,20182019,1,60,6,1,5,4.79394322137523,3.71667464706115,1.07726857431408,44,25,19,61,33,28,81,44,37,3,1,0,0
"22227","TOR","OTT",2018020821,17933,20182019,1,60,5,4,1,3.75352840356004,7.87391586398007,-4.12038746042003,30,44,-14,42,56,-14,63,69,-6,1,1,0,0
"22228","TOR","MTL",2018020846,17936,20182019,0,62.2833333333333,4,3,1,7.50457042364341,4.42946968760649,3.07510073603692,32,38,-6,45,45,0,59,72,-13,3,4,0,0
"22229","TOR","NYR",2018020859,17937,20182019,0,60,1,4,-3,7.67313436471522,5.41929921687188,2.25383514784335,56,30,26,68,38,30,86,46,40,4,1,0,0
"22230","TOR","COL",2018020873,17939,20182019,0,60,5,2,3,3.08291790848216,2.64700385541175,0.435914053070411,28,36,-8,33,46,-13,44,66,-22,5,3,0,0
"22231","TOR","VGK",2018020885,17941,20182019,0,60,6,3,3,3.65468784075347,3.27945649866774,0.375231342085729,43,33,10,51,42,9,66,58,8,6,3,0,0
"22232","TOR","ARI",2018020898,17943,20182019,0,60,0,2,-2,5.99038139347297,4.7821245621111,1.20825683136188,22,29,-7,39,38,1,66,55,11,3,1,0,0
"22233","TOR","STL",2018020921,17946,20182019,0,60.5666666666667,2,3,-1,5.1162782982484,5.22546879897345,-0.109190500725056,33,41,-8,50,55,-5,67,65,2,0,3,0,0
"22234","TOR","WSH",2018020929,17948,20182019,1,60,2,3,-1,5.21851937298925,4.03171379767082,1.18680557531843,42,28,14,68,53,15,89,65,24,3,4,0,0
"22235","TOR","MTL",2018020952,17950,20182019,1,60,6,3,3,5.71809000248777,3.26787215541368,2.45021784707409,37,35,2,51,49,2,70,69,1,2,4,0,0
"22236","TOR","BUF",2018020962,17952,20182019,1,60,5,3,2,6.52205861203674,4.07501301814045,2.44704559389629,33,34,-1,47,51,-4,62,71,-9,1,5,0,0
"22237","TOR","EDM",2018020979,17954,20182019,1,60,6,2,4,4.80460818274878,7.38298795057926,-2.57837976783048,36,36,0,51,50,1,68,64,4,5,2,0,0
"22238","TOR","NYI",2018020985,17955,20182019,0,60,1,6,-5,2.44720029056771,5.68775167566491,-3.24055138509721,35,37,-2,40,49,-9,57,56,1,2,1,0,0
"22239","TOR","BUF",2018021002,17957,20182019,1,60,5,2,3,5.29227189915855,4.78658309167262,0.505688807485931,32,37,-5,44,45,-1,61,58,3,2,2,0,0
"22240","TOR","CGY",2018021018,17959,20182019,0,60,6,2,4,4.84364232991356,5.01821114769342,-0.174568817779853,32,37,-5,41,58,-17,57,78,-21,2,1,0,0
"22241","TOR","VAN",2018021030,17961,20182019,0,63.1833333333333,2,3,-1,6.19063540317967,4.35161218353511,1.83902321964456,30,31,-1,39,55,-16,58,79,-21,2,4,0,0
"22242","TOR","EDM",2018021055,17964,20182019,0,60,3,2,1,4.85495731487336,5.42635400995813,-0.571396695084768,40,33,7,57,50,7,72,62,10,2,4,0,0
"22243","TOR","T.B",2018021065,17966,20182019,1,60,2,6,-4,5.51481149934989,5.75612548366189,-0.241313984312001,28,42,-14,40,53,-13,48,60,-12,2,1,0,0
"22244","TOR","CHI",2018021080,17968,20182019,1,60,4,5,-1,7.16717210118077,6.21524117258377,0.951930928596994,47,39,8,66,47,19,94,56,38,1,0,0,0
"22245","TOR","PHI",2018021093,17970,20182019,1,60,7,6,1,5.75413238537226,2.42662878634292,3.32750359902934,51,29,22,70,41,29,96,49,47,5,3,0,0
"22246","TOR","OTT",2018021104,17971,20182019,0,60,2,6,-4,7.69368705585657,6.31409832653544,1.37958872932114,37,44,-7,51,54,-3,73,66,7,3,4,0,0
"22247","TOR","NSH",2018021128,17974,20182019,0,60,0,3,-3,3.07537785945846,4.35390114110101,-1.27852328164255,22,20,2,33,29,4,51,40,11,3,1,0,0
"22248","TOR","BUF",2018021132,17975,20182019,0,60,4,2,2,4.6985687425869,4.72194439752002,-0.0233756549331225,46,24,22,63,37,26,77,47,30,3,2,0,0
"22249","TOR","NYR",2018021154,17978,20182019,1,61.8,1,2,-1,6.18589131685545,2.53285834562848,3.65303297122696,45,28,17,71,45,26,104,58,46,3,3,0,0
"22250","TOR","FLA",2018021169,17980,20182019,1,60,7,5,2,2.90413870065806,6.28994433419075,-3.38580563353269,37,36,1,47,56,-9,64,71,-7,4,4,0,0
"22251","TOR","PHI",2018021185,17982,20182019,0,65,4,4,0,9.23721669660881,9.02195244125323,0.215264255355578,42,44,-2,61,56,5,78,65,13,2,1,0,0
"22252","TOR","OTT",2018021205,17985,20182019,0,60,2,4,-2,4.63369433966986,4.14749147789712,0.486202861772739,44,22,22,57,30,27,80,43,37,3,3,0,0
"22253","TOR","NYI",2018021223,17987,20182019,0,60,2,1,1,6.40919142396951,4.27791729625358,2.13127412771594,38,29,9,54,38,16,65,57,8,2,4,0,0
"22254","TOR","CAR",2018021231,17988,20182019,1,60,1,4,-3,5.93415388953872,6.8353580777366,-0.90120418819788,24,37,-13,40,56,-16,56,71,-15,5,3,0,0
"22255","TOR","T.B",2018021243,17990,20182019,1,60,1,3,-2,4.67556683667863,5.61228847540293,-0.9367216387243,30,29,1,45,45,0,59,55,4,2,1,0,0
"22256","TOR","MTL",2018021259,17992,20182019,0,65,5,5,0,7.25123605571935,5.32493842466556,1.92629763105379,49,49,0,64,61,3,85,72,13,1,1,0,0
"22257","VAN","CGY",2008020007,14161,20082009,1,60,6,0,6,0,0,0,23,25,-2,36,38,-2,47,53,-6,10,7,0,0
"22258","VAN","CGY",2008020026,14163,20082009,0,63.9,5,4,1,0,0,0,34,29,5,43,44,-1,53,58,-5,7,8,0,0
"22259","VAN","WSH",2008020036,14165,20082009,0,60,1,5,-4,0,0,0,10,35,-25,30,45,-15,42,63,-21,4,4,0,0
"22260","VAN","DET",2008020053,14168,20082009,0,60.45,4,3,1,0,0,0,29,35,-6,39,52,-13,50,70,-20,5,6,0,0
"22261","VAN","BUF",2008020059,14169,20082009,0,60,2,5,-3,0,0,0,25,31,-6,36,39,-3,50,55,-5,4,6,0,0
"22262","VAN","CHI",2008020076,14171,20082009,0,60,2,4,-2,0,0,0,30,26,4,34,32,2,53,35,18,8,8,0,0
"22263","VAN","CBJ",2008020084,14173,20082009,0,60,2,4,-2,0,0,0,25,33,-8,31,41,-10,40,52,-12,4,4,0,0
"22264","VAN","EDM",2008020118,14177,20082009,1,60,6,3,3,0,0,0,30,28,2,42,42,0,52,54,-2,7,5,0,0
"22265","VAN","BOS",2008020131,14180,20082009,1,60,0,1,-1,0,0,0,31,30,1,43,35,8,61,46,15,3,2,0,0
"22266","VAN","L.A",2008020146,14182,20082009,0,60,4,0,4,0,0,0,18,28,-10,30,42,-12,38,54,-16,7,9,0,0
"22267","VAN","ANA",2008020149,14183,20082009,0,65,6,6,0,0,0,0,29,37,-8,37,48,-11,45,57,-12,8,11,0,0
"22268","VAN","DET",2008020167,14185,20082009,1,60,2,3,-1,0,0,0,27,23,4,37,36,1,51,51,0,7,5,0,0
"22269","VAN","NSH",2008020175,14187,20082009,1,60,4,0,4,0,0,0,39,24,15,44,35,9,52,45,7,7,6,0,0
"22270","VAN","ARI",2008020189,14189,20082009,1,60,1,0,1,0,0,0,32,28,4,53,35,18,70,55,15,8,4,0,0
"22271","VAN","MIN",2008020205,14191,20082009,1,60,2,0,2,0,0,0,29,29,0,41,41,0,58,55,3,7,4,0,0
"22272","VAN","COL",2008020227,14195,20082009,1,65,1,1,0,0,0,0,32,34,-2,40,39,1,67,48,19,4,5,0,0
"22273","VAN","TOR",2008020246,14198,20082009,1,60,4,2,2,0,0,0,15,30,-15,28,42,-14,41,53,-12,6,9,0,0
"22274","VAN","NYI",2008020257,14200,20082009,0,65,1,1,0,0,0,0,32,35,-3,49,43,6,65,63,2,4,5,0,0
"22275","VAN","NYR",2008020269,14202,20082009,0,60,6,3,3,0,0,0,33,42,-9,43,58,-15,50,73,-23,4,6,0,0
"22276","VAN","MIN",2008020274,14203,20082009,0,60,3,2,1,0,0,0,27,30,-3,35,41,-6,44,60,-16,4,3,0,0
"22277","VAN","PIT",2008020285,14205,20082009,0,60,3,1,2,0,0,0,19,19,0,25,32,-7,37,48,-11,6,8,0,0
"22278","VAN","DET",2008020304,14207,20082009,1,62.55,3,2,1,0,0,0,24,34,-10,33,48,-15,38,64,-26,3,3,0,0
"22279","VAN","CGY",2008020322,14210,20082009,1,60,3,4,-1,0,0,0,30,33,-3,43,39,4,52,49,3,4,2,0,0
"22280","VAN","CGY",2008020345,14212,20082009,0,60,1,3,-2,0,0,0,18,31,-13,26,48,-22,41,65,-24,3,5,0,0
"22281","VAN","CBJ",2008020351,14214,20082009,0,60,2,3,-1,0,0,0,32,29,3,42,37,5,50,43,7,4,8,0,0
"22282","VAN","DET",2008020372,14217,20082009,0,60,5,6,-1,0,0,0,25,38,-13,35,64,-29,42,72,-30,4,7,0,0
"22283","VAN","MIN",2008020376,14218,20082009,0,60,2,1,1,0,0,0,31,17,14,41,31,10,58,45,13,4,4,0,0
"22284","VAN","COL",2008020395,14220,20082009,0,65,4,4,0,0,0,0,38,35,3,51,46,5,65,59,6,5,4,0,0
"22285","VAN","NSH",2008020404,14222,20082009,0,60,3,1,2,0,0,0,28,21,7,42,31,11,53,44,9,8,7,0,0
"22286","VAN","EDM",2008020439,14226,20082009,0,60,0,3,-3,0,0,0,23,29,-6,34,43,-9,47,56,-9,6,10,0,0
"22287","VAN","FLA",2008020443,14227,20082009,1,60,5,3,2,0,0,0,30,21,9,42,37,5,53,46,7,6,5,0,0
"22288","VAN","EDM",2008020458,14230,20082009,1,60,4,2,2,0,0,0,28,24,4,36,35,1,47,52,-5,7,7,0,0
"22289","VAN","CHI",2008020484,14233,20082009,1,60,1,3,-2,0,0,0,31,34,-3,51,48,3,65,54,11,7,5,0,0
"22290","VAN","ANA",2008020493,14235,20082009,1,60,4,3,1,0,0,0,26,27,-1,40,45,-5,50,61,-11,10,8,0,0
"22291","VAN","S.J",2008020506,14236,20082009,0,60,0,5,-5,0,0,0,33,31,2,41,43,-2,45,53,-8,2,7,0,0
"22292","VAN","EDM",2008020514,14239,20082009,1,60,2,3,-1,0,0,0,28,23,5,43,34,9,55,50,5,5,5,0,0
"22293","VAN","OTT",2008020532,14241,20082009,1,60,3,0,3,0,0,0,32,18,14,41,28,13,49,40,9,11,9,0,0
"22294","VAN","PHI",2008020546,14243,20082009,1,60,2,3,-1,0,0,0,31,29,2,46,36,10,54,51,3,3,1,0,0
"22295","VAN","NSH",2008020558,14245,20082009,0,60,2,1,1,0,0,0,32,32,0,44,38,6,56,43,13,4,3,0,0
"22296","VAN","ATL",2008020561,14246,20082009,0,65,3,3,0,0,0,0,38,37,1,42,48,-6,56,57,-1,4,6,0,0
"22297","VAN","DAL",2008020582,14248,20082009,1,65,2,2,0,0,0,0,35,36,-1,45,48,-3,54,59,-5,2,3,0,0
"22298","VAN","EDM",2008020597,14251,20082009,0,60,4,2,2,0,0,0,22,25,-3,32,37,-5,51,52,-1,4,4,0,0
"22299","VAN","STL",2008020612,14253,20082009,1,60,4,6,-2,0,0,0,22,36,-14,28,50,-22,39,65,-26,2,5,0,0
"22300","VAN","S.J",2008020624,14254,20082009,1,60,2,4,-2,0,0,0,26,27,-1,39,40,-1,46,48,-2,6,6,0,0
"22301","VAN","N.J",2008020640,14257,20082009,1,60,3,5,-2,0,0,0,29,28,1,41,37,4,54,44,10,4,2,0,0
"22302","VAN","ARI",2008020653,14259,20082009,1,60,1,4,-3,0,0,0,32,32,0,46,44,2,71,57,14,2,3,0,0
"22303","VAN","CBJ",2008020676,14262,20082009,1,65,5,5,0,0,0,0,30,28,2,38,40,-2,52,52,0,7,5,0,0
"22304","VAN","S.J",2008020691,14264,20082009,0,63.1333333333333,1,2,-1,0,0,0,14,29,-15,19,40,-21,28,49,-21,1,5,0,0
"22305","VAN","NSH",2008020715,14272,20082009,1,60,3,5,-2,0,0,0,27,38,-11,41,44,-3,55,55,0,6,8,0,0
"22306","VAN","MIN",2008020740,14275,20082009,1,61.8666666666667,3,4,-1,0,0,0,40,27,13,58,34,24,76,48,28,3,5,0,0
"22307","VAN","CAR",2008020758,14278,20082009,1,60,4,3,1,0,0,0,24,27,-3,34,41,-7,50,60,-10,5,4,0,0
"22308","VAN","CHI",2008020788,14282,20082009,1,60,7,3,4,0,0,0,26,39,-13,36,46,-10,47,64,-17,7,5,0,0
"22309","VAN","STL",2008020801,14285,20082009,0,60,6,4,2,0,0,0,30,28,2,43,37,6,62,47,15,7,5,0,0
"22310","VAN","ARI",2008020816,14287,20082009,0,60,4,3,1,0,0,0,32,28,4,48,38,10,75,47,28,7,4,0,0
"22311","VAN","DAL",2008020823,14288,20082009,0,60,1,2,-1,0,0,0,33,30,3,48,40,8,61,49,12,4,4,0,0
"22312","VAN","MTL",2008020840,14290,20082009,1,60,4,2,2,0,0,0,34,27,7,46,38,8,59,49,10,2,0,0,0
"22313","VAN","CGY",2008020852,14292,20082009,0,65,3,3,0,0,0,0,43,41,2,55,56,-1,68,68,0,7,8,0,0
"22314","VAN","OTT",2008020863,14294,20082009,0,60,5,2,3,0,0,0,24,27,-3,32,34,-2,41,44,-3,3,6,0,0
"22315","VAN","TOR",2008020880,14296,20082009,0,65,2,2,0,0,0,0,37,38,-1,49,53,-4,69,69,0,7,8,0,0
"22316","VAN","MTL",2008020897,14299,20082009,0,60,0,3,-3,0,0,0,34,17,17,54,26,28,71,44,27,7,7,0,0
"22317","VAN","T.B",2008020922,14302,20082009,1,60,2,1,1,0,0,0,25,21,4,35,32,3,54,48,6,5,2,0,0
"22318","VAN","CBJ",2008020939,14304,20082009,1,60,3,1,2,0,0,0,30,20,10,38,36,2,52,47,5,5,5,0,0
"22319","VAN","MIN",2008020951,14306,20082009,1,60,4,2,2,0,0,0,32,19,13,42,29,13,56,35,21,2,2,0,0
"22320","VAN","S.J",2008020978,14310,20082009,1,60,3,1,2,0,0,0,29,29,0,36,48,-12,49,57,-8,8,5,0,0
"22321","VAN","L.A",2008020988,14312,20082009,0,60,2,3,-1,0,0,0,22,22,0,43,31,12,56,41,15,4,6,0,0
"22322","VAN","ANA",2008021002,14314,20082009,0,63.6166666666667,3,4,-1,0,0,0,35,41,-6,52,57,-5,61,65,-4,7,7,0,0
"22323","VAN","L.A",2008021017,14316,20082009,1,60,4,2,2,0,0,0,32,26,6,45,41,4,54,56,-2,6,5,0,0
"22324","VAN","COL",2008021037,14318,20082009,1,60,4,2,2,0,0,0,23,20,3,37,36,1,45,52,-7,5,8,0,0
"22325","VAN","DAL",2008021049,14320,20082009,1,60,4,2,2,0,0,0,25,26,-1,28,36,-8,34,46,-12,3,8,0,0
"22326","VAN","STL",2008021060,14322,20082009,1,60,3,0,3,0,0,0,21,30,-9,36,43,-7,51,52,-1,3,6,0,0
"22327","VAN","DAL",2008021094,14327,20082009,0,60,5,2,3,0,0,0,22,37,-15,37,61,-24,46,80,-34,10,7,0,0
"22328","VAN","STL",2008021107,14329,20082009,0,60,2,4,-2,0,0,0,23,32,-9,29,45,-16,43,54,-11,6,7,0,0
"22329","VAN","COL",2008021114,14330,20082009,0,60,4,1,3,0,0,0,34,23,11,50,36,14,66,48,18,6,4,0,0
"22330","VAN","CHI",2008021131,14332,20082009,0,60,4,0,4,0,0,0,23,26,-3,27,36,-9,35,45,-10,9,5,0,0
"22331","VAN","MIN",2008021141,14334,20082009,0,64,2,1,1,0,0,0,19,34,-15,33,52,-19,44,65,-21,2,5,0,0
"22332","VAN","ANA",2008021156,14336,20082009,1,65,5,5,0,0,0,0,30,32,-2,41,43,-2,58,48,10,4,1,0,0
"22333","VAN","EDM",2008021172,14338,20082009,0,60,3,5,-2,0,0,0,46,25,21,61,33,28,78,42,36,5,5,0,0
"22334","VAN","COL",2008021180,14339,20082009,1,60,1,4,-3,0,0,0,21,26,-5,41,34,7,62,37,25,4,2,0,0
"22335","VAN","CGY",2008021194,14341,20082009,1,60,4,1,3,0,0,0,25,47,-22,39,57,-18,50,75,-25,6,7,0,0
"22336","VAN","L.A",2008021208,14343,20082009,1,60,1,0,1,0,0,0,28,20,8,41,27,14,57,39,18,5,3,0,0
"22337","VAN","COL",2008021217,14345,20082009,0,60.6666666666667,1,0,1,0,0,0,33,22,11,44,29,15,54,36,18,3,3,0,0
"22338","VAN","STL",2008030171,14349,20082009,1,60,2,1,1,0,0,0,31,26,5,39,36,3,49,48,1,7,8,0,0
"22339","VAN","STL",2008030172,14351,20082009,1,60,3,0,3,0,0,0,27,30,-3,44,41,3,61,56,5,6,5,0,0
"22340","VAN","STL",2008030173,14353,20082009,0,60,3,2,1,0,0,0,26,26,0,35,40,-5,51,52,-1,8,7,0,0
"22341","VAN","STL",2008030174,14355,20082009,0,79.6833333333333,3,2,1,0,0,0,36,49,-13,48,62,-14,54,78,-24,3,6,0,0
"22342","VAN","CHI",2008030241,14364,20082009,1,60,5,3,2,0,0,0,27,31,-4,45,40,5,59,52,7,5,3,0,0
"22343","VAN","CHI",2008030242,14366,20082009,1,60,3,6,-3,0,0,0,21,32,-11,29,43,-14,38,62,-24,10,11,0,0
"22344","VAN","CHI",2008030243,14369,20082009,0,60,3,1,2,0,0,0,21,24,-3,23,30,-7,36,51,-15,6,6,0,0
"22345","VAN","CHI",2008030244,14371,20082009,0,62.8666666666667,1,2,-1,0,0,0,15,28,-13,17,40,-23,26,49,-23,4,5,0,0
"22346","VAN","CHI",2008030245,14373,20082009,1,60,2,4,-2,0,0,0,21,30,-9,31,40,-9,44,56,-12,3,6,0,0
"22347","VAN","CHI",2008030246,14375,20082009,0,60,5,7,-2,0,0,0,38,30,8,42,37,5,55,42,13,5,4,0,0
"22348","VAN","CGY",2009020004,14518,20092010,0,60,3,5,-2,0,0,0,42,23,19,54,37,17,69,50,19,6,5,0,0
"22349","VAN","COL",2009020009,14520,20092010,0,60,0,3,-3,0,0,0,35,27,8,47,37,10,63,49,14,4,7,0,0
"22350","VAN","MTL",2009020034,14524,20092010,1,60,7,1,6,0,0,0,35,28,7,45,32,13,62,43,19,6,5,0,0
"22351","VAN","DAL",2009020063,14528,20092010,1,65,3,3,0,0,0,0,25,35,-10,34,40,-6,46,52,-6,4,5,0,0
"22352","VAN","CGY",2009020091,14533,20092010,0,60,3,5,-2,0,0,0,29,24,5,42,39,3,55,56,-1,5,6,0,0
"22353","VAN","MIN",2009020104,14534,20092010,1,60,2,1,1,0,0,0,39,18,21,50,25,25,66,41,25,5,4,0,0
"22354","VAN","EDM",2009020108,14536,20092010,0,60,1,2,-1,0,0,0,40,29,11,57,41,16,74,55,19,5,3,0,0
"22355","VAN","CHI",2009020116,14538,20092010,0,60,3,2,1,0,0,0,31,20,11,36,31,5,55,42,13,6,5,0,0
"22356","VAN","EDM",2009020147,14542,20092010,1,60,2,0,2,0,0,0,29,27,2,41,32,9,50,41,9,4,5,0,0
"22357","VAN","DET",2009020154,14544,20092010,1,60,4,5,-1,0,0,0,26,42,-16,38,52,-14,51,64,-13,4,3,0,0
"22358","VAN","L.A",2009020171,14546,20092010,0,65,1,1,0,0,0,0,15,31,-16,24,49,-25,41,65,-24,3,4,0,0
"22359","VAN","ANA",2009020178,14547,20092010,0,60,2,7,-5,0,0,0,38,34,4,55,47,8,62,53,9,4,2,0,0
"22360","VAN","COL",2009020194,14549,20092010,1,60,3,0,3,0,0,0,20,18,2,29,26,3,40,34,6,4,4,0,0
"22361","VAN","NYR",2009020201,14551,20092010,1,60,4,1,3,0,0,0,30,23,7,48,36,12,61,49,12,7,4,0,0
"22362","VAN","MIN",2009020214,14553,20092010,0,60,5,2,3,0,0,0,22,30,-8,34,50,-16,41,63,-22,4,5,0,0
"22363","VAN","DAL",2009020223,14554,20092010,0,60,1,2,-1,0,0,0,33,47,-14,45,69,-24,53,79,-26,2,3,0,0
"22364","VAN","STL",2009020245,14558,20092010,0,60,1,6,-5,0,0,0,23,30,-7,39,38,1,51,48,3,7,9,0,0
"22365","VAN","DET",2009020258,14560,20092010,0,60,1,3,-2,0,0,0,32,29,3,47,41,6,58,57,1,6,3,0,0
"22366","VAN","COL",2009020279,14562,20092010,0,60,8,2,6,0,0,0,30,34,-4,45,41,4,57,50,7,9,8,0,0
"22367","VAN","COL",2009020311,14568,20092010,1,60,5,2,3,0,0,0,27,24,3,41,36,5,56,47,9,4,4,0,0
"22368","VAN","CHI",2009020327,14570,20092010,1,60,0,1,-1,0,0,0,30,17,13,46,28,18,64,37,27,5,4,0,0
"22369","VAN","L.A",2009020354,14574,20092010,1,60,4,1,3,0,0,0,34,32,2,53,41,12,69,61,8,6,5,0,0
"22370","VAN","EDM",2009020378,14576,20092010,1,60,7,3,4,0,0,0,35,34,1,42,43,-1,56,56,0,7,6,0,0
"22371","VAN","S.J",2009020381,14577,20092010,1,60,2,4,-2,0,0,0,27,30,-3,40,41,-1,46,52,-6,4,5,0,0
"22372","VAN","N.J",2009020395,14580,20092010,0,60,5,2,3,0,0,0,26,29,-3,33,36,-3,39,45,-6,3,4,0,0
"22373","VAN","PHI",2009020399,14581,20092010,0,60,3,0,3,0,0,0,29,38,-9,38,57,-19,54,73,-19,5,6,0,0
"22374","VAN","CAR",2009020413,14583,20092010,0,60,3,5,-2,0,0,0,36,28,8,53,39,14,73,51,22,3,2,0,0
"22375","VAN","NSH",2009020440,14586,20092010,0,60,2,4,-2,0,0,0,36,26,10,50,44,6,65,62,3,3,7,0,0
"22376","VAN","ATL",2009020456,14588,20092010,1,60,4,2,2,0,0,0,38,24,14,50,28,22,60,33,27,3,5,0,0
"22377","VAN","MIN",2009020476,14590,20092010,1,60,4,3,1,0,0,0,29,41,-12,43,48,-5,58,58,0,5,4,0,0
"22378","VAN","L.A",2009020487,14592,20092010,1,60,3,1,2,0,0,0,28,25,3,36,40,-4,48,45,3,6,6,0,0
"22379","VAN","ANA",2009020501,14594,20092010,1,60,2,3,-1,0,0,0,30,34,-4,45,41,4,56,50,6,6,5,0,0
"22380","VAN","STL",2009020530,14598,20092010,1,60,1,3,-2,0,0,0,30,26,4,40,35,5,59,44,15,5,4,0,0
"22381","VAN","NSH",2009020544,14600,20092010,1,60,4,1,3,0,0,0,36,21,15,46,33,13,60,46,14,3,2,0,0
"22382","VAN","EDM",2009020568,14604,20092010,1,60,4,1,3,0,0,0,28,25,3,48,43,5,60,59,1,6,3,0,0
"22383","VAN","CGY",2009020575,14605,20092010,0,60,5,1,4,0,0,0,29,30,-1,45,44,1,55,60,-5,9,6,0,0
"22384","VAN","STL",2009020604,14609,20092010,0,62.4,4,3,1,0,0,0,30,25,5,43,35,8,57,44,13,12,7,0,0
"22385","VAN","DAL",2009020612,14611,20092010,0,60,3,1,2,0,0,0,27,32,-5,43,47,-4,57,58,-1,2,2,0,0
"22386","VAN","CGY",2009020670,14618,20092010,1,65,2,2,0,0,0,0,21,40,-19,32,53,-21,50,72,-22,3,4,0,0
"22387","VAN","NSH",2009020678,14620,20092010,1,60,2,3,-1,0,0,0,32,25,7,47,35,12,60,45,15,4,8,0,0
"22388","VAN","MIN",2009020689,14622,20092010,0,60,2,5,-3,0,0,0,31,22,9,39,33,6,54,46,8,7,7,0,0
"22389","VAN","PIT",2009020718,14625,20092010,1,60,6,2,4,0,0,0,27,24,3,41,30,11,54,44,10,9,6,0,0
"22390","VAN","EDM",2009020743,14629,20092010,0,61.65,3,2,1,0,0,0,29,33,-4,44,45,-1,70,53,17,6,5,0,0
"22391","VAN","DAL",2009020754,14630,20092010,1,60,4,3,1,0,0,0,23,23,0,30,29,1,47,41,6,3,2,0,0
"22392","VAN","CHI",2009020770,14632,20092010,1,60,5,1,4,0,0,0,28,44,-16,33,53,-20,43,70,-27,3,6,0,0
"22393","VAN","STL",2009020792,14636,20092010,1,60,3,2,1,0,0,0,34,27,7,42,35,7,50,51,-1,7,4,0,0
"22394","VAN","TOR",2009020809,14639,20092010,0,60,5,3,2,0,0,0,36,21,15,59,30,29,79,40,39,6,5,0,0
"22395","VAN","MTL",2009020830,14642,20092010,0,60,2,3,-1,0,0,0,47,28,19,62,35,27,70,42,28,6,5,0,0
"22396","VAN","OTT",2009020844,14644,20092010,0,60,1,3,-2,0,0,0,30,21,9,43,33,10,61,44,17,3,3,0,0
"22397","VAN","BOS",2009020855,14646,20092010,0,65,2,2,0,0,0,0,31,43,-12,36,55,-19,48,66,-18,5,6,0,0
"22398","VAN","T.B",2009020880,14649,20092010,0,60,1,3,-2,0,0,0,40,19,21,57,29,28,74,36,38,5,5,0,0
"22399","VAN","FLA",2009020894,14651,20092010,0,60,3,0,3,0,0,0,35,31,4,50,49,1,63,65,-2,6,7,0,0
"22400","VAN","MIN",2009020918,14654,20092010,0,60,2,6,-4,0,0,0,29,41,-12,35,54,-19,43,66,-23,2,8,0,0
"22401","VAN","DET",2009020937,14671,20092010,0,60,6,3,3,0,0,0,33,31,2,39,51,-12,42,63,-21,5,3,0,0
"22402","VAN","CHI",2009020952,14673,20092010,0,60,3,6,-3,0,0,0,23,24,-1,33,28,5,40,41,-1,6,9,0,0
"22403","VAN","NSH",2009020966,14675,20092010,0,60,4,2,2,0,0,0,28,35,-7,39,47,-8,52,61,-9,1,2,0,0
"22404","VAN","COL",2009020982,14677,20092010,0,60,6,4,2,0,0,0,32,27,5,48,28,20,65,38,27,3,2,0,0
"22405","VAN","OTT",2009021013,14681,20092010,1,60,5,1,4,0,0,0,35,14,21,49,16,33,68,28,40,7,3,0,0
"22406","VAN","CGY",2009021024,14682,20092010,1,60,3,1,2,0,0,0,28,33,-5,34,52,-18,46,70,-24,8,7,0,0
"22407","VAN","NYI",2009021038,14684,20092010,1,60,2,5,-3,0,0,0,37,20,17,51,32,19,72,37,35,2,4,0,0
"22408","VAN","S.J",2009021051,14686,20092010,1,60,3,2,1,0,0,0,26,34,-8,35,58,-23,50,74,-24,4,3,0,0
"22409","VAN","DET",2009021066,14688,20092010,1,64.9833333333333,3,4,-1,0,0,0,32,54,-22,43,64,-21,49,81,-32,2,2,0,0
"22410","VAN","EDM",2009021089,14691,20092010,0,60,2,3,-1,0,0,0,33,22,11,54,27,27,76,36,40,3,2,0,0
"22411","VAN","ANA",2009021095,14692,20092010,1,60,4,1,3,0,0,0,30,31,-1,43,44,-1,50,59,-9,2,4,0,0
"22412","VAN","S.J",2009021120,14695,20092010,0,60,2,4,-2,0,0,0,37,30,7,54,39,15,69,52,17,4,3,0,0
"22413","VAN","L.A",2009021156,14700,20092010,0,60,3,8,-5,0,0,0,30,29,1,50,39,11,65,52,13,3,5,0,0
"22414","VAN","ANA",2009021163,14701,20092010,0,65,4,4,0,0,0,0,40,34,6,51,52,-1,61,65,-4,5,7,0,0
"22415","VAN","MIN",2009021178,14703,20092010,1,62.25,4,3,1,0,0,0,40,27,13,50,38,12,71,55,16,7,8,0,0
"22416","VAN","COL",2009021191,14705,20092010,1,65,3,3,0,0,0,0,32,31,1,51,37,14,65,47,18,3,3,0,0
"22417","VAN","S.J",2009021206,14707,20092010,0,60,2,4,-2,0,0,0,32,31,1,47,43,4,59,55,4,9,9,0,0
"22418","VAN","CGY",2009021221,14709,20092010,1,60,7,3,4,0,0,0,29,41,-12,38,52,-14,50,63,-13,5,3,0,0
"22419","VAN","L.A",2009030171,14714,20092010,1,68.8666666666667,3,2,1,0,0,0,44,27,17,60,39,21,78,52,26,5,2,0,0
"22420","VAN","L.A",2009030172,14716,20092010,1,67.4666666666667,2,3,-1,0,0,0,26,32,-6,43,43,0,50,56,-6,4,7,0,0
"22421","VAN","L.A",2009030173,14718,20092010,0,60,3,5,-2,0,0,0,28,23,5,48,33,15,76,46,30,4,3,0,0
"22422","VAN","L.A",2009030174,14720,20092010,0,60,6,4,2,0,0,0,37,26,11,57,37,20,71,47,24,7,6,0,0
"22423","VAN","L.A",2009030175,14722,20092010,1,60,7,2,5,0,0,0,30,26,4,38,36,2,49,49,0,7,6,0,0
"22424","VAN","L.A",2009030176,14724,20092010,0,60,4,2,2,0,0,0,22,32,-10,36,53,-17,44,65,-21,3,5,0,0
"22425","VAN","CHI",2009030241,14730,20092010,0,60,5,1,4,0,0,0,28,37,-9,35,51,-16,48,64,-16,4,6,0,0
"22426","VAN","CHI",2009030242,14732,20092010,0,60,2,4,-2,0,0,0,26,34,-8,44,47,-3,62,63,-1,6,2,0,0
"22427","VAN","CHI",2009030243,14734,20092010,1,60,2,5,-3,0,0,0,33,35,-2,47,45,2,63,52,11,5,8,0,0
"22428","VAN","CHI",2009030244,14736,20092010,1,60,4,7,-3,0,0,0,30,34,-4,45,38,7,65,48,17,4,8,0,0
"22429","VAN","CHI",2009030245,14738,20092010,0,60,4,1,3,0,0,0,24,30,-6,32,41,-9,46,53,-7,7,5,0,0
"22430","VAN","CHI",2009030246,14740,20092010,1,60,1,5,-4,0,0,0,30,35,-5,38,45,-7,53,54,-1,2,2,0,0
"22431","VAN","L.A",2010020023,14891,20102011,1,65,1,1,0,2.64906394654352,3.57688447687073,-0.927820530327203,24,32,-8,31,42,-11,45,55,-10,5,6,0,0
"22432","VAN","FLA",2010020033,14893,20102011,1,60,2,1,1,4.60495748124413,5.03954928862368,-0.434591807379547,35,42,-7,43,53,-10,59,78,-19,0,3,0,0
"22433","VAN","ANA",2010020041,14895,20102011,0,60,3,4,-1,5.3660032831076,5.99063842993928,-0.624635146831679,39,32,7,58,43,15,68,55,13,3,5,0,0
"22434","VAN","L.A",2010020054,14897,20102011,0,60,1,4,-3,3.7340662388493,1.95353734203673,1.78052889681257,26,19,7,46,24,22,60,37,23,5,5,0,0
"22435","VAN","CAR",2010020068,14899,20102011,1,60,5,1,4,3.43984165981965,5.50093855134389,-2.06109689152424,28,33,-5,44,50,-6,70,65,5,7,8,0,0
"22436","VAN","MIN",2010020076,14901,20102011,0,60,2,6,-4,5.65369519186788,4.16197202841005,1.49172316345783,27,24,3,41,34,7,57,44,13,7,4,0,0
"22437","VAN","CHI",2010020080,14902,20102011,0,65,1,1,0,3.97891560030439,3.15578580078221,0.823129799522178,37,32,5,48,47,1,64,59,5,4,4,0,0
"22438","VAN","MIN",2010020097,14904,20102011,1,60,5,1,4,5.69375128168031,3.40660147220034,2.28714980947997,35,24,11,55,36,19,76,48,28,5,4,0,0
"22439","VAN","COL",2010020122,14908,20102011,1,60.4666666666667,4,3,1,6.55312206612507,5.41345013025611,1.13967193586896,31,39,-8,43,46,-3,57,60,-3,3,2,0,0
"22440","VAN","N.J",2010020159,14914,20102011,1,60,3,0,3,3.86894911227864,3.30451874487335,0.564430367405294,23,30,-7,36,40,-4,51,58,-7,5,3,0,0
"22441","VAN","EDM",2010020163,14915,20102011,0,60,4,3,1,4.10670865277189,3.65540359745501,0.45130505531688,30,26,4,48,40,8,61,55,6,4,3,0,0
"22442","VAN","COL",2010020177,14917,20102011,0,60,3,1,2,5.06124057770933,4.39721858351272,0.664021994196608,36,34,2,48,46,2,58,62,-4,4,2,0,0
"22443","VAN","DET",2010020197,14919,20102011,1,60,6,4,2,4.467855978015,2.64121457813931,1.82664139987569,34,28,6,47,36,11,59,59,0,5,4,0,0
"22444","VAN","MTL",2010020206,14922,20102011,0,60,0,2,-2,3.94926718420174,3.77275278097852,0.176514403223225,34,29,5,48,40,8,69,51,18,4,3,0,0
"22445","VAN","OTT",2010020223,14924,20102011,0,60,6,2,4,4.80170117588568,6.79476498608915,-1.99306381020347,33,35,-2,43,48,-5,51,63,-12,4,6,0,0
"22446","VAN","TOR",2010020235,14926,20102011,0,60,5,3,2,5.6660585380922,4.03637418347368,1.62968435461852,32,32,0,47,48,-1,59,60,-1,4,5,0,0
"22447","VAN","PIT",2010020259,14930,20102011,0,60,1,3,-2,4.55519075976981,2.99255110735703,1.56263965241278,30,29,1,45,39,6,66,57,9,5,2,0,0
"22448","VAN","CHI",2010020292,14933,20102011,1,60,1,7,-6,0,0,0,28,41,-13,37,53,-16,56,62,-6,4,8,0,0
"22449","VAN","COL",2010020318,14937,20102011,1,60,4,2,2,2.71664348734759,4.57007275705747,-1.85342926970988,19,23,-4,30,33,-3,50,44,6,4,5,0,0
"22450","VAN","S.J",2010020333,14939,20102011,1,60,6,1,5,4.57107162344619,6.06690738839097,-1.49583576494479,32,33,-1,35,41,-6,44,62,-18,1,1,0,0
"22451","VAN","CGY",2010020363,14944,20102011,0,60,7,2,5,4.07101731299184,3.32884148253945,0.742175830452395,36,20,16,52,31,21,59,43,16,8,4,0,0
"22452","VAN","CHI",2010020377,14946,20102011,0,60,3,0,3,3.55649408166573,4.05619695056328,-0.499702868897543,18,32,-14,27,41,-14,38,60,-22,5,4,0,0
"22453","VAN","STL",2010020395,14948,20102011,1,60,2,3,-1,0,0,0,23,28,-5,31,35,-4,50,53,-3,5,5,0,0
"22454","VAN","ANA",2010020410,14951,20102011,1,65,4,4,0,4.34551899222424,2.17158387880772,2.17393511341652,40,20,20,59,22,37,80,28,52,7,4,0,0
"22455","VAN","T.B",2010020435,14954,20102011,1,60.5666666666667,4,5,-1,3.3287690429447,2.51584887894569,0.81292016399901,27,23,4,40,29,11,56,41,15,4,3,0,0
"22456","VAN","EDM",2010020439,14955,20102011,0,60,2,1,1,5.93349527195164,1.88129983132239,4.05219544062925,32,12,20,40,20,20,51,40,11,4,5,0,0
"22457","VAN","TOR",2010020483,14961,20102011,1,60,4,1,3,6.06620459875558,5.08879013966178,0.977414459093794,29,28,1,41,39,2,55,50,5,6,4,0,0
"22458","VAN","STL",2010020493,14963,20102011,0,60,3,1,2,3.20746127333405,3.57982131726203,-0.372360043927983,29,16,13,43,31,12,61,47,14,5,3,0,0
"22459","VAN","DET",2010020504,14965,20102011,0,62.9833333333333,4,5,-1,4.06676433616667,6.9525359114341,-2.88577157526743,39,45,-6,47,54,-7,53,63,-10,3,4,0,0
"22460","VAN","EDM",2010020528,14969,20102011,1,60,3,2,1,4.85365788618927,4.17647157429019,0.677186311899084,33,21,12,53,28,25,70,37,33,4,4,0,0
"22461","VAN","PHI",2010020544,14971,20102011,1,60,6,2,4,5.43016162951062,4.71728106759201,0.71288056191861,49,37,12,63,45,18,79,56,23,4,7,0,0
"22462","VAN","DAL",2010020564,14974,20102011,0,60,4,1,3,2.07779643051387,6.3683106500539,-4.29051421954003,22,45,-23,29,62,-33,41,80,-39,7,5,0,0
"22463","VAN","COL",2010020579,14976,20102011,0,60,2,1,1,4.16759810811982,2.8842027054925,1.28339540262732,29,32,-3,40,46,-6,50,58,-8,7,9,0,0
"22464","VAN","S.J",2010020585,14977,20102011,0,60,4,3,1,5.1149491174001,4.57440457769553,0.54054453970457,47,35,12,57,52,5,70,63,7,3,2,0,0
"22465","VAN","CGY",2010020595,14979,20102011,1,60,3,1,2,4.3449420905672,5.77639488918066,-1.43145279861346,21,44,-23,24,51,-27,34,67,-33,2,3,0,0
"22466","VAN","EDM",2010020610,14981,20102011,1,60,6,1,5,6.02536006842274,3.29747846411192,2.72788160431082,34,24,10,44,33,11,57,44,13,7,7,0,0
"22467","VAN","DET",2010020621,14982,20102011,1,65,1,1,0,6.80312038138452,3.4587989513002,3.34432143008433,35,33,2,61,41,20,82,57,25,5,5,0,0
"22468","VAN","NYI",2010020634,14985,20102011,0,65,3,3,0,9.58475069353881,6.24866469897097,3.33608599456784,51,41,10,64,51,13,79,67,12,2,2,0,0
"22469","VAN","NYR",2010020649,14987,20102011,0,60,0,1,-1,3.94476109243988,5.56753685363219,-1.62277576119232,31,35,-4,48,49,-1,72,61,11,3,3,0,0
"22470","VAN","MIN",2010020673,14990,20102011,0,60,0,4,-4,8.15991975012913,3.09199494880158,5.06792480132755,32,25,7,48,38,10,65,42,23,4,3,0,0
"22471","VAN","COL",2010020690,14992,20102011,0,62.8666666666667,3,4,-1,6.43324944069741,4.82192960250541,1.611319838192,43,30,13,54,41,13,68,53,15,3,6,0,0
"22472","VAN","S.J",2010020706,14994,20102011,1,65,1,1,0,3.82917048594391,4.38049570219876,-0.551325216254856,37,46,-9,45,59,-14,64,76,-12,5,2,0,0
"22473","VAN","CGY",2010020721,14996,20102011,1,65,3,3,0,6.69100839726161,4.20507680321546,2.48593159404616,44,33,11,58,39,19,77,56,21,5,6,0,0
"22474","VAN","DAL",2010020732,14998,20102011,1,60,7,1,6,4.418361628226,4.86608949188667,-0.447727863660665,36,26,10,47,34,13,61,45,16,11,8,0,0
"22475","VAN","NSH",2010020749,15000,20102011,1,60,2,1,1,4.44344656422618,3.32873594936555,1.11471061486063,35,27,8,43,37,6,62,47,15,4,5,0,0
"22476","VAN","DAL",2010020762,15006,20102011,0,60,4,1,3,3.39396442184412,4.95071253046626,-1.55674810862214,26,26,0,39,46,-7,55,62,-7,3,5,0,0
"22477","VAN","CHI",2010020781,15009,20102011,1,60,4,3,1,4.45809303697159,3.79887866356876,0.659214373402833,32,45,-13,40,60,-20,61,76,-15,5,6,0,0
"22478","VAN","OTT",2010020801,15012,20102011,1,60,4,2,2,3.91323127591875,1.35638629526312,2.55684498065563,30,33,-3,38,45,-7,53,57,-4,3,5,0,0
"22479","VAN","ANA",2010020815,15014,20102011,1,60,3,4,-1,8.18468836904458,3.65669543396507,4.52799293507951,38,24,14,55,31,24,73,40,33,1,2,0,0
"22480","VAN","CGY",2010020836,15017,20102011,1,60,4,2,2,5.73532975477985,2.31877229473321,3.41655746004665,33,26,7,36,33,3,53,43,10,3,3,0,0
"22481","VAN","STL",2010020845,15019,20102011,0,60,2,3,-1,3.35157028860074,6.63112303134403,-3.27955274274329,25,34,-9,40,44,-4,52,56,-4,1,5,0,0
"22482","VAN","MIN",2010020853,15020,20102011,0,60,4,1,3,2.711478296937,5.12848710152321,-2.4170088045862,14,29,-15,28,42,-14,36,54,-18,2,5,0,0
"22483","VAN","NSH",2010020866,15022,20102011,0,60,1,3,-2,5.06236524706765,3.43028042733204,1.63208481973561,36,26,10,45,32,13,64,45,19,5,2,0,0
"22484","VAN","DAL",2010020884,15024,20102011,1,60,5,2,3,3.90245009658679,4.00903545803158,-0.106585361444786,38,24,14,49,39,10,66,55,11,3,4,0,0
"22485","VAN","MTL",2010020901,15027,20102011,1,60,2,3,-1,5.49832753092051,4.08750709851358,1.41082043240693,39,25,14,53,37,16,75,44,31,6,3,0,0
"22486","VAN","STL",2010020913,15029,20102011,1,60,3,2,1,3.80224649594626,5.98333249794086,-2.1810860019946,27,30,-3,37,49,-12,49,66,-17,1,4,0,0
"22487","VAN","BOS",2010020931,15031,20102011,1,60,1,3,-2,4.45836490773172,2.85438138933387,1.60398351839785,28,25,3,42,34,8,65,47,18,3,2,0,0
"22488","VAN","NSH",2010020965,15036,20102011,1,60,0,3,-3,5.025957116915,4.5795306332293,0.4464264836857,29,29,0,49,43,6,61,54,7,2,2,0,0
"22489","VAN","L.A",2010020975,15038,20102011,0,60,3,1,2,3.98001770264455,4.07482535031045,-0.0948076476659026,36,22,14,50,33,17,62,38,24,8,8,0,0
"22490","VAN","ANA",2010020988,15039,20102011,0,60,3,0,3,3.08346021189936,5.25911469039846,-2.1756544784991,16,26,-10,27,35,-8,37,45,-8,6,7,0,0
"22491","VAN","S.J",2010021014,15043,20102011,0,65,4,4,0,4.37655912064656,8.54814958073757,-4.17159046009101,28,48,-20,42,65,-23,57,78,-21,9,10,0,0
"22492","VAN","CGY",2010021031,15045,20102011,0,60,4,3,1,3.23806382089808,5.60510001934017,-2.36703619844209,32,23,9,40,34,6,62,50,12,2,2,0,0
"22493","VAN","MIN",2010021040,15047,20102011,1,60,4,2,2,5.49219664799946,4.3997865417914,1.09241010620806,22,35,-13,33,48,-15,44,61,-17,2,6,0,0
"22494","VAN","COL",2010021053,15049,20102011,1,60,4,2,2,7.07232130835129,3.15339766493707,3.91892364341422,40,29,11,57,35,22,80,45,35,1,1,0,0
"22495","VAN","DET",2010021098,15056,20102011,0,60,2,1,1,3.64183796270663,6.58794119862978,-2.94610323592315,33,40,-7,41,56,-15,50,60,-10,4,4,0,0
"22496","VAN","ATL",2010021114,15058,20102011,0,60,3,1,2,4.01874372605744,4.99091367468645,-0.972169948629016,26,31,-5,34,42,-8,44,56,-12,2,4,0,0
"22497","VAN","NSH",2010021142,15062,20102011,0,60,3,1,2,5.11979112026965,2.62923731061164,2.49055380965801,32,17,15,42,24,18,56,31,25,5,5,0,0
"22498","VAN","L.A",2010021158,15064,20102011,1,60,3,1,2,6.18708008566586,4.40308630709478,1.78399377857107,35,19,16,60,28,32,71,34,37,4,3,0,0
"22499","VAN","EDM",2010021173,15066,20102011,1,60,1,4,-3,4.26161270181183,5.22624420997771,-0.964631508165883,41,34,7,49,48,1,63,57,6,4,3,0,0
"22500","VAN","EDM",2010021192,15069,20102011,0,60,0,2,-2,3.15472773672082,3.08457626329619,0.0701514734246302,26,22,4,39,30,9,54,37,17,4,7,0,0
"22501","VAN","MIN",2010021204,15071,20102011,1,60,5,0,5,3.16962776994251,2.99025901011191,0.179368759830595,28,29,-1,39,39,0,52,51,1,3,4,0,0
"22502","VAN","CGY",2010021223,15073,20102011,0,62.6833333333333,3,2,1,7.14309355754864,3.82947541028261,3.31361814726603,39,36,3,57,46,11,78,57,21,6,10,0,0
"22503","VAN","CHI",2010030151,15077,20102011,1,60,2,0,2,4.28617812759114,6.82875099340163,-2.54257286581048,33,32,1,45,51,-6,63,62,1,3,4,0,0
"22504","VAN","CHI",2010030152,15079,20102011,1,60,4,3,1,7.00697744627118,3.42139757107361,3.58557987519757,27,26,1,42,33,9,54,43,11,2,2,0,0
"22505","VAN","CHI",2010030153,15081,20102011,0,60,3,2,1,4.38936037824774,4.76537652208935,-0.376016143841611,26,32,-6,36,43,-7,43,52,-9,2,7,0,0
"22506","VAN","CHI",2010030154,15083,20102011,0,60,2,7,-5,2.55365090697887,5.07361765843234,-2.51996675145347,23,35,-12,32,44,-12,43,51,-8,6,8,0,0
"22507","VAN","CHI",2010030155,15085,20102011,1,60,0,5,-5,4.19030411855783,4.68125324948252,-0.490949130924683,36,26,10,43,32,11,63,41,22,5,5,0,0
"22508","VAN","CHI",2010030156,15088,20102011,0,75.5,3,4,-1,8.11358103476596,6.59365594724659,1.51992508751937,35,33,2,54,42,12,85,54,31,3,6,0,0
"22509","VAN","CHI",2010030157,15090,20102011,1,65.3666666666667,2,1,1,7.53556886728377,5.37490671688874,2.16066215039503,38,32,6,53,41,12,69,57,12,3,2,0,0
"22510","VAN","NSH",2010030231,15092,20102011,1,60,1,0,1,4.06687687837672,1.96548640366018,2.10139047471654,30,20,10,38,29,9,53,41,12,5,5,0,0
"22511","VAN","NSH",2010030232,15094,20102011,1,80,1,1,0,7.59475685648795,9.60282072325936,-2.00806386677141,26,43,-17,45,57,-12,64,73,-9,1,3,0,0
"22512","VAN","NSH",2010030233,15097,20102011,0,70.75,3,2,1,9.37734735581029,4.39922603996695,4.97812131584333,47,30,17,59,43,16,74,56,18,4,3,0,0
"22513","VAN","NSH",2010030234,15099,20102011,0,60,4,2,2,6.28358066431247,4.00876095857529,2.27481970573717,28,21,7,35,28,7,50,44,6,4,4,0,0
"22514","VAN","NSH",2010030235,15101,20102011,1,60,3,4,-1,4.25313763853046,4.68363443865383,-0.430496800123365,34,23,11,43,28,15,73,45,28,4,3,0,0
"22515","VAN","NSH",2010030236,15103,20102011,0,60,2,1,1,3.27659155443525,3.99104420874898,-0.714452654313729,19,24,-5,29,32,-3,39,45,-6,4,6,0,0
"22516","VAN","S.J",2010030321,15109,20102011,1,60,3,2,1,5.71741932502482,4.58751344906341,1.12990587596141,38,29,9,50,32,18,71,45,26,5,2,0,0
"22517","VAN","S.J",2010030322,15112,20102011,1,60,7,3,4,5.00502156531002,3.230828251676,1.77419331363402,38,31,7,52,40,12,64,50,14,9,3,0,0
"22518","VAN","S.J",2010030323,15114,20102011,0,60,3,4,-1,5.60736615140922,4.90920139420172,0.698164757207508,30,38,-8,40,52,-12,66,74,-8,4,10,0,0
"22519","VAN","S.J",2010030324,15116,20102011,0,60,4,2,2,2.7102416150592,3.77982515372423,-1.06958353866503,13,35,-22,22,51,-29,31,74,-43,6,5,0,0
"22520","VAN","S.J",2010030325,15118,20102011,1,80,2,2,0,7.24776897241436,9.00188226512432,-1.75411329270996,29,52,-23,48,66,-18,73,92,-19,1,4,0,0
"22521","VAN","BOS",2010030411,15126,20102011,1,60,1,0,1,3.53156082319856,3.32978963394395,0.201771189254612,34,36,-2,50,46,4,69,58,11,7,6,0,0
"22522","VAN","BOS",2010030412,15129,20102011,1,60.1833333333333,3,2,1,6.79060802412179,5.65384437749162,1.13676364663016,33,30,3,47,42,5,65,58,7,2,3,0,0
"22523","VAN","BOS",2010030413,15131,20102011,0,60,1,8,-7,6.38339307862298,3.55591508134238,2.8274779972806,41,38,3,51,44,7,63,55,8,9,5,0,0
"22524","VAN","BOS",2010030414,15133,20102011,0,60,0,4,-4,4.69129979372079,5.30702334437404,-0.615723550653257,38,29,9,49,39,10,64,56,8,10,8,0,0
"22525","VAN","BOS",2010030415,15135,20102011,1,60,1,0,1,2.27119739496584,2.70520928376936,-0.434011888803525,25,31,-6,37,40,-3,56,57,-1,4,5,0,0
"22526","VAN","BOS",2010030416,15138,20102011,0,60,2,5,-3,4.5456039190758,5.70070612279414,-1.15510220371834,38,40,-2,53,45,8,70,59,11,8,7,0,0
"22527","VAN","PIT",2011020003,15253,20112012,1,65,3,3,0,4.19364045433758,2.277712992538,1.91592746179958,36,28,8,49,39,10,66,49,17,3,3,0,0
"22528","VAN","PHI",2011020035,15259,20112012,0,60,4,5,-1,6.49346386488976,2.92668271747781,3.56678114741194,40,27,13,52,34,18,79,43,36,7,5,0,0
"22529","VAN","DET",2011020042,15260,20112012,0,60,0,2,-2,1.76194261782803,4.44991853927872,-2.6879759214507,25,37,-12,33,52,-19,48,61,-13,5,8,0,0
"22530","VAN","EDM",2011020061,15262,20112012,0,60,4,3,1,5.63639863506978,5.0971388771577,0.539259757912077,26,30,-4,37,39,-2,52,56,-4,3,5,0,0
"22531","VAN","NYR",2011020076,15265,20112012,1,60,0,4,-4,5.31057432864327,2.07766323854776,3.23291109009551,40,19,21,59,27,32,82,35,47,8,4,0,0
"22532","VAN","NSH",2011020089,15267,20112012,1,60,5,1,4,7.02438202789585,4.88049810642951,2.14388392146634,40,26,14,57,38,19,69,56,13,9,4,0,0
"22533","VAN","MIN",2011020096,15269,20112012,1,64.65,3,2,1,4.93704925470001,1.20380003208993,3.73324922261008,32,23,9,49,29,20,66,36,30,3,4,0,0
"22534","VAN","EDM",2011020119,15272,20112012,0,60,2,3,-1,6.55071602820027,4.14304773346521,2.40766829473506,37,22,15,52,32,20,83,43,40,4,3,0,0
"22535","VAN","STL",2011020124,15273,20112012,1,60,0,3,-3,3.80386260789783,4.47287269856315,-0.669010090665324,32,31,1,51,41,10,72,48,24,2,3,0,0
"22536","VAN","CGY",2011020164,15279,20112012,0,60,5,1,4,2.19916678237496,3.06279869583942,-0.863631913464459,21,29,-8,33,44,-11,44,53,-9,6,5,0,0
"22537","VAN","MIN",2011020174,15281,20112012,0,60,1,5,-4,2.51530972216278,4.07527233367546,-1.55996261151267,25,45,-20,37,54,-17,53,61,-8,5,3,0,0
"22538","VAN","STL",2011020182,15282,20112012,0,60,2,3,-1,4.6230268214058,4.11793117834941,0.505095643056393,30,28,2,40,42,-2,54,55,-1,4,3,0,0
"22539","VAN","CHI",2011020198,15284,20112012,0,60,6,2,4,3.56850928828311,6.08569701371289,-2.51718772542978,38,40,-2,46,47,-1,64,55,9,7,6,0,0
"22540","VAN","L.A",2011020220,15288,20112012,0,60,3,2,1,4.63692515442247,3.78455129207578,0.852373862346695,32,30,2,41,46,-5,47,59,-12,5,7,0,0
"22541","VAN","ANA",2011020228,15289,20112012,0,60,3,4,-1,5.16084281195109,3.25119658786571,1.90964622408538,41,21,20,52,26,26,59,30,29,5,2,0,0
"22542","VAN","NYI",2011020243,15291,20112012,1,60,4,1,3,8.60651994244108,2.74339159583906,5.86312834660202,36,24,12,54,30,24,81,51,30,3,0,0,0
"22543","VAN","CHI",2011020258,15294,20112012,1,60,1,5,-4,2.51115554054559,4.81311155666481,-2.30195601611922,29,27,2,45,34,11,68,43,25,3,5,0,0
"22544","VAN","OTT",2011020289,15298,20112012,1,62.3,2,1,1,5.41118952292928,3.00227333919611,2.40891618373317,27,29,-2,41,43,-2,51,55,-4,4,5,0,0
"22545","VAN","COL",2011020310,15301,20112012,0,60,3,0,3,6.57954903914924,2.57799020117091,4.00155883797834,29,24,5,44,30,14,47,43,4,3,4,0,0
"22546","VAN","S.J",2011020335,15304,20112012,0,60,3,2,1,4.58397025903832,5.83880724197661,-1.25483698293829,27,45,-18,36,60,-24,56,78,-22,1,3,0,0
"22547","VAN","NSH",2011020363,15309,20112012,1,60,5,6,-1,4.60655474977102,4.63295330747496,-0.0263985577039421,37,20,17,60,25,35,81,37,44,4,3,0,0
"22548","VAN","CGY",2011020386,15312,20112012,1,60,5,1,4,4.69792384564187,2.64962364407256,2.0483002015693,36,22,14,53,25,28,65,34,31,7,5,0,0
"22549","VAN","COL",2011020399,15314,20112012,1,60,6,0,6,2.99220538816689,3.32102628722691,-0.32882089906002,23,33,-10,31,43,-12,38,63,-25,6,7,0,0
"22550","VAN","MTL",2011020411,15316,20112012,0,65,3,3,0,4.19980354908432,2.71542558113288,1.48437796795145,31,23,8,39,31,8,65,46,19,4,4,0,0
"22551","VAN","OTT",2011020423,15318,20112012,0,60,4,1,3,3.66857133086887,3.65846471488476,0.0101066159841139,28,25,3,41,36,5,45,56,-11,7,7,0,0
"22552","VAN","CBJ",2011020442,15321,20112012,0,65,1,1,0,5.50373148371,2.39620000972172,3.10753147398827,32,30,2,43,39,4,62,50,12,5,4,0,0
"22553","VAN","CAR",2011020452,15323,20112012,0,60,3,4,-1,8.04300912142708,5.74237734434428,2.3006317770828,36,41,-5,51,51,0,70,62,8,3,8,0,0
"22554","VAN","TOR",2011020467,15325,20112012,0,60,5,3,2,5.22230682705413,4.42042809443046,0.801878732623663,36,29,7,52,42,10,77,52,25,2,2,0,0
"22555","VAN","MIN",2011020486,15327,20112012,1,60,4,0,4,4.91751909078448,2.61240655329965,2.30511253748483,33,33,0,43,38,5,59,46,13,3,1,0,0
"22556","VAN","DET",2011020498,15329,20112012,1,60,4,2,2,3.860371658433,4.61743293600739,-0.757061277574394,25,40,-15,30,50,-20,40,68,-28,0,4,0,0
"22557","VAN","CGY",2011020517,15331,20112012,1,60,1,3,-2,5.10541490878677,5.6206202080939,-0.515205299307127,30,31,-1,38,35,3,55,45,10,2,1,0,0
"22558","VAN","EDM",2011020526,15334,20112012,1,60,5,3,2,4.02622537962816,4.12025401132688,-0.0940286316987242,26,21,5,41,27,14,53,39,14,7,7,0,0
"22559","VAN","S.J",2011020541,15336,20112012,0,63.3833333333333,3,2,1,5.44156907114666,3.9527176004718,1.48885147067486,30,35,-5,49,44,5,70,60,10,5,5,0,0
"22560","VAN","ANA",2011020550,15337,20112012,0,60,5,2,3,4.15147943818124,3.80923717561419,0.342242262567055,31,32,-1,41,47,-6,46,63,-17,1,6,0,0
"22561","VAN","L.A",2011020567,15339,20112012,0,60,1,4,-3,4.31381909714634,6.0571908673692,-1.74337177022286,28,33,-5,49,43,6,58,48,10,5,7,0,0
"22562","VAN","S.J",2011020572,15341,20112012,1,65,2,2,0,4.93991137916601,4.53561904106391,0.404292338102096,29,35,-6,40,49,-9,64,56,8,7,4,0,0
"22563","VAN","MIN",2011020582,15343,20112012,1,60,3,0,3,5.15758952483668,3.09163609874668,2.06595342609001,35,28,7,42,35,7,61,52,9,3,5,0,0
"22564","VAN","BOS",2011020598,15346,20112012,0,60,4,3,1,4.73349672748401,4.07792713899535,0.655569588488659,36,39,-3,46,47,-1,53,57,-4,10,11,0,0
"22565","VAN","FLA",2011020614,15348,20112012,0,60,1,2,-1,4.39723002841856,3.58632111782754,0.810908910591024,26,22,4,43,35,8,59,46,13,4,4,0,0
"22566","VAN","T.B",2011020623,15349,20112012,0,65,4,4,0,5.07778330220481,3.99840677116299,1.07937653104182,28,31,-3,38,47,-9,54,61,-7,4,3,0,0
"22567","VAN","STL",2011020636,15351,20112012,0,60.7666666666667,3,2,1,4.96879408647328,3.95603520867007,1.01275887780321,21,33,-12,29,49,-20,42,60,-18,4,5,0,0
"22568","VAN","ANA",2011020663,15354,20112012,1,60,2,4,-2,4.16249776212499,4.92927510775876,-0.766777345633777,23,34,-11,32,42,-10,50,51,-1,3,3,0,0
"22569","VAN","L.A",2011020679,15356,20112012,1,65,2,2,0,6.68141268193722,6.05319256376242,0.628220118174795,33,41,-8,42,45,-3,61,59,2,4,2,0,0
"22570","VAN","S.J",2011020701,15360,20112012,1,60,4,3,1,6.5324990908266,6.76482577982824,-0.232326689001638,30,26,4,47,42,5,70,52,18,4,1,0,0
"22571","VAN","EDM",2011020734,15363,20112012,1,65,2,2,0,5.58163536189022,6.65068429590974,-1.06904893401952,35,32,3,46,38,8,69,51,18,2,1,0,0
"22572","VAN","CHI",2011020747,15370,20112012,1,63.6166666666667,3,2,1,5.34429536829703,5.50103793627932,-0.156742567982292,33,39,-6,43,50,-7,62,66,-4,0,2,0,0
"22573","VAN","DET",2011020760,15372,20112012,1,65,3,3,0,3.91459021270566,3.81076906631642,0.103821146389237,25,43,-18,34,59,-25,44,75,-31,1,4,0,0
"22574","VAN","COL",2011020770,15374,20112012,0,65,2,2,0,4.32818503570525,5.46129784302299,-1.13311280731774,29,46,-17,43,55,-12,60,67,-7,6,5,0,0
"22575","VAN","NSH",2011020793,15377,20112012,0,65,3,3,0,5.48153171781451,4.98028856088058,0.501243156933924,31,40,-9,44,52,-8,57,63,-6,1,4,0,0
"22576","VAN","MIN",2011020809,15379,20112012,0,60,5,2,3,4.2977980388896,3.05721252923831,1.24058550965128,20,24,-4,28,29,-1,38,45,-7,4,4,0,0
"22577","VAN","CGY",2011020826,15381,20112012,0,65,2,2,0,4.81461788569629,0.922450753998419,3.89216713169787,31,18,13,50,27,23,69,36,33,4,6,0,0
"22578","VAN","ARI",2011020836,15398,20112012,0,65,1,1,0,5.37927698151179,4.99722126445744,0.382055717054349,40,35,5,50,43,7,61,55,6,4,5,0,0
"22579","VAN","COL",2011020850,15385,20112012,1,60,3,1,2,6.13849418775499,7.08055279243854,-0.942058604683552,31,30,1,39,44,-5,51,59,-8,1,2,0,0
"22580","VAN","TOR",2011020870,15388,20112012,1,60,6,2,4,5.22251527541084,6.16477614658652,-0.942260871175677,36,26,10,48,37,11,60,58,2,2,2,0,0
"22581","VAN","EDM",2011020881,15389,20112012,0,60,5,2,3,2.9672428114427,4.9333327051977,-1.966089893755,31,28,3,34,36,-2,54,49,5,5,1,0,0
"22582","VAN","NSH",2011020891,15391,20112012,0,60,1,3,-2,3.6436054870901,2.92300768254063,0.72059780454947,33,28,5,42,32,10,58,41,17,3,4,0,0
"22583","VAN","DET",2011020902,15393,20112012,0,65,3,3,0,4.77300430430244,3.59691366954939,1.17609063475304,43,36,7,56,43,13,65,52,13,4,5,0,0
"22584","VAN","N.J",2011020908,15394,20112012,0,60,2,1,1,1.99827907642285,3.66495953215781,-1.66668045573496,16,31,-15,23,39,-16,32,54,-22,1,2,0,0
"22585","VAN","DAL",2011020927,15396,20112012,0,63.8666666666667,2,3,-1,6.26448577280886,5.17316501445021,1.09132075835865,26,28,-2,42,43,-1,57,56,1,2,2,0,0
"22586","VAN","ARI",2011020944,15383,20112012,1,65,1,1,0,4.24582113634159,2.72686618051506,1.51895495582653,22,24,-2,29,34,-5,43,47,-4,4,3,0,0
"22587","VAN","STL",2011020957,15400,20112012,1,60,2,0,2,3.06278502996429,4.19318252007361,-1.13039749010932,24,29,-5,34,38,-4,46,45,1,2,2,0,0
"22588","VAN","DAL",2011020994,15405,20112012,1,60,2,5,-3,5.04151437051587,4.91816549413488,0.123348876380987,31,29,2,38,42,-4,60,58,2,5,4,0,0
"22589","VAN","WPG",2011021009,15407,20112012,1,60,3,2,1,7.54882947208534,2.49990336204064,5.0489261100447,45,32,13,60,38,22,80,61,19,1,3,0,0
"22590","VAN","MTL",2011021024,15409,20112012,1,60,1,4,-3,4.36864475321545,4.55254511097991,-0.183900357764458,33,35,-2,47,44,3,65,59,6,6,6,0,0
"22591","VAN","ARI",2011021050,15413,20112012,1,60,4,5,-1,6.0485738205798,3.03292957996018,3.01564424061962,43,33,10,60,38,22,79,47,32,3,2,0,0
"22592","VAN","CBJ",2011021073,15416,20112012,1,60,4,3,1,5.0095805938472,4.66974182400951,0.339838769837696,38,36,2,46,49,-3,80,62,18,3,2,0,0
"22593","VAN","MIN",2011021086,15418,20112012,0,60,0,2,-2,4.47911462454067,4.00559415679891,0.473520467741764,33,34,-1,46,43,3,60,52,8,2,4,0,0
"22594","VAN","CHI",2011021100,15420,20112012,0,62.7,1,2,-1,4.67952394113036,4.91946650235991,-0.239942561229554,24,37,-13,34,49,-15,49,68,-19,5,7,0,0
"22595","VAN","DAL",2011021106,15421,20112012,0,60,2,1,1,4.4283291155948,2.84603163796055,1.58229747763425,28,26,2,40,37,3,48,45,3,8,7,0,0
"22596","VAN","COL",2011021125,15423,20112012,0,61.6666666666667,3,2,1,5.70895828308676,7.45247386221308,-1.74351557912632,32,40,-8,46,51,-5,64,75,-11,5,7,0,0
"22597","VAN","L.A",2011021138,15425,20112012,1,60,1,0,1,4.7167378087175,5.18252263554314,-0.465784826825633,25,38,-13,40,47,-7,49,65,-16,4,3,0,0
"22598","VAN","COL",2011021152,15427,20112012,1,60,1,0,1,3.38191920513054,5.35378371659317,-1.97186451146263,22,43,-21,28,53,-25,49,71,-22,3,5,0,0
"22599","VAN","DAL",2011021168,15429,20112012,1,60,5,2,3,3.23705884787887,3.708403942524,-0.47134509464513,34,30,4,41,38,3,52,53,-1,3,1,0,0
"22600","VAN","CGY",2011021179,15430,20112012,1,63.9666666666667,3,2,1,7.12849586092771,4.15563023671712,2.9728656242106,34,33,1,52,39,13,74,50,24,3,3,0,0
"22601","VAN","ANA",2011021197,15433,20112012,1,65,4,4,0,7.84581781522138,1.688460659665,6.15735715555638,39,24,15,54,30,24,78,41,37,6,3,0,0
"22602","VAN","CGY",2011021212,15435,20112012,0,60,2,3,-1,5.63085957811927,3.70189491365454,1.92896466446473,34,28,6,46,31,15,57,40,17,8,6,0,0
"22603","VAN","EDM",2011021229,15437,20112012,1,60,3,0,3,5.11374062133837,3.18284345976359,1.93089716157477,42,17,25,55,26,29,70,38,32,7,3,0,0
"22604","VAN","L.A",2011030151,15441,20112012,1,60,2,4,-2,2.17479386655759,3.62350370726301,-1.44870984070542,26,39,-13,34,45,-11,53,63,-10,5,6,0,0
"22605","VAN","L.A",2011030152,15443,20112012,1,60,2,4,-2,4.74620286700818,3.46733129714266,1.27887156986552,48,26,22,57,35,22,77,45,32,7,6,0,0
"22606","VAN","L.A",2011030153,15445,20112012,0,60,0,1,-1,7.12614074535668,4.33557848871018,2.7905622566465,41,20,21,59,34,25,82,48,34,4,8,0,0
"22607","VAN","L.A",2011030154,15448,20112012,0,60,3,1,2,5.322299060761,5.77785110756076,-0.455552046799767,30,44,-14,41,57,-16,55,72,-17,4,4,0,0
"22608","VAN","L.A",2011030155,15452,20112012,1,64.45,1,2,-1,5.88688128214198,6.132432083803,-0.245550801661016,27,37,-10,40,54,-14,59,74,-15,4,3,0,0
"22609","VAN","ANA",2012020013,15724,20122013,1,60,3,7,-4,6.87721530362956,4.11687346478811,2.76034183884145,29,26,3,47,34,13,62,41,21,4,3,0,0
"22610","VAN","EDM",2012020018,15725,20122013,1,65,2,2,0,4.03442728207847,3.63860049172229,0.395826790356182,29,32,-3,43,41,2,60,55,5,5,4,0,0
"22611","VAN","CGY",2012020038,15728,20122013,1,65,2,2,0,4.84008692900534,6.10564248417359,-1.26555555516825,36,36,0,52,46,6,69,61,8,4,5,0,0
"22612","VAN","ANA",2012020056,15730,20122013,0,60,5,0,5,4.62673478064244,2.74353520281287,1.88319957782956,34,30,4,48,38,10,58,48,10,9,3,0,0
"22613","VAN","S.J",2012020072,15732,20122013,0,60,1,4,-3,5.08386951973353,3.54042224358326,1.54344727615027,24,27,-3,41,34,7,62,47,15,8,9,0,0
"22614","VAN","L.A",2012020077,15733,20122013,0,65,2,2,0,2.72321305966034,5.18593619932653,-2.4627231396662,23,28,-5,29,42,-13,38,62,-24,3,4,0,0
"22615","VAN","COL",2012020091,15735,20122013,1,60,3,0,3,5.48733564707254,3.21079717179236,2.27653847528018,23,24,-1,38,34,4,61,41,20,5,4,0,0
"22616","VAN","CHI",2012020106,15737,20122013,1,65,1,1,0,3.3237450668895,2.41278930959561,0.910955757293891,22,28,-6,31,38,-7,42,54,-12,5,6,0,0
"22617","VAN","EDM",2012020126,15740,20122013,0,64.6666666666667,3,2,1,7.21584200143116,3.93395518744364,3.28188681398751,40,25,15,50,33,17,73,48,25,4,5,0,0
"22618","VAN","MIN",2012020151,15743,20122013,0,60,4,1,3,2.50802930010832,4.56589406515786,-2.05786476504954,22,23,-1,28,38,-10,34,44,-10,8,6,0,0
"22619","VAN","CGY",2012020165,15745,20122013,1,60,5,1,4,5.53229743299744,4.27570787299555,1.25658956000188,31,34,-3,45,41,4,59,50,9,5,2,0,0
"22620","VAN","MIN",2012020187,15748,20122013,1,60,2,1,1,4.84864162066145,2.67018556363564,2.17845605702581,30,26,4,42,34,8,57,42,15,3,6,0,0
"22621","VAN","DAL",2012020203,15751,20122013,1,60,3,4,-1,4.34207680037798,4.51568696650532,-0.173610166127341,28,29,-1,37,36,1,50,47,3,3,4,0,0
"22622","VAN","STL",2012020218,15753,20122013,1,65,3,3,0,5.20516919778311,3.14282857545186,2.06234062233125,31,23,8,44,32,12,67,43,24,4,2,0,0
"22623","VAN","CHI",2012020232,15755,20122013,0,65,3,3,0,2.49130666431392,6.15243441826442,-3.6611277539505,32,43,-11,36,53,-17,49,67,-18,5,7,0,0
"22624","VAN","DAL",2012020245,15757,20122013,0,60,4,3,1,4.94168111188453,3.86511702824112,1.07656408364342,22,25,-3,32,35,-3,42,56,-14,5,5,0,0
"22625","VAN","NSH",2012020248,15758,20122013,0,60,1,0,1,5.92312096047681,2.67270524552441,3.2504157149524,24,23,1,40,28,12,58,40,18,2,2,0,0
"22626","VAN","DET",2012020264,15760,20122013,0,60,3,8,-5,3.78436114145279,5.31521117407829,-1.53085003262549,21,28,-7,26,40,-14,36,48,-12,3,6,0,0
"22627","VAN","ARI",2012020282,15762,20122013,1,60,2,4,-2,3.09499809617409,3.81063174241094,-0.715633646236846,31,22,9,40,24,16,54,30,24,3,2,0,0
"22628","VAN","L.A",2012020309,15766,20122013,1,60,5,2,3,3.23884145471607,3.2468716354058,-0.00803018068973316,24,30,-6,34,34,0,48,47,1,3,5,0,0
"22629","VAN","CGY",2012020319,15767,20122013,0,60,2,4,-2,7.31154851730858,3.88711256948591,3.42443594782267,31,25,6,38,39,-1,54,51,3,2,4,0,0
"22630","VAN","S.J",2012020333,15769,20122013,1,65,2,2,0,4.74126481369002,5.60600483132293,-0.86474001763291,38,30,8,53,44,9,73,54,19,5,3,0,0
"22631","VAN","CBJ",2012020345,15771,20122013,0,64.05,1,2,-1,2.81068543144829,4.94781265812344,-2.13712722667515,35,27,8,47,35,12,59,50,9,1,3,0,0
"22632","VAN","MIN",2012020372,15774,20122013,0,60,2,4,-2,3.54000901395743,2.4280559593912,1.11195305456623,27,32,-5,40,38,2,52,45,7,7,6,0,0
"22633","VAN","CBJ",2012020379,15776,20122013,0,65,1,1,0,4.77872342177068,5.25897461111842,-0.48025118934774,38,27,11,45,38,7,72,48,24,2,2,0,0
"22634","VAN","NSH",2012020400,15778,20122013,1,60,7,4,3,5.17383252368745,4.40413652693678,0.76969599675067,22,33,-11,36,42,-6,46,50,-4,3,4,0,0
"22635","VAN","DET",2012020416,15780,20122013,1,60,2,5,-3,0,0,0,35,26,9,46,34,12,58,46,12,7,3,0,0
"22636","VAN","MIN",2012020426,15782,20122013,1,60,1,3,-2,4.44673166889697,4.97358101280406,-0.526849343907088,36,25,11,56,34,22,79,39,40,5,3,0,0
"22637","VAN","STL",2012020436,15783,20122013,1,60,3,2,1,3.21876251236563,5.11667511251289,-1.89791260014727,19,34,-15,31,41,-10,46,59,-13,2,3,0,0
"22638","VAN","ARI",2012020450,15785,20122013,0,60,2,1,1,2.80545897816774,3.80225461538794,-0.996795637220202,32,34,-2,42,48,-6,48,65,-17,5,3,0,0
"22639","VAN","L.A",2012020458,15787,20122013,0,60,1,0,1,3.7852687802224,4.15779877165755,-0.372529991435158,13,20,-7,21,35,-14,27,45,-18,3,3,0,0
"22640","VAN","COL",2012020469,15788,20122013,0,60,3,2,1,1.91087971461002,5.37530474552758,-3.46442503091756,30,28,2,39,35,4,57,45,12,3,5,0,0
"22641","VAN","CBJ",2012020487,15790,20122013,1,65,0,0,0,6.10668729351892,2.52261745923897,3.58406983427994,34,17,17,48,22,26,75,38,37,3,2,0,0
"22642","VAN","COL",2012020500,15792,20122013,1,60,4,1,3,5.29834622220369,1.80007035830931,3.49827586389438,20,33,-13,31,40,-9,45,55,-10,0,2,0,0
"22643","VAN","EDM",2012020515,15794,20122013,0,60,0,4,-4,0.986496605379216,1.7312403130345,-0.744743707655289,23,24,-1,34,37,-3,50,45,5,3,3,0,0
"22644","VAN","S.J",2012020530,15796,20122013,0,60,2,3,-1,4.62672708322503,3.40909374773219,1.21763333549285,25,35,-10,38,49,-11,65,60,5,0,3,0,0
"22645","VAN","EDM",2012020550,15799,20122013,1,60,4,0,4,2.84420725461678,2.46050696096474,0.383700293652035,28,23,5,37,34,3,49,44,5,5,4,0,0
"22646","VAN","CGY",2012020568,15801,20122013,1,60,5,2,3,6.6871480854461,4.67079355198075,2.01635453346535,22,38,-16,28,47,-19,37,62,-25,2,5,0,0
"22647","VAN","ARI",2012020580,15803,20122013,1,60,2,0,2,4.36163975624368,2.10853104721676,2.25310870902692,42,19,23,53,34,19,63,42,21,3,4,0,0
"22648","VAN","CGY",2012020593,15805,20122013,0,60,4,1,3,3.26781395825674,2.53090928709809,0.736904671158653,29,41,-12,43,53,-10,61,65,-4,5,5,0,0
"22649","VAN","COL",2012020611,15808,20122013,0,60,3,4,-1,3.88444128085393,3.53530452831183,0.349136752542108,27,26,1,37,37,0,52,50,2,2,3,0,0
"22650","VAN","NSH",2012020628,15810,20122013,0,60,5,2,3,3.68623913942417,4.28149925562168,-0.595260116197511,24,38,-14,33,48,-15,38,59,-21,6,4,0,0
"22651","VAN","STL",2012020637,15811,20122013,0,65,1,1,0,3.28573144568394,5.37362185149425,-2.08789040581031,22,36,-14,36,57,-21,47,77,-30,7,8,0,0
"22652","VAN","DAL",2012020651,15813,20122013,0,60,1,5,-4,5.15807497205275,3.50793949963027,1.65013547242248,38,30,8,60,47,13,71,56,15,4,7,0,0
"22653","VAN","DET",2012020667,15815,20122013,1,65,1,1,0,3.4521864419803,4.18822413077578,-0.736037688795477,14,34,-20,26,42,-16,38,53,-15,5,4,0,0
"22654","VAN","CHI",2012020680,15817,20122013,1,60,3,1,2,4.68470469705062,3.69342773863536,0.991276958415256,32,25,7,41,30,11,65,46,19,6,3,0,0
"22655","VAN","ANA",2012020703,15820,20122013,1,60,1,3,-2,7.73353862011572,5.65224950769698,2.08128911241874,29,30,-1,43,31,12,59,45,14,3,3,0,0
"22656","VAN","EDM",2012020718,15822,20122013,0,60,2,7,-5,2.88589408516418,6.7965326281701,-3.91063854300592,30,37,-7,49,60,-11,59,68,-9,5,6,0,0
"22657","VAN","S.J",2012030171,15826,20122013,1,60,1,3,-2,6.11864435646704,2.95569805963896,3.16294629682808,31,28,3,44,35,9,59,46,13,3,5,0,0
"22658","VAN","S.J",2012030172,15828,20122013,1,65.5166666666667,2,3,-1,5.56435773381963,7.22100794286234,-1.65665020904271,31,33,-2,48,43,5,70,54,16,3,5,0,0
"22659","VAN","S.J",2012030173,15830,20122013,0,60,2,5,-3,6.37991813151062,5.61892365250969,0.760994479000924,30,38,-8,39,48,-9,59,65,-6,4,11,0,0
"22660","VAN","S.J",2012030174,15832,20122013,0,73.3,3,4,-1,5.87363412811101,8.4701322925539,-2.59649816444289,35,47,-12,47,66,-19,70,82,-12,3,6,0,0
"22661","VAN","S.J",2013020014,15981,20132014,0,60,1,4,-3,5.44961140077794,5.98852391439141,-0.538912513613468,22,35,-13,44,52,-8,62,74,-12,6,8,0,0
"22662","VAN","EDM",2013020030,15983,20132014,1,60,6,2,4,8.07744679885218,2.34622794722245,5.73121885162973,44,23,21,55,35,20,74,45,29,10,7,0,0
"22663","VAN","CGY",2013020034,15984,20132014,0,63.2833333333333,5,4,1,6.21065941755421,4.39334553078515,1.81731388676906,28,36,-8,41,46,-5,59,65,-6,1,3,0,0
"22664","VAN","N.J",2013020043,15986,20132014,1,62.3,3,2,1,4.20325330892229,1.95786547439639,2.2453878345259,32,23,9,42,31,11,58,36,22,2,1,0,0
"22665","VAN","S.J",2013020056,15988,20132014,1,60,1,4,-3,2.91406962347025,4.94677275779395,-2.0327031343237,26,29,-3,28,42,-14,41,57,-16,1,3,0,0
"22666","VAN","MTL",2013020073,15990,20132014,1,60,1,4,-3,4.33999833349662,7.72722339555912,-3.3872250620625,40,39,1,51,53,-2,68,69,-1,3,4,0,0
"22667","VAN","PHI",2013020084,15993,20132014,0,60,3,2,1,3.87077452731319,3.88579412491526,-0.0150195976020768,25,22,3,37,36,1,54,54,0,1,2,0,0
"22668","VAN","CBJ",2013020123,15998,20132014,0,60,1,3,-2,8.4720695768433,5.80461321855546,2.66745635828784,38,29,9,49,41,8,64,49,15,4,6,0,0
"22669","VAN","NYI",2013020130,16000,20132014,0,62.2666666666667,5,4,1,6.16159487002369,6.8434200690057,-0.681825198982011,33,32,1,52,47,5,72,64,8,2,4,0,0
"22670","VAN","N.J",2013020140,16002,20132014,0,65,2,2,0,0,0,0,21,30,-9,29,41,-12,33,47,-14,2,3,0,0
"22671","VAN","STL",2013020153,16003,20132014,0,64.75,3,2,1,4.61434909622767,5.09085887745459,-0.476509781226923,21,24,-3,33,44,-11,44,57,-13,3,3,0,0
"22672","VAN","DET",2013020186,16008,20132014,1,60,1,2,-1,3.48557790828636,4.23941727547117,-0.753839367184809,20,27,-7,30,39,-9,45,58,-13,4,3,0,0
"22673","VAN","TOR",2013020208,16011,20132014,1,60,4,0,4,8.12973727776807,2.15426601538638,5.97547126238169,47,21,26,63,30,33,74,42,32,10,6,0,0
"22674","VAN","ARI",2013020224,16014,20132014,0,65,2,2,0,4.47299935139017,8.73349277760099,-4.26049342621081,33,32,1,48,48,0,66,64,2,3,3,0,0
"22675","VAN","S.J",2013020240,16016,20132014,0,60,4,2,2,3.30006107754568,5.04234304208512,-1.74228196453944,34,24,10,41,38,3,48,53,-5,4,4,0,0
"22676","VAN","L.A",2013020254,16018,20132014,0,60,1,5,-4,2.90766129997729,5.72217784557142,-2.81451654559413,26,32,-6,40,44,-4,49,59,-10,2,4,0,0
"22677","VAN","ANA",2013020261,16019,20132014,0,60,1,3,-2,0,0,0,36,23,13,49,30,19,65,47,18,2,2,0,0
"22678","VAN","S.J",2013020283,16023,20132014,1,62.6333333333333,1,2,-1,6.65909499244299,2.56278991116756,4.09630508127542,35,30,5,50,38,12,71,63,8,3,5,0,0
"22679","VAN","DAL",2013020308,16026,20132014,1,60,1,2,-1,6.53953266181634,2.64046131586656,3.89907134594978,43,23,20,61,32,29,83,42,41,5,3,0,0
"22680","VAN","FLA",2013020320,16028,20132014,1,65,2,2,0,4.06910379794749,4.3634708962345,-0.294367098287012,29,36,-7,42,39,3,54,51,3,2,3,0,0
"22681","VAN","CBJ",2013020339,16031,20132014,1,60,6,2,4,4.81697964477172,2.55979094649229,2.25718869827944,35,16,19,45,24,21,62,43,19,6,6,0,0
"22682","VAN","CHI",2013020350,16032,20132014,1,60,1,2,-1,4.03899664760684,3.91615813475801,0.12283851284883,37,29,8,47,39,8,61,50,11,3,2,0,0
"22683","VAN","L.A",2013020363,16034,20132014,1,60.8,2,3,-1,5.08991952572251,3.53257589560235,1.55734363012016,39,22,17,52,29,23,71,42,29,10,5,0,0
"22684","VAN","OTT",2013020378,16037,20132014,0,60,5,2,3,5.12395729556283,7.95938880642416,-2.83543151086133,28,39,-11,37,49,-12,49,68,-19,4,4,0,0
"22685","VAN","NYR",2013020392,16039,20132014,0,60,2,5,-3,4.66415588953532,3.27573702606605,1.38841886346927,37,24,13,47,36,11,60,52,8,3,3,0,0
"22686","VAN","CAR",2013020403,16040,20132014,0,60,3,2,1,5.40495620904185,4.49225925689097,0.912696952150876,30,31,-1,39,46,-7,49,69,-20,4,6,0,0
"22687","VAN","NSH",2013020416,16042,20132014,0,60,3,1,2,5.18740501895081,5.01549790974241,0.171907109208405,33,31,2,43,36,7,61,44,17,5,3,0,0
"22688","VAN","ARI",2013020437,16045,20132014,1,63.6833333333333,3,2,1,3.56397099720198,4.52730936267471,-0.963338365472737,32,39,-7,41,47,-6,51,65,-14,2,2,0,0
"22689","VAN","COL",2013020453,16047,20132014,1,60,3,1,2,3.44425593534834,4.99644361587707,-1.55218768052873,21,29,-8,30,44,-14,45,61,-16,3,1,0,0
"22690","VAN","CAR",2013020456,16048,20132014,1,60,2,0,2,3.00451869856624,3.40176794753643,-0.397249248970184,26,31,-5,37,45,-8,51,59,-8,4,4,0,0
"22691","VAN","EDM",2013020486,16052,20132014,1,60,4,0,4,6.3664896911996,2.37225025705993,3.99423943413967,40,19,21,54,29,25,72,37,35,3,3,0,0
"22692","VAN","BOS",2013020498,16053,20132014,1,60,6,2,4,2.52285517434939,3.49477761379239,-0.971922439443006,30,41,-11,35,53,-18,50,72,-22,3,4,0,0
"22693","VAN","MIN",2013020518,16056,20132014,0,65,2,2,0,5.63568242211477,5.70777187955626,-0.0720894574414928,31,32,-1,41,43,-2,50,60,-10,2,2,0,0
"22694","VAN","DAL",2013020531,16058,20132014,0,60,1,4,-3,2.56569283080171,4.21298244793434,-1.64728961713263,28,26,2,43,37,6,56,54,2,3,4,0,0
"22695","VAN","CHI",2013020537,16059,20132014,0,65,2,2,0,3.70270902942866,3.01860011104145,0.68410891838721,24,26,-2,37,36,1,50,48,2,4,4,0,0
"22696","VAN","WPG",2013020552,16061,20132014,1,60,2,1,1,5.11797516047955,4.59570337383775,0.522271786641795,25,22,3,32,27,5,52,49,3,3,1,0,0
"22697","VAN","CGY",2013020589,16068,20132014,0,60,2,0,2,4.2206688002625,2.36430189193925,1.85636690832325,30,18,12,41,26,15,52,41,11,0,1,0,0
"22698","VAN","PHI",2013020598,16069,20132014,1,65,3,3,0,3.39893222405226,2.86180463484847,0.537127589203785,44,27,17,55,34,21,70,49,21,5,3,0,0
"22699","VAN","T.B",2013020611,16071,20132014,1,60,2,4,-2,2.70099393630392,2.07262604113203,0.628367895171891,30,33,-3,51,42,9,61,57,4,2,3,0,0
"22700","VAN","L.A",2013020637,16074,20132014,0,60,1,3,-2,4.3208134612521,5.81603496548472,-1.49522150423262,28,49,-21,39,61,-22,48,74,-26,4,3,0,0
"22701","VAN","ANA",2013020642,16075,20132014,0,64.9666666666667,3,4,-1,3.94598742727612,7.11074197887501,-3.16475455159889,20,49,-29,38,68,-30,44,90,-46,3,3,0,0
"22702","VAN","STL",2013020674,16080,20132014,1,60,2,1,1,5.70365930546541,6.79596576494782,-1.09230645948242,22,31,-9,30,41,-11,47,58,-11,2,1,0,0
"22703","VAN","L.A",2013020695,16083,20132014,0,60,0,1,-1,2.71866844969588,4.10852988495026,-1.38986143525437,28,20,8,35,31,4,44,46,-2,5,7,0,0
"22704","VAN","ANA",2013020709,16085,20132014,0,60,1,9,-8,4.65750156448212,10.0498586573478,-5.39235709286572,32,44,-12,48,64,-16,62,80,-18,3,9,0,0
"22705","VAN","ARI",2013020720,16086,20132014,0,60,0,1,-1,3.74447473630816,3.2012685439043,0.543206192403865,29,23,6,45,42,3,55,55,0,10,10,0,0
"22706","VAN","CGY",2013020735,16088,20132014,1,65,2,2,0,1.88409087772015,4.07218620903456,-2.1880953313144,33,33,0,43,45,-2,59,60,-1,8,9,0,0
"22707","VAN","EDM",2013020754,16091,20132014,0,60,2,1,1,3.11681486209739,2.82756936457008,0.289245497527304,27,29,-2,43,39,4,56,53,3,4,4,0,0
"22708","VAN","NSH",2013020766,16093,20132014,1,60,1,2,-1,2.18539843552753,3.37428059032932,-1.18888215480179,34,26,8,45,34,11,64,45,19,4,3,0,0
"22709","VAN","ARI",2013020788,16096,20132014,1,62.25,5,4,1,5.38100047603257,3.89189183708771,1.48910863894486,25,33,-8,37,39,-2,61,51,10,5,6,0,0
"22710","VAN","EDM",2013020793,16097,20132014,1,60,2,4,-2,4.12655497680096,3.10226096244878,1.02429401435218,27,20,7,37,30,7,54,48,6,3,4,0,0
"22711","VAN","CHI",2013020808,16099,20132014,1,60,2,5,-3,3.94812457006554,4.94775675325945,-0.99963218319391,31,40,-9,41,59,-18,72,74,-2,4,4,0,0
"22712","VAN","WPG",2013020823,16101,20132014,0,60,3,4,-1,5.61557050030387,3.88483288537827,1.7307376149256,26,34,-8,41,43,-2,57,59,-2,2,3,0,0
"22713","VAN","DET",2013020839,16104,20132014,0,60,0,2,-2,2.88416052830871,2.15882937638645,0.725331151922262,24,30,-6,32,46,-14,37,56,-19,7,4,0,0
"22714","VAN","BOS",2013020844,16105,20132014,0,60,1,3,-2,5.42004385513176,6.00432096541044,-0.584277110278683,28,32,-4,50,48,2,67,63,4,2,3,0,0
"22715","VAN","MTL",2013020860,16107,20132014,0,60,2,5,-3,7.61392204543517,6.33044413512208,1.2834779103131,44,29,15,55,38,17,74,52,22,5,3,0,0
"22716","VAN","TOR",2013020875,16109,20132014,0,60,1,3,-2,4.55677882226756,4.69572877010796,-0.138949947840402,33,24,9,46,40,6,57,62,-5,4,5,0,0
"22717","VAN","STL",2013020885,16127,20132014,1,60,1,0,1,3.6587344996442,3.39860990018781,0.26012459945639,35,20,15,47,38,9,58,52,6,4,3,0,0
"22718","VAN","MIN",2013020900,16129,20132014,1,65,1,1,0,3.46929438889492,2.43904908009722,1.0302453087977,31,23,8,45,33,12,70,39,31,2,3,0,0
"22719","VAN","OTT",2013020915,16131,20132014,1,60,2,4,-2,0,0,0,31,28,3,40,39,1,52,47,5,6,6,0,0
"22720","VAN","ARI",2013020931,16133,20132014,0,60,0,1,-1,4.23474209337604,3.81292136394768,0.421820729428358,23,32,-9,38,45,-7,59,60,-1,0,3,0,0
"22721","VAN","DAL",2013020944,16135,20132014,0,60,1,6,-5,3.83591452026536,3.46134310570051,0.374571414564848,33,22,11,47,31,16,63,48,15,6,4,0,0
"22722","VAN","CGY",2013020961,16137,20132014,1,60,2,1,1,2.9909106136246,3.72020465449896,-0.729294040874362,14,23,-9,30,38,-8,62,70,-8,1,5,0,0
"22723","VAN","NYI",2013020974,16139,20132014,1,60,4,7,-3,3.79844306479208,5.90459898335394,-2.10615591856185,24,28,-4,37,40,-3,50,57,-7,4,7,0,0
"22724","VAN","WPG",2013020986,16141,20132014,0,65,2,2,0,6.14138558987382,4.05550216254869,2.08588342732513,33,34,-1,47,47,0,61,65,-4,6,6,0,0
"22725","VAN","FLA",2013021013,16145,20132014,0,65,3,3,0,5.82772679347545,4.02756322104992,1.80016357242553,32,29,3,52,43,9,63,57,6,4,4,0,0
"22726","VAN","T.B",2013021023,16146,20132014,0,60,3,4,-1,4.48907154973131,4.36738006243831,0.121691487292992,28,30,-2,42,43,-1,56,58,-2,4,5,0,0
"22727","VAN","NSH",2013021041,16148,20132014,1,60,2,0,2,2.73771964311595,3.86977372627007,-1.13205408315412,22,30,-8,33,37,-4,43,48,-5,1,4,0,0
"22728","VAN","MIN",2013021089,16155,20132014,0,60,5,2,3,3.11291345092637,7.23839736246919,-4.12548391154282,19,31,-12,29,42,-13,39,60,-21,2,4,0,0
"22729","VAN","COL",2013021100,16156,20132014,0,60.9166666666667,2,3,-1,5.37027942969871,2.8897159784733,2.48056345122541,31,28,3,42,35,7,62,48,14,5,3,0,0
"22730","VAN","ANA",2013021117,16158,20132014,1,60,1,5,-4,6.41220188247723,3.18833794588136,3.22386393659588,32,21,11,46,32,14,60,44,16,4,6,0,0
"22731","VAN","NYR",2013021137,16161,20132014,1,60,1,3,-2,5.62176432961132,3.05488625483122,2.56687807478011,35,31,4,44,40,4,58,50,8,2,2,0,0
"22732","VAN","L.A",2013021169,16165,20132014,1,60,2,1,1,0,0,0,40,26,14,53,43,10,73,55,18,6,3,0,0
"22733","VAN","ANA",2013021179,16167,20132014,1,60,0,3,-3,3.9942226348212,2.44180733773283,1.55241529708837,18,23,-5,39,29,10,61,40,21,5,3,0,0
"22734","VAN","COL",2013021204,16170,20132014,1,60,2,4,-2,5.1451276117757,3.74861785203393,1.39650975974177,40,28,12,54,38,16,68,51,17,2,6,0,0
"22735","VAN","EDM",2013021219,16172,20132014,0,60,2,5,-3,5.64062277529956,4.17212455768532,1.46849821761424,42,22,20,55,39,16,78,54,24,3,5,0,0
"22736","VAN","CGY",2013021228,16173,20132014,1,60,5,1,4,4.98610268902848,3.10968828038676,1.87641440864172,23,22,1,37,32,5,60,45,15,2,2,0,0
"22737","VAN","CGY",2014020003,16351,20142015,0,60,4,2,2,2.86133842723318,3.97172047084314,-1.11038204360996,33,25,8,39,32,7,50,45,5,5,6,0,0
"22738","VAN","EDM",2014020031,16354,20142015,1,65,4,4,0,7.08442181107239,3.06599880760768,4.0184230034647,43,29,14,63,39,24,75,49,26,6,3,0,0
"22739","VAN","EDM",2014020061,16360,20142015,0,60,2,0,2,4.25784614905569,4.20202007435,0.055826074705692,30,28,2,39,39,0,56,58,-2,3,4,0,0
"22740","VAN","T.B",2014020073,16361,20142015,1,60,2,4,-2,4.55432604930667,2.23300515724623,2.32132089206044,32,24,8,40,31,9,58,40,18,8,7,0,0
"22741","VAN","DAL",2014020086,16364,20142015,0,60,3,6,-3,3.63437613778589,4.87370854151478,-1.23933240372889,46,28,18,59,37,22,69,47,22,4,6,0,0
"22742","VAN","STL",2014020095,16366,20142015,0,60,4,1,3,2.97948703326779,4.6858439649659,-1.70635693169811,23,32,-9,33,44,-11,40,67,-27,4,7,0,0
"22743","VAN","COL",2014020103,16367,20142015,0,60,3,7,-4,5.70432008538046,6.87322756910956,-1.16890748372911,29,48,-19,39,59,-20,47,67,-20,5,6,0,0
"22744","VAN","CAR",2014020135,16371,20142015,1,60,4,1,3,3.87979185347831,2.57734504924156,1.30244680423675,25,30,-5,37,35,2,46,51,-5,3,3,0,0
"22745","VAN","MTL",2014020147,16373,20142015,1,62.75,3,2,1,4.56284598546335,2.76307465938919,1.79977132607417,30,25,5,45,36,9,60,49,11,2,3,0,0
"22746","VAN","EDM",2014020163,16375,20142015,0,60,3,2,1,5.23335317692181,5.35502693912713,-0.121673762205319,30,27,3,43,37,6,50,48,2,3,3,0,0
"22747","VAN","NSH",2014020170,16376,20142015,1,60,1,3,-2,3.32150299687396,3.20345856499625,0.118044431877706,27,33,-6,41,40,1,55,56,-1,4,5,0,0
"22748","VAN","COL",2014020182,16378,20142015,0,60,5,2,3,3.77716394994712,3.49624200587168,0.28092194407544,37,22,15,47,29,18,71,41,30,4,4,0,0
"22749","VAN","S.J",2014020196,16380,20142015,0,60,3,2,1,2.37793765310198,5.30850822780303,-2.93057057470105,19,36,-17,20,54,-34,23,79,-56,1,4,0,0
"22750","VAN","L.A",2014020213,16382,20142015,0,60,1,5,-4,2.98460300890275,3.55676764978529,-0.572164640882536,19,36,-17,28,53,-25,37,60,-23,5,3,0,0
"22751","VAN","ANA",2014020217,16383,20142015,0,65,1,1,0,5.98410209384747,6.08052604817249,-0.0964239543250187,35,29,6,53,46,7,66,65,1,4,2,0,0
"22752","VAN","OTT",2014020230,16385,20142015,1,64.0833333333333,4,3,1,8.4371474186355,5.15815105401634,3.27899636461916,37,24,13,47,29,18,57,42,15,2,1,0,0
"22753","VAN","ARI",2014020247,16388,20142015,1,60,0,5,-5,6.01254707043877,2.77452390146209,3.23802316897668,35,23,12,47,34,13,70,42,28,4,5,0,0
"22754","VAN","EDM",2014020279,16393,20142015,0,60,5,4,1,3.73814331645372,5.62316537430763,-1.88502205785392,31,32,-1,44,45,-1,59,59,0,5,5,0,0
"22755","VAN","ANA",2014020288,16394,20142015,1,65,3,3,0,2.97314068524986,3.96162577631185,-0.988485091061989,28,26,2,38,31,7,62,49,13,1,3,0,0
"22756","VAN","CHI",2014020311,16397,20142015,1,60,4,1,3,4.48714415184804,3.0364528400136,1.45069131183445,30,25,5,43,35,8,57,53,4,2,4,0,0
"22757","VAN","N.J",2014020321,16399,20142015,1,60,2,0,2,4.18397182741319,4.43412177603204,-0.250149948618855,36,20,16,47,32,15,60,46,14,2,0,0,0
"22758","VAN","CBJ",2014020340,16402,20142015,0,60,5,0,5,4.65534588682259,4.39200765153146,0.263338235291132,30,31,-1,37,43,-6,44,53,-9,2,3,0,0
"22759","VAN","DET",2014020356,16404,20142015,0,60,3,5,-2,7.05113883753074,6.70863781147636,0.342501026054379,33,30,3,42,38,4,51,54,-3,4,5,0,0
"22760","VAN","TOR",2014020392,16410,20142015,0,60,2,5,-3,6.15806518316458,5.85774337066094,0.300321812503637,46,28,18,67,37,30,91,47,44,6,4,0,0
"22761","VAN","OTT",2014020404,16411,20142015,0,61.35,3,4,-1,3.71969721045753,7.0719069209589,-3.35220971050137,33,45,-12,37,64,-27,48,89,-41,3,7,0,0
"22762","VAN","MTL",2014020413,16413,20142015,0,60,1,3,-2,2.60583992539455,7.16444364781717,-4.55860372242262,16,25,-9,21,43,-22,30,69,-39,2,5,0,0
"22763","VAN","NYR",2014020446,16417,20142015,1,60,1,5,-4,6.09856499815942,2.72655009012669,3.37201490803272,30,23,7,36,28,8,53,35,18,1,1,0,0
"22764","VAN","DAL",2014020466,16421,20142015,1,60,0,2,-2,2.11456982319942,4.26350163107804,-2.14893180787862,27,29,-2,38,40,-2,48,54,-6,5,3,0,0
"22765","VAN","ARI",2014020500,16426,20142015,1,60,7,1,6,4.60551172328996,6.91289239587786,-2.3073806725879,40,39,1,46,52,-6,56,75,-19,8,6,0,0
"22766","VAN","ANA",2014020528,16432,20142015,0,62.7,1,2,-1,3.1818279508152,6.53343975052849,-3.35161179971328,14,31,-17,36,56,-20,48,77,-29,1,4,0,0
"22767","VAN","S.J",2014020544,16434,20142015,0,60,3,1,2,2.53626753354911,5.03270789375529,-2.49644036020618,21,32,-11,35,52,-17,48,65,-17,1,6,0,0
"22768","VAN","L.A",2014020557,16436,20142015,1,60,2,3,-1,0,0,0,16,40,-24,23,51,-28,33,67,-34,1,4,0,0
"22769","VAN","DET",2014020574,16438,20142015,1,60,4,1,3,3.90683363221433,2.14992131711006,1.75691231510427,24,30,-6,35,42,-7,45,54,-9,7,6,0,0
"22770","VAN","NYI",2014020593,16441,20142015,1,60,3,2,1,2.01812166620905,2.55347999647802,-0.535358330268963,20,23,-3,30,33,-3,46,59,-13,2,3,0,0
"22771","VAN","PHI",2014020646,16450,20142015,0,60,4,0,4,4.75010220401751,4.68634894301067,0.063753261006835,22,30,-8,38,41,-3,50,63,-13,4,4,0,0
"22772","VAN","CAR",2014020655,16451,20142015,0,60,3,0,3,4.5386234323858,2.89508115212084,1.64354228026497,17,28,-11,28,42,-14,40,56,-16,2,3,0,0
"22773","VAN","T.B",2014020688,16455,20142015,0,60,1,4,-3,5.64623104804195,5.10857928870246,0.537651759339496,28,26,2,39,31,8,56,49,7,7,5,0,0
"22774","VAN","ANA",2014020707,16462,20142015,1,60,0,4,-4,2.49728830056983,5.43907784977591,-2.94178954920608,17,24,-7,28,40,-12,42,50,-8,3,3,0,0
"22775","VAN","MIN",2014020741,16467,20142015,1,60,2,4,-2,6.09971945915822,5.30802503524032,0.791694423917908,37,20,17,49,30,19,61,33,28,5,3,0,0
"22776","VAN","WPG",2014020754,16469,20142015,1,60.6,3,2,1,5.61011895346746,6.75252859821921,-1.14240964475175,33,28,5,49,36,13,63,49,14,8,5,0,0
"22777","VAN","S.J",2014020767,16471,20142015,1,60,1,5,-4,0,0,0,34,38,-4,41,49,-8,52,61,-9,3,4,0,0
"22778","VAN","MIN",2014020794,16475,20142015,0,60,3,5,-2,4.71405030993128,5.53981889388524,-0.825768583953959,25,32,-7,43,41,2,54,55,-1,3,7,0,0
"22779","VAN","CHI",2014020807,16477,20142015,0,61.3333333333333,5,4,1,6.96637600072427,7.23851102197659,-0.272135021252325,36,41,-5,45,52,-7,56,73,-17,1,4,0,0
"22780","VAN","BOS",2014020822,16479,20142015,1,60,5,2,3,6.27204385283403,4.44601195982978,1.82603189300426,25,23,2,37,42,-5,49,60,-11,2,3,0,0
"22781","VAN","MIN",2014020844,16482,20142015,1,60,3,2,1,3.50999083584611,2.39056075213011,1.119430083716,29,22,7,38,34,4,47,55,-8,1,1,0,0
"22782","VAN","NYR",2014020860,16485,20142015,0,65,4,4,0,6.48711501297657,4.03635064611444,2.45076436686213,28,34,-6,41,39,2,53,51,2,3,5,0,0
"22783","VAN","N.J",2014020867,16486,20142015,0,60,2,4,-2,3.83966170801068,4.83389016568253,-0.994228457671852,23,27,-4,35,37,-2,43,45,-2,3,4,0,0
"22784","VAN","NYI",2014020887,16488,20142015,0,60,4,0,4,3.99685463698336,4.34043711182312,-0.343582474839764,24,37,-13,30,52,-22,35,68,-33,3,5,0,0
"22785","VAN","BOS",2014020894,16490,20142015,0,60,2,1,1,1.94307594094294,7.3923925490235,-5.44931660808056,28,41,-13,35,63,-28,41,80,-39,3,5,0,0
"22786","VAN","S.J",2014020951,16497,20142015,1,60,2,6,-4,6.68528816301841,3.98184212942192,2.70344603359649,28,30,-2,44,36,8,59,46,13,5,1,0,0
"22787","VAN","ARI",2014020962,16499,20142015,0,65,2,2,0,3.79799481123337,5.94775289948201,-2.14975808824865,34,35,-1,47,45,2,66,59,7,3,1,0,0
"22788","VAN","S.J",2014020979,16501,20142015,0,60,3,2,1,5.37025708786678,7.06424263468944,-1.69398554682266,34,40,-6,44,55,-11,66,72,-6,7,4,0,0
"22789","VAN","ANA",2014020988,16503,20142015,1,60,2,1,1,4.39039034830057,6.50318355827767,-2.1127932099771,16,30,-14,23,49,-26,32,71,-39,3,5,0,0
"22790","VAN","L.A",2014021010,16506,20142015,1,60,0,4,-4,3.97411922877654,3.04620505921775,0.92791416955879,19,20,-1,27,32,-5,40,50,-10,2,3,0,0
"22791","VAN","TOR",2014021025,16508,20142015,1,60,4,1,3,4.03775778095183,3.77196012734203,0.265797653609803,35,29,6,45,39,6,56,61,-5,4,9,0,0
"22792","VAN","PHI",2014021049,16511,20142015,1,60,4,1,3,6.69365026305354,4.25085724580237,2.44279301725118,35,28,7,47,43,4,53,59,-6,2,3,0,0
"22793","VAN","CBJ",2014021061,16513,20142015,1,60,2,6,-4,10.0042988494824,3.74919902987597,6.25509981960647,40,33,7,54,40,14,72,54,18,2,1,0,0
"22794","VAN","L.A",2014021068,16515,20142015,0,60,4,1,3,6.39211227836313,2.79633879947671,3.59577347888642,42,26,16,58,39,19,74,61,13,3,4,0,0
"22795","VAN","ARI",2014021082,16516,20142015,0,60,3,1,2,5.18676014829543,4.15679020015523,1.02996994814021,44,27,17,60,44,16,81,64,17,2,1,0,0
"22796","VAN","WPG",2014021097,16518,20142015,1,60,5,2,3,7.0060289594694,5.30468745506369,1.70134150440572,30,28,2,35,34,1,47,50,-3,1,2,0,0
"22797","VAN","COL",2014021111,16520,20142015,1,60,1,4,-3,3.0691324234957,2.53162935658823,0.537503066907476,34,38,-4,43,42,1,63,55,8,4,5,0,0
"22798","VAN","DAL",2014021127,16522,20142015,1,64.2166666666667,3,4,-1,3.73955948077491,10.7188078550971,-6.9792483743222,36,40,-4,49,52,-3,58,63,-5,4,2,0,0
"22799","VAN","CHI",2014021160,16527,20142015,0,60,1,3,-2,5.30509610376907,4.9604341471491,0.344661956619969,36,38,-2,41,46,-5,56,57,-1,2,4,0,0
"22800","VAN","WPG",2014021169,16529,20142015,0,60,4,5,-1,4.39459346602204,5.01611291826703,-0.621519452244987,30,36,-6,44,47,-3,55,60,-5,4,5,0,0
"22801","VAN","L.A",2014021188,16531,20142015,1,65,1,1,0,9.15046676781458,4.93730197899191,4.21316478882267,38,37,1,48,46,2,63,58,5,3,2,0,0
"22802","VAN","ARI",2014021213,16534,20142015,1,60,5,0,5,5.63144081245741,3.14157333220417,2.48986748025324,32,28,4,43,39,4,56,53,3,5,5,0,0
"22803","VAN","EDM",2014021230,16536,20142015,1,62.4833333333333,6,5,1,3.75836837427033,4.67556387958234,-0.917195505312015,23,28,-5,34,38,-4,52,57,-5,3,1,0,0
"22804","VAN","CGY",2014030181,16540,20142015,1,60,1,2,-1,2.97396366478642,4.52344431600068,-1.54948065121425,30,30,0,41,41,0,61,54,7,3,1,0,0
"22805","VAN","CGY",2014030182,16542,20142015,1,60,4,1,3,6.29391444688077,3.56313909911907,2.73077534776171,32,23,9,41,34,7,56,46,10,5,3,0,0
"22806","VAN","CGY",2014030183,16544,20142015,0,60,2,4,-2,3.99007843035542,3.55344014303409,0.43663828732133,25,28,-3,35,39,-4,65,58,7,5,7,0,0
"22807","VAN","CGY",2014030184,16546,20142015,0,60,1,3,-2,6.59914813612567,2.57039893847277,4.02874919765291,29,22,7,41,29,12,70,38,32,2,4,0,0
"22808","VAN","CGY",2014030185,16548,20142015,1,60,2,1,1,3.76185524616417,2.39430917729624,1.36754606886794,43,21,22,50,33,17,66,50,16,2,3,0,0
"22809","VAN","CGY",2014030186,16550,20142015,0,60,4,7,-3,4.25394926082498,6.80932864918552,-2.55537938836054,22,33,-11,35,44,-9,58,55,3,2,3,0,0
"22810","VAN","ANA",2015020036,16720,20152016,0,65,1,1,0,5.80812043727042,2.85410014670977,2.95402029056065,25,29,-4,35,48,-13,51,66,-15,2,2,0,0
"22811","VAN","L.A",2015020045,16721,20152016,0,60,3,0,3,3.84749132902465,1.56834991348749,2.27914141553715,26,15,11,34,37,-3,42,54,-12,4,3,0,0
"22812","VAN","EDM",2015020078,16726,20152016,1,61.7666666666667,1,2,-1,4.75040397932753,3.21660763466794,1.53379634465959,34,24,10,47,31,16,56,37,19,2,2,0,0
"22813","VAN","DET",2015020116,16732,20152016,1,63.8333333333333,2,3,-1,4.22924995061887,3.808366512676,0.420883437942869,32,28,4,47,37,10,58,46,12,4,6,0,0
"22814","VAN","MTL",2015020133,16735,20152016,1,60,5,1,4,2.61639737071937,3.05037181969965,-0.43397444898028,28,26,2,36,34,2,45,44,1,2,2,0,0
"22815","VAN","DAL",2015020143,16737,20152016,0,62.4666666666667,3,4,-1,2.80985459082876,5.22496296622558,-2.41510837539681,32,29,3,45,41,4,60,75,-15,4,4,0,0
"22816","VAN","ARI",2015020153,16738,20152016,0,60,4,3,1,5.33671406042413,4.6136972483276,0.72301681209653,22,31,-9,31,45,-14,40,61,-21,4,2,0,0
"22817","VAN","PHI",2015020171,16741,20152016,1,60,4,1,3,4.00890824908856,3.02636889694259,0.982539352145977,34,28,6,41,34,7,47,49,-2,2,3,0,0
"22818","VAN","N.J",2015020212,16747,20152016,0,63.55,3,4,-1,3.8562799191568,3.27714829168326,0.579131627473544,31,28,3,47,38,9,58,42,16,7,7,0,0
"22819","VAN","CBJ",2015020219,16749,20152016,0,60,5,3,2,3.55272837350276,4.99877587637366,-1.4460475028709,30,45,-15,33,52,-19,46,70,-24,4,4,0,0
"22820","VAN","OTT",2015020234,16751,20152016,0,60,2,3,-1,4.56954584565304,3.23906571319078,1.33048013246226,35,25,10,47,36,11,68,46,22,3,4,0,0
"22821","VAN","TOR",2015020249,16753,20152016,0,60,2,4,-2,6.81060622981022,4.16695439973162,2.6436518300786,45,40,5,58,48,10,75,63,12,4,6,0,0
"22822","VAN","MTL",2015020263,16755,20152016,0,63.4166666666667,3,4,-1,0,0,0,26,36,-10,34,46,-12,47,67,-20,5,4,0,0
"22823","VAN","WPG",2015020275,16757,20152016,0,60,1,4,-3,3.77370686933864,3.56946301879666,0.204243850541978,30,34,-4,44,46,-2,56,59,-3,7,6,0,0
"22824","VAN","CHI",2015020303,16760,20152016,1,60,6,3,3,2.13346590020228,2.59206618260032,-0.458600282398041,20,29,-9,34,39,-5,44,55,-11,4,2,0,0
"22825","VAN","N.J",2015020307,16761,20152016,1,60,2,3,-1,9.26796309280326,2.7165040175023,6.55145907530095,38,22,16,50,31,19,64,43,21,8,5,0,0
"22826","VAN","MIN",2015020324,16764,20152016,0,60,3,2,1,2.85872435200594,2.41016982806877,0.448554523937162,28,33,-5,38,42,-4,54,56,-2,1,3,0,0
"22827","VAN","DAL",2015020340,16766,20152016,0,65,2,2,0,6.36358292323712,3.66122126119747,2.70236166203964,36,25,11,53,35,18,68,49,19,7,5,0,0
"22828","VAN","ANA",2015020358,16769,20152016,0,60,0,4,-4,3.08471246593399,5.01180089265108,-1.92708842671709,25,30,-5,43,44,-1,59,59,0,3,4,0,0
"22829","VAN","L.A",2015020367,16770,20152016,0,62.0333333333333,1,2,-1,1.74562933680136,3.76621296758822,-2.02058363078686,16,40,-24,26,56,-30,31,73,-42,4,6,0,0
"22830","VAN","DAL",2015020380,16772,20152016,1,60,2,4,-2,2.41893880139833,5.14965266664512,-2.7307138652468,16,34,-18,28,48,-20,44,60,-16,3,5,0,0
"22831","VAN","BOS",2015020396,16774,20152016,1,60,0,4,-4,2.24040173165849,4.40914995787898,-2.16874822622049,17,22,-5,27,34,-7,43,44,-1,5,3,0,0
"22832","VAN","NYR",2015020420,16778,20152016,1,60,2,1,1,2.47009686323872,1.86024183662585,0.609855026612877,25,33,-8,30,44,-14,43,60,-17,6,6,0,0
"22833","VAN","CHI",2015020447,16782,20152016,0,60,0,4,-4,4.38166047330014,3.44112433407292,0.94053613922722,30,30,0,38,41,-3,53,60,-7,3,2,0,0
"22834","VAN","MIN",2015020460,16784,20152016,0,60,2,6,-4,5.51168745799077,6.56528047543543,-1.05359301744465,31,41,-10,37,55,-18,46,65,-19,1,5,0,0
"22835","VAN","PHI",2015020468,16786,20152016,0,60,0,2,-2,5.44139244452617,5.15446193271782,0.28693051180835,36,31,5,46,47,-1,65,61,4,5,6,0,0
"22836","VAN","DET",2015020481,16787,20152016,0,65,3,3,0,5.3884876280724,6.27358984270749,-0.885102214635095,40,28,12,43,34,9,55,45,10,3,4,0,0
"22837","VAN","T.B",2015020510,16791,20152016,0,60,2,1,1,3.30248990555306,2.45146456159091,0.851025343962153,19,27,-8,30,47,-17,34,65,-31,3,12,0,0
"22838","VAN","EDM",2015020525,16795,20152016,1,64.0166666666667,2,1,1,3.39828171691624,3.97835729660437,-0.580075579688128,24,33,-9,42,45,-3,52,54,-2,2,3,0,0
"22839","VAN","L.A",2015020539,16797,20152016,1,60,0,5,-5,2.13855107300333,3.25846405929769,-1.11991298629437,27,38,-11,31,49,-18,41,63,-22,6,5,0,0
"22840","VAN","ANA",2015020566,16801,20152016,1,65,1,1,0,2.3965767287882,6.02802171189069,-3.63144498310248,25,28,-3,33,42,-9,38,55,-17,3,2,0,0
"22841","VAN","ARI",2015020587,16804,20152016,1,60,2,3,-1,3.95214088899652,3.15490830130875,0.797232587687773,37,29,8,47,37,10,63,46,17,2,2,0,0
"22842","VAN","CAR",2015020599,16806,20152016,1,60,3,2,1,2.87721385259647,3.26227823255573,-0.385064379959262,21,28,-7,34,43,-9,39,50,-11,5,2,0,0
"22843","VAN","T.B",2015020622,16809,20152016,1,63.85,2,3,-1,2.85083661883275,4.05533241729427,-1.20449579846152,23,35,-12,36,50,-14,47,59,-12,2,3,0,0
"22844","VAN","CAR",2015020656,16815,20152016,0,63.4166666666667,3,2,1,4.65527524289791,4.94649522998952,-0.291219987091608,22,40,-18,28,53,-25,39,72,-33,0,2,0,0
"22845","VAN","NYI",2015020671,16817,20152016,0,65,1,1,0,4.66566796367988,5.32179842729545,-0.656130463615568,26,48,-22,36,76,-40,51,94,-43,4,5,0,0
"22846","VAN","NYR",2015020683,16819,20152016,0,63.9,2,3,-1,3.63618728448637,4.36628053125605,-0.730093246769684,20,49,-29,27,65,-38,37,78,-41,1,1,0,0
"22847","VAN","BOS",2015020693,16821,20152016,0,60,4,2,2,5.26300711245858,3.63812945746031,1.62487765499827,27,30,-3,37,44,-7,46,58,-12,0,0,0,0
"22848","VAN","PIT",2015020709,16823,20152016,0,60,4,5,-1,2.74098953558291,4.2588952126971,-1.51790567711419,32,30,2,38,37,1,44,52,-8,1,5,0,0
"22849","VAN","CBJ",2015020769,16835,20152016,1,65,1,1,0,2.92702291544992,2.86801457998808,0.05900833546184,38,28,10,50,40,10,69,54,15,3,3,0,0
"22850","VAN","COL",2015020804,16840,20152016,0,60,3,1,2,4.67711191014678,4.35149524785811,0.325616662288667,28,30,-2,39,39,0,46,52,-6,1,4,0,0
"22851","VAN","ARI",2015020808,16841,20152016,0,60,2,1,1,6.07115145795156,3.8764343548981,2.19471710305346,26,34,-8,41,45,-4,61,67,-6,4,4,0,0
"22852","VAN","TOR",2015020830,16844,20152016,1,60,2,5,-3,1.91673725453438,6.18735919214396,-4.27062193760958,19,38,-19,26,49,-23,37,61,-24,5,6,0,0
"22853","VAN","MIN",2015020846,16846,20152016,1,60,2,5,-3,6.04874747450865,6.49910455927602,-0.450357084767369,26,34,-8,38,47,-9,55,52,3,4,4,0,0
"22854","VAN","ANA",2015020868,16849,20152016,1,60,2,5,-3,2.81031051876198,3.42084650450852,-0.610535985746537,21,33,-12,27,42,-15,41,49,-8,5,4,0,0
"22855","VAN","COL",2015020888,16852,20152016,1,60,5,1,4,3.9090620230088,5.64563958107325,-1.73657755806445,29,38,-9,36,50,-14,38,64,-26,4,4,0,0
"22856","VAN","OTT",2015020914,16856,20152016,1,60,5,3,2,4.29521381758877,4.8813249130651,-0.586111095476326,36,30,6,41,38,3,49,50,-1,5,5,0,0
"22857","VAN","S.J",2015020934,16859,20152016,1,60,1,4,-3,7.22658485003939,5.54576569214987,1.68081915788952,24,28,-4,37,39,-2,50,50,0,1,4,0,0
"22858","VAN","NYI",2015020950,16861,20152016,1,60,2,3,-1,5.05141588742845,5.9893469180098,-0.937931030581353,33,24,9,42,31,11,59,44,15,2,1,0,0
"22859","VAN","S.J",2015020964,16863,20152016,1,60,2,3,-1,4.02484596981402,4.16340940119699,-0.138563431382966,30,30,0,37,40,-3,55,61,-6,1,4,0,0
"22860","VAN","S.J",2015020979,16865,20152016,0,60,4,2,2,3.82551944546867,2.28771736107592,1.53780208439275,26,34,-8,30,42,-12,43,56,-13,7,4,0,0
"22861","VAN","L.A",2015020992,16867,20152016,0,60,1,5,-4,3.95603283710079,6.33582915939041,-2.37979632228962,22,29,-7,38,46,-8,56,54,2,6,3,0,0
"22862","VAN","ARI",2015021005,16869,20152016,1,61.7,3,2,1,3.08951892967161,5.24112385031185,-2.15160492064024,31,34,-3,40,45,-5,56,56,0,4,1,0,0
"22863","VAN","WPG",2015021037,16874,20152016,1,60,2,5,-3,3.31492621998041,4.01559732909755,-0.700671109117138,28,29,-1,38,43,-5,46,50,-4,4,3,0,0
"22864","VAN","COL",2015021051,16876,20152016,1,60,1,3,-2,6.34413338807644,1.73296411812771,4.61116926994873,29,34,-5,37,42,-5,58,50,8,1,2,0,0
"22865","VAN","EDM",2015021065,16878,20152016,0,60,0,2,-2,4.20987466176666,2.02359343973512,2.18628122203154,40,25,15,57,34,23,83,47,36,6,5,0,0
"22866","VAN","WPG",2015021095,16882,20152016,0,60,0,2,-2,3.18212069170005,6.15231741267905,-2.970196720979,28,49,-21,36,62,-26,46,73,-27,2,3,0,0
"22867","VAN","CHI",2015021131,16887,20152016,1,60,2,3,-1,3.75598096346948,3.87393158608211,-0.117950622612625,28,32,-4,34,41,-7,53,53,0,2,2,0,0
"22868","VAN","S.J",2015021148,16889,20152016,1,60,1,4,-3,3.57608881814787,5.01571821836683,-1.43962940021896,24,31,-7,34,41,-7,48,46,2,2,3,0,0
"22869","VAN","S.J",2015021161,16891,20152016,0,60,4,2,2,4.01131128689849,4.59691846213579,-0.585607175237299,26,34,-8,41,47,-6,59,60,-1,4,4,0,0
"22870","VAN","ANA",2015021166,16892,20152016,0,60,3,2,1,4.05198229035796,6.30914518896975,-2.2571628986118,28,36,-8,39,53,-14,52,61,-9,3,2,0,0
"22871","VAN","L.A",2015021187,16895,20152016,1,60,3,2,1,3.46952747972682,4.7653407335165,-1.29581325378967,24,42,-18,30,52,-22,38,71,-33,5,3,0,0
"22872","VAN","EDM",2015021201,16897,20152016,0,60,2,6,-4,5.9356606786605,5.08667358232196,0.848987096338533,27,38,-11,41,47,-6,56,54,2,6,6,0,0
"22873","VAN","EDM",2015021228,16900,20152016,1,65,3,3,0,3.40417133108713,5.10386958133074,-1.69969825024361,28,38,-10,41,47,-6,55,56,-1,3,3,0,0
"22874","VAN","CAR",2016020032,17090,20162017,1,60.5333333333333,4,3,1,1.72692232386908,2.90579112542917,-1.1788688015601,31,22,9,38,28,10,50,43,7,2,2,0,0
"22875","VAN","L.A",2016020076,17096,20162017,0,65,3,3,0,3.96398727914493,7.15451215408399,-3.19052487493906,25,31,-6,37,53,-16,45,74,-29,6,3,0,0
"22876","VAN","ANA",2016020080,17097,20162017,0,60,2,4,-2,4.58105431772128,5.45707050474675,-0.876016187025471,19,37,-18,31,56,-25,40,77,-37,2,2,0,0
"22877","VAN","OTT",2016020091,17099,20162017,1,60,0,3,-3,3.06331485425471,4.74629028152352,-1.6829754272688,22,28,-6,32,40,-8,47,49,-2,1,1,0,0
"22878","VAN","EDM",2016020111,17102,20162017,1,60,0,2,-2,3.36160902101986,5.16871714236913,-1.80710812134927,26,27,-1,34,31,3,50,42,8,1,1,0,0
"22879","VAN","MTL",2016020143,17107,20162017,0,60,0,3,-3,6.89137514026149,5.00808104095995,1.88329409930154,42,22,20,50,28,22,74,40,34,5,3,0,0
"22880","VAN","OTT",2016020150,17108,20162017,0,60,0,1,-1,5.85274163808559,4.56996116475784,1.28278047332775,27,24,3,39,32,7,64,43,21,5,6,0,0
"22881","VAN","TOR",2016020163,17110,20162017,0,60,3,6,-3,4.83709078103129,4.03247317653984,0.804617604491455,29,42,-13,41,56,-15,54,72,-18,5,8,0,0
"22882","VAN","NYI",2016020181,17112,20162017,0,60,2,4,-2,0,0,0,32,32,0,42,48,-6,65,61,4,2,2,0,0
"22883","VAN","NYR",2016020184,17113,20162017,0,60,5,3,2,3.49402830326402,3.84488317283109,-0.350854869567069,29,26,3,31,38,-7,41,52,-11,2,5,0,0
"22884","VAN","DET",2016020200,17115,20162017,0,60,1,3,-2,4.81199339987063,4.05802805001798,0.753965349852649,37,27,10,44,39,5,56,49,7,3,4,0,0
"22885","VAN","DAL",2016020224,17118,20162017,1,61.45,5,4,1,4.12101266949321,1.25017867577697,2.87083399371625,30,21,9,43,31,12,57,40,17,3,2,0,0
"22886","VAN","NYR",2016020241,17120,20162017,1,60,2,7,-5,5.52878410817721,3.95186269224561,1.5769214159316,38,25,13,51,33,18,72,39,33,4,3,0,0
"22887","VAN","ARI",2016020252,17122,20162017,1,62.5666666666667,3,2,1,0,0,0,42,36,6,55,41,14,69,55,14,3,2,0,0
"22888","VAN","CHI",2016020270,17124,20162017,1,64.0666666666667,3,4,-1,2.63138926716056,5.74942757486133,-3.11803830770077,27,32,-5,41,39,2,52,59,-7,2,3,0,0
"22889","VAN","ARI",2016020297,17128,20162017,0,60,4,1,3,4.58949190062884,4.99385471995629,-0.404362819327446,27,36,-9,38,58,-20,46,69,-23,2,2,0,0
"22890","VAN","DAL",2016020311,17130,20162017,0,60,1,2,-1,6.01216574374484,4.48308552835078,1.52908021539406,31,28,3,45,42,3,69,52,17,2,1,0,0
"22891","VAN","COL",2016020319,17131,20162017,0,65,2,2,0,3.57204054904287,6.6026868249379,-3.03064627589504,31,35,-4,41,52,-11,48,66,-18,3,4,0,0
"22892","VAN","MIN",2016020339,17134,20162017,1,60,5,4,1,6.69403499260079,5.03450555774998,1.65952943485081,35,42,-7,43,47,-4,55,56,-1,3,2,0,0
"22893","VAN","ANA",2016020356,17136,20162017,1,60,1,3,-2,4.48103665420786,4.01108566725543,0.469950986952426,28,24,4,33,32,1,52,50,2,3,1,0,0
"22894","VAN","TOR",2016020367,17138,20162017,1,65,2,2,0,2.4105048878082,6.02055949787609,-3.61005461006789,24,40,-16,35,60,-25,42,68,-26,2,4,0,0
"22895","VAN","N.J",2016020383,17141,20162017,0,60,2,3,-1,4.17707828181636,3.07157465489581,1.10550362692054,24,22,2,32,33,-1,38,40,-2,4,3,0,0
"22896","VAN","T.B",2016020399,17143,20162017,0,60,5,1,4,4.45716143850586,6.01306335508534,-1.55590191657947,30,41,-11,41,56,-15,50,74,-24,3,3,0,0
"22897","VAN","CAR",2016020434,17148,20162017,0,60,6,8,-2,6.79930843463808,6.86558730239631,-0.0662788677582284,34,36,-2,45,51,-6,58,66,-8,2,3,0,0
"22898","VAN","T.B",2016020459,17151,20162017,1,60,4,2,2,6.74128042045049,1.96629808639409,4.7749823340564,24,27,-3,33,35,-2,51,41,10,2,2,0,0
"22899","VAN","CBJ",2016020472,17153,20162017,1,60.7666666666667,3,4,-1,2.96893371274928,6.89930458614253,-3.93037087339326,17,25,-8,31,33,-2,47,41,6,4,2,0,0
"22900","VAN","WPG",2016020491,17155,20162017,1,60,4,1,3,5.68508397238475,6.13351263967343,-0.448428667288681,24,32,-8,34,39,-5,40,48,-8,3,5,0,0
"22901","VAN","WPG",2016020504,17157,20162017,1,60,1,4,-3,2.24062868809521,3.41010709613329,-1.16947840803807,23,25,-2,28,37,-9,37,47,-10,5,5,0,0
"22902","VAN","L.A",2016020531,17163,20162017,1,60,2,1,1,1.56955818906243,5.98583158268593,-4.4162733936235,20,37,-17,27,46,-19,37,55,-18,3,2,0,0
"22903","VAN","ANA",2016020546,17165,20162017,1,64.0166666666667,3,2,1,3.66268672497245,2.46120237724842,1.20148434772402,26,26,0,36,31,5,47,43,4,7,1,0,0
"22904","VAN","EDM",2016020557,17166,20162017,0,65,2,2,0,4.32051959778893,4.92830682211206,-0.607787224323133,32,44,-12,50,60,-10,63,79,-16,2,5,0,0
"22905","VAN","COL",2016020564,17168,20162017,1,60,3,2,1,4.07547353947302,2.66606612424948,1.40940741522354,24,26,-2,43,38,5,55,51,4,4,3,0,0
"22906","VAN","ARI",2016020576,17170,20162017,1,60,3,0,3,4.26149998772598,3.55135825125899,0.710141736466994,24,22,2,36,35,1,51,48,3,3,2,0,0
"22907","VAN","PHI",2016020624,17178,20162017,0,65,4,4,0,3.23066862216771,6.13313240098023,-2.90246377881252,38,35,3,54,51,3,72,57,15,6,4,0,0
"22908","VAN","N.J",2016020654,17181,20162017,1,61.4666666666667,1,2,-1,2.91901930829039,2.09869018680183,0.820329121488555,22,22,0,31,29,2,40,36,4,4,2,0,0
"22909","VAN","CHI",2016020706,17188,20162017,0,60,2,4,-2,3.39497337763896,4.20708596880081,-0.812112591161849,28,35,-7,37,48,-11,53,59,-6,3,1,0,0
"22910","VAN","COL",2016020726,17191,20162017,0,60,3,2,1,7.18920972057595,5.23648309156488,1.95272662901107,41,32,9,46,51,-5,58,59,-1,2,2,0,0
"22911","VAN","ARI",2016020739,17192,20162017,0,60,0,3,-3,3.95305472753975,6.61278927046806,-2.65973454292831,19,31,-12,42,48,-6,58,65,-7,0,2,0,0
"22912","VAN","S.J",2016020765,17199,20162017,1,60,1,4,-3,3.40397335597438,5.41629809030565,-2.01232473433127,33,32,1,48,40,8,69,55,14,2,3,0,0
"22913","VAN","MIN",2016020782,17201,20162017,1,60,3,6,-3,4.28998721342214,5.31219533766853,-1.02220812424639,27,39,-12,37,48,-11,49,59,-10,4,3,0,0
"22914","VAN","CBJ",2016020807,17206,20162017,0,60,3,0,3,4.56940509592278,5.30150480719749,-0.732099711274714,24,33,-9,34,42,-8,51,57,-6,4,4,0,0
"22915","VAN","BOS",2016020815,17208,20162017,0,60,3,4,-1,6.13365046965191,6.16668502071274,-0.0330345510608296,32,30,2,46,43,3,55,55,0,3,2,0,0
"22916","VAN","PIT",2016020837,17211,20162017,0,60,0,4,-4,3.29627768765204,6.83229386655148,-3.53601617889944,29,42,-13,36,48,-12,50,60,-10,1,2,0,0
"22917","VAN","PHI",2016020879,17216,20162017,1,60,2,3,-1,2.94087495381245,2.58066172898543,0.360213224827021,20,28,-8,32,37,-5,56,55,1,4,3,0,0
"22918","VAN","S.J",2016020911,17222,20162017,1,60,1,4,-3,3.4352698403236,4.4804791229144,-1.0452092825908,36,26,10,45,38,7,68,53,15,2,1,0,0
"22919","VAN","DET",2016020932,17225,20162017,1,62.5166666666667,2,3,-1,2.56148253356514,2.49793375204899,0.0635487815161468,27,28,-1,33,33,0,52,43,9,3,4,0,0
"22920","VAN","S.J",2016020945,17227,20162017,0,60,1,3,-2,2.46419877215521,4.02023580634292,-1.55603703418771,18,32,-14,25,43,-18,42,64,-22,3,3,0,0
"22921","VAN","L.A",2016020961,17229,20162017,0,60,4,3,1,3.51207778346725,5.77042960574181,-2.25835182227456,21,44,-23,26,60,-34,30,80,-50,3,7,0,0
"22922","VAN","ANA",2016020967,17230,20162017,0,60,2,1,1,2.0416505245812,4.60517715862614,-2.56352663404494,27,44,-17,37,64,-27,47,81,-34,2,2,0,0
"22923","VAN","MTL",2016020980,17232,20162017,1,61.2166666666667,1,2,-1,2.16615656067165,5.79195012763739,-3.62579356696574,28,38,-10,36,44,-8,54,58,-4,1,3,0,0
"22924","VAN","NYI",2016020992,17234,20162017,1,61.55,3,4,-1,2.40380090371272,3.3852720470486,-0.981471143335879,39,28,11,47,35,12,58,45,13,3,3,0,0
"22925","VAN","PIT",2016021009,17236,20162017,1,60,0,3,-3,1.54143052269501,4.78827595789335,-3.24684543519834,27,48,-21,34,60,-26,48,75,-27,1,3,0,0
"22926","VAN","BOS",2016021021,17238,20162017,1,60,3,6,-3,2.92724080996413,7.1600953302368,-4.23285452027267,29,43,-14,35,55,-20,40,67,-27,2,2,0,0
"22927","VAN","DAL",2016021045,17241,20162017,1,60,2,4,-2,4.08245865009667,6.17379429602443,-2.09133564592776,28,36,-8,39,40,-1,59,49,10,2,1,0,0
"22928","VAN","EDM",2016021061,17243,20162017,0,60,0,2,-2,6.12322475091014,4.3915241244249,1.73170062648524,33,22,11,49,34,15,71,46,25,2,3,0,0
"22929","VAN","CHI",2016021084,17246,20162017,0,62.2,5,4,1,3.37225053925067,7.79551617766265,-4.42326563841198,15,44,-29,20,63,-43,29,83,-54,2,6,0,0
"22930","VAN","MIN",2016021106,17250,20162017,0,60,4,2,2,3.36528460064437,3.42041205911892,-0.0551274584745443,21,27,-6,33,43,-10,39,56,-17,2,3,0,0
"22931","VAN","WPG",2016021120,17251,20162017,0,60,1,2,-1,3.24612820859466,2.89026562386425,0.355862584730403,29,32,-3,40,39,1,51,51,0,1,2,0,0
"22932","VAN","ANA",2016021135,17253,20162017,1,60,1,4,-3,5.87181397576754,7.40889544069069,-1.53708146492314,35,39,-4,44,48,-4,50,63,-13,2,4,0,0
"22933","VAN","L.A",2016021155,17256,20162017,1,60,0,2,-2,2.79395465458583,3.58649251979659,-0.792537865210761,35,26,9,50,39,11,59,46,13,2,1,0,0
"22934","VAN","S.J",2016021172,17258,20162017,1,60,1,3,-2,3.45298136331597,3.33788944716798,0.115091916147991,30,25,5,37,30,7,56,37,19,1,1,0,0
"22935","VAN","S.J",2016021191,17260,20162017,0,60,1,3,-2,5.89139481401071,3.77702958221198,2.11436523179873,34,25,9,43,42,1,71,57,14,3,1,0,0
"22936","VAN","ARI",2016021202,17262,20162017,0,60,3,4,-1,6.05353539180942,2.13081191736273,3.92272347444668,29,22,7,42,31,11,57,39,18,4,4,0,0
"22937","VAN","EDM",2016021218,17264,20162017,1,60,2,3,-1,5.35720037238207,6.76909014210105,-1.41188976971898,31,35,-4,38,46,-8,54,58,-4,3,1,0,0
"22938","VAN","EDM",2016021230,17265,20162017,0,60,2,5,-3,4.18353160954575,4.93874918180518,-0.755217572259426,17,44,-27,29,54,-25,41,66,-25,1,5,0,0
"22939","VAN","EDM",2017020028,17446,20172018,1,60,3,2,1,4.0945639399419,3.94807291595363,0.146491023988266,26,35,-9,37,54,-17,44,69,-25,7,5,0,0
"22940","VAN","WPG",2017020055,17451,20172018,1,60,2,4,-2,3.52204221308057,2.79218289059602,0.729859322484543,32,20,12,40,26,14,55,35,20,5,2,0,0
"22941","VAN","BOS",2017020095,17458,20172018,0,60,3,6,-3,4.82229777381872,5.02541773847406,-0.203119964655343,29,35,-6,41,53,-12,56,64,-8,6,4,0,0
"22942","VAN","DET",2017020122,17461,20172018,0,60,4,1,3,5.23732903034409,5.17778899794198,0.059540032402106,37,21,16,46,37,9,56,49,7,2,1,0,0
"22943","VAN","MIN",2017020133,17463,20172018,0,60,1,0,1,6.81166108950487,4.71853962488831,2.09312146461656,25,29,-4,37,41,-4,47,55,-8,3,4,0,0
"22944","VAN","DAL",2017020176,17469,20172018,1,62.5333333333333,1,2,-1,4.37129099352839,2.34769744478004,2.02359354874835,39,29,10,50,34,16,65,40,25,4,5,0,0
"22945","VAN","N.J",2017020183,17471,20172018,1,60,0,2,-2,6.56482529891218,4.98603705527603,1.57878824363615,37,26,11,59,33,26,80,42,38,4,1,0,0
"22946","VAN","PIT",2017020210,17474,20172018,1,60,4,2,2,1.60163441003301,6.88564372501681,-5.2840093149838,21,39,-18,34,53,-19,42,60,-18,2,4,0,0
"22947","VAN","DET",2017020222,17476,20172018,1,60,2,3,-1,3.27357997710351,4.94584724622837,-1.67226726912486,28,30,-2,36,43,-7,55,52,3,3,3,0,0
"22948","VAN","ANA",2017020240,17479,20172018,0,60,1,4,-3,1.74189020693973,6.15817283639376,-4.41628262945403,20,35,-15,28,57,-29,40,72,-32,5,6,0,0
"22949","VAN","S.J",2017020260,17481,20172018,0,60,0,5,-5,4.63358895335296,5.6399776582918,-1.00638870493884,41,31,10,50,41,9,71,56,15,4,5,0,0
"22950","VAN","L.A",2017020274,17484,20172018,0,60,3,2,1,3.13200968645629,5.9417956925663,-2.80978600611002,27,32,-5,36,47,-11,43,57,-14,4,5,0,0
"22951","VAN","VGK",2017020287,17486,20172018,1,60,2,5,-3,2.75711006447091,7.80807342443326,-5.05096335996235,21,30,-9,30,41,-11,48,52,-4,2,0,0,0
"22952","VAN","PHI",2017020316,17491,20172018,0,60,5,2,3,6.02180149912223,5.12646298073128,0.89533851839095,36,38,-2,43,52,-9,54,79,-25,3,2,0,0
"22953","VAN","PIT",2017020324,17492,20172018,0,60,5,2,3,6.49611949416568,6.70965062771947,-0.213531133553792,37,45,-8,45,56,-11,56,70,-14,3,5,0,0
"22954","VAN","N.J",2017020340,17494,20172018,0,60,2,3,-1,3.29383771322058,2.18868979613762,1.10514791708296,25,26,-1,37,36,1,48,43,5,3,3,0,0
"22955","VAN","NYR",2017020360,17496,20172018,0,65,3,3,0,4.34604049143672,5.81057742654957,-1.46453693511285,32,20,12,43,33,10,63,49,14,1,2,0,0
"22956","VAN","NYI",2017020368,17498,20172018,0,60,2,5,-3,2.28000239702574,5.73922359265271,-3.45922119562696,25,36,-11,35,50,-15,51,59,-8,2,3,0,0
"22957","VAN","TOR",2017020402,17502,20172018,1,60,2,1,1,3.84707273880485,5.638172073639,-1.79109933483414,26,36,-10,37,47,-10,47,66,-19,1,2,0,0
"22958","VAN","CAR",2017020423,17505,20172018,1,60,3,0,3,3.68449864571448,4.07045151472994,-0.385952869015455,22,30,-8,32,45,-13,42,60,-18,2,2,0,0
"22959","VAN","PHI",2017020436,17507,20172018,1,60,1,4,-3,3.30470236922247,3.32221993344137,-0.0175175642189078,37,26,11,45,36,9,63,41,22,2,6,0,0
"22960","VAN","WPG",2017020464,17511,20172018,0,60,1,5,-4,5.35956030260422,4.55831522203516,0.801245080569061,26,24,2,33,33,0,44,45,-1,2,3,0,0
"22961","VAN","S.J",2017020495,17515,20172018,1,64.5666666666667,4,3,1,6.00906542382654,5.45314230792653,0.555923115900014,40,37,3,50,47,3,55,63,-8,3,4,0,0
"22962","VAN","MTL",2017020524,17519,20172018,1,60,5,7,-2,5.06514631466416,4.9855438074519,0.0796025072122575,39,32,7,52,38,14,72,49,23,3,3,0,0
"22963","VAN","S.J",2017020538,17521,20172018,0,61.8833333333333,4,5,-1,5.05783625033744,4.68339319724919,0.374443053088248,40,32,8,52,48,4,62,63,-1,4,5,0,0
"22964","VAN","CHI",2017020573,17528,20172018,1,60,5,2,3,2.71422524867393,3.72013302834966,-1.00590777967573,31,32,-1,37,43,-6,45,58,-13,4,6,0,0
"22965","VAN","L.A",2017020592,17530,20172018,1,60,3,4,-1,3.38639416114893,3.53720003980561,-0.150805878656683,25,36,-11,32,45,-13,44,64,-20,1,2,0,0
"22966","VAN","ANA",2017020612,17533,20172018,1,60,0,5,-5,4.30665084676809,3.27147474844242,1.03517609832568,31,27,4,47,33,14,61,43,18,4,2,0,0
"22967","VAN","TOR",2017020637,17537,20172018,0,65,2,2,0,9.57169753837115,5.67915044602705,3.8925470923441,36,36,0,52,46,6,57,67,-10,3,4,0,0
"22968","VAN","MTL",2017020648,17538,20172018,0,60,2,5,-3,3.80367919921412,7.52943326490868,-3.72575406569456,36,45,-9,47,55,-8,60,79,-19,3,3,0,0
"22969","VAN","CBJ",2017020665,17543,20172018,0,60,5,2,3,7.92554279760225,4.79066345016849,3.13487934743375,29,29,0,43,44,-1,61,63,-2,3,2,0,0
"22970","VAN","MIN",2017020682,17545,20172018,0,62.8333333333333,3,2,1,3.34418840409489,4.13116735778749,-0.786978953692596,25,23,2,40,33,7,49,42,7,1,1,0,0
"22971","VAN","EDM",2017020720,17551,20172018,0,60,2,5,-3,4.18687621824936,5.14958373708214,-0.962707518832783,27,35,-8,42,43,-1,59,57,2,3,3,0,0
"22972","VAN","WPG",2017020723,17552,20172018,0,60,0,1,-1,3.87308739744185,4.24088321287695,-0.367795815435102,29,36,-7,37,54,-17,56,68,-12,2,2,0,0
"22973","VAN","L.A",2017020740,17554,20172018,1,60,6,2,4,5.59001197725554,5.01245170609124,0.5775602711643,35,32,3,40,44,-4,58,61,-3,7,5,0,0
"22974","VAN","COL",2017020772,17561,20172018,1,61.1166666666667,4,3,1,4.56453202984994,3.44701971373479,1.11751231611515,26,30,-4,40,44,-4,53,55,-2,5,5,0,0
"22975","VAN","CHI",2017020787,17563,20172018,1,60,4,2,2,3.2291818424128,3.16895562182594,0.0602262205868556,21,28,-7,31,40,-9,44,59,-15,2,4,0,0
"22976","VAN","T.B",2017020803,17565,20172018,1,60,2,4,-2,3.63833152419066,1.68489057046827,1.95344095372239,33,28,5,42,32,10,55,39,16,4,6,0,0
"22977","VAN","T.B",2017020830,17570,20172018,0,60,2,5,-3,5.14886844610852,6.41066128482635,-1.26179283871783,29,36,-7,42,53,-11,54,65,-11,3,3,0,0
"22978","VAN","CAR",2017020839,17571,20172018,0,60,1,4,-3,4.51453438173485,6.41520288755419,-1.90066850581934,22,33,-11,32,48,-16,37,72,-35,3,4,0,0
"22979","VAN","DAL",2017020855,17573,20172018,0,60,6,0,6,4.79060856792057,4.39104484435144,0.399563723569128,41,30,11,49,40,9,67,60,7,6,1,0,0
"22980","VAN","S.J",2017020889,17577,20172018,0,60,1,4,-3,7.93178200540933,3.35346323724737,4.57831876816196,44,30,14,59,43,16,72,57,15,1,3,0,0
"22981","VAN","BOS",2017020904,17579,20172018,1,60,6,1,5,1.84006640014573,4.11891032081621,-2.27884392067049,24,45,-21,30,59,-29,32,77,-45,0,5,0,0
"22982","VAN","COL",2017020926,17582,20172018,1,63.6,4,5,-1,3.07107548270267,5.72222871942903,-2.65115323672635,28,34,-6,44,45,-1,60,56,4,3,6,0,0
"22983","VAN","VGK",2017020945,17585,20172018,0,60,3,6,-3,5.54771618568338,5.02009969554513,0.527616490138257,33,34,-1,47,46,1,61,61,0,3,2,0,0
"22984","VAN","ARI",2017020963,17587,20172018,0,60,3,1,2,3.28279265864642,5.03262610067031,-1.74983344202389,27,42,-15,46,58,-12,56,76,-20,4,6,0,0
"22985","VAN","COL",2017020967,17588,20172018,0,60,1,3,-2,3.80195031664858,3.90971194163632,-0.107761624987738,32,28,4,43,51,-8,63,67,-4,2,5,0,0
"22986","VAN","NYR",2017020982,17590,20172018,1,61.3666666666667,5,6,-1,6.56607750849798,3.90130285522901,2.66477465326898,55,27,28,66,36,30,81,44,37,3,2,0,0
"22987","VAN","NYI",2017021019,17595,20172018,1,62.7833333333333,4,3,1,3.39785218391626,3.24561374058248,0.152238443333772,23,34,-11,31,45,-14,47,58,-11,2,4,0,0
"22988","VAN","ARI",2017021031,17597,20172018,1,60,1,2,-1,3.32572458943469,2.35731652231334,0.968408067121345,17,34,-17,29,44,-15,40,63,-23,1,3,0,0
"22989","VAN","MIN",2017021047,17599,20172018,1,60,2,5,-3,5.9731038765749,5.07877028644725,0.894333590127644,32,36,-4,46,43,3,62,52,10,1,2,0,0
"22990","VAN","ARI",2017021062,17601,20172018,0,60,0,1,-1,6.71152087986047,4.1588722706656,2.55264860919488,27,24,3,41,37,4,59,60,-1,1,2,0,0
"22991","VAN","L.A",2017021069,17602,20172018,0,60,0,3,-3,6.43182214656444,5.12584051018818,1.30598163637626,35,33,2,46,50,-4,58,65,-7,4,4,0,0
"22992","VAN","ANA",2017021082,17604,20172018,0,60,0,3,-3,6.04236066605036,6.81677996035341,-0.774419294303052,32,37,-5,43,48,-5,54,58,-4,2,5,0,0
"22993","VAN","S.J",2017021107,17607,20172018,1,60,3,5,-2,5.21240155963527,5.23918076435075,-0.0267792047154813,31,30,1,47,41,6,70,51,19,4,4,0,0
"22994","VAN","VGK",2017021130,17610,20172018,0,60,1,4,-3,6.47871962551653,4.02075101755327,2.45796860796327,30,28,2,50,44,6,67,57,10,1,3,0,0
"22995","VAN","CHI",2017021143,17612,20172018,0,60,5,2,3,0,0,0,27,41,-14,34,54,-20,45,69,-24,1,4,0,0
"22996","VAN","DAL",2017021164,17615,20172018,0,60,4,1,3,4.89113298945267,4.00460186473699,0.886531124715681,27,31,-4,41,50,-9,53,63,-10,6,3,0,0
"22997","VAN","ANA",2017021185,17617,20172018,1,60,4,1,3,4.63037956065091,0.973218411005064,3.65716114964584,30,24,6,44,29,15,52,46,6,1,2,0,0
"22998","VAN","EDM",2017021198,17619,20172018,1,60,2,1,1,4.1161956278861,3.06172255289221,1.05447307499389,30,36,-6,37,50,-13,43,63,-20,1,2,0,0
"22999","VAN","CBJ",2017021208,17621,20172018,1,61.35,5,4,1,3.32097022990177,5.03183550347603,-1.71086527357426,29,30,-1,38,43,-5,45,63,-18,1,3,0,0
"23000","VAN","VGK",2017021236,17624,20172018,1,65,4,4,0,3.58513499725655,5.41204497691069,-1.82690997965415,25,39,-14,35,53,-18,50,69,-19,2,4,0,0
"23001","VAN","ARI",2017021250,17626,20172018,1,62.55,4,3,1,3.17714631588082,2.60662733286154,0.570518983019281,40,19,21,51,26,25,73,44,29,3,2,0,0
"23002","VAN","EDM",2017021269,17628,20172018,0,65,2,2,0,5.98865511092299,4.5545102584656,1.43414485245739,38,33,5,53,50,3,69,65,4,4,2,0,0
"23003","VAN","CAR",2018020037,17813,20182019,0,60,3,5,-2,3.93485218147115,5.75227307754483,-1.81742089607368,25,33,-8,38,44,-6,49,60,-11,5,3,0,0
"23004","VAN","T.B",2018020053,17815,20182019,0,60,4,1,3,4.33773623320371,4.28387009288417,0.053866140319542,28,34,-6,36,53,-17,49,75,-26,4,5,0,0
"23005","VAN","PIT",2018020081,17820,20182019,0,60.5666666666667,3,2,1,5.6358633741329,2.91490135114873,2.72096202298417,26,28,-2,36,37,-1,48,54,-6,1,2,0,0
"23006","VAN","WPG",2018020094,17822,20182019,0,60,1,4,-3,2.96573499002261,4.97151268772723,-2.00577769770462,27,32,-5,34,48,-14,48,60,-12,3,3,0,0
"23007","VAN","BOS",2018020112,17824,20182019,1,63.2,2,1,1,5.20134561442879,4.01968814869178,1.181657465737,22,31,-9,36,50,-14,45,64,-19,1,3,0,0
"23008","VAN","VGK",2018020133,17828,20182019,0,65,2,2,0,4.06095211139109,7.07968577678548,-3.01873366539439,26,35,-9,34,48,-14,47,68,-21,2,4,0,0
"23009","VAN","ARI",2018020143,17829,20182019,0,60,1,4,-3,7.06124216958855,4.48123508955359,2.58000708003496,28,30,-2,44,46,-2,52,54,-2,4,4,0,0
"23010","VAN","PIT",2018020158,17831,20182019,1,60,0,5,-5,3.73511156594404,5.14277060230961,-1.40765903636557,29,35,-6,45,48,-3,55,56,-1,4,3,0,0
"23011","VAN","MIN",2018020166,17833,20182019,1,60,5,2,3,5.57914055613219,3.77416764303027,1.80497291310192,31,39,-8,41,51,-10,55,66,-11,5,5,0,0
"23012","VAN","CHI",2018020178,17835,20182019,1,60,4,2,2,3.74870633217506,2.76434784900923,0.984358483165835,28,26,2,39,38,1,53,51,2,3,2,0,0
"23013","VAN","COL",2018020193,17837,20182019,1,64.6333333333333,7,6,1,7.58241672407513,3.9523444622173,3.63007226185783,37,29,8,46,40,6,67,54,13,4,2,0,0
"23014","VAN","DET",2018020219,17841,20182019,0,65,2,2,0,5.31943854840938,3.58319936095005,1.73623918745933,42,30,12,56,42,14,67,57,10,3,2,0,0
"23015","VAN","BOS",2018020227,17843,20182019,0,60,8,5,3,2.52270130144379,4.9514627911513,-2.42876148970751,33,28,5,46,48,-2,58,57,1,6,6,0,0
"23016","VAN","NYR",2018020260,17847,20182019,0,60,1,2,-1,3.89955177434604,3.56839052212979,0.331161252216248,26,27,-1,41,32,9,56,46,10,4,6,0,0
"23017","VAN","NYI",2018020266,17848,20182019,0,60,2,5,-3,3.11255489097452,4.86047639709432,-1.74792150611979,24,34,-10,32,43,-11,41,57,-16,5,4,0,0
"23018","VAN","MIN",2018020282,17850,20182019,0,60,2,6,-4,4.02345339113867,8.0257936240896,-4.00234023295093,27,29,-2,36,39,-3,44,50,-6,6,2,0,0
"23019","VAN","MTL",2018020298,17852,20182019,1,60,2,3,-1,5.85791024512173,5.10652357366416,0.751386671457567,38,31,7,48,48,0,64,63,1,4,3,0,0
"23020","VAN","WPG",2018020316,17854,20182019,1,60,3,6,-3,5.01346330460001,6.54098415235057,-1.52752084775057,25,49,-24,38,59,-21,53,77,-24,3,5,0,0
"23021","VAN","ANA",2018020330,17856,20182019,0,60,3,4,-1,4.76763653209252,3.28688412743622,1.4807524046563,28,37,-9,48,51,-3,60,63,-3,2,4,0,0
"23022","VAN","S.J",2018020346,17858,20182019,0,60,0,4,-4,2.89461141309369,5.052002751705,-2.15739133861131,19,24,-5,31,32,-1,47,48,-1,4,6,0,0
"23023","VAN","L.A",2018020357,17859,20182019,0,60,4,2,2,3.2107424833257,4.6290753004796,-1.4183328171539,29,22,7,40,40,0,48,56,-8,2,4,0,0
"23024","VAN","L.A",2018020376,17862,20182019,1,60.8833333333333,1,2,-1,3.75456054693619,3.75604788231431,-0.00148733537811641,33,25,8,44,33,11,62,49,13,2,3,0,0
"23025","VAN","VGK",2018020389,17864,20182019,1,60,3,4,-1,4.6131180366865,6.14171541843098,-1.52859738174448,36,31,5,41,43,-2,54,52,2,3,2,0,0
"23026","VAN","DAL",2018020396,17866,20182019,1,60,1,2,-1,3.42924810857585,6.10498845398251,-2.67574034540667,25,27,-2,39,41,-2,56,54,2,5,4,0,0
"23027","VAN","MIN",2018020423,17869,20182019,1,60,2,3,-1,5.00611372478306,5.61695350808077,-0.610839783297706,31,28,3,41,35,6,58,49,9,3,3,0,0
"23028","VAN","CBJ",2018020469,17876,20182019,0,60,3,2,1,1.65331503292316,3.56427301757617,-1.91095798465301,25,36,-11,28,42,-14,45,54,-9,1,2,0,0
"23029","VAN","PHI",2018020504,17880,20182019,1,60,5,1,4,3.26293640790055,3.1863546366767,0.0765817712238572,24,32,-8,33,41,-8,43,54,-11,2,4,0,0
"23030","VAN","EDM",2018020511,17881,20182019,1,60,4,2,2,4.75097508945328,1.83965713013913,2.91131795931415,30,22,8,41,30,11,45,52,-7,5,1,0,0
"23031","VAN","T.B",2018020526,17883,20182019,1,60,2,5,-3,4.62069646242104,5.49189536314952,-0.871198900728481,38,37,1,46,47,-1,63,63,0,8,6,0,0
"23032","VAN","WPG",2018020558,17887,20182019,1,60,0,1,-1,4.85573945850774,4.20713980612345,0.648599652384291,40,24,16,53,32,21,67,42,25,4,3,0,0
"23033","VAN","EDM",2018020576,17892,20182019,0,60,4,2,2,5.48921930401411,3.79081379729905,1.69840550671506,20,32,-12,28,46,-18,38,68,-30,1,3,0,0
"23034","VAN","N.J",2018020600,17896,20182019,0,60,0,4,-4,5.26639247662388,3.17397683373498,2.09241564288889,25,23,2,38,32,6,56,40,16,4,3,0,0
"23035","VAN","MTL",2018020626,17899,20182019,0,60,0,2,-2,2.7701634868572,4.44598528080678,-1.67582179394958,33,27,6,45,38,7,67,56,11,5,3,0,0
"23036","VAN","TOR",2018020639,17901,20182019,0,60,0,5,-5,3.65235395377385,4.29445549274169,-0.642101538967836,28,34,-6,40,50,-10,58,69,-11,3,0,0,0
"23037","VAN","ARI",2018020680,17906,20182019,1,64.1666666666667,3,4,-1,4.55407863666414,4.55710693262517,-0.00302829596103926,36,22,14,49,30,19,65,41,24,2,2,0,0
"23038","VAN","EDM",2018020724,17912,20182019,1,65,2,2,0,2.8076087103691,4.00394851989236,-1.19633980952327,22,30,-8,31,43,-12,48,58,-10,5,4,0,0
"23039","VAN","CAR",2018020770,17919,20182019,1,60,2,5,-3,2.96132818023784,3.05249439945328,-0.0911662192154381,26,34,-8,39,49,-10,50,64,-14,3,7,0,0
"23040","VAN","COL",2018020800,17929,20182019,0,60,5,1,4,3.08966796376469,3.47844641597476,-0.388778452210073,26,35,-9,37,47,-10,45,68,-23,2,3,0,0
"23041","VAN","PHI",2018020807,17931,20182019,0,60,1,2,-1,5.37670571958055,4.49633264108815,0.880373078492396,42,30,12,53,40,13,83,50,33,3,3,0,0
"23042","VAN","CHI",2018020834,17934,20182019,0,63.35,3,4,-1,6.32243739213628,4.74178879091869,1.58064860121759,43,35,8,58,47,11,73,62,11,5,5,0,0
"23043","VAN","CGY",2018020850,17936,20182019,1,65,3,3,0,2.37919933062494,4.10646937882811,-1.72727004820317,25,47,-22,39,61,-22,56,77,-21,6,5,0,0
"23044","VAN","S.J",2018020862,17938,20182019,1,60,2,7,-5,2.44193592707254,3.50808587531674,-1.0661499482442,27,24,3,41,38,3,52,51,1,3,4,0,0
"23045","VAN","ANA",2018020876,17940,20182019,0,60,0,1,-1,5.48328406535813,1.55384993824931,3.92943412710882,35,22,13,50,31,19,73,43,30,5,4,0,0
"23046","VAN","L.A",2018020886,17941,20182019,0,65,3,3,0,6.25054943466185,4.36417359873303,1.88637583592882,27,38,-11,41,53,-12,54,64,-10,2,3,0,0
"23047","VAN","S.J",2018020902,17943,20182019,0,60,2,3,-1,2.07002955912026,4.7142386532505,-2.64420909413025,34,26,8,45,42,3,62,63,-1,4,4,0,0
"23048","VAN","ARI",2018020939,17948,20182019,1,61.9,2,3,-1,4.38745643256698,5.42621052939649,-1.03875409682951,32,38,-6,51,51,0,64,66,-2,3,2,0,0
"23049","VAN","NYI",2018020955,17950,20182019,1,60,0,4,-4,5.0357375870943,4.4731764443568,0.562561142737508,36,23,13,50,28,22,75,36,39,4,1,0,0
"23050","VAN","ANA",2018020967,17952,20182019,1,60,4,0,4,5.4175357419299,5.33966260755551,0.0778731343743857,29,29,0,51,42,9,69,56,13,2,2,0,0
"23051","VAN","COL",2018020982,17954,20182019,0,65,2,2,0,7.07688646188974,6.52085360140175,0.556032860487996,32,45,-13,42,53,-11,60,70,-10,6,4,0,0
"23052","VAN","ARI",2018020988,17955,20182019,0,60,2,5,-3,7.63025742745072,3.5090867898184,4.12117063763231,39,24,15,60,39,21,79,50,29,4,4,0,0
"23053","VAN","VGK",2018021011,17958,20182019,0,60,0,3,-3,5.90731522417627,6.64216583876987,-0.734850614593597,19,48,-29,30,68,-38,47,89,-42,0,2,0,0
"23054","VAN","TOR",2018021030,17961,20182019,1,63.1833333333333,3,2,1,4.35161218353511,6.19063540317967,-1.83902321964456,31,30,1,55,39,16,79,58,21,4,2,0,0
"23055","VAN","EDM",2018021040,17962,20182019,0,60,2,3,-1,4.10369809411128,3.46008394898672,0.643614145124559,37,34,3,54,43,11,79,55,24,4,3,0,0
"23056","VAN","VGK",2018021059,17964,20182019,1,60,2,6,-4,3.58975352961761,2.37584195154614,1.21391157807147,31,33,-2,39,40,-1,49,58,-9,1,2,0,0
"23057","VAN","NYR",2018021082,17968,20182019,1,60,4,1,3,3.12477968430176,3.42243435587307,-0.297654671571308,28,22,6,35,32,3,43,42,1,3,5,0,0
"23058","VAN","N.J",2018021098,17970,20182019,1,65,2,2,0,4.59269117156509,3.84744038109784,0.745250790467253,27,33,-6,42,41,1,55,58,-3,5,1,0,0
"23059","VAN","DAL",2018021114,17972,20182019,0,65,2,2,0,5.18395122420043,6.39329235056112,-1.20934112636069,27,46,-19,40,62,-22,58,87,-29,3,2,0,0
"23060","VAN","CHI",2018021119,17973,20182019,0,60.2666666666667,3,2,1,3.83216302586112,5.29536737367744,-1.46320434781631,34,31,3,40,41,-1,50,59,-9,1,3,0,0
"23061","VAN","CGY",2018021161,17978,20182019,1,60,1,3,-2,4.3035895396024,5.39729316691228,-1.09370362730988,28,31,-3,41,49,-8,51,62,-11,4,6,0,0
"23062","VAN","CBJ",2018021168,17979,20182019,1,60,0,5,-5,3.01402858108637,3.31518364890871,-0.301155067822346,21,33,-12,34,42,-8,47,54,-7,4,2,0,0
"23063","VAN","ANA",2018021183,17981,20182019,1,60,4,5,-1,6.44405807165276,1.6871180182352,4.75694005341757,32,24,8,43,31,12,55,42,13,1,3,0,0
"23064","VAN","L.A",2018021195,17983,20182019,1,65,2,2,0,4.2186429826376,5.13647993348422,-0.917836950846628,38,39,-1,50,59,-9,71,78,-7,2,5,0,0
"23065","VAN","DAL",2018021213,17985,20182019,1,65,2,2,0,4.09015583642758,6.3897557198249,-2.29959988339732,31,40,-9,44,53,-9,53,70,-17,4,3,0,0
"23066","VAN","S.J",2018021237,17988,20182019,1,60,4,2,2,5.64529592574973,4.0280450603459,1.61725086540383,23,35,-12,34,49,-15,46,61,-15,2,4,0,0
"23067","VGK","DAL",2017020015,17445,20172018,0,60,2,1,1,4.00585791841149,5.64809380153073,-1.64223588311924,30,46,-16,41,57,-16,61,75,-14,8,5,0,0
"23068","VGK","ARI",2017020026,17446,20172018,0,63.7666666666667,2,1,1,5.92849818004002,2.35196163258962,3.5765365474504,42,28,14,61,41,20,85,57,28,4,3,0,0
"23069","VGK","ARI",2017020045,17449,20172018,1,60,5,2,3,2.59182501066243,3.79063542678516,-1.19881041612273,28,33,-5,38,43,-5,54,57,-3,3,3,0,0
"23070","VGK","DET",2017020062,17452,20172018,1,60,3,6,-3,3.60558960778872,4.67685186478775,-1.07126225699903,27,27,0,45,36,9,55,46,9,4,2,0,0
"23071","VGK","BOS",2017020077,17454,20172018,1,60,3,1,2,4.36476045128678,3.52856662434442,0.83619382694236,26,22,4,41,34,7,54,44,10,5,3,0,0
"23072","VGK","BUF",2017020090,17456,20172018,1,63.8666666666667,5,4,1,3.73359883284138,5.92062322725044,-2.18702439440906,31,34,-3,43,53,-10,61,70,-9,5,5,0,0
"23073","VGK","STL",2017020121,17460,20172018,1,64.6,3,2,1,3.80464812805667,8.04154405314148,-4.23689592508481,22,49,-27,38,61,-23,47,79,-32,4,5,0,0
"23074","VGK","CHI",2017020135,17463,20172018,1,60,4,2,2,5.38322110479159,3.76509257761063,1.61812852718096,33,31,2,49,39,10,67,56,11,5,3,0,0
"23075","VGK","COL",2017020149,17466,20172018,1,60,7,0,7,1.46267822786467,4.33370111407351,-2.87102288620883,21,32,-11,38,42,-4,51,56,-5,5,4,0,0
"23076","VGK","NYI",2017020170,17469,20172018,0,60,3,6,-3,3.93707767461683,6.60148552322607,-2.66440784860924,34,30,4,45,40,5,68,54,14,5,5,0,0
"23077","VGK","NYR",2017020178,17470,20172018,0,60,4,6,-2,2.91652445117143,5.84573624184122,-2.9292117906698,34,38,-4,45,52,-7,58,66,-8,4,5,0,0
"23078","VGK","BOS",2017020186,17472,20172018,0,60,1,2,-1,3.16410297351734,3.92043007276483,-0.756327099247487,29,28,1,38,41,-3,51,61,-10,3,1,0,0
"23079","VGK","OTT",2017020200,17474,20172018,0,60,5,4,1,3.14839901294272,5.32333986668746,-2.17494085374474,34,28,6,47,45,2,58,63,-5,6,3,0,0
"23080","VGK","TOR",2017020218,17476,20172018,0,65,3,3,0,7.59627977624348,4.25389398406821,3.34238579217526,28,25,3,47,33,14,59,52,7,3,4,0,0
"23081","VGK","MTL",2017020229,17477,20172018,0,60,2,3,-1,9.31282020394377,5.07178899575956,4.24103120818421,31,28,3,48,41,7,65,51,14,2,2,0,0
"23082","VGK","WPG",2017020248,17480,20172018,1,60,5,2,3,1.96765954518045,3.64201941678766,-1.67435987160722,27,29,-2,37,42,-5,52,60,-8,4,6,0,0
"23083","VGK","EDM",2017020273,17484,20172018,0,60,2,8,-6,4.57225283421576,5.91243887750898,-1.34018604329322,24,32,-8,35,44,-9,46,54,-8,5,4,0,0
"23084","VGK","VAN",2017020287,17486,20172018,0,60,5,2,3,7.80807342443326,2.75711006447091,5.05096335996235,30,21,9,41,30,11,52,48,4,0,2,0,0
"23085","VGK","L.A",2017020308,17489,20172018,1,60,4,2,2,5.01999307063976,2.66655515458842,2.35343791605133,40,29,11,51,34,17,71,52,19,1,1,0,0
"23086","VGK","ANA",2017020332,17492,20172018,0,60,4,2,2,6.11641109480115,2.9161974280978,3.20021366670335,49,19,30,61,30,31,76,39,37,3,4,0,0
"23087","VGK","S.J",2017020347,17494,20172018,1,61.35,5,4,1,5.34144222883333,3.80866296511394,1.53277926371939,33,26,7,43,39,4,62,61,1,4,2,0,0
"23088","VGK","ARI",2017020355,17495,20172018,0,60,4,2,2,6.14342838482779,3.43789602175457,2.70553236307322,28,26,2,41,40,1,54,63,-9,4,5,0,0
"23089","VGK","DAL",2017020376,17498,20172018,1,60,0,3,-3,3.84632638312011,3.62797517864965,0.218351204470459,34,30,4,42,37,5,54,48,6,3,4,0,0
"23090","VGK","MIN",2017020384,17500,20172018,0,60,2,4,-2,3.29737757473049,6.25298646078727,-2.95560888605678,31,32,-1,41,45,-4,59,57,2,3,2,0,0
"23091","VGK","WPG",2017020394,17501,20172018,0,60,4,7,-3,0,0,0,31,38,-7,43,55,-12,62,66,-4,5,5,0,0
"23092","VGK","ARI",2017020411,17503,20172018,1,63.85,3,2,1,6.65742853228585,8.15941230020326,-1.50198376791741,45,33,12,66,50,16,88,63,25,1,2,0,0
"23093","VGK","ANA",2017020424,17505,20172018,1,65,3,3,0,4.96365007042186,2.44620615440862,2.51744391601324,43,29,14,57,36,21,75,53,22,4,2,0,0
"23094","VGK","NSH",2017020441,17508,20172018,0,65,3,3,0,4.29488634358859,3.99941456015222,0.295471783436369,39,44,-5,51,53,-2,66,67,-1,5,5,0,0
"23095","VGK","DAL",2017020452,17509,20172018,0,60,5,3,2,3.3645138231857,4.39904687027501,-1.03453304708931,39,39,0,43,45,-2,60,70,-10,2,3,0,0
"23096","VGK","CAR",2017020474,17512,20172018,1,65,2,2,0,2.28425552805675,4.53729045779619,-2.25303492973944,24,37,-13,30,44,-14,43,59,-16,3,4,0,0
"23097","VGK","PIT",2017020490,17514,20172018,1,60,2,1,1,3.93717616648417,3.10316072776914,0.834015438715031,26,25,1,41,34,7,57,56,1,2,3,0,0
"23098","VGK","FLA",2017020510,17517,20172018,1,60,5,2,3,6.7066894987986,2.24544545239473,4.46124404640386,40,18,22,58,30,28,73,43,30,4,3,0,0
"23099","VGK","T.B",2017020525,17519,20172018,1,60,4,3,1,5.08184183281264,5.89707148382149,-0.815229651008849,36,38,-2,49,46,3,68,63,5,5,4,0,0
"23100","VGK","WSH",2017020555,17523,20172018,1,60,3,0,3,2.19896690211447,4.75085811328609,-2.55189121117161,28,26,2,39,38,1,49,63,-14,2,4,0,0
"23101","VGK","ANA",2017020568,17527,20172018,0,60,4,1,3,5.89813366252929,3.69769398551625,2.20043967701304,28,28,0,43,46,-3,56,64,-8,2,2,0,0
"23102","VGK","L.A",2017020574,17528,20172018,0,63.5,3,2,1,5.13294678955572,5.54093290935089,-0.407986119795169,39,28,11,55,39,16,67,59,8,6,2,0,0
"23103","VGK","TOR",2017020593,17531,20172018,1,60,6,3,3,5.12641811899084,4.73705969657749,0.389358422413352,31,23,8,40,41,-1,55,59,-4,3,3,0,0
"23104","VGK","NSH",2017020613,17533,20172018,1,60,3,0,3,3.87882334433925,2.70361484633759,1.17520849800167,31,29,2,42,44,-2,55,60,-5,1,2,0,0
"23105","VGK","STL",2017020621,17535,20172018,0,60,1,2,-1,4.26351719524246,5.13268404061819,-0.86916684537573,33,39,-6,43,51,-8,68,67,1,1,2,0,0
"23106","VGK","CHI",2017020632,17536,20172018,0,60,5,4,1,4.55645732831908,2.98244001378589,1.57401731453319,43,32,11,55,40,15,59,53,6,2,2,0,0
"23107","VGK","NYR",2017020651,17538,20172018,1,60,2,1,1,3.70847037748899,7.46202193619683,-3.75355155870784,34,29,5,40,42,-2,64,51,13,1,2,0,0
"23108","VGK","EDM",2017020676,17544,20172018,1,60.8833333333333,2,3,-1,4.30753898876856,4.87880105446806,-0.5712620656995,36,30,6,49,33,16,65,36,29,6,3,0,0
"23109","VGK","NSH",2017020691,17547,20172018,0,60,0,1,-1,5.13657099672128,5.70126640100735,-0.564695404286073,43,27,16,58,39,19,81,56,25,4,2,0,0
"23110","VGK","T.B",2017020701,17549,20172018,0,60,4,1,3,5.00844792989665,4.99170529268791,0.0167426372087363,30,29,1,45,36,9,62,45,17,4,5,0,0
"23111","VGK","FLA",2017020705,17550,20172018,0,60.6666666666667,3,4,-1,6.06747301965515,2.62074458842476,3.4467284312304,36,26,10,52,32,20,75,40,35,3,1,0,0
"23112","VGK","CAR",2017020722,17552,20172018,0,60,5,1,4,6.79976506857201,5.12777399492946,1.67199107364255,33,28,5,47,44,3,53,58,-5,5,5,0,0
"23113","VGK","CBJ",2017020741,17554,20172018,1,60,6,3,3,5.30599912197795,4.70931646075504,0.596682661222911,38,32,6,48,47,1,64,60,4,4,4,0,0
"23114","VGK","NYI",2017020758,17556,20172018,1,60,1,2,-1,5.77917846181663,2.3022942427524,3.47688421906423,39,25,14,54,32,22,74,39,35,2,1,0,0
"23115","VGK","CGY",2017020771,17561,20172018,0,60,4,2,2,6.099664874527,3.64718249836005,2.45248237616694,35,33,2,50,56,-6,63,78,-15,2,3,0,0
"23116","VGK","WPG",2017020783,17563,20172018,0,63.95,3,2,1,5.73923844989622,4.82979847881506,0.909439971081156,31,28,3,47,44,3,64,58,6,2,3,0,0
"23117","VGK","MIN",2017020791,17564,20172018,0,60,2,5,-3,5.69843988865614,6.91965419071494,-1.2212143020588,24,36,-12,35,50,-15,49,65,-16,3,4,0,0
"23118","VGK","WSH",2017020805,17566,20172018,0,60,4,3,1,8.37053767150285,2.92294074816164,5.44759692334121,31,23,8,49,31,18,66,43,23,1,2,0,0
"23119","VGK","PIT",2017020813,17568,20172018,0,60,4,5,-1,2.81899426994399,4.57993891570136,-1.76094464575736,25,38,-13,36,50,-14,52,60,-8,3,5,0,0
"23120","VGK","S.J",2017020834,17570,20172018,0,60,5,3,2,3.1368938259111,5.48419515698435,-2.34730133107325,33,38,-5,51,45,6,65,56,9,5,4,0,0
"23121","VGK","PHI",2017020859,17573,20172018,1,60,1,4,-3,6.69603817164898,3.78858893111572,2.90744924053326,39,18,21,54,26,28,64,34,30,1,0,0,0
"23122","VGK","CHI",2017020874,17575,20172018,1,60,5,2,3,6.81513323204126,3.90818194072053,2.90695129132073,37,31,6,51,43,8,67,61,6,7,4,0,0
"23123","VGK","EDM",2017020888,17577,20172018,1,60,4,1,3,2.87431369486148,6.95554123826878,-4.08122754340729,28,29,-1,31,43,-12,52,58,-6,2,1,0,0
"23124","VGK","MTL",2017020900,17579,20172018,1,60,6,3,3,4.50305407455381,3.99922926758882,0.503824806964994,34,33,1,43,47,-4,59,65,-6,2,2,0,0
"23125","VGK","ANA",2017020917,17581,20172018,1,60,0,2,-2,5.55025305750314,2.23831579416805,3.3119372633351,33,20,13,48,33,15,73,41,32,3,1,0,0
"23126","VGK","CGY",2017020929,17583,20172018,1,60,7,3,4,3.87032465563971,6.8866210313281,-3.0162963756884,26,31,-5,33,47,-14,45,66,-21,4,3,0,0
"23127","VGK","VAN",2017020945,17585,20172018,1,60,6,3,3,5.02009969554513,5.54771618568338,-0.527616490138257,34,33,1,46,47,-1,61,61,0,2,3,0,0
"23128","VGK","L.A",2017020968,17588,20172018,0,63.2333333333333,2,3,-1,4.78512542303133,7.32649157219566,-2.54136614916433,39,44,-5,51,57,-6,63,67,-4,4,5,0,0
"23129","VGK","L.A",2017020976,17589,20172018,1,60,1,4,-3,3.04439461993052,2.45572764149199,0.588666978438539,42,30,12,52,37,15,70,47,23,4,6,0,0
"23130","VGK","OTT",2017020998,17592,20172018,1,60,4,5,-1,5.68745068483986,6.06532818769762,-0.377877502857757,29,38,-9,36,47,-11,58,60,-2,2,5,0,0
"23131","VGK","N.J",2017021011,17594,20172018,0,60,3,2,1,3.52181698905122,5.04743505231454,-1.52561806326332,27,35,-8,43,48,-5,51,57,-6,2,3,0,0
"23132","VGK","CBJ",2017021023,17596,20172018,0,60,1,4,-3,6.53466657023321,5.48503027828632,1.0496362919469,38,21,17,46,39,7,62,47,15,3,3,0,0
"23133","VGK","DET",2017021036,17598,20172018,0,60,4,0,4,3.34227462191484,3.86311861744048,-0.520843995525638,32,28,4,43,44,-1,53,52,1,4,3,0,0
"23134","VGK","BUF",2017021049,17600,20172018,0,65,1,1,0,5.86214011808852,4.83511139738201,1.02702872070651,34,32,2,43,51,-8,58,58,0,2,2,0,0
"23135","VGK","PHI",2017021064,17602,20172018,0,60,3,2,1,3.86654104630642,4.40107061419985,-0.534529567893433,29,40,-11,40,58,-18,51,74,-23,2,4,0,0
"23136","VGK","N.J",2017021081,17604,20172018,1,60,3,8,-5,7.06480136088157,7.27588235846756,-0.211080997585981,42,28,14,58,42,16,84,51,33,5,2,0,0
"23137","VGK","MIN",2017021097,17606,20172018,1,60,2,4,-2,7.2977176271088,5.17269960380509,2.12501802330371,28,30,-2,56,43,13,74,58,16,3,3,0,0
"23138","VGK","CGY",2017021109,17608,20172018,1,60,4,0,4,3.62229249241521,8.22582707274114,-4.60353458032593,31,42,-11,40,56,-16,50,67,-17,4,4,0,0
"23139","VGK","VAN",2017021130,17610,20172018,1,60,4,1,3,4.02075101755327,6.47871962551653,-2.45796860796327,28,30,-2,44,50,-6,57,67,-10,3,1,0,0
"23140","VGK","S.J",2017021145,17612,20172018,0,60.65,1,2,-1,3.88949061877065,6.05302668413788,-2.16353606536723,25,44,-19,36,59,-23,49,80,-31,2,5,0,0
"23141","VGK","COL",2017021151,17614,20172018,0,65,1,1,0,3.95763392023349,4.41270842824815,-0.455074508014663,40,30,10,47,42,5,61,60,1,1,4,0,0
"23142","VGK","COL",2017021175,17616,20172018,1,60,4,1,3,7.16642822480935,1.6371441938536,5.52928403095575,30,29,1,42,41,1,62,54,8,3,3,0,0
"23143","VGK","ARI",2017021189,17618,20172018,1,60,2,3,-1,4.48654290055856,5.90169174895709,-1.41514884839853,29,32,-3,46,40,6,65,56,9,5,3,0,0
"23144","VGK","STL",2017021205,17620,20172018,1,60.3666666666667,4,3,1,2.45797495717125,4.62727120798081,-2.16929625080957,26,24,2,33,34,-1,49,53,-4,1,2,0,0
"23145","VGK","S.J",2017021217,17621,20172018,1,60,3,2,1,6.06928222762053,4.81179741254891,1.25748481507162,38,31,7,56,39,17,79,54,25,4,2,0,0
"23146","VGK","VAN",2017021236,17624,20172018,0,65,4,4,0,5.41204497691069,3.58513499725655,1.82690997965415,39,25,14,53,35,18,69,50,19,4,2,0,0
"23147","VGK","EDM",2017021249,17626,20172018,0,60,3,4,-1,3.28441947603551,4.53409239789471,-1.2496729218592,33,33,0,49,47,2,56,54,2,2,3,0,0
"23148","VGK","CGY",2017021268,17628,20172018,0,60,1,7,-6,3.69211339180401,7.12675423453493,-3.43464084273091,27,31,-4,42,45,-3,60,60,0,3,5,0,0
"23149","VGK","L.A",2017030171,17632,20172018,1,60,1,0,1,4.62462258084277,5.53072647225054,-0.906103891407767,28,30,-2,51,40,11,73,53,20,3,3,0,0
"23150","VGK","L.A",2017030172,17634,20172018,1,80,1,1,0,5.37462945338098,3.16948543605395,2.20514401732703,47,27,20,63,40,23,90,61,29,3,3,0,0
"23151","VGK","L.A",2017030173,17636,20172018,0,60,3,2,1,6.05589776813714,4.54039360496972,1.51550416316742,26,39,-13,46,51,-5,65,69,-4,5,6,0,0
"23152","VGK","L.A",2017030174,17638,20172018,0,60,1,0,1,3.59764738914964,5.12555184142548,-1.52790445227583,21,31,-10,34,47,-13,41,67,-26,1,2,0,0
"23153","VGK","S.J",2017030241,17647,20172018,1,60,7,0,7,6.43993411085464,4.82443754474058,1.61549656611405,34,33,1,55,41,14,68,67,1,8,5,0,0
"23154","VGK","S.J",2017030242,17649,20172018,1,80,3,3,0,2.82739838794636,4.75358726275385,-1.9261888748075,28,42,-14,44,60,-16,77,83,-6,6,9,0,0
"23155","VGK","S.J",2017030243,17651,20172018,0,68.2833333333333,4,3,1,4.65876994561222,6.68193330189774,-2.02316335628552,33,42,-9,52,49,3,75,66,9,6,4,0,0
"23156","VGK","S.J",2017030244,17653,20172018,0,60,0,4,-4,4.63726213751364,3.73369535422671,0.903566783286934,34,34,0,43,46,-3,62,59,3,6,6,0,0
"23157","VGK","S.J",2017030245,17655,20172018,1,60,5,3,2,5.85715982491337,5.75704617072257,0.100113654190795,39,30,9,53,39,14,71,63,8,5,4,0,0
"23158","VGK","S.J",2017030246,17657,20172018,0,60,3,0,3,4.80750350535503,5.4478014439997,-0.640297938644669,33,28,5,41,46,-5,55,68,-13,1,2,0,0
"23159","VGK","WPG",2017030321,17663,20172018,0,60,2,4,-2,2.99201473311405,3.43775485752603,-0.445740124411984,21,26,-5,35,35,0,57,45,12,4,6,0,0
"23160","VGK","WPG",2017030322,17665,20172018,0,60,3,1,2,3.62984557170557,3.34925411375298,0.280591457952596,28,31,-3,42,48,-6,57,69,-12,3,4,0,0
"23161","VGK","WPG",2017030323,17667,20172018,1,60,4,2,2,4.29364429295777,5.59134096393245,-1.29769667097469,30,35,-5,38,50,-12,56,68,-12,11,9,0,0
"23162","VGK","WPG",2017030324,17669,20172018,1,60,3,2,1,3.86540488953324,8.47547784518974,-4.61007295565651,29,37,-8,41,60,-19,59,85,-26,2,4,0,0
"23163","VGK","WPG",2017030325,17671,20172018,0,60,2,1,1,3.27880295285689,5.58609871682711,-2.30729576397022,32,32,0,42,50,-8,57,59,-2,2,4,0,0
"23164","VGK","WSH",2017030411,17679,20172018,1,60,6,4,2,5.91179841401754,7.85315020955022,-1.94135179553268,34,28,6,49,51,-2,67,68,-1,2,2,0,0
"23165","VGK","WSH",2017030412,17681,20172018,1,60,2,3,-1,5.73870313446969,4.74362176517025,0.995081369299442,39,26,13,51,36,15,69,44,25,7,4,0,0
"23166","VGK","WSH",2017030413,17684,20172018,0,60,1,3,-2,3.64433936870102,4.53916516144454,-0.894825792743524,22,26,-4,36,49,-13,62,58,4,2,4,0,0
"23167","VGK","WSH",2017030414,17686,20172018,0,60,2,6,-4,3.63391792942741,4.85515129251871,-1.22123336309131,30,23,7,47,33,14,71,41,30,5,6,0,0
"23168","VGK","WSH",2017030415,17689,20172018,1,60,3,4,-1,6.46367479409173,3.31678769353684,3.14688710055489,31,33,-2,41,44,-3,54,55,-1,4,6,0,0
"23169","VGK","PHI",2018020014,17808,20182019,1,60,2,5,-3,2.97540891907568,4.83838565915357,-1.8629767400779,25,25,0,40,31,9,52,41,11,4,5,0,0
"23170","VGK","MIN",2018020025,17810,20182019,0,65,1,1,0,6.81923726520389,6.93143184343489,-0.112194578231005,42,30,12,60,45,15,78,49,29,3,2,0,0
"23171","VGK","BUF",2018020034,17812,20182019,0,60,2,4,-2,3.71973446196492,4.69622183519095,-0.976487373226037,37,17,20,53,29,24,67,35,32,2,2,0,0
"23172","VGK","WSH",2018020043,17814,20182019,0,60,2,5,-3,4.47596802774251,8.35961739700713,-3.88364936926462,31,29,2,48,43,5,68,51,17,3,4,0,0
"23173","VGK","PIT",2018020050,17815,20182019,0,60,2,4,-2,3.29472839835216,3.09604921345925,0.19867918489291,37,22,15,49,31,18,76,41,35,2,1,0,0
"23174","VGK","PHI",2018020058,17817,20182019,0,60,1,0,1,3.21771587169496,2.65889571429864,0.558820157396326,21,26,-5,35,38,-3,52,55,-3,3,2,0,0
"23175","VGK","BUF",2018020085,17820,20182019,1,60,4,1,3,4.49431705977622,3.32779715440455,1.16651990537167,29,27,2,35,33,2,58,51,7,3,6,0,0
"23176","VGK","ANA",2018020113,17824,20182019,1,60,3,1,2,6.51842180769017,3.28807528780507,3.2303465198851,45,18,27,53,28,25,75,49,26,5,2,0,0
"23177","VGK","VAN",2018020133,17828,20182019,1,65,2,2,0,7.07968577678548,4.06095211139109,3.01873366539439,35,26,9,48,34,14,68,47,21,4,2,0,0
"23178","VGK","T.B",2018020144,17830,20182019,1,60,2,3,-1,4.37445867004917,2.01945645934824,2.35500221070093,31,23,8,47,30,17,74,45,29,4,2,0,0
"23179","VGK","OTT",2018020163,17832,20182019,1,62.4,4,3,1,8.18906412515472,3.31911035526551,4.86995376988921,53,22,31,68,29,39,97,39,58,5,3,0,0
"23180","VGK","NSH",2018020173,17834,20182019,0,60,1,4,-3,3.37932045420797,3.7992059854276,-0.419885531219627,24,29,-5,34,42,-8,46,52,-6,4,4,0,0
"23181","VGK","STL",2018020186,17836,20182019,0,60,3,5,-2,3.78408061775281,2.23236850589751,1.5517121118553,34,26,8,48,33,15,72,45,27,4,4,0,0
"23182","VGK","CAR",2018020204,17838,20182019,1,60,3,0,3,4.94192437968104,2.74461966415519,2.19730471552585,25,34,-9,42,45,-3,57,73,-16,4,3,0,0
"23183","VGK","TOR",2018020215,17841,20182019,0,60,1,3,-2,6.12947308845105,4.45975583700056,1.66971725145049,37,21,16,62,29,33,82,40,42,3,1,0,0
"23184","VGK","OTT",2018020231,17843,20182019,0,60,5,3,2,4.37750307635457,4.33881944789027,0.0386836284642982,42,30,12,57,45,12,81,58,23,2,2,0,0
"23185","VGK","MTL",2018020246,17845,20182019,0,60,4,5,-1,5.40877822400395,4.24583990644896,1.16293831755499,38,27,11,47,36,11,58,59,-1,3,2,0,0
"23186","VGK","BOS",2018020256,17846,20182019,0,60,1,4,-3,2.41577260686471,5.09530265891374,-2.67953005204902,38,37,1,48,51,-3,55,59,-4,4,7,0,0
"23187","VGK","ANA",2018020276,17849,20182019,1,60,5,0,5,3.37402182676669,3.85484132590139,-0.480819499134697,26,29,-3,38,44,-6,55,77,-22,6,4,0,0
"23188","VGK","STL",2018020290,17851,20182019,1,60,1,4,-3,4.94176909720039,3.99968399980571,0.942085097394681,33,35,-2,50,47,3,68,58,10,4,5,0,0
"23189","VGK","EDM",2018020306,17853,20182019,0,60,6,3,3,4.30520249426627,4.16721730842255,0.137985185843718,31,32,-1,41,42,-1,65,51,14,3,3,0,0
"23190","VGK","CGY",2018020315,17854,20182019,0,60,2,7,-5,3.67138846943632,4.093281289679,-0.421892820242682,22,32,-10,37,42,-5,49,55,-6,2,6,0,0
"23191","VGK","ARI",2018020328,17856,20182019,0,63.6,3,2,1,3.19458278327498,3.41927816346647,-0.224695380191491,25,21,4,38,33,5,58,44,14,2,3,0,0
"23192","VGK","CGY",2018020338,17858,20182019,1,60,2,0,2,3.44943400505872,3.01280495147876,0.436629053579964,28,29,-1,42,39,3,54,58,-4,4,2,0,0
"23193","VGK","S.J",2018020356,17859,20182019,1,60,6,0,6,2.55109581747047,3.48623142213885,-0.935135604668377,36,33,3,43,46,-3,60,62,-2,8,5,0,0
"23194","VGK","CHI",2018020374,17862,20182019,0,60,8,3,5,5.54235251341015,3.24255421785347,2.29979829555668,43,24,19,52,33,19,65,38,27,3,2,0,0
"23195","VGK","VAN",2018020389,17864,20182019,0,60,4,3,1,6.14171541843098,4.6131180366865,1.52859738174448,31,36,-5,43,41,2,52,54,-2,2,3,0,0
"23196","VGK","EDM",2018020406,17866,20182019,0,60,1,2,-1,4.37630730144834,3.20599454177281,1.17031275967553,32,34,-2,55,44,11,76,58,18,3,3,0,0
"23197","VGK","WSH",2018020424,17869,20182019,1,60,5,3,2,5.42850379747874,3.47988744006581,1.94861635741293,28,26,2,37,37,0,54,51,3,5,3,0,0
"23198","VGK","CHI",2018020438,17871,20182019,1,60,4,3,1,4.25399174236895,4.35081989638275,-0.0968281540137923,36,35,1,49,57,-8,60,79,-19,2,4,0,0
"23199","VGK","L.A",2018020445,17873,20182019,0,60,1,5,-4,3.03136896887372,6.12570744025288,-3.09433847137916,30,25,5,41,36,5,53,41,12,3,1,0,0
"23200","VGK","DAL",2018020460,17874,20182019,1,60,4,2,2,2.97854540688443,2.71544920210231,0.263096204782122,28,24,4,45,30,15,65,39,26,5,3,0,0
"23201","VGK","NYI",2018020475,17877,20182019,0,60,3,2,1,3.40176177932881,2.47176443804346,0.929997341285343,17,25,-8,29,36,-7,41,51,-10,1,1,0,0
"23202","VGK","N.J",2018020487,17879,20182019,0,60.6833333333333,4,5,-1,1.64540313264092,6.35448712819561,-4.70908399555469,22,42,-20,31,58,-27,39,69,-30,3,5,0,0
"23203","VGK","NYR",2018020505,17881,20182019,0,62.1833333333333,4,3,1,3.48869153515261,6.60594577549585,-3.11725424034324,41,30,11,58,44,14,82,52,30,2,4,0,0
"23204","VGK","CBJ",2018020513,17882,20182019,0,60,0,1,-1,3.28617150557693,2.92432406567423,0.361847439902704,28,31,-3,36,40,-4,51,45,6,1,2,0,0
"23205","VGK","NYI",2018020540,17885,20182019,1,60,4,2,2,6.99697796086548,2.51378999307781,4.48318796778767,47,21,26,57,36,21,73,49,24,3,3,0,0
"23206","VGK","MTL",2018020549,17887,20182019,1,61.9833333333333,3,4,-1,4.64370352096739,7.69873612401716,-3.05503260304977,26,47,-21,41,71,-30,58,93,-35,2,2,0,0
"23207","VGK","L.A",2018020565,17888,20182019,1,61.6666666666667,3,4,-1,4.32318969600601,5.19341680518119,-0.870227109175175,25,32,-7,37,39,-2,53,54,-1,1,2,0,0
"23208","VGK","COL",2018020577,17892,20182019,1,60,2,1,1,9.70559210227673,5.0415055981025,4.66408650417423,43,32,11,56,42,14,79,58,21,4,4,0,0
"23209","VGK","L.A",2018020586,17894,20182019,0,60,4,1,3,5.4122161866643,2.50059128785506,2.91162489880924,32,31,1,50,41,9,67,51,16,1,2,0,0
"23210","VGK","ARI",2018020598,17895,20182019,0,60,5,1,4,4.40909520039393,4.10750212403877,0.301593076355152,37,30,7,49,43,6,64,61,3,3,6,0,0
"23211","VGK","L.A",2018020614,17897,20182019,1,60,2,0,2,6.63662918454156,1.57390825508628,5.06272092945528,48,17,31,66,21,45,88,37,51,3,2,0,0
"23212","VGK","ANA",2018020635,17900,20182019,0,60,3,2,1,5.46021540724338,4.01754941174295,1.44266599550044,42,27,15,64,37,27,77,50,27,2,3,0,0
"23213","VGK","N.J",2018020646,17902,20182019,1,60,3,2,1,2.15269634188735,5.88330359451356,-3.73060725262621,28,38,-10,39,45,-6,56,62,-6,2,2,0,0
"23214","VGK","NYR",2018020666,17904,20182019,1,60,4,2,2,3.71112276870299,2.35452894767831,1.35659382102468,31,29,2,44,41,3,53,59,-6,3,2,0,0
"23215","VGK","S.J",2018020681,17906,20182019,1,60,2,3,-1,4.97808520173817,2.63097478076816,2.34711042097001,38,27,11,46,38,8,66,60,6,3,2,0,0
"23216","VGK","CHI",2018020694,17908,20182019,0,61.3166666666667,4,3,1,4.01922688312334,5.3104420157033,-1.29121513257996,34,23,11,43,29,14,62,39,23,2,3,0,0
"23217","VGK","WPG",2018020718,17911,20182019,0,60,1,4,-3,5.43331575509728,4.80045858424273,0.63285717085455,44,27,17,58,37,21,70,44,26,6,2,0,0
"23218","VGK","PIT",2018020750,17915,20182019,1,60,7,3,4,4.74524286211567,4.05989368518567,0.685349176930004,35,37,-2,43,46,-3,63,56,7,2,2,0,0
"23219","VGK","MIN",2018020757,17917,20182019,1,60,2,4,-2,3.89918194594793,3.55125498003326,0.347926965914667,32,22,10,46,29,17,65,47,18,5,2,0,0
"23220","VGK","NSH",2018020768,17919,20182019,1,60,1,2,-1,4.61493127438456,2.24311052077449,2.37182075361008,48,27,21,64,36,28,84,53,31,6,4,0,0
"23221","VGK","CAR",2018020787,17928,20182019,0,60,2,5,-3,3.89461785997496,8.45361224802036,-4.55899438804541,25,32,-7,33,46,-13,49,63,-14,2,3,0,0
"23222","VGK","FLA",2018020793,17929,20182019,0,60,1,3,-2,4.99912367627257,5.51589604979381,-0.516772373521235,35,25,10,49,39,10,61,48,13,1,2,0,0
"23223","VGK","T.B",2018020816,17932,20182019,0,65,2,2,0,3.862837563491,3.80190025874475,0.060937304746254,37,26,11,47,38,9,60,53,7,3,5,0,0
"23224","VGK","DET",2018020830,17934,20182019,0,60,4,3,1,7.37169244387769,6.14742561539424,1.22426682848345,32,39,-7,44,52,-8,52,69,-17,2,4,0,0
"23225","VGK","CBJ",2018020851,17936,20182019,1,60,3,4,-1,2.33153764248709,4.85165948991198,-2.52012184742489,23,33,-10,29,43,-14,42,57,-15,2,3,0,0
"23226","VGK","ARI",2018020874,17939,20182019,1,60,2,5,-3,5.77208647118096,6.19330222697317,-0.421215755792218,43,26,17,50,36,14,63,58,5,2,3,0,0
"23227","VGK","TOR",2018020885,17941,20182019,1,60,3,6,-3,3.27945649866774,3.65468784075347,-0.375231342085729,33,43,-10,42,51,-9,58,66,-8,3,6,0,0
"23228","VGK","NSH",2018020901,17943,20182019,1,60,5,1,4,6.86005913300197,1.82119089033222,5.03886824266975,50,30,20,64,39,25,78,52,26,3,3,0,0
"23229","VGK","COL",2018020913,17945,20182019,0,60,0,3,-3,4.01608326377641,3.77986293059084,0.236220333185561,40,38,2,46,49,-3,66,56,10,4,3,0,0
"23230","VGK","BOS",2018020928,17947,20182019,1,65,2,2,0,6.59446057619149,5.45491054576269,1.13955003042881,33,27,6,56,35,21,76,53,23,2,3,0,0
"23231","VGK","WPG",2018020944,17949,20182019,1,60,3,6,-3,2.7064685964724,6.7608574731028,-4.0543888766304,32,29,3,42,39,3,60,56,4,3,4,0,0
"23232","VGK","DAL",2018020978,17953,20182019,1,60,4,1,3,10.0491647088929,2.96349958002247,7.08566512887046,48,24,24,65,33,32,95,51,44,4,3,0,0
"23233","VGK","FLA",2018020989,17955,20182019,1,65,5,5,0,4.65524915774552,3.75715467880946,0.898094478936059,46,37,9,60,44,16,80,48,32,2,5,0,0
"23234","VGK","ANA",2018020997,17956,20182019,0,60,3,0,3,5.78974935050792,6.0064794352802,-0.21673008477228,34,34,0,48,47,1,56,60,-4,2,2,0,0
"23235","VGK","VAN",2018021011,17958,20182019,1,60,3,0,3,6.64216583876987,5.90731522417627,0.734850614593597,48,19,29,68,30,38,89,47,42,2,0,0,0
"23236","VGK","CGY",2018021032,17961,20182019,1,60,2,1,1,5.10923986713624,3.50564681308416,1.60359305405209,38,34,4,48,39,9,66,56,10,6,5,0,0
"23237","VGK","VAN",2018021059,17964,20182019,0,60,6,2,4,2.37584195154614,3.58975352961761,-1.21391157807147,33,31,2,40,39,1,58,49,9,2,1,0,0
"23238","VGK","CGY",2018021063,17965,20182019,0,60,3,6,-3,3.72537488530297,5.71767991721551,-1.99230503191254,28,35,-7,45,43,2,58,51,7,3,3,0,0
"23239","VGK","DAL",2018021095,17970,20182019,0,60,2,1,1,3.78523609524018,2.98908173026223,0.796154364977951,37,41,-4,49,51,-2,68,69,-1,3,5,0,0
"23240","VGK","EDM",2018021117,17972,20182019,1,60,6,3,3,3.32264291118751,2.29458965881349,1.02805325237402,34,19,15,51,25,26,64,37,27,3,1,0,0
"23241","VGK","S.J",2018021121,17973,20182019,0,60,7,3,4,5.9255321062242,5.04041971697006,0.885112389254136,42,39,3,51,55,-4,56,69,-13,7,6,0,0
"23242","VGK","WPG",2018021146,17976,20182019,1,60,5,0,5,5.5701038638494,3.50794769756612,2.06215616628327,38,20,18,53,33,20,63,44,19,2,2,0,0
"23243","VGK","DET",2018021162,17978,20182019,1,60.3166666666667,2,3,-1,3.6271281912741,2.0239072645487,1.6032209267254,30,30,0,43,36,7,58,49,9,3,2,0,0
"23244","VGK","STL",2018021173,17980,20182019,0,60,1,3,-2,2.81752768389197,5.35018081178146,-2.5326531278895,25,22,3,41,33,8,59,41,18,1,1,0,0
"23245","VGK","COL",2018021188,17982,20182019,0,60,3,4,-1,4.19231461795516,3.71304513125754,0.479269486697627,37,30,7,51,35,16,69,40,29,5,4,0,0
"23246","VGK","MIN",2018021202,17984,20182019,1,60,2,3,-1,6.07809718049808,5.01072642809595,1.06737075240213,37,32,5,51,42,9,74,55,19,2,4,0,0
"23247","VGK","S.J",2018021211,17985,20182019,0,60.3666666666667,3,4,-1,3.52056990005647,5.57010974756849,-2.04953984751202,26,34,-8,35,42,-7,44,55,-11,5,6,0,0
"23248","VGK","EDM",2018021227,17987,20182019,1,60,3,1,2,5.04476878482819,2.06889049468637,2.97587829014182,31,19,12,49,28,21,67,44,23,2,2,0,0
"23249","VGK","ARI",2018021253,17990,20182019,1,60,1,4,-3,5.36852258251747,3.39534044645428,1.97318213606319,38,41,-3,46,47,-1,62,63,-1,2,3,0,0
"23250","VGK","L.A",2018021270,17992,20182019,0,60,2,5,-3,6.82909879283896,5.77250028458366,1.0565985082553,31,32,-1,46,43,3,62,59,3,2,3,0,0
"23251","VGK","S.J",2018030181,17996,20182019,0,60,2,5,-3,3.80955837666443,4.99834517601346,-1.18878679934903,26,33,-7,41,43,-2,57,64,-7,6,7,0,0
"23252","VGK","S.J",2018030182,17998,20182019,0,60,5,3,2,3.65247039918265,5.63195503648603,-1.97948463730338,23,37,-14,34,47,-13,44,73,-29,6,11,0,0
"23253","VGK","S.J",2018030183,18000,20182019,1,60,6,3,3,6.75685052006966,4.83980169526522,1.91704882480444,40,28,12,54,38,16,71,51,20,7,5,0,0
"23254","VGK","S.J",2018030184,18002,20182019,1,60,5,0,5,4.20515493194548,4.13899831946395,0.0661566124815334,27,28,-1,39,40,-1,51,60,-9,9,4,0,0
"23255","VGK","S.J",2018030185,18004,20182019,0,60,2,5,-3,5.01108600501902,4.97880306973821,0.0322829352808185,32,29,3,42,43,-1,60,64,-4,2,3,0,0
"23256","VGK","S.J",2018030186,18007,20182019,1,80,1,1,0,8.39380378457522,6.0608874955069,2.33291628906832,51,28,23,74,38,36,103,67,36,2,2,0,0
"23257","VGK","S.J",2018030187,18009,20182019,0,78.3166666666667,4,5,-1,3.04138986382895,6.26192426538182,-3.22053440155287,38,48,-10,47,63,-16,63,88,-25,2,4,0,0
"23258","WPG","MTL",2011020023,15256,20112012,1,60,1,5,-4,3.42051014259778,2.23256531530951,1.18794482728826,31,22,9,43,32,11,57,39,18,8,5,0,0
"23259","WPG","CHI",2011020045,15260,20112012,0,60,3,4,-1,6.13202587226624,4.12554443156114,2.0064814407051,30,32,-2,50,38,12,62,51,11,2,3,0,0
"23260","WPG","ARI",2011020055,15262,20112012,0,60,1,4,-3,1.96014383530746,4.88610802148503,-2.92596418617757,19,34,-15,33,50,-17,49,65,-16,4,4,0,0
"23261","WPG","PIT",2011020066,15264,20112012,1,60,2,1,1,5.68718605254605,3.88959488240653,1.79759117013953,34,29,5,53,39,14,61,50,11,6,4,0,0
"23262","WPG","TOR",2011020079,15266,20112012,0,65,3,3,0,5.61628796355217,2.95595580421559,2.66033215933658,29,23,6,45,33,12,59,48,11,4,4,0,0
"23263","WPG","OTT",2011020083,15267,20112012,0,60,1,4,-3,5.87108280745451,5.74922214820981,0.121860659244703,36,30,6,52,42,10,64,59,5,5,4,0,0
"23264","WPG","CAR",2011020103,15269,20112012,1,60,5,3,2,4.2136215762591,3.49515692148725,0.718464654771849,24,24,0,40,36,4,51,44,7,6,7,0,0
"23265","WPG","NYR",2011020112,15271,20112012,1,60,1,2,-1,2.55061306375137,3.22020010265987,-0.669587038908503,28,17,11,42,30,12,56,38,18,1,5,0,0
"23266","WPG","PHI",2011020128,15274,20112012,0,60,9,8,1,3.82897172954489,6.36543000518319,-2.5364582756383,25,48,-23,32,65,-33,43,84,-41,6,6,0,0
"23267","WPG","T.B",2011020146,15276,20112012,0,60,0,1,-1,5.20557400520568,3.38290073424287,1.82267327096281,28,27,1,37,39,-2,51,52,-1,2,4,0,0
"23268","WPG","FLA",2011020158,15278,20112012,0,65,3,3,0,4.74383457098156,3.74097621926558,1.00285835171599,31,42,-11,38,49,-11,47,69,-22,2,6,0,0
"23269","WPG","NYI",2011020168,15281,20112012,0,60,3,0,3,6.83041411414158,5.07803905842593,1.75237505571565,26,34,-8,40,48,-8,49,67,-18,0,3,0,0
"23270","WPG","N.J",2011020186,15283,20112012,0,61.4666666666667,2,3,-1,4.49014405451877,2.55836164770588,1.93178240681289,23,28,-5,31,33,-2,38,37,1,3,2,0,0
"23271","WPG","NYR",2011020197,15284,20112012,0,60,0,3,-3,3.24633274262305,5.32923739048542,-2.08290464786236,23,27,-4,35,42,-7,46,53,-7,4,6,0,0
"23272","WPG","BUF",2011020202,15286,20112012,0,64.5833333333333,5,6,-1,5.07992693270691,7.06326683016766,-1.98333989746076,31,45,-14,37,63,-26,44,80,-36,5,12,0,0
"23273","WPG","FLA",2011020217,15288,20112012,1,60,2,5,-3,2.54313096069657,6.7737500775676,-4.23061911687103,27,20,7,41,38,3,52,47,5,3,5,0,0
"23274","WPG","CBJ",2011020234,15290,20112012,0,60,1,2,-1,3.37516594028397,3.86308222384832,-0.487916283564349,36,27,9,43,38,5,59,53,6,5,4,0,0
"23275","WPG","T.B",2011020246,15292,20112012,1,60,5,2,3,4.76968454005818,5.25473287728892,-0.48504833723074,39,32,7,53,44,9,57,55,2,3,7,0,0
"23276","WPG","WSH",2011020267,15295,20112012,1,60,4,1,3,3.60240345539913,6.36575574651511,-2.76335229111598,31,32,-1,43,56,-13,48,67,-19,5,5,0,0
"23277","WPG","PHI",2011020274,15297,20112012,1,60,6,4,2,5.97266682317262,3.31132035019073,2.66134647298189,40,31,9,50,41,9,60,55,5,9,9,0,0
"23278","WPG","WSH",2011020304,15301,20112012,0,61.8666666666667,3,4,-1,5.45462604665423,7.05948713319958,-1.60486108654536,25,37,-12,37,51,-14,51,68,-17,3,4,0,0
"23279","WPG","CAR",2011020320,15303,20112012,0,60,3,1,2,5.99960748522981,3.4253013265261,2.57430615870372,30,21,9,47,48,-1,60,66,-6,1,4,0,0
"23280","WPG","BOS",2011020329,15304,20112012,0,60,2,4,-2,5.5138123894867,6.0172131023483,-0.503400712861598,42,36,6,46,46,0,58,55,3,4,6,0,0
"23281","WPG","OTT",2011020349,15307,20112012,1,60,4,6,-2,3.84264653583591,5.5957124545821,-1.75306591874619,43,34,9,55,50,5,61,59,2,6,5,0,0
"23282","WPG","ARI",2011020360,15309,20112012,1,60,1,0,1,3.81454000260675,5.59976272247752,-1.78522271987077,31,33,-2,45,46,-1,54,59,-5,3,2,0,0
"23283","WPG","N.J",2011020376,15311,20112012,1,60,4,2,2,4.32535721489694,4.60855701202672,-0.283199797129782,20,25,-5,28,43,-15,40,62,-22,3,5,0,0
"23284","WPG","BOS",2011020397,15314,20112012,1,60,2,1,1,5.1756486226077,4.285404700855,0.890243921752699,35,40,-5,47,52,-5,62,74,-12,4,4,0,0
"23285","WPG","CAR",2011020419,15317,20112012,1,60,4,2,2,4.60630895523003,3.62445451910889,0.981854436121139,37,25,12,45,39,6,61,60,1,5,5,0,0
"23286","WPG","DET",2011020426,15318,20112012,0,60,1,7,-6,2.4458287454172,3.09034442715347,-0.644515681736266,30,29,1,35,45,-10,47,57,-10,2,3,0,0
"23287","WPG","MIN",2011020446,15321,20112012,1,60,2,1,1,5.51435731704584,5.0936210815388,0.420736235507036,27,35,-8,50,50,0,62,62,0,4,3,0,0
"23288","WPG","WSH",2011020458,15323,20112012,1,60,0,1,-1,4.64497573021799,4.93456161458744,-0.289585884369444,26,28,-2,44,46,-2,58,65,-7,4,2,0,0
"23289","WPG","ANA",2011020470,15325,20112012,1,60,5,3,2,4.87698364954154,4.81235740611706,0.0646262434244846,31,36,-5,47,57,-10,53,69,-16,3,5,0,0
"23290","WPG","NYI",2011020492,15328,20112012,1,65,2,2,0,5.77859960867863,4.33605191856623,1.44254769011241,38,33,5,57,45,12,75,56,19,1,3,0,0
"23291","WPG","MTL",2011020504,15330,20112012,1,60,4,0,4,3.91937458756276,3.26555192931846,0.653822658244302,34,27,7,45,44,1,56,60,-4,1,4,0,0
"23292","WPG","COL",2011020535,15335,20112012,0,60,4,1,3,4.37873675994342,4.5255577256612,-0.146820965717779,26,33,-7,32,42,-10,40,60,-20,1,1,0,0
"23293","WPG","L.A",2011020547,15337,20112012,1,61.15,1,0,1,5.2851316045444,5.33992581945677,-0.0547942149123628,27,31,-4,38,42,-4,50,66,-16,3,6,0,0
"23294","WPG","TOR",2011020562,15339,20112012,1,60,3,2,1,2.65640527156211,1.95413173719394,0.702273534368172,35,24,11,45,40,5,55,61,-6,6,3,0,0
"23295","WPG","MTL",2011020580,15343,20112012,0,60,3,7,-4,3.64060449655517,5.95999192365025,-2.31938742709508,27,31,-4,42,39,3,56,57,-1,3,5,0,0
"23296","WPG","TOR",2011020585,15344,20112012,0,60,0,4,-4,3.21098580242688,3.81016837537754,-0.599182572950667,24,25,-1,49,42,7,65,69,-4,1,3,0,0
"23297","WPG","BUF",2011020602,15346,20112012,0,60.95,2,1,1,8.28800327431442,3.79511920447133,4.49288406984308,41,32,9,61,44,17,70,64,6,4,4,0,0
"23298","WPG","BOS",2011020616,15349,20112012,0,60,3,5,-2,3.68943521855493,7.05372404546089,-3.36428882690596,32,42,-10,45,57,-12,55,76,-21,5,4,0,0
"23299","WPG","S.J",2011020638,15351,20112012,1,60,0,2,-2,2.48760253138607,6.87147498305421,-4.38387245166814,24,37,-13,37,54,-17,56,66,-10,3,3,0,0
"23300","WPG","N.J",2011020653,15353,20112012,1,60,1,2,-1,6.1392212624778,2.19155779089488,3.94766347158293,23,25,-2,35,33,2,53,46,7,2,3,0,0
"23301","WPG","OTT",2011020666,15355,20112012,0,60,2,0,2,4.85370564204641,5.95444591761229,-1.10074027556588,35,25,10,46,41,5,61,64,-3,4,3,0,0
"23302","WPG","N.J",2011020671,15356,20112012,0,60,1,5,-4,3.89897966425633,3.79298507950807,0.10599458474826,21,20,1,26,25,1,32,29,3,1,4,0,0
"23303","WPG","BUF",2011020691,15358,20112012,1,60,4,1,3,4.08125124534126,3.92583773031947,0.155413515021792,33,26,7,50,36,14,67,53,14,5,3,0,0
"23304","WPG","FLA",2011020706,15360,20112012,1,65,3,3,0,6.47683337537455,2.54077010150831,3.93606327386624,44,23,21,56,28,28,80,35,45,5,3,0,0
"23305","WPG","CAR",2011020717,15362,20112012,0,60,1,2,-1,7.27613289390047,2.8671919034803,4.40894099042016,30,16,14,51,24,27,67,32,35,3,2,0,0
"23306","WPG","NYR",2011020724,15363,20112012,0,60,0,3,-3,2.75156308524311,2.40152675374702,0.350036331496085,22,31,-9,39,42,-3,56,55,1,2,4,0,0
"23307","WPG","PHI",2011020738,15370,20112012,0,65,1,1,0,5.38633573098923,5.38820970873348,-0.00187397774425335,24,28,-4,39,42,-3,53,64,-11,3,1,0,0
"23308","WPG","T.B",2011020757,15372,20112012,0,63.2333333333333,2,1,1,2.29077583459773,6.3934138100373,-4.10263797543957,24,31,-7,34,41,-7,51,57,-6,3,3,0,0
"23309","WPG","FLA",2011020763,15373,20112012,0,60,1,2,-1,3.58255409655976,6.37271938870333,-2.79016529214357,21,30,-9,26,43,-17,45,58,-13,1,3,0,0
"23310","WPG","MTL",2011020782,15375,20112012,0,60,0,3,-3,4.25700208238095,2.63568769885393,1.62131438352702,23,23,0,47,32,15,59,50,9,5,4,0,0
"23311","WPG","TOR",2011020794,15377,20112012,1,60,2,1,1,3.2393153994696,4.54880102316383,-1.30948562369423,29,18,11,36,31,5,49,46,3,2,2,0,0
"23312","WPG","WSH",2011020805,15379,20112012,0,65,2,2,0,4.96267717689801,2.94085608558089,2.02182109131712,27,34,-7,46,46,0,68,64,4,3,5,0,0
"23313","WPG","NYI",2011020844,15384,20112012,1,60,1,3,-2,7.05276861489983,4.36638376367773,2.6863848512221,38,25,13,56,37,19,72,44,28,5,3,0,0
"23314","WPG","MIN",2011020855,15386,20112012,0,65,3,3,0,4.86853419907857,3.33632603505976,1.53220816401881,27,25,2,35,31,4,50,48,2,5,5,0,0
"23315","WPG","BOS",2011020863,15387,20112012,1,60,4,2,2,3.1495727393189,4.14511908116401,-0.995546341845107,25,33,-8,30,46,-16,43,57,-14,3,3,0,0
"23316","WPG","COL",2011020882,15389,20112012,1,60,5,1,4,4.38599507457911,4.46976470377558,-0.0837696291964676,25,32,-7,47,45,2,58,58,0,5,5,0,0
"23317","WPG","PHI",2011020892,15391,20112012,1,64.2666666666667,4,5,-1,1.89445099269506,8.13404322335555,-6.23959223066049,26,55,-29,33,66,-33,43,80,-37,4,4,0,0
"23318","WPG","T.B",2011020904,15393,20112012,1,60,4,3,1,3.67305359162856,4.81737654280238,-1.14432295117382,34,25,9,45,35,10,54,56,-2,5,7,0,0
"23319","WPG","STL",2011020915,15395,20112012,1,65,2,2,0,6.82612803051597,2.1365939259349,4.68953410458107,41,16,25,55,27,28,67,42,25,2,1,0,0
"23320","WPG","EDM",2011020934,15397,20112012,1,60,3,5,-2,6.28730489269947,4.21349653525976,2.0738083574397,32,25,7,44,35,9,64,49,15,4,4,0,0
"23321","WPG","FLA",2011020954,15400,20112012,1,60,7,0,7,5.54207996754121,4.20951729174703,1.33256267579418,32,33,-1,42,45,-3,57,61,-4,4,4,0,0
"23322","WPG","BUF",2011020982,15404,20112012,1,60,3,1,2,3.0466725845763,2.40440936604864,0.64226321852766,31,24,7,50,33,17,62,52,10,3,3,0,0
"23323","WPG","VAN",2011021009,15407,20112012,0,60,2,3,-1,2.49990336204064,7.54882947208534,-5.0489261100447,32,45,-13,38,60,-22,61,80,-19,3,1,0,0
"23324","WPG","CGY",2011021013,15408,20112012,0,60,3,5,-2,7.5926052935574,4.52918042970123,3.06342486385617,45,27,18,67,39,28,76,52,24,3,4,0,0
"23325","WPG","DAL",2011021048,15413,20112012,1,60,5,2,3,3.22245680808555,3.76842015375047,-0.545963345664916,28,30,-2,38,41,-3,51,52,-1,5,2,0,0
"23326","WPG","WSH",2011021061,15415,20112012,1,60,3,2,1,4.62252978939796,1.88543553585987,2.73709425353809,28,22,6,39,32,7,57,47,10,6,4,0,0
"23327","WPG","CAR",2011021081,15417,20112012,1,60,3,4,-1,4.96658947308481,3.62071406216768,1.34587541091713,33,35,-2,48,46,2,64,54,10,6,5,0,0
"23328","WPG","WSH",2011021112,15422,20112012,0,62.6166666666667,4,3,1,5.33862832007769,4.05363068138831,1.28499763868938,42,23,19,56,38,18,76,51,25,2,2,0,0
"23329","WPG","NSH",2011021124,15423,20112012,0,60,1,3,-2,3.23941811668919,4.47633627749747,-1.23691816080827,25,28,-3,37,47,-10,54,59,-5,1,4,0,0
"23330","WPG","OTT",2011021136,15425,20112012,1,60,4,6,-2,6.55825865244941,4.44282219717792,2.1154364552715,48,35,13,64,46,18,80,59,21,5,2,0,0
"23331","WPG","NYR",2011021148,15427,20112012,1,60,2,4,-2,3.13002849495388,4.25000992433622,-1.11998142938234,24,28,-4,37,36,1,61,48,13,5,4,0,0
"23332","WPG","CAR",2011021162,15429,20112012,0,60.2666666666667,4,3,1,6.74044742526016,3.60776234847066,3.1326850767895,35,33,2,53,44,9,68,58,10,4,4,0,0
"23333","WPG","T.B",2011021174,15430,20112012,0,60.75,2,3,-1,2.4406057304177,6.36731046653586,-3.92670473611815,28,39,-11,39,52,-13,53,70,-17,4,9,0,0
"23334","WPG","FLA",2011021194,15433,20112012,0,63.2,5,4,1,6.04049569080235,5.96080343757058,0.0796922532317694,30,38,-8,42,49,-7,50,64,-14,2,2,0,0
"23335","WPG","NYI",2011021202,15435,20112012,0,60,4,5,-1,3.85765167352536,2.8232141105691,1.03443756295627,25,28,-3,40,37,3,57,48,9,3,3,0,0
"23336","WPG","T.B",2011021223,15437,20112012,1,61.1333333333333,3,4,-1,5.64430479610746,4.64208793609578,1.00221686001169,31,25,6,46,37,9,60,59,1,2,3,0,0
"23337","WPG","OTT",2012020002,15724,20122013,1,60,1,4,-3,4.75077410705853,4.11623736466299,0.634536742395539,28,37,-9,44,51,-7,58,61,-3,7,3,0,0
"23338","WPG","BOS",2012020020,15726,20122013,0,65,1,1,0,2.70954584859271,2.32149396079194,0.388051887800771,27,27,0,41,41,0,63,57,6,4,2,0,0
"23339","WPG","WSH",2012020027,15727,20122013,0,60,4,2,2,6.93821849002302,4.14373159987736,2.79448689014566,39,34,5,46,39,7,56,57,-1,5,4,0,0
"23340","WPG","NYI",2012020070,15732,20122013,1,61.9833333333333,5,4,1,4.37241678807186,3.97079865847627,0.40161812959559,35,25,10,55,47,8,71,66,5,7,5,0,0
"23341","WPG","MTL",2012020081,15734,20122013,0,60,3,4,-1,2.73818074483583,3.70254552447559,-0.964364779639759,21,26,-5,33,38,-5,49,49,0,7,6,0,0
"23342","WPG","FLA",2012020097,15736,20122013,0,60,3,6,-3,4.57537898444571,5.29343726031948,-0.718058275873773,25,34,-9,41,44,-3,46,57,-11,5,7,0,0
"23343","WPG","T.B",2012020103,15737,20122013,0,60,3,8,-5,4.37248062969567,3.47744077816606,0.895039851529617,29,25,4,43,31,12,58,40,18,5,5,0,0
"23344","WPG","FLA",2012020135,15741,20122013,1,64.7333333333333,3,2,1,4.91016769672569,2.7856251798803,2.12454251684539,21,19,2,36,25,11,56,37,19,4,2,0,0
"23345","WPG","TOR",2012020148,15743,20122013,1,60,2,3,-1,2.61607144664049,2.56205138127393,0.0540200653665579,25,18,7,37,25,12,51,43,8,4,4,0,0
"23346","WPG","OTT",2012020157,15745,20122013,0,60,1,0,1,3.85386791739768,8.91887440952996,-5.06500649213228,37,33,4,48,56,-8,55,78,-23,1,3,0,0
"23347","WPG","PHI",2012020183,15748,20122013,1,60,2,3,-1,3.02203633670442,3.954312452213,-0.932276115508586,26,23,3,42,28,14,54,42,12,3,4,0,0
"23348","WPG","BOS",2012020214,15753,20122013,1,60,2,3,-1,5.36072969046654,2.92555352472118,2.43517616574536,24,26,-2,50,42,8,70,62,8,2,1,0,0
"23349","WPG","BUF",2012020226,15755,20122013,0,60,2,1,1,3.07174764673709,3.11878566079258,-0.047038014055488,28,30,-2,40,41,-1,55,60,-5,2,4,0,0
"23350","WPG","CAR",2012020240,15757,20122013,0,60,4,3,1,5.72577870407258,4.83491423144005,0.890864472632529,23,30,-7,36,43,-7,57,57,0,4,3,0,0
"23351","WPG","PHI",2012020251,15759,20122013,0,60,3,5,-2,0,0,0,37,39,-2,49,49,0,66,62,4,6,8,0,0
"23352","WPG","N.J",2012020263,15760,20122013,0,60,4,2,2,5.61086225404188,3.93462826957693,1.67623398446494,27,26,1,36,36,0,45,47,-2,2,2,0,0
"23353","WPG","NYR",2012020275,15762,20122013,0,60,4,3,1,3.95004818439691,2.6147080172226,1.33534016717431,32,33,-1,36,42,-6,50,60,-10,3,2,0,0
"23354","WPG","N.J",2012020293,15764,20122013,1,60,3,1,2,3.48010634762775,2.87951822408947,0.600588123538286,21,23,-2,29,36,-7,46,58,-12,4,4,0,0
"23355","WPG","WSH",2012020305,15766,20122013,1,60,0,3,-3,3.95846152026843,3.24033653019461,0.71812499007382,35,21,14,49,35,14,66,44,22,4,4,0,0
"23356","WPG","FLA",2012020330,15769,20122013,0,60,1,4,-3,3.5261441556504,4.66688907745993,-1.14074492180953,31,26,5,41,39,2,47,48,-1,0,3,0,0
"23357","WPG","T.B",2012020346,15771,20122013,0,60,2,1,1,3.09469871916735,5.19964752843953,-2.10494880927217,28,29,-1,39,40,-1,54,53,1,2,5,0,0
"23358","WPG","FLA",2012020351,15772,20122013,0,64.3166666666667,3,2,1,4.24665619328557,6.57682369750796,-2.33016750422239,28,40,-12,37,54,-17,54,63,-9,1,4,0,0
"23359","WPG","N.J",2012020368,15774,20122013,0,65,2,2,0,4.31628593360074,5.10795696649438,-0.791671032893646,25,27,-2,33,41,-8,44,57,-13,1,1,0,0
"23360","WPG","TOR",2012020382,15776,20122013,1,60,5,2,3,2.85075898273499,3.46646661881823,-0.615707636083243,34,26,8,45,34,11,68,46,22,6,5,0,0
"23361","WPG","NYR",2012020396,15778,20122013,1,60,3,1,2,4.34103272578795,2.91865258026519,1.42238014552277,33,29,4,44,46,-2,62,67,-5,2,2,0,0
"23362","WPG","TOR",2012020409,15780,20122013,0,65,4,4,0,3.70030885445885,5.19379879569439,-1.49348994123554,33,32,1,51,42,9,77,60,17,4,4,0,0
"23363","WPG","OTT",2012020419,15781,20122013,0,60,1,4,-3,5.56258341479406,4.65662844036706,0.905954974427004,26,42,-16,37,55,-18,46,64,-18,3,4,0,0
"23364","WPG","BOS",2012020435,15783,20122013,1,60,3,1,2,3.95720149125555,3.92693304724547,0.0302684440100762,25,28,-3,32,42,-10,45,61,-16,2,4,0,0
"23365","WPG","WSH",2012020448,15785,20122013,1,60,0,4,-4,2.98090056369256,2.63699856271341,0.343902000979145,20,25,-5,32,30,2,50,45,5,3,3,0,0
"23366","WPG","WSH",2012020454,15786,20122013,1,60,1,6,-5,5.22167779636499,3.60692352856778,1.6147542677972,31,24,7,44,34,10,61,40,21,6,5,0,0
"23367","WPG","T.B",2012020468,15788,20122013,1,60,3,2,1,2.98047460741691,3.7530119039161,-0.772537296499195,24,25,-1,36,37,-1,51,48,3,4,4,0,0
"23368","WPG","CAR",2012020482,15790,20122013,0,60,4,1,3,5.59152209023341,4.97005820425693,0.621463885976482,36,39,-3,52,54,-2,67,79,-12,2,3,0,0
"23369","WPG","CAR",2012020508,15794,20122013,1,60,1,3,-2,2.03604843166767,2.95178112270514,-0.915732691037476,35,28,7,43,42,1,60,58,2,3,6,0,0
"23370","WPG","NYR",2012020523,15796,20122013,0,60,2,4,-2,3.64093024772592,3.96571785063134,-0.324787602905417,28,35,-7,45,42,3,70,57,13,5,1,0,0
"23371","WPG","NYI",2012020532,15797,20122013,0,60,2,5,-3,4.23966589887834,7.3058725867304,-3.06620668785206,25,39,-14,36,55,-19,55,71,-16,2,2,0,0
"23372","WPG","MTL",2012020547,15799,20122013,0,60,1,4,-3,5.334692073724,3.71308249630965,1.62160957741435,34,24,10,41,29,12,68,45,23,4,3,0,0
"23373","WPG","PHI",2012020559,15801,20122013,1,60,4,1,3,4.40817833401979,1.71383683557647,2.69434149844332,25,31,-6,40,42,-2,58,55,3,3,3,0,0
"23374","WPG","BUF",2012020587,15804,20122013,1,60,4,1,3,3.55437629400905,6.4367032519076,-2.88232695789855,30,30,0,42,38,4,58,47,11,1,3,0,0
"23375","WPG","FLA",2012020602,15806,20122013,1,60,7,2,5,6.81858542337432,3.86845803519827,2.95012738817604,35,27,8,51,40,11,67,50,17,4,2,0,0
"23376","WPG","T.B",2012020636,15811,20122013,1,65,3,3,0,7.32688020722043,3.5712149424653,3.75566526475512,36,27,9,55,37,18,69,53,16,3,1,0,0
"23377","WPG","CAR",2012020649,15813,20122013,1,61.3833333333333,4,3,1,4.19432620727457,4.72553798567185,-0.531211778397278,31,27,4,46,38,8,67,59,8,6,1,0,0
"23378","WPG","NYI",2012020661,15815,20122013,1,65,4,4,0,6.50858451086674,5.08353216166142,1.42505234920532,28,33,-5,44,47,-3,60,72,-12,5,7,0,0
"23379","WPG","BUF",2012020676,15817,20122013,0,60,2,1,1,5.6240370577143,5.19879187975312,0.425245177961187,39,25,14,53,42,11,59,47,12,3,1,0,0
"23380","WPG","WSH",2012020682,15818,20122013,0,60,3,5,-2,3.72113521094025,7.03204605434928,-3.31091084340903,27,41,-14,31,56,-25,48,72,-24,3,1,0,0
"23381","WPG","MTL",2012020700,15820,20122013,1,60,2,4,-2,1.27080176313757,5.74647971976083,-4.47567795662326,25,30,-5,35,47,-12,47,65,-18,3,5,0,0
"23382","WPG","EDM",2013020003,15979,20132014,0,60,5,4,1,4.56710469065001,6.78524114167703,-2.21813645102702,28,38,-10,42,48,-6,56,71,-15,5,6,0,0
"23383","WPG","L.A",2013020019,15982,20132014,1,60,5,3,2,6.68948203608488,6.94796021885874,-0.258478182773857,33,36,-3,45,52,-7,59,67,-8,6,5,0,0
"23384","WPG","ANA",2013020033,15984,20132014,1,60,2,3,-1,2.19215163098971,3.35228158191603,-1.16012995092632,17,34,-17,27,48,-21,44,61,-17,3,4,0,0
"23385","WPG","MIN",2013020054,15988,20132014,0,60,1,2,-1,2.90365894824205,4.61533560520607,-1.71167665696402,15,30,-15,31,45,-14,41,62,-21,7,8,0,0
"23386","WPG","DAL",2013020062,15989,20132014,1,60,1,4,-3,4.90079287101901,4.87948099042394,0.0213118805950643,44,31,13,59,41,18,78,50,28,5,5,0,0
"23387","WPG","N.J",2013020077,15991,20132014,1,60,3,0,3,0,0,0,35,24,11,47,36,11,56,55,1,4,6,0,0
"23388","WPG","MTL",2013020091,15993,20132014,1,60,0,3,-3,7.94930389384854,4.9121935149351,3.03711037891344,36,25,11,53,41,12,79,51,28,4,6,0,0
"23389","WPG","STL",2013020108,15996,20132014,1,65,3,3,0,4.28917237538468,4.52219264306768,-0.233020267682998,29,32,-3,45,44,1,66,62,4,2,3,0,0
"23390","WPG","NSH",2013020124,15998,20132014,1,60,1,3,-2,7.24820455600275,2.50558603559585,4.7426185204069,39,26,13,50,34,16,68,38,30,3,3,0,0
"23391","WPG","WSH",2013020135,16000,20132014,1,65,4,4,0,5.32208063948103,4.65423833020031,0.66784230928072,47,32,15,69,44,25,82,53,29,4,6,0,0
"23392","WPG","NSH",2013020144,16002,20132014,0,64.7166666666667,2,3,-1,5.89871698641218,4.21399608990259,1.68472089650959,36,33,3,48,41,7,69,51,18,4,2,0,0
"23393","WPG","DAL",2013020161,16004,20132014,0,65,1,1,0,4.23347074202195,5.69509778096881,-1.46162703894686,38,36,2,57,56,1,72,75,-3,2,4,0,0
"23394","WPG","COL",2013020169,16005,20132014,0,60,2,3,-1,6.15129852731479,5.36750432697204,0.783794200342754,25,36,-11,45,49,-4,64,66,-2,6,2,0,0
"23395","WPG","STL",2013020181,16007,20132014,0,60,2,3,-1,3.53679134027334,4.52052256265097,-0.983731222377628,23,33,-10,32,46,-14,41,65,-24,5,6,0,0
"23396","WPG","CHI",2013020199,16011,20132014,1,60,1,5,-4,5.39718900686057,5.48650890315184,-0.089319896291272,27,25,2,40,36,4,56,54,2,1,3,0,0
"23397","WPG","DET",2013020216,16013,20132014,1,60,4,2,2,4.17298763107101,3.64596387126949,0.527023759801523,47,28,19,55,37,18,76,50,26,6,3,0,0
"23398","WPG","CHI",2013020227,16015,20132014,0,60,1,4,-3,4.32841184106655,2.66067258024123,1.66773926082533,25,28,-3,32,37,-5,42,52,-10,2,2,0,0
"23399","WPG","NSH",2013020242,16017,20132014,1,60,5,0,5,5.01237659927256,6.51192465815984,-1.49954805888729,32,41,-9,49,54,-5,62,71,-9,5,6,0,0
"23400","WPG","S.J",2013020259,16019,20132014,1,65,4,4,0,8.07292270893375,4.27909116573344,3.79383154320031,46,34,12,62,47,15,79,57,22,3,6,0,0
"23401","WPG","DET",2013020270,16021,20132014,0,65,2,2,0,2.8816339305049,5.83831235791328,-2.95667842740838,21,43,-22,29,56,-27,41,62,-21,3,4,0,0
"23402","WPG","PHI",2013020292,16024,20132014,1,65,2,2,0,5.504706636013,6.01406440102743,-0.509357765014428,38,34,4,53,42,11,66,53,13,4,3,0,0
"23403","WPG","MIN",2013020307,16026,20132014,0,60,1,2,-1,6.49252783222801,3.98000400483761,2.5125238273904,22,24,-2,30,38,-8,54,54,0,2,2,0,0
"23404","WPG","CGY",2013020311,16027,20132014,1,65,4,4,0,5.06992676735354,5.65772418425769,-0.587797416904152,47,33,14,56,43,13,92,57,35,5,7,0,0
"23405","WPG","CHI",2013020330,16030,20132014,1,60,3,6,-3,4.45987799695831,5.3585880991991,-0.898710102240791,25,33,-8,38,48,-10,49,62,-13,5,5,0,0
"23406","WPG","MIN",2013020342,16032,20132014,1,65,2,2,0,6.82836637840956,5.23020907945465,1.5981572989549,39,35,4,56,48,8,67,65,2,2,2,0,0
"23407","WPG","N.J",2013020357,16034,20132014,0,60,3,1,2,2.98771306034178,3.52775600827953,-0.540042947937758,22,26,-4,24,35,-11,30,49,-19,2,2,0,0
"23408","WPG","NYI",2013020367,16036,20132014,0,60,3,2,1,3.82136937035102,3.09847437241115,0.722894997939875,29,30,-1,41,45,-4,58,66,-8,2,4,0,0
"23409","WPG","PHI",2013020383,16038,20132014,0,60,1,2,-1,3.50323193211343,4.99044967126611,-1.48721773915268,26,34,-8,36,45,-9,55,62,-7,7,5,0,0
"23410","WPG","NYR",2013020406,16041,20132014,0,60,5,2,3,5.33571295189358,5.2043523565153,0.131360595378283,30,37,-7,40,42,-2,44,63,-19,2,2,0,0
"23411","WPG","FLA",2013020427,16044,20132014,0,60,2,5,-3,2.62794699147344,3.38137576088775,-0.753428769414313,31,26,5,40,33,7,51,48,3,1,2,0,0
"23412","WPG","T.B",2013020442,16046,20132014,0,61.0666666666667,2,1,1,4.93656295555411,5.53735065825458,-0.600787702700472,36,29,7,48,47,1,57,58,-1,5,3,0,0
"23413","WPG","STL",2013020464,16049,20132014,1,60,1,2,-1,3.18952771469753,2.67903523295945,0.510492481738083,21,20,1,31,35,-4,43,57,-14,5,4,0,0
"23414","WPG","COL",2013020479,16051,20132014,1,65,3,3,0,5.66744986620324,5.08900945202913,0.578440414174111,38,26,12,56,36,20,73,61,12,6,2,0,0
"23415","WPG","DAL",2013020489,16053,20132014,1,60,4,6,-2,5.53880327536059,3.8251235227799,1.71367975258069,38,32,6,54,40,14,71,57,14,6,4,0,0
"23416","WPG","CBJ",2013020506,16055,20132014,0,60,3,2,1,4.10840415532584,6.32419006712735,-2.2157859118015,32,24,8,41,31,10,49,47,2,4,3,0,0
"23417","WPG","BUF",2013020510,16056,20132014,0,60,2,4,-2,4.97009023001465,4.84533233121419,0.124757898800453,27,31,-4,43,44,-1,56,59,-3,2,6,0,0
"23418","WPG","FLA",2013020538,16059,20132014,1,60,5,2,3,3.47203880257278,5.16225293345997,-1.69021413088718,32,23,9,46,33,13,54,47,7,7,7,0,0
"23419","WPG","VAN",2013020552,16061,20132014,0,60,1,2,-1,4.59570337383775,5.11797516047955,-0.522271786641795,22,25,-3,27,32,-5,49,52,-3,1,3,0,0
"23420","WPG","EDM",2013020564,16062,20132014,0,60,2,6,-4,3.63665958177446,4.59801708847226,-0.961357506697797,20,30,-10,39,49,-10,50,60,-10,5,9,0,0
"23421","WPG","MIN",2013020573,16066,20132014,1,60,6,4,2,5.9652760165045,3.86750979084172,2.09776622566278,38,29,9,44,33,11,63,45,18,2,3,0,0
"23422","WPG","COL",2013020593,16068,20132014,0,64.9666666666667,2,1,1,5.59228353932849,3.77786818129243,1.81441535803606,37,34,3,53,44,9,72,64,8,2,1,0,0
"23423","WPG","BUF",2013020604,16070,20132014,1,60,3,0,3,5.1844905319158,3.52656202791695,1.65792850399885,26,27,-1,37,38,-1,53,53,0,3,4,0,0
"23424","WPG","OTT",2013020615,16072,20132014,0,60,3,4,-1,4.67855150172545,5.45775169038097,-0.779200188655523,35,29,6,48,38,10,62,56,6,1,3,0,0
"23425","WPG","BOS",2013020626,16074,20132014,0,60,1,4,-3,7.54375831215293,6.29899903261794,1.24475927953499,37,29,8,48,45,3,62,58,4,3,2,0,0
"23426","WPG","T.B",2013020651,16077,20132014,1,60,2,4,-2,2.61455229762942,3.89261994447947,-1.27806764685006,14,33,-19,22,49,-27,36,66,-30,9,9,0,0
"23427","WPG","CBJ",2013020679,16081,20132014,1,60,3,6,-3,4.61161161271002,5.94391565964906,-1.33230404693904,31,26,5,43,42,1,57,50,7,5,5,0,0
"23428","WPG","ARI",2013020694,16083,20132014,1,60,5,1,4,8.58799720907155,4.43305098527344,4.15494622379811,38,19,19,59,30,29,73,47,26,10,4,0,0
"23429","WPG","CGY",2013020719,16086,20132014,0,60,5,2,3,3.41493246910977,3.93087339214981,-0.515940923040034,23,22,1,30,34,-4,45,45,0,5,3,0,0
"23430","WPG","EDM",2013020725,16088,20132014,1,61.1666666666667,3,2,1,7.48493943394351,2.66205084951071,4.8228885844328,39,22,17,58,30,28,78,44,34,5,5,0,0
"23431","WPG","ANA",2013020755,16091,20132014,0,60,3,2,1,2.50903533547535,4.99203327924261,-2.48299794376726,21,42,-21,36,58,-22,40,94,-54,2,4,0,0
"23432","WPG","S.J",2013020768,16093,20132014,0,60,0,1,-1,1.95181245464033,4.15319857511343,-2.2013861204731,20,32,-12,34,50,-16,45,66,-21,3,4,0,0
"23433","WPG","TOR",2013020780,16095,20132014,1,62.7333333333333,5,4,1,7.13323563642018,5.21307322324719,1.92016241317299,32,28,4,47,43,4,57,69,-12,4,6,0,0
"23434","WPG","CHI",2013020786,16096,20132014,0,60,3,1,2,5.15016606696219,4.23994064001264,0.910225426949543,21,35,-14,36,54,-18,46,67,-21,2,4,0,0
"23435","WPG","NSH",2013020802,16098,20132014,1,60,3,4,-1,3.15969224274158,7.41518529682071,-4.25549305407912,27,25,2,40,39,1,54,47,7,2,3,0,0
"23436","WPG","VAN",2013020823,16101,20132014,1,60,4,3,1,3.88483288537827,5.61557050030387,-1.7307376149256,34,26,8,43,41,2,59,57,2,3,2,0,0
"23437","WPG","MTL",2013020836,16103,20132014,0,60,2,1,1,7.3861557585642,4.43140682356898,2.95474893499522,35,31,4,46,42,4,69,63,6,8,7,0,0
"23438","WPG","CAR",2013020846,16105,20132014,0,60,2,1,1,3.49513784531155,3.65157126286067,-0.156433417549124,27,29,-2,40,44,-4,47,58,-11,1,4,0,0
"23439","WPG","WSH",2013020859,16107,20132014,0,60,2,4,-2,4.78211609475859,3.24381971685216,1.53829637790643,36,30,6,45,45,0,57,61,-4,1,4,0,0
"23440","WPG","STL",2013020873,16109,20132014,0,65,3,3,0,3.79227921483107,2.50798260745069,1.28429660738038,31,26,5,39,34,5,51,49,2,5,7,0,0
"23441","WPG","ARI",2013020894,16128,20132014,1,65,2,2,0,7.00343237161815,9.78213797626086,-2.77870560464271,29,36,-7,43,47,-4,55,60,-5,6,7,0,0
"23442","WPG","NSH",2013020906,16130,20132014,0,60,3,1,2,2.24656965535485,5.28831200729473,-3.04174235193989,20,40,-20,27,55,-28,40,75,-35,2,7,0,0
"23443","WPG","NYI",2013020930,16133,20132014,1,63.8833333333333,2,3,-1,6.10468245788908,5.47765552217322,0.627026935715861,38,27,11,54,40,14,70,56,14,6,2,0,0
"23444","WPG","L.A",2013020939,16135,20132014,1,60,1,3,-2,2.48328005573057,6.93322704206184,-4.44994698633127,18,41,-23,30,55,-25,46,78,-32,1,4,0,0
"23445","WPG","OTT",2013020953,16137,20132014,1,60,3,5,-2,5.29856255382765,5.75187573694575,-0.453313183118098,49,32,17,64,40,24,76,47,29,9,6,0,0
"23446","WPG","COL",2013020972,16139,20132014,0,62.55,2,3,-1,3.97887535861992,6.28613190856777,-2.30725654994785,35,34,1,49,40,9,67,50,17,4,8,0,0
"23447","WPG","VAN",2013020986,16141,20132014,1,65,2,2,0,4.05550216254869,6.14138558987382,-2.08588342732513,34,33,1,47,47,0,65,61,4,6,6,0,0
"23448","WPG","NYR",2013021001,16143,20132014,1,60,2,4,-2,4.77220186816703,1.28737087400879,3.48483099415824,32,23,9,42,29,13,66,48,18,4,4,0,0
"23449","WPG","DAL",2013021021,16145,20132014,1,60,7,2,5,5.96562308428111,2.63120361467751,3.33441946960359,34,27,7,41,32,9,59,48,11,7,2,0,0
"23450","WPG","STL",2013021024,16146,20132014,0,60,1,3,-2,2.33351587760262,6.29248915614698,-3.95897327854436,17,26,-9,25,44,-19,36,62,-26,5,7,0,0
"23451","WPG","COL",2013021040,16148,20132014,1,61.7,5,4,1,5.14774436740845,2.58944989583688,2.55829447157157,27,27,0,41,37,4,52,49,3,2,1,0,0
"23452","WPG","CAR",2013021062,16151,20132014,1,60,2,3,-1,5.59393100984744,5.3350025381169,0.258928471730542,36,32,4,43,48,-5,65,66,-1,2,3,0,0
"23453","WPG","DAL",2013021077,16153,20132014,0,60,1,2,-1,6.74240615113762,3.4364173338945,3.30598881724312,33,27,6,49,38,11,66,49,17,4,5,0,0
"23454","WPG","S.J",2013021101,16156,20132014,0,60,4,3,1,5.66492632495263,4.19663555742702,1.46829076752561,31,30,1,45,41,4,66,55,11,6,5,0,0
"23455","WPG","L.A",2013021118,16158,20132014,0,60,2,4,-2,3.52603973279929,4.23030730940809,-0.7042675766088,26,29,-3,45,45,0,55,59,-4,3,2,0,0
"23456","WPG","ANA",2013021127,16160,20132014,0,60.2666666666667,4,5,-1,4.4398296629588,5.52169966435758,-1.08187000139878,37,36,1,47,50,-3,66,67,-1,4,2,0,0
"23457","WPG","ARI",2013021138,16161,20132014,0,65,1,1,0,5.04194632379949,2.88246713398257,2.15947918981692,22,29,-7,32,46,-14,44,60,-16,1,2,0,0
"23458","WPG","TOR",2013021163,16165,20132014,0,60,4,2,2,6.46373322723684,4.78345614365634,1.6802770835805,41,25,16,58,36,22,71,48,23,2,4,0,0
"23459","WPG","MIN",2013021178,16167,20132014,1,60,0,1,-1,3.66632569947585,2.14966791064626,1.51665778882959,24,17,7,31,24,7,47,37,10,4,3,0,0
"23460","WPG","BOS",2013021202,16170,20132014,1,65,1,1,0,6.74476051848615,5.85618549966966,0.888575018816482,37,33,4,51,48,3,67,62,5,2,5,0,0
"23461","WPG","CGY",2013021210,16171,20132014,0,60,5,3,2,6.05931663175579,6.07263708361279,-0.0133204518569983,27,38,-11,37,52,-15,54,73,-19,2,5,0,0
"23462","WPG","ARI",2014020016,16352,20142015,0,60,6,2,4,2.08673031092235,3.6874571973749,-1.60072688645255,27,28,-1,35,41,-6,43,57,-14,8,6,0,0
"23463","WPG","S.J",2014020032,16354,20142015,0,60,0,3,-3,3.38651349359787,3.12620774365496,0.260305749942916,30,26,4,39,40,-1,55,54,1,3,9,0,0
"23464","WPG","L.A",2014020034,16355,20142015,0,60,1,4,-3,3.83245141158113,4.58806097176785,-0.755609560186713,30,31,-1,42,45,-3,50,55,-5,4,5,0,0
"23465","WPG","NSH",2014020060,16360,20142015,1,60,0,2,-2,2.7707590823361,4.0352729902952,-1.2645139079591,31,27,4,39,40,-1,53,54,-1,5,6,0,0
"23466","WPG","CGY",2014020076,16362,20142015,1,60,1,4,-3,5.71202648872273,3.72869079071097,1.98333569801176,35,29,6,48,39,9,70,48,22,3,4,0,0
"23467","WPG","CAR",2014020084,16364,20142015,1,60,3,1,2,5.02998355700793,5.63317402719986,-0.603190470191926,26,22,4,42,31,11,55,44,11,5,5,0,0
"23468","WPG","T.B",2014020102,16367,20142015,1,60,2,4,-2,4.11209621789749,3.56001337262569,0.552082845271798,42,27,15,50,34,16,64,45,19,5,4,0,0
"23469","WPG","COL",2014020117,16369,20142015,1,64.5833333333333,2,1,1,6.94707458023913,4.37462265841507,2.57245192182406,28,23,5,48,26,22,82,40,42,5,4,0,0
"23470","WPG","NYI",2014020125,16371,20142015,0,60,4,3,1,3.93775464327337,4.07590095625247,-0.138146312979103,30,21,9,38,39,-1,48,49,-1,4,8,0,0
"23471","WPG","N.J",2014020139,16373,20142015,0,65,1,1,0,2.20286442735232,3.58478556026239,-1.38192113291007,25,28,-3,33,36,-3,40,50,-10,2,1,0,0
"23472","WPG","NYR",2014020158,16375,20142015,0,65,0,0,0,7.27927577684492,5.77709053314368,1.50218524370124,25,38,-13,42,54,-12,62,72,-10,3,5,0,0
"23473","WPG","CHI",2014020169,16376,20142015,0,60,1,0,1,2.49663601670181,4.70058635604801,-2.20395033934619,27,33,-6,34,46,-12,43,76,-33,2,2,0,0
"23474","WPG","NSH",2014020180,16378,20142015,1,60,3,1,2,5.10738345334146,4.30382439449394,0.803559058847512,26,24,2,37,40,-3,51,58,-7,5,6,0,0
"23475","WPG","OTT",2014020206,16382,20142015,0,65,1,1,0,5.90884352959622,6.81500422010413,-0.906160690507907,37,38,-1,47,51,-4,63,69,-6,3,3,0,0
"23476","WPG","MTL",2014020224,16385,20142015,0,60,0,3,-3,5.89554625100118,4.33206201213761,1.56348423886357,29,27,2,44,33,11,67,43,24,3,4,0,0
"23477","WPG","CAR",2014020234,16387,20142015,0,60,3,1,2,6.17833315653843,6.1305257276108,0.0478074289276265,37,23,14,54,43,11,71,62,9,2,3,0,0
"23478","WPG","NSH",2014020257,16389,20142015,0,60,1,2,-1,5.59044736369106,4.47736339372932,1.11308396996174,22,29,-7,33,39,-6,48,50,-2,0,4,0,0
"23479","WPG","MIN",2014020261,16390,20142015,0,61.0166666666667,3,4,-1,4.81585663601874,4.79536249096336,0.0204941450553804,25,27,-2,40,32,8,61,41,20,11,8,0,0
"23480","WPG","N.J",2014020273,16392,20142015,1,60,3,1,2,6.16953642142471,4.24627260956814,1.92326381185656,34,22,12,43,33,10,63,45,18,5,2,0,0
"23481","WPG","DET",2014020284,16394,20142015,1,60,3,4,-1,4.49891935645142,2.72362541381924,1.77529394263217,31,27,4,44,34,10,60,48,12,3,4,0,0
"23482","WPG","STL",2014020308,16397,20142015,1,60,2,4,-2,2.04866356992216,4.31569765706081,-2.26703408713865,30,29,1,38,37,1,54,47,7,1,4,0,0
"23483","WPG","CBJ",2014020316,16399,20142015,0,60,4,2,2,5.95255056281046,7.02773532797852,-1.07518476516806,32,34,-2,41,46,-5,53,54,-1,4,6,0,0
"23484","WPG","BUF",2014020323,16400,20142015,0,60,2,1,1,5.97479250093,3.47675604453332,2.49803645639668,26,20,6,36,28,8,51,38,13,4,4,0,0
"23485","WPG","BOS",2014020336,16402,20142015,0,63.65,1,2,-1,4.88087549109804,4.558389691617,0.322485799481034,36,38,-2,48,46,2,63,61,2,4,3,0,0
"23486","WPG","EDM",2014020374,16407,20142015,1,60.2833333333333,3,2,1,2.76347463740967,3.14277869532816,-0.379304057918489,26,24,2,32,33,-1,52,43,9,0,1,0,0
"23487","WPG","COL",2014020388,16409,20142015,1,60,6,2,4,5.31336339272093,5.92734400636982,-0.613980613648891,37,22,15,50,34,16,66,52,14,5,6,0,0
"23488","WPG","ANA",2014020402,16411,20142015,1,60.8833333333333,3,4,-1,3.40351394601646,4.3181919229296,-0.91467797691314,30,25,5,48,32,16,68,44,24,7,5,0,0
"23489","WPG","DAL",2014020416,16413,20142015,0,60,5,2,3,6.92442346030896,2.94192228668908,3.98250117361988,32,28,4,46,40,6,66,60,6,5,6,0,0
"23490","WPG","COL",2014020428,16415,20142015,0,65,3,3,0,3.32345782404796,3.95730476433528,-0.633846940287321,33,26,7,48,37,11,65,51,14,4,4,0,0
"23491","WPG","ANA",2014020442,16417,20142015,1,60,1,4,-3,3.30461233987845,6.50561297261386,-3.20100063273541,28,31,-3,41,41,0,59,56,3,4,5,0,0
"23492","WPG","BUF",2014020460,16420,20142015,1,60,5,1,4,6.91669438964163,5.32623285031877,1.59046153932286,36,28,8,49,37,12,69,45,24,5,5,0,0
"23493","WPG","BOS",2014020477,16423,20142015,1,60,2,1,1,0,0,0,27,31,-4,33,42,-9,48,52,-4,4,3,0,0
"23494","WPG","PHI",2014020496,16425,20142015,1,60.1666666666667,3,4,-1,2.70883554840111,3.80332974628254,-1.09449419788143,28,23,5,34,31,3,45,52,-7,2,5,0,0
"23495","WPG","CHI",2014020511,16427,20142015,0,60,5,1,4,3.96034593003716,4.22584677319264,-0.265500843155479,26,39,-13,35,50,-15,53,68,-15,2,2,0,0
"23496","WPG","MIN",2014020520,16431,20142015,0,62.7833333333333,4,3,1,3.37917789246421,5.09438445117399,-1.71520655870978,23,25,-2,34,40,-6,52,54,-2,3,5,0,0
"23497","WPG","MIN",2014020536,16433,20142015,1,60,2,3,-1,3.72845556788683,8.15229027227906,-4.42383470439223,30,31,-1,38,43,-5,67,60,7,3,4,0,0
"23498","WPG","NYI",2014020545,16435,20142015,1,60,2,5,-3,2.91330456279286,5.03910069813719,-2.12579613534433,23,33,-10,33,40,-7,49,58,-9,4,7,0,0
"23499","WPG","TOR",2014020571,16438,20142015,1,60,5,1,4,7.86307831213344,1.58276754431427,6.28031076781917,40,21,19,58,26,32,70,36,34,7,6,0,0
"23500","WPG","S.J",2014020583,16440,20142015,1,60,2,3,-1,2.32866828427388,5.45996250522148,-3.1312942209476,19,37,-18,34,50,-16,47,65,-18,3,6,0,0
"23501","WPG","ARI",2014020605,16443,20142015,0,60,1,4,-3,6.243989542083,5.48771383179076,0.756275710292243,35,30,5,54,42,12,74,49,25,6,5,0,0
"23502","WPG","L.A",2014020622,16445,20142015,0,65,4,4,0,5.45801454724691,6.8264271663902,-1.36841261914329,25,29,-4,33,47,-14,41,59,-18,5,8,0,0
"23503","WPG","ANA",2014020626,16446,20142015,0,65,4,4,0,3.58377972266828,6.61850902368315,-3.03472930101486,32,43,-11,45,54,-9,59,66,-7,7,6,0,0
"23504","WPG","FLA",2014020637,16448,20142015,1,60,8,2,6,4.74650150390517,4.24750413134075,0.498997372564418,35,27,8,51,31,20,66,41,25,3,3,0,0
"23505","WPG","DAL",2014020651,16450,20142015,0,60,2,1,1,2.22650485099439,9.51423284014163,-7.28772798914724,22,47,-25,28,70,-42,37,97,-60,3,8,0,0
"23506","WPG","CHI",2014020658,16451,20142015,0,60,4,2,2,4.64214470688967,3.72141334208164,0.920731364808024,35,33,2,42,42,0,51,62,-11,5,4,0,0
"23507","WPG","ARI",2014020674,16453,20142015,1,65,3,3,0,3.2586158334783,5.80101322414703,-2.54239739066873,30,31,-1,44,43,1,59,54,5,5,6,0,0
"23508","WPG","CBJ",2014020693,16456,20142015,1,60,4,0,4,3.55018329706218,4.26115874804236,-0.710975450980186,29,29,0,44,37,7,56,53,3,4,4,0,0
"23509","WPG","PHI",2014020713,16464,20142015,0,60,2,5,-3,0,0,0,38,32,6,53,38,15,66,46,20,7,4,0,0
"23510","WPG","DAL",2014020734,16466,20142015,1,60,2,5,-3,8.31473242283391,5.43474087553841,2.8799915472955,40,32,8,63,44,19,94,55,39,4,10,0,0
"23511","WPG","CGY",2014020743,16468,20142015,0,60,2,5,-3,2.84319498916094,8.85236926395055,-6.00917427478961,19,28,-9,41,43,-2,63,52,11,3,4,0,0
"23512","WPG","VAN",2014020754,16469,20142015,0,60.6,2,3,-1,6.75252859821921,5.61011895346746,1.14240964475175,28,33,-5,36,49,-13,49,63,-14,5,8,0,0
"23513","WPG","CHI",2014020771,16472,20142015,1,63.0166666666667,1,2,-1,0.899087615543976,5.1589437671937,-4.25985615164973,21,22,-1,28,35,-7,43,48,-5,3,3,0,0
"23514","WPG","COL",2014020790,16474,20142015,1,60,5,3,2,3.20625866959369,4.01257539929611,-0.806316729702417,29,28,1,41,40,1,60,51,9,5,3,0,0
"23515","WPG","MIN",2014020805,16476,20142015,1,64,2,1,1,3.76167414866359,3.86998357460834,-0.108309425944753,34,30,4,49,38,11,74,45,29,4,3,0,0
"23516","WPG","NSH",2014020814,16478,20142015,0,60,1,3,-2,5.87878768809605,3.98543183202855,1.8933558560675,33,26,7,42,38,4,65,49,16,5,6,0,0
"23517","WPG","DET",2014020825,16480,20142015,0,65,4,4,0,6.38609129463873,3.23937914615286,3.14671214848587,38,29,9,50,37,13,57,44,13,4,5,0,0
"23518","WPG","EDM",2014020841,16482,20142015,1,65,4,4,0,4.63433652865933,2.90654901077505,1.72778751788428,46,22,24,60,30,30,72,41,31,3,4,0,0
"23519","WPG","WSH",2014020863,16485,20142015,0,60,1,5,-4,3.0202708874519,3.68159999827346,-0.661329110821558,20,33,-13,31,40,-9,52,49,3,3,6,0,0
"23520","WPG","TOR",2014020875,16487,20142015,0,63.7833333333333,3,4,-1,6.12657245209127,4.29122812113613,1.83534433095513,34,33,1,47,44,3,60,61,-1,7,6,0,0
"23521","WPG","DAL",2014020902,16490,20142015,1,60,4,2,2,5.38062965298377,5.49951802153373,-0.11888836854996,25,28,-3,39,49,-10,45,66,-21,3,3,0,0
"23522","WPG","STL",2014020914,16492,20142015,1,65,1,1,0,4.45637278811773,5.13711930076261,-0.680746512644873,31,29,2,42,39,3,65,58,7,4,4,0,0
"23523","WPG","L.A",2014020933,16495,20142015,1,60,5,2,3,4.76081255436293,5.36309675348457,-0.602284199121641,29,20,9,40,33,7,47,47,0,5,6,0,0
"23524","WPG","OTT",2014020952,16498,20142015,1,60,1,3,-2,6.03755602258025,3.22700094898227,2.81055507359798,36,20,16,48,29,19,69,37,32,3,2,0,0
"23525","WPG","NSH",2014020976,16501,20142015,0,60,3,1,2,6.26755874371156,2.9991820238065,3.26837671990506,26,21,5,32,31,1,44,45,-1,3,3,0,0
"23526","WPG","STL",2014020996,16504,20142015,0,60,4,5,-1,1.75627286759845,5.30912144843023,-3.55284858083178,16,27,-11,32,37,-5,46,48,-2,8,8,0,0
"23527","WPG","FLA",2014021007,16506,20142015,0,60,2,4,-2,2.49284579220785,2.73314872847891,-0.240302936271064,20,20,0,31,32,-1,43,38,5,2,3,0,0
"23528","WPG","T.B",2014021022,16508,20142015,0,60,2,1,1,3.94704709425423,2.07843143017351,1.86861566408072,29,16,13,40,22,18,49,40,9,4,4,0,0
"23529","WPG","S.J",2014021046,16511,20142015,1,60,5,2,3,2.81379528343678,9.13505061221925,-6.32125532878247,22,40,-18,33,52,-19,46,75,-29,4,4,0,0
"23530","WPG","STL",2014021058,16513,20142015,1,65,1,1,0,5.45605146549053,4.80883694968585,0.647214515804683,34,33,1,50,38,12,73,53,20,4,5,0,0
"23531","WPG","WSH",2014021074,16515,20142015,1,60,3,0,3,4.35186222132324,2.54182890174105,1.81003331958219,24,28,-4,36,46,-10,54,72,-18,4,4,0,0
"23532","WPG","EDM",2014021089,16517,20142015,0,60,4,1,3,4.510686281997,4.67867324000451,-0.167986958007511,24,34,-10,37,44,-7,59,54,5,5,5,0,0
"23533","WPG","VAN",2014021097,16518,20142015,0,60,2,5,-3,5.30468745506369,7.0060289594694,-1.70134150440572,28,30,-2,34,35,-1,50,47,3,2,1,0,0
"23534","WPG","MTL",2014021110,16520,20142015,1,60,5,2,3,2.05788275285158,4.99451700964939,-2.93663425679781,22,41,-19,32,48,-16,45,59,-14,3,6,0,0
"23535","WPG","CHI",2014021135,16523,20142015,1,60,3,4,-1,5.16724591010396,4.95968917432947,0.207556735774496,34,24,10,47,36,11,56,55,1,4,3,0,0
"23536","WPG","NYR",2014021148,16525,20142015,1,60,2,3,-1,4.57316035020949,3.83067472005496,0.742485630154533,34,24,10,49,30,19,73,39,34,2,3,0,0
"23537","WPG","VAN",2014021169,16529,20142015,1,60,5,4,1,5.01611291826703,4.39459346602204,0.621519452244987,36,30,6,47,44,3,60,55,5,5,4,0,0
"23538","WPG","MIN",2014021187,16531,20142015,0,60,2,0,2,3.02363640980911,6.27320632363013,-3.24956991382101,34,32,2,43,48,-5,51,67,-16,4,3,0,0
"23539","WPG","STL",2014021195,16532,20142015,0,60,1,0,1,3.67638693447225,4.98976761795348,-1.31338068348123,31,30,1,44,47,-3,57,60,-3,6,6,0,0
"23540","WPG","COL",2014021210,16534,20142015,0,65,0,0,0,4.42476802345482,3.03027394145647,1.39449408199835,41,21,20,49,27,22,64,39,25,4,1,0,0
"23541","WPG","CGY",2014021218,16536,20142015,1,60,5,1,4,2.11592669569654,2.85639369077398,-0.740466995077441,22,25,-3,28,32,-4,40,45,-5,4,2,0,0
"23542","WPG","ANA",2014030171,16541,20142015,0,60,2,4,-2,4.02692625755662,6.80320470915467,-2.77627845159805,27,33,-6,36,53,-17,42,67,-25,3,4,0,0
"23543","WPG","ANA",2014030172,16543,20142015,0,60,1,2,-1,4.05280029172491,4.76325965361876,-0.710459361893854,29,39,-10,41,54,-13,56,62,-6,4,5,0,0
"23544","WPG","ANA",2014030173,16545,20142015,1,65.2,4,5,-1,3.79118595148248,8.24051217441081,-4.44932622292833,35,31,4,47,40,7,62,57,5,4,4,0,0
"23545","WPG","ANA",2014030174,16547,20142015,1,60,2,5,-3,4.07093569636345,4.91072175198497,-0.839786055621516,27,35,-8,39,45,-6,54,54,0,3,1,0,0
"23546","WPG","BOS",2015020005,16716,20152016,0,60,6,2,4,5.4577689937156,6.90173432277516,-1.44396532905955,32,31,1,41,50,-9,50,63,-13,1,3,0,0
"23547","WPG","N.J",2015020012,16717,20152016,0,60,3,1,2,4.21059004950318,3.55169704783475,0.658893001668432,30,21,9,38,28,10,44,32,12,4,4,0,0
"23548","WPG","NYI",2015020033,16720,20152016,0,60,2,4,-2,3.99041120458605,7.54302215086682,-3.55261094628077,24,44,-20,35,57,-22,51,73,-22,5,9,0,0
"23549","WPG","NYR",2015020038,16721,20152016,0,60,4,1,3,2.52462976424431,3.61459645305406,-1.08996668880975,29,41,-12,35,47,-12,47,60,-13,6,6,0,0
"23550","WPG","CGY",2015020061,16724,20152016,1,60,3,1,2,5.40564888267545,4.75505356333451,0.650595319340937,30,20,10,39,30,9,57,40,17,3,2,0,0
"23551","WPG","STL",2015020076,16726,20152016,1,60,2,4,-2,4.02511422247858,4.05427803596831,-0.0291638134897312,29,41,-12,41,47,-6,50,56,-6,10,9,0,0
"23552","WPG","T.B",2015020102,16731,20152016,1,60.6,3,4,-1,9.57216506521218,3.97565234913054,5.59651271608163,36,31,5,55,40,15,67,54,13,3,4,0,0
"23553","WPG","MIN",2015020118,16733,20152016,1,60,5,4,1,5.83814173801724,3.51416295289528,2.32397878512197,33,30,3,41,41,0,54,55,-1,1,5,0,0
"23554","WPG","L.A",2015020131,16735,20152016,1,60,1,4,-3,1.34782895041826,6.98404944324284,-5.63622049282458,25,32,-7,37,43,-6,52,59,-7,1,1,0,0
"23555","WPG","CHI",2015020142,16737,20152016,1,60,3,1,2,2.12263095956769,5.06199233624375,-2.93936137667606,31,46,-15,41,52,-11,51,70,-19,3,3,0,0
"23556","WPG","CBJ",2015020161,16739,20152016,0,60,3,2,1,3.07489454793682,3.59237733582268,-0.517482787885855,27,21,6,36,30,6,50,42,8,3,4,0,0
"23557","WPG","MTL",2015020166,16740,20152016,0,60,1,5,-4,2.16400713683106,4.29443114495371,-2.13042400812265,19,26,-7,28,37,-9,48,53,-5,5,7,0,0
"23558","WPG","TOR",2015020181,16743,20152016,0,60,4,2,2,8.95160565275838,4.34976756054675,4.60183809221163,34,26,8,55,40,15,69,57,12,2,3,0,0
"23559","WPG","OTT",2015020188,16744,20152016,0,65,2,2,0,5.41246605596825,2.94231037731515,2.4701556786531,40,31,9,55,39,16,70,56,14,2,2,0,0
"23560","WPG","PHI",2015020205,16746,20152016,1,60,0,3,-3,3.07114628883168,4.5384278538404,-1.46728156500873,28,23,5,44,34,10,63,43,20,6,6,0,0
"23561","WPG","MIN",2015020224,16749,20152016,0,60,3,5,-2,3.41002809093787,3.80396236671368,-0.393934275775806,28,28,0,37,42,-5,59,57,2,2,6,0,0
"23562","WPG","DAL",2015020239,16751,20152016,0,60,3,6,-3,3.92925569306681,5.50250292245619,-1.57324722938938,38,34,4,42,46,-4,67,68,-1,4,4,0,0
"23563","WPG","NSH",2015020255,16753,20152016,0,60,0,7,-7,4.49398940819083,2.84037272014018,1.65361668805065,20,34,-14,28,41,-13,41,44,-3,11,11,0,0
"23564","WPG","STL",2015020266,16755,20152016,0,60,2,3,-1,2.61224868583807,3.24381553457351,-0.631566848735446,18,28,-10,30,37,-7,42,48,-6,5,5,0,0
"23565","WPG","VAN",2015020275,16757,20152016,1,60,4,1,3,3.56946301879666,3.77370686933864,-0.204243850541978,34,30,4,46,44,2,59,56,3,6,7,0,0
"23566","WPG","ARI",2015020299,16760,20152016,1,60,3,2,1,2.14504242888261,3.8620652295258,-1.71702280064319,23,29,-6,33,35,-2,46,45,1,6,7,0,0
"23567","WPG","COL",2015020314,16762,20152016,1,60,1,4,-3,4.56243526028993,5.56000550216413,-0.9975702418742,21,29,-8,41,35,6,61,44,17,2,2,0,0
"23568","WPG","WSH",2015020322,16764,20152016,0,60,3,5,-2,2.36341721906501,3.30920948313724,-0.945792264072224,26,34,-8,39,48,-9,57,62,-5,3,3,0,0
"23569","WPG","MIN",2015020332,16766,20152016,0,60,3,1,2,5.84513184474781,1.91040126024745,3.93473058450036,29,15,14,42,22,20,52,34,18,5,3,0,0
"23570","WPG","COL",2015020350,16767,20152016,0,60,3,5,-2,6.73171642864327,5.46391378817498,1.26780264046829,28,25,3,38,36,2,55,47,8,2,3,0,0
"23571","WPG","TOR",2015020369,16771,20152016,1,60,6,1,5,6.81514997611521,3.54276409288286,3.27238588323235,35,33,2,46,45,1,54,61,-7,5,3,0,0
"23572","WPG","WSH",2015020388,16774,20152016,1,64.6666666666667,2,1,1,7.64874081144808,7.10566973162349,0.543071079824585,36,38,-2,50,50,0,57,69,-12,6,5,0,0
"23573","WPG","CHI",2015020399,16775,20152016,0,60,1,3,-2,0,0,0,31,32,-1,38,43,-5,56,54,2,2,3,0,0
"23574","WPG","CBJ",2015020426,16779,20152016,1,60,6,4,2,5.03444561979268,2.99019133768161,2.04425428211107,35,29,6,44,39,5,53,49,4,4,5,0,0
"23575","WPG","CHI",2015020430,16780,20152016,0,60,0,2,-2,3.9059689223634,3.0564654963317,0.849503426031697,25,31,-6,34,37,-3,57,45,12,5,5,0,0
"23576","WPG","STL",2015020461,16784,20152016,1,60,3,4,-1,5.9707038609719,3.60551660596386,2.36518725500805,36,26,10,44,37,7,66,56,10,3,4,0,0
"23577","WPG","NYR",2015020482,16787,20152016,1,60,5,2,3,4.90561981174687,6.81316491085454,-1.90754509910767,36,28,8,53,38,15,67,54,13,4,3,0,0
"23578","WPG","EDM",2015020506,16790,20152016,0,60,1,3,-2,7.12614227683772,3.05724292299783,4.06889935383989,45,21,24,63,27,36,83,37,46,7,4,0,0
"23579","WPG","CGY",2015020514,16791,20152016,0,60,1,4,-3,2.61334528087173,5.21008573517089,-2.59674045429917,20,33,-13,32,51,-19,49,68,-19,1,5,0,0
"23580","WPG","PIT",2015020531,16796,20152016,1,60,1,0,1,3.18074634373481,4.02458521435619,-0.843838870621383,28,30,-2,44,41,3,51,59,-8,3,2,0,0
"23581","WPG","DET",2015020547,16798,20152016,1,60,4,1,3,5.40769559678353,3.94941617568111,1.45827942110242,25,34,-9,36,48,-12,42,64,-22,3,6,0,0
"23582","WPG","ARI",2015020564,16800,20152016,0,60,2,4,-2,6.01979038894922,4.87697923055384,1.14281115839538,37,21,16,60,33,27,80,42,38,4,6,0,0
"23583","WPG","S.J",2015020578,16802,20152016,0,60,4,1,3,6.69266769244713,3.31282161385752,3.37984607858961,27,28,-1,39,37,2,53,58,-5,4,6,0,0
"23584","WPG","ANA",2015020582,16803,20152016,0,60,1,4,-3,2.61985485555488,5.35880408994946,-2.73894923439458,20,35,-15,31,53,-22,40,64,-24,6,4,0,0
"23585","WPG","NSH",2015020594,16805,20152016,0,60,4,1,3,5.09717890234606,5.52106963227243,-0.42389072992637,19,44,-25,27,60,-33,36,76,-40,3,4,0,0
"23586","WPG","DAL",2015020604,16807,20152016,0,65,1,1,0,3.32814921369572,4.37252356205681,-1.04437434836109,33,24,9,42,37,5,62,57,5,4,3,0,0
"23587","WPG","BUF",2015020624,16810,20152016,1,60,2,4,-2,6.37864601836645,6.8687097003567,-0.49006368199025,44,29,15,54,36,18,67,44,23,2,3,0,0
"23588","WPG","S.J",2015020638,16812,20152016,1,60,1,4,-3,2.42869198968816,3.60394833202906,-1.1752563423409,22,27,-5,28,37,-9,49,47,2,3,5,0,0
"23589","WPG","NSH",2015020650,16814,20152016,1,60.85,5,4,1,4.22696770093171,4.54544696930729,-0.318479268375583,24,35,-11,34,52,-18,54,76,-22,8,5,0,0
"23590","WPG","MIN",2015020658,16815,20152016,0,60,1,0,1,3.64673320483416,4.01437846681802,-0.367645261983853,26,24,2,35,41,-6,45,54,-9,2,3,0,0
"23591","WPG","COL",2015020679,16818,20152016,1,60,1,2,-1,5.48495852865744,4.1734823465813,1.31147618207615,37,34,3,51,42,9,72,50,22,2,2,0,0
"23592","WPG","NSH",2015020699,16821,20152016,1,60,1,4,-3,3.85476221995032,6.48901780759709,-2.63425558764678,27,28,-1,34,36,-2,49,48,1,4,3,0,0
"23593","WPG","N.J",2015020715,16823,20152016,1,60,1,3,-2,4.05286844109651,4.8810677761212,-0.828199335024692,23,16,7,33,29,4,46,41,5,1,2,0,0
"23594","WPG","ARI",2015020737,16826,20152016,1,60,5,2,3,4.45179556077665,3.66021720898012,0.791578351796527,37,34,3,43,41,2,53,64,-11,4,5,0,0
"23595","WPG","DAL",2015020751,16833,20152016,1,60,3,5,-2,3.26765832704889,5.55596818121421,-2.28830985416532,24,27,-3,32,41,-9,47,55,-8,4,5,0,0
"23596","WPG","CAR",2015020772,16836,20152016,1,60,3,5,-2,6.49444514399956,3.27135763580009,3.22308750819948,36,29,7,51,36,15,67,48,19,2,4,0,0
"23597","WPG","COL",2015020785,16837,20152016,0,60,4,2,2,6.3866012088256,7.85354970485415,-1.46694849602855,39,34,5,53,43,10,71,60,11,6,8,0,0
"23598","WPG","STL",2015020800,16840,20152016,0,65,1,1,0,4.51742559433181,3.78549422210894,0.731931372222873,33,22,11,49,33,16,68,39,29,5,3,0,0
"23599","WPG","BOS",2015020814,16842,20152016,1,60,2,6,-4,0,0,0,36,39,-3,52,47,5,66,66,0,6,4,0,0
"23600","WPG","EDM",2015020833,16844,20152016,0,65,1,1,0,3.97449374909047,2.00156339774094,1.97293035134953,33,22,11,50,38,12,66,58,8,7,6,0,0
"23601","WPG","CAR",2015020849,16847,20152016,0,60,1,2,-1,2.06566479430494,2.55446202741894,-0.488797233113992,21,29,-8,31,41,-10,44,57,-13,4,5,0,0
"23602","WPG","T.B",2015020862,16849,20152016,0,65,5,5,0,6.02998466229838,4.22122003124241,1.80876463105596,41,26,15,50,41,9,61,53,8,6,8,0,0
"23603","WPG","FLA",2015020877,16851,20152016,0,60,1,3,-2,3.79812882491493,4.69453935039294,-0.896410525478018,30,32,-2,36,47,-11,50,63,-13,4,4,0,0
"23604","WPG","DAL",2015020899,16854,20152016,1,60,3,5,-2,5.0543655740538,3.93359127411593,1.12077429993788,25,27,-2,40,37,3,62,49,13,4,5,0,0
"23605","WPG","DAL",2015020912,16856,20152016,0,60,6,3,3,5.23381350381533,3.13935144518499,2.09446205863034,28,30,-2,37,44,-7,49,54,-5,4,6,0,0
"23606","WPG","PIT",2015020922,16858,20152016,0,60,1,4,-3,4.47229859595245,5.03114273492247,-0.558844138970017,28,33,-5,39,43,-4,49,53,-4,2,1,0,0
"23607","WPG","FLA",2015020949,16861,20152016,1,60,2,3,-1,2.99789553863229,4.69059737713542,-1.69270183850313,32,22,10,45,31,14,59,43,16,4,3,0,0
"23608","WPG","NYI",2015020961,16863,20152016,1,62.3333333333333,3,4,-1,2.53171193733004,6.12537501442421,-3.59366307709416,29,27,2,37,36,1,54,42,12,4,4,0,0
"23609","WPG","MTL",2015020977,16865,20152016,1,60,4,2,2,8.28055819054134,5.14447646588087,3.13608172466047,30,28,2,40,39,1,51,49,2,3,2,0,0
"23610","WPG","EDM",2015020984,16866,20152016,1,60,1,2,-1,5.73978962506226,5.13828277341963,0.601506851642625,40,31,9,56,42,14,78,56,22,2,2,0,0
"23611","WPG","NSH",2015020999,16868,20152016,1,60,2,4,-2,3.50593091841438,3.28805047938386,0.217880439030523,23,31,-8,36,41,-5,59,53,6,3,5,0,0
"23612","WPG","DET",2015021009,16870,20152016,0,60,2,3,-1,3.43765025096945,4.5045902194106,-1.06693996844115,25,35,-10,30,44,-14,38,64,-26,6,5,0,0
"23613","WPG","COL",2015021024,16872,20152016,1,60,3,2,1,4.5435213935998,5.12453269428167,-0.581011300681867,30,37,-7,42,45,-3,58,63,-5,4,3,0,0
"23614","WPG","VAN",2015021037,16874,20152016,0,60,5,2,3,4.01559732909755,3.31492621998041,0.700671109117138,29,28,1,43,38,5,50,46,4,3,4,0,0
"23615","WPG","CGY",2015021050,16876,20152016,0,60,1,4,-3,4.76817016024143,2.26494122312243,2.50322893711899,29,21,8,43,30,13,65,42,23,2,3,0,0
"23616","WPG","CHI",2015021063,16878,20152016,1,60,0,4,-4,4.96828218997689,6.77551033462078,-1.80722814464389,28,36,-8,38,46,-8,50,59,-9,5,2,0,0
"23617","WPG","ANA",2015021078,16880,20152016,1,64.0166666666667,2,3,-1,3.41285884240642,7.36325460307853,-3.95039576067211,29,33,-4,36,39,-3,47,48,-1,3,2,0,0
"23618","WPG","VAN",2015021095,16882,20152016,1,60,2,0,2,6.15231741267905,3.18212069170005,2.970196720979,49,28,21,62,36,26,73,46,27,3,2,0,0
"23619","WPG","L.A",2015021108,16884,20152016,1,60,4,1,3,6.36003341752439,5.9727308477668,0.387302569757594,24,34,-10,34,51,-17,48,76,-28,3,3,0,0
"23620","WPG","BUF",2015021116,16886,20152016,0,60,2,3,-1,3.19546647899551,5.88432902807835,-2.68886254908284,20,29,-9,31,47,-16,40,63,-23,1,2,0,0
"23621","WPG","PHI",2015021132,16888,20152016,0,64.7666666666667,2,3,-1,5.95723363583602,9.20303017855622,-3.2457965427202,28,32,-4,44,54,-10,63,77,-14,1,3,0,0
"23622","WPG","OTT",2015021149,16890,20152016,1,60,1,2,-1,5.40691458561923,2.89574722508996,2.51116736052927,21,19,2,34,30,4,51,47,4,4,4,0,0
"23623","WPG","CHI",2015021164,16892,20152016,1,61.0333333333333,4,5,-1,3.56325339651085,2.96185716085085,0.60139623565999,32,27,5,43,33,10,62,48,14,3,3,0,0
"23624","WPG","MIN",2015021180,16894,20152016,1,60,5,1,4,6.5898483969213,4.83999930158461,1.74984909533669,34,29,5,44,41,3,58,60,-2,4,3,0,0
"23625","WPG","ANA",2015021198,16896,20152016,0,63.1166666666667,2,1,1,4.60351812345033,6.71579816934593,-2.1122800458956,26,28,-2,39,42,-3,47,60,-13,3,4,0,0
"23626","WPG","S.J",2015021214,16898,20152016,0,60,5,4,1,3.03407867741771,4.31194416768631,-1.2778654902686,26,25,1,34,37,-3,49,50,-1,4,4,0,0
"23627","WPG","L.A",2015021229,16900,20152016,0,65,3,3,0,2.89871691130611,6.05766716301594,-3.15895025170983,31,29,2,43,47,-4,55,62,-7,3,0,0,0
"23628","WPG","CAR",2016020012,17087,20162017,1,62.6833333333333,5,4,1,3.30966634288779,3.34292374561941,-0.0332574027316115,26,27,-1,36,44,-8,46,56,-10,5,5,0,0
"23629","WPG","MIN",2016020024,17089,20162017,0,60,3,4,-1,2.78279412584379,4.76313227253888,-1.98033814669509,17,31,-14,21,45,-24,37,56,-19,4,5,0,0
"23630","WPG","BOS",2016020036,17091,20162017,1,60,1,4,-3,4.50624684509239,4.97915146068,-0.472904615587609,35,25,10,43,36,7,58,46,12,5,4,0,0
"23631","WPG","TOR",2016020050,17093,20162017,1,62.6666666666667,5,4,1,5.71751704020426,5.47676859161584,0.24074844858842,34,40,-6,54,48,6,81,64,17,3,2,0,0
"23632","WPG","EDM",2016020077,17097,20162017,1,60,0,3,-3,4.13200596882962,4.45623076387892,-0.324224795049304,31,32,-1,45,40,5,56,47,9,4,2,0,0
"23633","WPG","DAL",2016020090,17099,20162017,0,60,2,3,-1,6.48061106954182,4.96783834383389,1.51277272570793,30,26,4,45,36,9,65,53,12,5,7,0,0
"23634","WPG","DAL",2016020104,17101,20162017,1,60,4,1,3,3.26691629976267,7.93565645139968,-4.66874015163701,36,39,-3,46,54,-8,55,71,-16,7,6,0,0
"23635","WPG","COL",2016020109,17102,20162017,0,60,1,0,1,0.983629516294343,6.04208314772802,-5.05845363143368,21,37,-16,24,54,-30,42,68,-26,3,4,0,0
"23636","WPG","BUF",2016020123,17104,20162017,1,60,1,3,-2,5.898304187147,3.46622196978112,2.43208221736589,38,28,10,49,39,10,64,51,13,8,3,0,0
"23637","WPG","WSH",2016020138,17106,20162017,1,60,2,3,-1,5.6962532007019,4.47112162140547,1.22513157929643,45,27,18,56,35,21,61,48,13,4,4,0,0
"23638","WPG","WSH",2016020149,17108,20162017,0,63.35,3,4,-1,3.60226320727088,3.32736549177207,0.27489771549881,27,32,-5,42,46,-4,53,65,-12,3,6,0,0
"23639","WPG","DET",2016020159,17109,20162017,0,60,5,3,2,6.90188270729323,1.53324139781762,5.36864130947561,31,33,-2,41,37,4,50,49,1,1,4,0,0
"23640","WPG","NYR",2016020177,17111,20162017,0,60,2,5,-3,3.78354447454331,1.77005002416485,2.01349445037845,26,18,8,37,27,10,58,37,21,2,0,0,0
"23641","WPG","DAL",2016020191,17113,20162017,1,60,8,2,6,4.9495266917329,5.91525129438378,-0.96572460265088,31,30,1,40,45,-5,59,61,-2,6,6,0,0
"23642","WPG","ARI",2016020205,17115,20162017,0,60,3,2,1,3.25958992959931,2.89907750031603,0.36051242928329,27,25,2,50,37,13,57,48,9,2,1,0,0
"23643","WPG","COL",2016020210,17116,20162017,0,61.3833333333333,2,3,-1,1.13037763140164,5.05808235264435,-3.92770472124271,18,29,-11,20,41,-21,27,56,-29,6,5,0,0
"23644","WPG","L.A",2016020223,17118,20162017,1,65,2,2,0,4.86944830963577,6.37846629837486,-1.50901798873909,29,29,0,38,40,-2,57,69,-12,2,5,0,0
"23645","WPG","CHI",2016020238,17120,20162017,1,60,4,0,4,1.85661932770191,4.46020123086521,-2.6035819031633,24,27,-3,34,40,-6,49,58,-9,1,3,0,0
"23646","WPG","PHI",2016020246,17122,20162017,0,60,2,5,-3,3.65929523526938,5.0478816194227,-1.38858638415331,32,22,10,49,31,18,69,52,17,1,1,0,0
"23647","WPG","BOS",2016020262,17124,20162017,0,60,1,4,-3,1.69534810978803,5.32939678104594,-3.63404867125791,12,38,-26,23,51,-28,33,67,-34,5,5,0,0
"23648","WPG","CAR",2016020273,17125,20162017,0,60,1,3,-2,2.77272577083204,5.61256472172681,-2.83983895089477,29,40,-11,39,52,-13,49,70,-21,5,9,0,0
"23649","WPG","MIN",2016020293,17128,20162017,0,60,1,3,-2,1.5105379201877,4.9578306216863,-3.4472927014986,16,26,-10,25,33,-8,39,43,-4,2,3,0,0
"23650","WPG","NSH",2016020307,17130,20162017,0,60,1,5,-4,4.28978610948354,6.88280426558346,-2.59301815609992,23,30,-7,27,42,-15,35,61,-26,1,3,0,0
"23651","WPG","NSH",2016020325,17132,20162017,1,60,3,0,3,4.51097627119452,5.82623990277304,-1.31526363157852,24,42,-18,37,52,-15,47,79,-32,4,4,0,0
"23652","WPG","N.J",2016020335,17134,20162017,1,60,3,2,1,3.70108824985186,6.74323458041231,-3.04214633056045,29,25,4,48,45,3,57,60,-3,5,5,0,0
"23653","WPG","EDM",2016020352,17136,20162017,1,60,3,6,-3,4.90741826989688,7.77673677087781,-2.86931850098093,25,33,-8,38,42,-4,53,53,0,5,5,0,0
"23654","WPG","STL",2016020366,17138,20162017,0,60.2833333333333,3,2,1,3.38117737265839,6.31623481080169,-2.9350574381433,23,22,1,31,34,-3,42,46,-4,2,5,0,0
"23655","WPG","CHI",2016020374,17139,20162017,0,60,2,1,1,4.73779422012058,3.35817310309332,1.37962111702726,32,26,6,41,33,8,51,53,-2,2,2,0,0
"23656","WPG","DET",2016020388,17141,20162017,1,65,3,3,0,4.15413999696466,6.53326225635101,-2.37912225938635,34,30,4,40,40,0,55,51,4,3,2,0,0
"23657","WPG","NYR",2016020401,17143,20162017,1,60,1,2,-1,2.53363646229263,3.24379133107141,-0.710154868778773,18,24,-6,26,32,-6,36,47,-11,3,4,0,0
"23658","WPG","CGY",2016020419,17145,20162017,0,60,2,6,-4,3.60446439377621,4.00496788896353,-0.400503495187323,28,35,-7,43,49,-6,57,56,1,4,4,0,0
"23659","WPG","EDM",2016020428,17146,20162017,0,60,2,3,-1,4.27862965408713,2.08766162429879,2.19096802978834,31,31,0,38,47,-9,51,58,-7,2,3,0,0
"23660","WPG","FLA",2016020451,17150,20162017,1,65,3,3,0,5.01558925100835,5.97133664836292,-0.955747397354571,32,44,-12,44,60,-16,53,69,-16,5,6,0,0
"23661","WPG","COL",2016020471,17153,20162017,1,60,4,1,3,5.06523505708901,4.08761729020625,0.977617766882759,30,28,2,39,34,5,47,43,4,1,3,0,0
"23662","WPG","VAN",2016020491,17155,20162017,0,60,1,4,-3,6.13351263967343,5.68508397238475,0.448428667288681,32,24,8,39,34,5,48,40,8,5,3,0,0
"23663","WPG","VAN",2016020504,17157,20162017,0,60,4,1,3,3.41010709613329,2.24062868809521,1.16947840803807,25,23,2,37,28,9,47,37,10,5,5,0,0
"23664","WPG","CHI",2016020523,17162,20162017,0,60,3,1,2,5.42429923223244,5.41896257153712,0.00533666069532046,34,35,-1,43,44,-1,52,62,-10,1,3,0,0
"23665","WPG","CBJ",2016020539,17164,20162017,1,60,3,5,-2,3.50396841934932,3.98813862395764,-0.484170204608318,34,35,-1,48,44,4,58,58,0,6,6,0,0
"23666","WPG","NYI",2016020553,17166,20162017,1,60,2,6,-4,3.97174628413632,3.23861723663867,0.733129047497641,34,24,10,42,30,12,59,41,18,3,2,0,0
"23667","WPG","T.B",2016020569,17169,20162017,0,60,6,4,2,5.26358302993685,5.01507108134319,0.248511948593659,34,36,-2,45,45,0,62,57,5,6,7,0,0
"23668","WPG","FLA",2016020572,17170,20162017,0,60,4,1,3,4.95901297775976,5.29314142023213,-0.334128442472377,39,32,7,47,44,3,56,57,-1,2,5,0,0
"23669","WPG","BUF",2016020591,17173,20162017,0,60,3,4,-1,4.00082841213066,2.80252564407419,1.19830276805646,35,36,-1,43,45,-2,60,52,8,5,8,0,0
"23670","WPG","CGY",2016020611,17175,20162017,1,60,2,0,2,2.85856189853209,3.6401578149635,-0.781595916431415,27,28,-1,33,38,-5,41,51,-10,4,4,0,0
"23671","WPG","MTL",2016020621,17177,20162017,1,60,4,7,-3,4.4265997808165,3.86673429817893,0.559865482637576,27,30,-3,40,36,4,54,45,9,4,2,0,0
"23672","WPG","ARI",2016020639,17179,20162017,0,60,3,4,-1,3.97518715141632,3.3398186720151,0.635368479401222,37,29,8,47,39,8,61,49,12,2,3,0,0
"23673","WPG","L.A",2016020650,17180,20162017,0,61.6,2,3,-1,4.71924686002694,5.15293346336694,-0.433686603339993,28,38,-10,38,49,-11,52,67,-15,4,4,0,0
"23674","WPG","S.J",2016020660,17182,20162017,0,60,2,5,-3,0,0,0,28,32,-4,40,48,-8,58,68,-10,2,3,0,0
"23675","WPG","ARI",2016020673,17184,20162017,1,60,6,3,3,4.94178466856829,3.90169960456114,1.04008506400714,39,33,6,53,38,15,75,50,25,3,4,0,0
"23676","WPG","STL",2016020691,17187,20162017,1,60,5,3,2,4.13422022755981,4.15938518585151,-0.0251649582917022,29,37,-8,37,46,-9,48,55,-7,5,4,0,0
"23677","WPG","ANA",2016020711,17189,20162017,1,60,2,3,-1,3.88335839168576,2.83197147206504,1.05138691962072,33,27,6,43,32,11,55,40,15,7,4,0,0
"23678","WPG","S.J",2016020721,17190,20162017,1,60,3,4,-1,7.32512443582527,5.6799012829515,1.64522315287377,34,26,8,49,38,11,67,57,10,2,3,0,0
"23679","WPG","CHI",2016020737,17192,20162017,0,60,5,3,2,4.0080937414823,2.91443784498649,1.0936558964958,33,41,-8,37,47,-10,49,66,-17,5,5,0,0
"23680","WPG","STL",2016020749,17197,20162017,0,60,5,3,2,2.6996812170255,2.539898593619,0.1597826234065,24,27,-3,33,37,-4,45,47,-2,2,2,0,0
"23681","WPG","DAL",2016020763,17199,20162017,0,60,4,3,1,2.68821041510091,8.28006186107541,-5.5918514459745,29,42,-13,36,54,-18,43,83,-40,2,2,0,0
"23682","WPG","COL",2016020773,17201,20162017,0,60,2,5,-3,3.23874815458839,3.18204824562417,0.0566999089642195,25,28,-3,40,36,4,50,47,3,5,3,0,0
"23683","WPG","MIN",2016020799,17204,20162017,1,60,2,4,-2,6.72319310196326,4.92703873894061,1.79615436302265,40,25,15,58,35,23,72,50,22,1,2,0,0
"23684","WPG","CHI",2016020814,17207,20162017,1,60,2,5,-3,6.36966745660175,7.59006414504904,-1.22039668844729,30,36,-6,45,50,-5,63,62,1,3,2,0,0
"23685","WPG","T.B",2016020825,17208,20162017,1,60,1,4,-3,5.46150239007761,4.06084054600797,1.40066184406965,33,30,3,46,37,9,59,47,12,4,3,0,0
"23686","WPG","DAL",2016020841,17211,20162017,1,60,5,2,3,4.8705277926087,5.71892677137316,-0.848398978764465,24,36,-12,35,52,-17,51,77,-26,4,5,0,0
"23687","WPG","PIT",2016020850,17213,20162017,0,64.6333333333333,3,4,-1,8.77465672249673,5.6911751268683,3.08348159562843,47,39,8,60,51,9,80,65,15,6,4,0,0
"23688","WPG","MTL",2016020859,17215,20162017,0,60,3,1,2,5.81751638634887,1.76231718575582,4.05519920059305,33,20,13,42,31,11,59,49,10,3,4,0,0
"23689","WPG","OTT",2016020871,17216,20162017,0,60,3,2,1,4.81186253351373,7.3768115027342,-2.56494896922047,20,34,-14,31,47,-16,54,56,-2,1,4,0,0
"23690","WPG","TOR",2016020885,17218,20162017,0,62.4833333333333,4,5,-1,5.14384480053559,6.09917881792535,-0.95533401738976,20,37,-17,30,58,-28,36,75,-39,6,7,0,0
"23691","WPG","MIN",2016020929,17225,20162017,1,60,5,6,-1,4.21915218812645,4.44097831033287,-0.221826122206413,36,28,8,43,31,12,53,40,13,5,3,0,0
"23692","WPG","STL",2016020948,17228,20162017,1,60,3,0,3,7.69673635205254,5.17834622578306,2.51839012626948,40,29,11,54,39,15,65,57,8,7,5,0,0
"23693","WPG","COL",2016020958,17229,20162017,1,60,6,1,5,5.31521062310186,2.18183124653297,3.1333793765689,31,23,8,42,34,8,55,47,8,5,4,0,0
"23694","WPG","S.J",2016020972,17231,20162017,1,60,2,3,-1,4.08815101807704,4.78686071073117,-0.69870969265413,33,30,3,47,43,4,63,58,5,4,3,0,0
"23695","WPG","PIT",2016020984,17233,20162017,1,60,4,7,-3,0,0,0,35,32,3,48,45,3,62,57,5,6,8,0,0
"23696","WPG","CGY",2016021005,17236,20162017,1,60,0,3,-3,4.74276577797298,3.52481346664405,1.21795231132893,31,29,2,42,38,4,57,54,3,4,5,0,0
"23697","WPG","NSH",2016021019,17238,20162017,0,62.1833333333333,4,5,-1,3.25523319435888,6.65939836081816,-3.40416516645928,34,42,-8,46,55,-9,51,72,-21,1,3,0,0
"23698","WPG","N.J",2016021024,17253,20162017,0,65,3,3,0,5.72842044908271,2.69090060930851,3.03751983977419,36,23,13,54,34,20,63,42,21,3,5,0,0
"23699","WPG","NYI",2016021038,17241,20162017,0,60,4,2,2,3.88776037896851,1.86382106741337,2.02393931155515,28,29,-1,42,40,2,52,60,-8,5,4,0,0
"23700","WPG","MIN",2016021065,17244,20162017,1,60,5,4,1,4.10955254912187,5.23873775530626,-1.12918520618439,21,48,-27,32,62,-30,50,86,-36,4,3,0,0
"23701","WPG","PHI",2016021083,17246,20162017,1,60,3,2,1,3.31929085010819,3.58354106094376,-0.264250210835566,33,26,7,50,34,16,70,45,25,8,6,0,0
"23702","WPG","L.A",2016021100,17248,20162017,0,60,2,5,-3,5.0366449395014,5.11736316381575,-0.0807182243143529,21,36,-15,33,53,-20,45,72,-27,4,4,0,0
"23703","WPG","ANA",2016021104,17249,20162017,0,60,1,3,-2,2.35255454134312,5.5272265493295,-3.17467200798637,18,35,-17,30,55,-25,39,78,-39,3,3,0,0
"23704","WPG","VAN",2016021120,17251,20162017,1,60,2,1,1,2.89026562386425,3.24612820859466,-0.355862584730403,32,29,3,39,40,-1,51,51,0,2,1,0,0
"23705","WPG","ANA",2016021148,17255,20162017,1,63.5666666666667,4,3,1,8.14677142749946,3.32991703590218,4.81685439159727,41,28,13,61,35,26,74,44,30,5,4,0,0
"23706","WPG","OTT",2016021163,17257,20162017,1,60,4,2,2,8.21526613015158,4.76272283666185,3.45254329348973,28,31,-3,46,41,5,62,51,11,2,2,0,0
"23707","WPG","STL",2016021184,17260,20162017,0,60,5,2,3,5.50610412216799,2.71293557962417,2.79316854254381,31,26,5,39,35,4,51,50,1,1,1,0,0
"23708","WPG","CBJ",2016021197,17262,20162017,0,60,5,4,1,7.16530376698938,5.85278954243703,1.31251422455235,32,39,-7,42,50,-8,54,71,-17,2,0,0,0
"23709","WPG","NSH",2016021215,17264,20162017,1,60,2,1,1,5.318565625872,4.79648190876469,0.522083717107307,36,34,2,45,46,-1,52,65,-13,2,6,0,0
"23710","WPG","TOR",2017020001,17443,20172018,1,60,2,7,-5,4.53350199910943,5.32444614412679,-0.790944145017352,37,31,6,47,39,8,71,53,18,8,4,0,0
"23711","WPG","CGY",2017020027,17446,20172018,0,60,3,6,-3,3.87804918189067,6.08663126501779,-2.20858208312711,28,45,-17,37,57,-20,47,78,-31,3,6,0,0
"23712","WPG","EDM",2017020037,17448,20172018,0,60,5,2,3,3.56910923370742,4.18231004066183,-0.61320080695441,43,39,4,49,50,-1,66,67,-1,4,2,0,0
"23713","WPG","VAN",2017020055,17451,20172018,0,60,4,2,2,2.79218289059602,3.52204221308057,-0.729859322484543,20,32,-12,26,40,-14,35,55,-20,2,5,0,0
"23714","WPG","CAR",2017020068,17453,20172018,1,60,2,1,1,2.45837671010452,2.76781193968145,-0.30943522957693,21,29,-8,30,42,-12,44,61,-17,2,4,0,0
"23715","WPG","CBJ",2017020087,17456,20172018,1,60,2,5,-3,3.32140798795186,6.29491692269221,-2.97350893474035,26,39,-13,34,49,-15,51,66,-15,1,3,0,0
"23716","WPG","MIN",2017020108,17459,20172018,1,60,4,3,1,3.27964323559354,2.16897828239598,1.11066495319756,30,27,3,37,32,5,46,42,4,3,1,0,0
"23717","WPG","PIT",2017020141,17465,20172018,0,61.1166666666667,1,2,-1,3.35058003718086,3.37453145711743,-0.0239514199365654,31,36,-5,41,50,-9,54,70,-16,3,5,0,0
"23718","WPG","CBJ",2017020151,17466,20172018,0,62.6333333333333,1,2,-1,4.67921677149846,5.91101937641542,-1.23180260491696,30,37,-7,44,56,-12,53,71,-18,6,4,0,0
"23719","WPG","PIT",2017020168,17468,20172018,1,60,7,1,6,4.31652989228314,7.85972700880366,-3.54319711652051,24,32,-8,35,48,-13,46,58,-12,6,6,0,0
"23720","WPG","MIN",2017020180,17470,20172018,0,60,2,1,1,1.75147260303493,6.98098965745885,-5.22951705442392,19,29,-10,26,53,-27,38,75,-37,4,6,0,0
"23721","WPG","DAL",2017020193,17472,20172018,1,60,5,2,3,4.68926454774919,6.78797827825877,-2.09871373050958,27,23,4,40,35,5,53,49,4,5,1,0,0
"23722","WPG","MTL",2017020206,17474,20172018,1,63.1166666666667,4,5,-1,3.60449486854958,8.11417908588162,-4.50968421733204,23,50,-27,31,69,-38,39,81,-42,3,6,0,0
"23723","WPG","DAL",2017020221,17476,20172018,0,60,4,1,3,5.42522832844406,3.83521697719698,1.59001135124709,26,34,-8,40,36,4,54,51,3,3,4,0,0
"23724","WPG","VGK",2017020248,17480,20172018,0,60,2,5,-3,3.64201941678766,1.96765954518045,1.67435987160722,29,27,2,42,37,5,60,52,8,6,4,0,0
"23725","WPG","ARI",2017020259,17481,20172018,0,60,4,1,3,4.33584084179106,3.42763266882685,0.908208172964216,21,30,-9,32,48,-16,44,67,-23,2,4,0,0
"23726","WPG","ARI",2017020272,17484,20172018,1,60,4,1,3,2.48556663941417,3.98725787764704,-1.50169123823287,30,34,-4,38,45,-7,45,61,-16,4,6,0,0
"23727","WPG","PHI",2017020284,17486,20172018,1,65,2,2,0,3.64490959237446,4.08622561070643,-0.441316018331968,33,32,1,41,44,-3,48,59,-11,5,6,0,0
"23728","WPG","N.J",2017020295,17488,20172018,1,60,5,2,3,4.17328844938311,4.77571498265024,-0.602426533267135,34,36,-2,44,49,-5,57,64,-7,0,2,0,0
"23729","WPG","NSH",2017020313,17490,20172018,0,60,3,5,-2,4.51292499819018,4.31965561611287,0.193269382077313,35,29,6,45,39,6,57,52,5,2,3,0,0
"23730","WPG","L.A",2017020333,17492,20172018,0,60,2,1,1,3.36297871147142,4.64876942747469,-1.28579071600327,27,39,-12,48,53,-5,64,69,-5,4,5,0,0
"23731","WPG","ANA",2017020337,17494,20172018,0,60,4,1,3,7.45808653265703,5.96877193453111,1.48931459812593,36,31,5,49,51,-2,61,70,-9,4,3,0,0
"23732","WPG","S.J",2017020357,17495,20172018,0,60,0,4,-4,4.2670032150636,7.72399502882035,-3.45699181375676,38,34,4,54,45,9,75,59,16,3,2,0,0
"23733","WPG","MIN",2017020365,17497,20172018,1,60,7,2,5,3.22194484170539,4.98605448677699,-1.76410964507161,28,19,9,36,27,9,52,35,17,7,3,0,0
"23734","WPG","COL",2017020380,17499,20172018,0,60.9833333333333,2,3,-1,5.09961006002845,2.35761524163612,2.74199481839234,33,26,7,44,39,5,61,53,8,6,7,0,0
"23735","WPG","VGK",2017020394,17501,20172018,1,60,7,4,3,0,0,0,38,31,7,55,43,12,66,62,4,5,5,0,0
"23736","WPG","OTT",2017020409,17503,20172018,1,60,5,0,5,6.60293166430056,2.9183341737953,3.68459749050526,49,21,28,61,32,29,77,50,27,5,3,0,0
"23737","WPG","DET",2017020419,17505,20172018,0,60,1,5,-4,3.4709962427186,5.51919195286478,-2.04819571014618,26,32,-6,42,50,-8,54,61,-7,6,6,0,0
"23738","WPG","FLA",2017020434,17507,20172018,0,60,4,6,-2,3.78650058261871,3.24330972981988,0.54319085279883,39,36,3,56,45,11,68,53,15,8,5,0,0
"23739","WPG","T.B",2017020447,17509,20172018,0,60.6,3,4,-1,2.75410900770402,2.49317509448156,0.260933913222459,20,28,-8,30,40,-10,44,54,-10,2,4,0,0
"23740","WPG","VAN",2017020464,17511,20172018,1,60,5,1,4,4.55831522203516,5.35956030260422,-0.801245080569061,24,26,-2,33,33,0,45,44,1,3,2,0,0
"23741","WPG","CHI",2017020485,17514,20172018,1,60,1,5,-4,5.22678720135099,4.59300866429112,0.633778537059869,28,30,-2,46,41,5,63,57,6,2,3,0,0
"23742","WPG","STL",2017020501,17516,20172018,0,60,0,2,-2,6.33358331524147,2.41753680794355,3.91604650729792,48,30,18,65,39,26,77,54,23,5,5,0,0
"23743","WPG","STL",2017020507,17517,20172018,1,60,4,0,4,4.98173825701267,4.10821896104608,0.873519295966588,46,24,22,62,32,30,81,48,33,4,4,0,0
"23744","WPG","NSH",2017020521,17519,20172018,0,60,6,4,2,6.39136031176977,4.37731377357503,2.01404653819475,36,34,2,48,45,3,58,59,-1,6,4,0,0
"23745","WPG","BOS",2017020529,17521,20172018,0,65,1,1,0,4.49295810962212,4.04784527966694,0.445112829955178,38,33,5,48,46,2,61,66,-5,3,3,0,0
"23746","WPG","NYI",2017020544,17523,20172018,0,60,2,5,-3,3.82322304445552,5.48861392777508,-1.66539088331956,40,29,11,55,36,19,71,44,27,3,3,0,0
"23747","WPG","EDM",2017020566,17527,20172018,1,60,4,3,1,4.7770700896217,3.33303099689383,1.44403909272788,39,25,14,55,38,17,72,50,22,4,1,0,0
"23748","WPG","NYI",2017020582,17529,20172018,1,60,4,2,2,5.16766669832759,4.41938033698534,0.748286361342252,37,44,-7,52,60,-8,75,81,-6,5,4,0,0
"23749","WPG","EDM",2017020600,17531,20172018,0,60,5,0,5,6.37275365595172,5.37657788790966,0.996175768042054,38,35,3,52,42,10,72,64,8,3,2,0,0
"23750","WPG","COL",2017020610,17533,20172018,0,64.8333333333333,2,3,-1,5.44007238940685,3.71760610585625,1.7224662835506,44,26,18,57,38,19,88,55,33,4,2,0,0
"23751","WPG","BUF",2017020631,17536,20172018,1,60,4,3,1,3.28872158235635,3.26678403757978,0.0219375447765628,29,29,0,38,46,-8,51,69,-18,4,5,0,0
"23752","WPG","S.J",2017020646,17538,20172018,1,60,4,1,3,3.86178661117447,4.77452107883801,-0.91273446766354,30,32,-2,39,47,-8,54,68,-14,3,4,0,0
"23753","WPG","BUF",2017020653,17540,20172018,0,60,7,4,3,4.24944462185522,3.7398872575418,0.509557364313423,37,34,3,47,47,0,54,56,-2,4,3,0,0
"23754","WPG","CHI",2017020668,17543,20172018,0,60,1,2,-1,3.08134101285586,6.34904670116066,-3.2677056883048,32,27,5,42,41,1,59,54,5,3,3,0,0
"23755","WPG","MIN",2017020674,17544,20172018,0,60,1,4,-3,0,0,0,33,41,-8,44,51,-7,57,68,-11,2,4,0,0
"23756","WPG","CGY",2017020711,17551,20172018,0,65,1,1,0,6.41476998939246,3.17506555601488,3.23970443337759,35,31,4,48,49,-1,61,65,-4,2,4,0,0
"23757","WPG","VAN",2017020723,17552,20172018,1,60,1,0,1,4.24088321287695,3.87308739744185,0.367795815435102,36,29,7,54,37,17,68,56,12,2,2,0,0
"23758","WPG","S.J",2017020743,17554,20172018,0,60.3,5,4,1,4.75210220623156,3.84934045193602,0.902761754295547,23,33,-10,39,41,-2,60,64,-4,2,5,0,0
"23759","WPG","ANA",2017020759,17556,20172018,0,65,3,3,0,4.52234338126559,5.70237328259827,-1.18002990133269,27,39,-12,46,59,-13,55,76,-21,2,4,0,0
"23760","WPG","T.B",2017020769,17561,20172018,1,60,3,1,2,4.51655059578479,4.11222976230783,0.404320833476959,37,24,13,44,36,8,60,54,6,4,4,0,0
"23761","WPG","VGK",2017020783,17563,20172018,1,63.95,2,3,-1,4.82979847881506,5.73923844989622,-0.909439971081156,28,31,-3,44,47,-3,58,64,-6,3,2,0,0
"23762","WPG","COL",2017020799,17565,20172018,1,60,3,0,3,5.24383998080157,3.73030545898541,1.51353452181615,32,25,7,45,34,11,59,44,15,2,1,0,0
"23763","WPG","ARI",2017020820,17568,20172018,1,60,4,3,1,3.23861689574551,4.2244002289005,-0.98578333315499,23,24,-1,39,33,6,51,44,7,4,4,0,0
"23764","WPG","STL",2017020840,17571,20172018,1,60,2,5,-3,2.50433370727114,3.55355915987001,-1.04922545259887,22,27,-5,31,37,-6,43,54,-11,4,2,0,0
"23765","WPG","NYR",2017020854,17573,20172018,1,60,1,3,-2,4.86156404271099,4.33590534038376,0.525658702327227,38,28,10,50,44,6,69,56,13,4,4,0,0
"23766","WPG","WSH",2017020873,17575,20172018,1,62.5833333333333,4,3,1,5.82223761299974,3.19794904282162,2.62428857017812,44,27,17,58,40,18,78,48,30,3,2,0,0
"23767","WPG","COL",2017020892,17578,20172018,1,60,6,1,5,4.48893045846078,4.47418699819309,0.0147434602676935,28,31,-3,40,42,-2,53,56,-3,5,6,0,0
"23768","WPG","FLA",2017020910,17580,20172018,1,60,7,2,5,7.35967935762892,5.13448087690631,2.22519848072261,34,27,7,51,36,15,62,50,12,2,4,0,0
"23769","WPG","L.A",2017020924,17582,20172018,1,60,3,4,-1,4.24625701236073,2.97054992084118,1.27570709151955,33,32,1,43,44,-1,53,58,-5,5,5,0,0
"23770","WPG","STL",2017020943,17585,20172018,0,60,4,0,4,3.94733525007541,3.14208763981924,0.805247610256174,23,34,-11,33,48,-15,49,65,-16,6,5,0,0
"23771","WPG","DAL",2017020955,17586,20172018,0,60,5,3,2,2.17656096923535,3.45219855445248,-1.27563758521713,27,36,-9,37,50,-13,50,71,-21,3,4,0,0
"23772","WPG","NSH",2017020974,17589,20172018,1,60,5,6,-1,6.38521496007161,5.57832535832131,0.806889601750299,39,32,7,53,49,4,64,73,-9,3,3,0,0
"23773","WPG","DET",2017020994,17592,20172018,1,60,4,3,1,7.64192314192769,6.40267322762071,1.23924991430698,42,33,9,59,43,16,80,53,27,3,1,0,0
"23774","WPG","CAR",2017021012,17594,20172018,0,60,3,2,1,5.22718455738504,6.68295344081707,-1.45576888343203,23,35,-12,40,54,-14,46,68,-22,2,3,0,0
"23775","WPG","NYR",2017021022,17596,20172018,0,60,3,0,3,3.61044710372153,5.12414363393327,-1.51369653021175,34,31,3,45,46,-1,63,60,3,1,2,0,0
"23776","WPG","N.J",2017021033,17598,20172018,0,60,3,2,1,3.92267169669503,7.72482768600639,-3.80215598931136,24,43,-19,31,60,-29,42,82,-40,1,3,0,0
"23777","WPG","PHI",2017021051,17600,20172018,0,60,1,2,-1,2.4097967944806,4.70705833392458,-2.29726153944398,28,35,-7,37,45,-8,53,56,-3,4,2,0,0
"23778","WPG","WSH",2017021065,17602,20172018,0,64.1833333333333,2,3,-1,3.75434814674372,7.17953459406272,-3.42518644731899,28,43,-15,40,52,-12,62,73,-11,3,4,0,0
"23779","WPG","NSH",2017021074,17603,20172018,0,60,1,3,-2,6.00150644010864,5.27918910386357,0.722317336245069,33,45,-12,45,56,-11,69,67,2,9,7,0,0
"23780","WPG","CHI",2017021089,17605,20172018,1,60,6,2,4,5.97897556939279,1.9148868513571,4.06408871803569,39,27,12,55,41,14,68,55,13,4,3,0,0
"23781","WPG","DAL",2017021114,17608,20172018,1,60,4,2,2,5.79720881622052,4.12842911854993,1.66877969767059,24,30,-6,43,44,-1,59,58,1,4,3,0,0
"23782","WPG","L.A",2017021128,17610,20172018,1,61.6166666666667,2,1,1,5.39879886594281,1.81482979401829,3.58396907192451,38,17,21,50,24,26,73,29,44,4,2,0,0
"23783","WPG","ANA",2017021149,17613,20172018,1,63.2666666666667,3,2,1,6.11226524271478,3.33616994111799,2.7760953015968,42,18,24,59,29,30,83,35,48,2,2,0,0
"23784","WPG","NSH",2017021165,17615,20172018,1,65,4,4,0,5.27843999635661,7.52888113971858,-2.25044114336197,47,36,11,68,50,18,82,64,18,7,7,0,0
"23785","WPG","BOS",2017021182,17617,20172018,1,65,4,4,0,4.32292351187539,8.22168662631884,-3.89876311444345,32,32,0,39,47,-8,50,64,-14,1,3,0,0
"23786","WPG","CHI",2017021196,17619,20172018,0,60,2,6,-4,6.09718516014578,4.67743597924709,1.41974918089869,34,42,-8,42,48,-6,64,62,2,1,2,0,0
"23787","WPG","TOR",2017021209,17621,20172018,0,60,3,1,2,4.11971245560969,1.92744465100741,2.19226780460228,29,29,0,41,44,-3,48,58,-10,3,4,0,0
"23788","WPG","OTT",2017021224,17623,20172018,0,60,6,5,1,5.57097568287994,4.93714903589702,0.633826646982918,40,37,3,53,54,-1,66,73,-7,5,7,0,0
"23789","WPG","MTL",2017021232,17624,20172018,0,63,5,4,1,3.74091376868873,5.36101633223007,-1.62010256354134,32,40,-8,40,54,-14,49,73,-24,4,7,0,0
"23790","WPG","CGY",2017021248,17626,20172018,1,60,2,1,1,3.42621441005794,2.84596588091346,0.580248529144473,26,32,-6,38,43,-5,45,52,-7,5,3,0,0
"23791","WPG","CHI",2017021264,17628,20172018,1,60,4,1,3,4.86078391661377,5.18491619372799,-0.324132277114217,39,31,8,52,36,16,76,46,30,4,1,0,0
"23792","WPG","MIN",2017030161,17632,20172018,1,60,3,2,1,9.08121973618108,1.47138334485444,7.60983639132664,40,20,20,60,31,29,82,47,35,2,1,0,0
"23793","WPG","MIN",2017030162,17634,20172018,1,60,4,1,3,3.18988319032724,3.24807845964096,-0.0581952693137282,44,17,27,54,26,28,70,40,30,5,6,0,0
"23794","WPG","MIN",2017030163,17636,20172018,0,60,2,6,-4,6.95163173312903,3.73061356290555,3.22101817022349,31,29,2,40,37,3,60,45,15,5,3,0,0
"23795","WPG","MIN",2017030164,17638,20172018,0,60,2,0,2,5.72469633608125,4.7438116032863,0.980884732794948,28,30,-2,46,42,4,69,56,13,1,2,0,0
"23796","WPG","MIN",2017030165,17641,20172018,1,60,5,0,5,5.1171479797049,4.99244478480047,0.124703194904423,26,30,-4,44,41,3,54,63,-9,2,3,0,0
"23797","WPG","NSH",2017030231,17648,20172018,0,60,4,1,3,5.70984045194928,6.21487250580685,-0.505032053857576,19,48,-29,32,61,-29,39,87,-48,0,3,0,0
"23798","WPG","NSH",2017030232,17650,20172018,0,80,4,4,0,8.72238711520913,8.22558099798603,0.496806117223096,48,38,10,65,60,5,91,88,3,5,5,0,0
"23799","WPG","NSH",2017030233,17652,20172018,1,60,7,4,3,8.20269241722508,2.40009898614937,5.80259343107571,45,30,15,58,38,20,70,49,21,6,5,0,0
"23800","WPG","NSH",2017030234,17654,20172018,1,60,1,2,-1,4.29532473295694,4.67451954007265,-0.379194807115709,33,29,4,49,49,0,58,55,3,3,3,0,0
"23801","WPG","NSH",2017030235,17656,20172018,0,60,6,2,4,4.06166426110576,5.42784029075951,-1.36617602965374,32,40,-8,42,52,-10,62,68,-6,3,1,0,0
"23802","WPG","NSH",2017030236,17658,20172018,1,60,0,4,-4,4.05219055420326,5.68769383547415,-1.63550328127089,34,29,5,49,40,9,72,48,24,4,1,0,0
"23803","WPG","NSH",2017030237,17661,20172018,0,60,5,1,4,4.75008095531666,7.37382178916596,-2.6237408338493,24,37,-13,34,50,-16,51,70,-19,1,3,0,0
"23804","WPG","VGK",2017030321,17663,20172018,1,60,4,2,2,3.43775485752603,2.99201473311405,0.445740124411984,26,21,5,35,35,0,45,57,-12,6,4,0,0
"23805","WPG","VGK",2017030322,17665,20172018,1,60,1,3,-2,3.34925411375298,3.62984557170557,-0.280591457952596,31,28,3,48,42,6,69,57,12,4,3,0,0
"23806","WPG","VGK",2017030323,17667,20172018,0,60,2,4,-2,5.59134096393245,4.29364429295777,1.29769667097469,35,30,5,50,38,12,68,56,12,9,11,0,0
"23807","WPG","VGK",2017030324,17669,20172018,0,60,2,3,-1,8.47547784518974,3.86540488953324,4.61007295565651,37,29,8,60,41,19,85,59,26,4,2,0,0
"23808","WPG","VGK",2017030325,17671,20172018,1,60,1,2,-1,5.58609871682711,3.27880295285689,2.30729576397022,32,32,0,50,42,8,59,57,2,4,2,0,0
"23809","WPG","STL",2018020011,17808,20182019,0,60,5,1,4,2.10081865353277,6.61101802660414,-4.51019937307137,25,42,-17,36,58,-22,49,69,-20,2,4,0,0
"23810","WPG","DAL",2018020023,17810,20182019,0,60,1,5,-4,4.28420824152458,3.93518021896294,0.34902802256164,33,35,-2,43,42,1,58,63,-5,4,6,0,0
"23811","WPG","L.A",2018020040,17813,20182019,1,60,2,1,1,4.0601673045494,3.05050344891379,1.00966385563561,39,17,22,49,27,22,70,42,28,3,2,0,0
"23812","WPG","NSH",2018020055,17815,20182019,0,60,0,3,-3,1.86278191381962,4.87631594062532,-3.0135340268057,29,30,-1,37,45,-8,43,51,-8,3,9,0,0
"23813","WPG","CAR",2018020073,17818,20182019,1,60,3,1,2,3.5864369951596,7.27614681258274,-3.68970981742314,26,43,-17,36,58,-22,48,79,-31,2,2,0,0
"23814","WPG","EDM",2018020084,17820,20182019,1,61.4166666666667,4,5,-1,6.13064566506364,5.52570295747137,0.604942707592272,33,35,-2,39,52,-13,54,64,-10,3,2,0,0
"23815","WPG","VAN",2018020094,17822,20182019,1,60,4,1,3,4.97151268772723,2.96573499002261,2.00577769770462,32,27,5,48,34,14,60,48,12,3,3,0,0
"23816","WPG","ARI",2018020104,17824,20182019,1,60,5,3,2,4.43208461039467,5.8721389566781,-1.44005434628343,32,45,-13,43,54,-11,57,69,-12,4,5,0,0
"23817","WPG","STL",2018020120,17826,20182019,1,62.9,5,4,1,5.61155766600859,3.41266729878687,2.19889036722172,36,34,2,52,43,9,67,53,14,6,3,0,0
"23818","WPG","TOR",2018020131,17828,20182019,1,60,2,4,-2,3.84896584169837,6.93639273899068,-3.0874268972923,40,39,1,63,52,11,79,68,11,3,1,0,0
"23819","WPG","DET",2018020145,17830,20182019,0,60,2,1,1,6.22744055443764,2.39988808317804,3.82755247125959,40,28,12,54,41,13,70,55,15,5,3,0,0
"23820","WPG","TOR",2018020153,17831,20182019,0,60,2,3,-1,3.4787282069301,3.82979191868799,-0.351063711757888,24,31,-7,41,48,-7,49,64,-15,3,4,0,0
"23821","WPG","FLA",2018020180,17836,20182019,0,60,4,2,2,5.39355883339695,4.53593572415036,0.857623109246589,36,38,-2,46,51,-5,59,77,-18,7,6,0,0
"23822","WPG","FLA",2018020192,17837,20182019,1,60,2,4,-2,9.08047591215347,5.73615803441498,3.34431787773849,34,26,8,43,40,3,64,53,11,2,4,0,0
"23823","WPG","COL",2018020240,17844,20182019,1,60,5,2,3,6.04971555065453,5.46025961231308,0.589455938341445,24,30,-6,38,42,-4,53,52,1,4,4,0,0
"23824","WPG","N.J",2018020257,17846,20182019,1,60,5,2,3,7.35174235969635,5.22376550897025,2.1279768507261,28,36,-8,42,46,-4,53,71,-18,3,5,0,0
"23825","WPG","WSH",2018020274,17849,20182019,1,60,3,1,2,5.5058093254047,3.85094726366515,1.65486206173955,24,28,-4,39,36,3,56,50,6,3,3,0,0
"23826","WPG","BUF",2018020287,17851,20182019,1,65,1,1,0,2.67124793020776,3.16731981832709,-0.496071888119332,26,32,-6,39,41,-2,53,53,0,1,3,0,0
"23827","WPG","VAN",2018020316,17854,20182019,0,60,6,3,3,6.54098415235057,5.01346330460001,1.52752084775057,49,25,24,59,38,21,77,53,24,5,3,0,0
"23828","WPG","CGY",2018020329,17856,20182019,0,60,3,6,-3,5.17691126841237,4.43396804404983,0.742943224362534,40,26,14,55,34,21,70,42,28,6,2,0,0
"23829","WPG","MIN",2018020336,17858,20182019,0,60,2,4,-2,4.26427653825424,4.66934140608646,-0.405064867832223,28,39,-11,41,50,-9,58,65,-7,6,8,0,0
"23830","WPG","STL",2018020354,17859,20182019,0,60,8,4,4,6.6937235164587,4.38096811082701,2.31275540563169,36,27,9,51,40,11,65,52,13,6,4,0,0
"23831","WPG","PIT",2018020373,17862,20182019,1,60,3,4,-1,2.24955396115183,5.28890605077027,-3.03935208961843,27,30,-3,42,45,-3,54,51,3,2,1,0,0
"23832","WPG","CHI",2018020387,17864,20182019,1,60,6,5,1,2.71055253194936,4.57638560407783,-1.86583307212847,33,31,2,40,46,-6,50,64,-14,3,2,0,0
"23833","WPG","N.J",2018020400,17866,20182019,0,64.7166666666667,4,3,1,6.75207890498954,5.23945219484449,1.51262671014505,38,39,-1,51,47,4,62,61,1,2,4,0,0
"23834","WPG","NYR",2018020408,17867,20182019,0,65,3,3,0,4.86640572617762,4.97799934407385,-0.111593617896233,42,19,23,54,28,26,66,43,23,4,2,0,0
"23835","WPG","NYI",2018020418,17869,20182019,0,60,3,1,2,3.56711824506056,4.10577344917692,-0.538655204116367,24,28,-4,29,41,-12,45,58,-13,3,2,0,0
"23836","WPG","STL",2018020441,17872,20182019,1,60,0,1,-1,2.74042251100764,2.37653896210577,0.363883548901867,26,27,-1,37,31,6,59,37,22,7,3,0,0
"23837","WPG","PHI",2018020455,17874,20182019,1,60,7,1,6,5.75980401597917,4.17981815322746,1.57998586275171,35,37,-2,43,49,-6,53,66,-13,4,3,0,0
"23838","WPG","CHI",2018020473,17876,20182019,1,60,6,3,3,4.59307876128423,5.16171176405288,-0.568633002768649,34,35,-1,50,45,5,60,53,7,5,2,0,0
"23839","WPG","EDM",2018020485,17878,20182019,1,60.6833333333333,5,4,1,6.49245288312341,2.48759435598573,4.00485852713767,40,26,14,54,34,20,75,42,33,3,2,0,0
"23840","WPG","CHI",2018020493,17879,20182019,0,60.8333333333333,4,3,1,6.39982911260449,2.73335258501902,3.66647652758547,42,37,5,50,45,5,64,58,6,4,2,0,0
"23841","WPG","T.B",2018020510,17881,20182019,1,64.3,5,4,1,6.3600698828086,7.2423621873872,-0.882292304578598,42,47,-5,54,65,-11,68,86,-18,1,2,0,0
"23842","WPG","L.A",2018020527,17883,20182019,0,60,1,4,-3,3.87384946535894,6.51483896555874,-2.64098950019979,28,31,-3,39,44,-5,57,52,5,3,3,0,0
"23843","WPG","S.J",2018020541,17885,20182019,0,60,5,3,2,2.70099831805356,5.5181060424229,-2.81710772436934,25,44,-19,30,57,-27,40,79,-39,3,4,0,0
"23844","WPG","VAN",2018020558,17887,20182019,0,60,1,0,1,4.20713980612345,4.85573945850774,-0.648599652384291,24,40,-16,32,53,-21,42,67,-25,3,4,0,0
"23845","WPG","CGY",2018020574,17892,20182019,1,60,1,4,-3,3.732356606118,3.5124117032974,0.219944902820599,36,29,7,52,38,14,67,52,15,3,5,0,0
"23846","WPG","MIN",2018020584,17894,20182019,1,60,1,3,-2,4.20492382982047,2.09072175861957,2.11420207120091,27,25,2,35,34,1,59,45,14,3,1,0,0
"23847","WPG","EDM",2018020610,17896,20182019,0,60,4,3,1,6.66222632414429,5.24870428188297,1.41352204226132,36,24,12,50,39,11,68,58,10,2,1,0,0
"23848","WPG","PIT",2018020629,17900,20182019,0,60,0,4,-4,4.32251562854094,3.88723439397972,0.435281234561216,33,33,0,43,41,2,68,55,13,1,3,0,0
"23849","WPG","DAL",2018020649,17902,20182019,1,60,5,1,4,4.16563692945419,3.36451974738156,0.80111718207263,30,27,3,44,38,6,55,50,5,3,3,0,0
"23850","WPG","COL",2018020665,17904,20182019,1,60,7,4,3,2.22911243952694,5.09796978038895,-2.86885734086201,21,41,-20,32,62,-30,48,80,-32,4,5,0,0
"23851","WPG","MIN",2018020678,17906,20182019,0,60,2,3,-1,5.63289402583086,4.11664988540549,1.51624414042537,28,22,6,44,37,7,66,44,22,4,2,0,0
"23852","WPG","DET",2018020684,17907,20182019,1,60,4,2,2,5.04321241356956,5.7460655735922,-0.702853160022642,27,35,-8,32,51,-19,41,71,-30,3,4,0,0
"23853","WPG","ANA",2018020701,17909,20182019,1,64.8166666666667,4,3,1,2.90528786162412,5.56340054253997,-2.65811268091585,34,31,3,45,44,1,56,57,-1,4,3,0,0
"23854","WPG","VGK",2018020718,17911,20182019,1,60,4,1,3,4.80045858424273,5.43331575509728,-0.63285717085455,27,44,-17,37,58,-21,44,70,-26,2,6,0,0
"23855","WPG","NSH",2018020730,17913,20182019,0,60,5,1,4,7.68788387134336,6.29181814744948,1.39606572389388,34,38,-4,42,46,-4,50,64,-14,3,4,0,0
"23856","WPG","DAL",2018020746,17915,20182019,0,60,2,4,-2,4.49956906201544,5.06958163230934,-0.570012570293898,29,39,-10,45,53,-8,57,72,-15,6,7,0,0
"23857","WPG","PHI",2018020771,17924,20182019,0,60,1,3,-2,3.47637582971781,4.15863076070178,-0.682254930983975,32,31,1,43,45,-2,64,58,6,3,2,0,0
"23858","WPG","BOS",2018020773,17925,20182019,0,65,3,3,0,1.69757864649549,5.5649811979456,-3.86740255145011,27,39,-12,32,55,-23,48,76,-28,2,3,0,0
"23859","WPG","CBJ",2018020780,17927,20182019,1,60,4,3,1,2.86972134454845,2.63502846669578,0.234692877852673,26,31,-5,41,40,1,54,55,-1,4,3,0,0
"23860","WPG","ANA",2018020797,17929,20182019,1,60,9,3,6,5.14526409241989,7.08533610144514,-1.94007200902524,31,29,2,45,43,2,54,57,-3,4,1,0,0
"23861","WPG","S.J",2018020818,17932,20182019,1,62.8166666666667,2,3,-1,2.62111808893678,3.57344249162903,-0.952324402692252,27,38,-11,50,54,-4,67,68,-1,6,4,0,0
"23862","WPG","MTL",2018020828,17934,20182019,0,60,2,5,-3,4.68301368480024,6.30595423901275,-1.62294055421251,34,53,-19,39,60,-21,56,83,-27,4,4,0,0
"23863","WPG","OTT",2018020843,17936,20182019,0,60,2,5,-3,6.51042057553423,3.55391824322203,2.9565023323122,46,32,14,66,48,18,86,60,26,3,1,0,0
"23864","WPG","BUF",2018020854,17937,20182019,0,60,3,1,2,5.98372006739373,5.1376215351047,0.846098532289034,29,36,-7,41,49,-8,51,66,-15,1,5,0,0
"23865","WPG","NYR",2018020872,17939,20182019,1,60,4,3,1,3.77974041888956,4.90237121471151,-1.12263079582195,36,37,-1,42,47,-5,54,62,-8,2,4,0,0
"23866","WPG","COL",2018020882,17941,20182019,1,60,1,4,-3,5.74328280094778,6.52130109019345,-0.778018289245665,25,35,-10,41,43,-2,60,56,4,5,4,0,0
"23867","WPG","OTT",2018020897,17943,20182019,1,63.7333333333333,3,4,-1,3.54800172367662,4.31720377527381,-0.769202051597189,26,41,-15,35,55,-20,48,71,-23,2,5,0,0
"23868","WPG","COL",2018020926,17947,20182019,0,60,1,7,-6,3.42688094547875,4.40924373842312,-0.982362792944367,27,46,-19,36,57,-21,52,74,-22,8,9,0,0
"23869","WPG","VGK",2018020944,17949,20182019,0,60,6,3,3,6.7608574731028,2.7064685964724,4.0543888766304,29,32,-3,39,42,-3,56,60,-4,4,3,0,0
"23870","WPG","ARI",2018020961,17951,20182019,0,60,1,4,-3,5.27241101756954,4.40552268189601,0.866888335673526,35,24,11,49,39,10,65,53,12,4,2,0,0
"23871","WPG","MIN",2018020976,17953,20182019,1,60,2,3,-1,4.598346426239,6.71541706775193,-2.11707064151293,32,40,-8,46,48,-2,57,57,0,4,2,0,0
"23872","WPG","NSH",2018020996,17956,20182019,1,60,5,3,2,6.96761130762752,5.92665354158817,1.04095776603936,32,38,-6,43,50,-7,55,63,-8,4,3,0,0
"23873","WPG","CBJ",2018021014,17958,20182019,0,60,5,2,3,6.85785624697564,4.78975351996237,2.06810272701327,26,42,-16,39,54,-15,49,67,-18,3,4,0,0
"23874","WPG","T.B",2018021023,17960,20182019,0,60,2,5,-3,2.65176963876002,4.38330059805594,-1.73153095929592,32,38,-6,41,48,-7,54,57,-3,5,6,0,0
"23875","WPG","CAR",2018021046,17963,20182019,0,60,8,1,7,3.550247017949,5.29518335170633,-1.74493633375732,29,29,0,42,48,-6,50,71,-21,3,5,0,0
"23876","WPG","WSH",2018021061,17965,20182019,0,60,1,3,-2,4.61992077068935,4.71382121311035,-0.0939004424209955,34,18,16,48,31,17,58,39,19,5,2,0,0
"23877","WPG","S.J",2018021077,17967,20182019,1,60,4,5,-1,2.83358225045959,7.79438880069233,-4.96080655023275,25,36,-11,38,48,-10,47,66,-19,2,2,0,0
"23878","WPG","BOS",2018021089,17969,20182019,1,60,4,3,1,3.67401401418309,4.66674637746473,-0.992732363281647,24,39,-15,34,46,-12,42,65,-23,2,1,0,0
"23879","WPG","CGY",2018021107,17971,20182019,1,60,2,1,1,2.69455878770896,5.08465773765056,-2.3900989499416,21,28,-7,34,40,-6,41,57,-16,3,3,0,0
"23880","WPG","L.A",2018021120,17973,20182019,0,60,3,2,1,4.7975728374297,2.4162576138333,2.3813152235964,28,17,11,43,36,7,48,53,-5,2,3,0,0
"23881","WPG","ANA",2018021135,17975,20182019,0,60,3,0,3,4.07224571937695,4.24769375417378,-0.17544803479683,23,29,-6,33,43,-10,47,59,-12,6,6,0,0
"23882","WPG","VGK",2018021146,17976,20182019,0,60,0,5,-5,3.50794769756612,5.5701038638494,-2.06215616628327,20,38,-18,33,53,-20,44,63,-19,2,2,0,0
"23883","WPG","NSH",2018021158,17978,20182019,1,60,5,0,5,8.95078025507974,2.92825033503955,6.02252992004018,43,33,10,56,44,12,67,66,1,2,0,0,0
"23884","WPG","DAL",2018021175,17980,20182019,1,60,2,5,-3,3.58045352630415,6.80363092810512,-3.22317740180097,23,37,-14,35,45,-10,44,65,-21,2,4,0,0
"23885","WPG","NYI",2018021193,17983,20182019,1,60,4,5,-1,3.69211634912062,5.60300719671734,-1.91089084759672,37,44,-7,43,56,-13,61,66,-5,4,4,0,0
"23886","WPG","MTL",2018021209,17985,20182019,1,60,1,3,-2,5.36219023691956,7.58855910783313,-2.22636887091357,24,44,-20,36,51,-15,45,59,-14,0,3,0,0
"23887","WPG","CHI",2018021226,17987,20182019,0,63.6333333333333,4,3,1,8.33391348063932,4.7877153225848,3.54619815805452,38,28,10,50,45,5,63,63,0,5,3,0,0
"23888","WPG","MIN",2018021234,17988,20182019,0,60,1,5,-4,3.67234458142593,4.02748454251801,-0.355139961092078,33,28,5,46,36,10,62,46,16,2,2,0,0
"23889","WPG","COL",2018021251,17990,20182019,0,61.8166666666667,2,3,-1,3.98738336403039,6.33520671933702,-2.34782335530662,36,38,-2,46,49,-3,68,63,5,3,4,0,0
"23890","WPG","ARI",2018021269,17992,20182019,0,60,4,2,2,3.87552539689932,2.39447609260969,1.48104930428963,32,21,11,45,29,16,61,35,26,3,4,0,0
"23891","WPG","STL",2018030161,17996,20182019,1,60,1,2,-1,2.48641186633641,3.38218195010535,-0.895770083768943,25,26,-1,33,42,-9,49,55,-6,1,3,0,0
"23892","WPG","STL",2018030162,17998,20182019,1,60,3,4,-1,3.73250330146705,3.26332360549473,0.469179695972315,29,32,-3,42,38,4,54,50,4,3,4,0,0
"23893","WPG","STL",2018030163,18000,20182019,0,60,6,3,3,5.82697772534448,4.65065823709122,1.17631948825325,29,29,0,44,42,2,61,54,7,7,7,0,0
"23894","WPG","STL",2018030164,18002,20182019,0,66.0333333333333,2,1,1,6.45693029765971,4.61368790300185,1.84324239465786,39,32,7,54,45,9,69,59,10,1,2,0,0
"23895","WPG","STL",2018030165,18004,20182019,1,60,2,3,-1,4.32585735778354,3.27471073737252,1.05114662041102,31,29,2,40,45,-5,49,59,-10,2,1,0,0
"23896","WPG","STL",2018030166,18006,20182019,0,60,2,3,-1,2.52949684049236,5.3898022780777,-2.86030543758534,20,36,-16,34,44,-10,49,60,-11,1,3,0,0
"23897","WSH","ATL",2008020013,14162,20082009,0,60,4,7,-3,0,0,0,43,31,12,49,32,17,59,41,18,7,9,0,0
"23898","WSH","CHI",2008020020,14163,20082009,1,60,4,2,2,0,0,0,34,21,13,44,36,8,59,47,12,5,6,0,0
"23899","WSH","VAN",2008020036,14165,20082009,1,60,5,1,4,0,0,0,35,10,25,45,30,15,63,42,21,4,4,0,0
"23900","WSH","PIT",2008020050,14168,20082009,0,60,4,3,1,0,0,0,30,26,4,40,36,4,66,48,18,4,6,0,0
"23901","WSH","N.J",2008020067,14170,20082009,1,65,3,3,0,0,0,0,27,37,-10,43,45,-2,58,58,0,8,4,0,0
"23902","WSH","CGY",2008020086,14173,20082009,0,60,1,2,-1,0,0,0,31,28,3,45,41,4,54,51,3,4,10,0,0
"23903","WSH","ARI",2008020098,14175,20082009,0,60,1,2,-1,0,0,0,32,34,-2,46,50,-4,61,61,0,4,4,0,0
"23904","WSH","DAL",2008020114,14177,20082009,0,62.2833333333333,6,5,1,0,0,0,30,33,-3,40,45,-5,55,55,0,4,4,0,0
"23905","WSH","NSH",2008020126,14180,20082009,1,65,3,3,0,0,0,0,32,26,6,43,33,10,61,47,14,5,7,0,0
"23906","WSH","BUF",2008020152,14184,20082009,0,60,0,5,-5,0,0,0,29,27,2,39,38,1,56,45,11,5,8,0,0
"23907","WSH","OTT",2008020173,14187,20082009,0,64.3333333333333,1,2,-1,0,0,0,27,44,-17,34,53,-19,49,61,-12,1,5,0,0
"23908","WSH","CAR",2008020183,14189,20082009,1,60,3,2,1,0,0,0,33,34,-1,42,40,2,59,49,10,4,3,0,0
"23909","WSH","NYR",2008020200,14191,20082009,1,60,3,1,2,0,0,0,28,29,-1,42,41,1,54,50,4,4,3,0,0
"23910","WSH","T.B",2008020214,14193,20082009,1,60,4,2,2,0,0,0,30,36,-6,39,44,-5,56,52,4,4,5,0,0
"23911","WSH","CAR",2008020223,14195,20082009,0,60,5,1,4,0,0,0,37,27,10,53,42,11,69,60,9,5,7,0,0
"23912","WSH","N.J",2008020236,14197,20082009,1,60,3,1,2,0,0,0,27,33,-6,42,47,-5,61,67,-6,1,2,0,0
"23913","WSH","N.J",2008020243,14198,20082009,0,65,5,5,0,0,0,0,30,33,-3,44,57,-13,63,77,-14,2,4,0,0
"23914","WSH","ANA",2008020270,14202,20082009,0,60,6,4,2,0,0,0,33,32,1,36,44,-8,41,50,-9,10,8,0,0
"23915","WSH","L.A",2008020278,14203,20082009,0,60,2,5,-3,0,0,0,21,33,-12,39,55,-16,55,67,-12,5,5,0,0
"23916","WSH","S.J",2008020296,14205,20082009,0,60,2,7,-5,0,0,0,21,28,-7,29,37,-8,42,48,-6,5,7,0,0
"23917","WSH","MIN",2008020303,14207,20082009,0,60,3,4,-1,0,0,0,28,33,-5,38,40,-2,57,50,7,3,6,0,0
"23918","WSH","ATL",2008020311,14209,20082009,1,60,5,3,2,0,0,0,33,18,15,48,28,20,59,40,19,4,3,0,0
"23919","WSH","MTL",2008020328,14211,20082009,1,60,3,0,3,0,0,0,30,28,2,43,34,9,63,48,15,3,3,0,0
"23920","WSH","CBJ",2008020340,14212,20082009,0,60,0,3,-3,0,0,0,26,31,-5,38,40,-2,53,50,3,5,3,0,0
"23921","WSH","FLA",2008020356,14215,20082009,1,60,3,5,-2,0,0,0,26,22,4,30,32,-2,52,46,6,4,4,0,0
"23922","WSH","NYI",2008020368,14217,20082009,1,60,5,2,3,0,0,0,47,29,18,59,38,21,77,52,25,6,9,0,0
"23923","WSH","TOR",2008020380,14219,20082009,0,60,2,1,1,0,0,0,30,20,10,48,30,18,65,47,18,3,4,0,0
"23924","WSH","CAR",2008020392,14220,20082009,0,60,1,3,-2,0,0,0,39,25,14,54,37,17,68,43,25,7,4,0,0
"23925","WSH","BOS",2008020407,14223,20082009,1,60,3,1,2,0,0,0,26,34,-8,38,49,-11,51,67,-16,2,3,0,0
"23926","WSH","OTT",2008020423,14225,20082009,1,60,5,1,4,0,0,0,34,33,1,51,43,8,67,55,12,8,5,0,0
"23927","WSH","MTL",2008020432,14226,20082009,0,60,2,1,1,0,0,0,26,33,-7,41,45,-4,58,59,-1,5,8,0,0
"23928","WSH","NYI",2008020446,14229,20082009,0,64.8166666666667,5,4,1,0,0,0,40,39,1,55,49,6,71,72,-1,3,5,0,0
"23929","WSH","STL",2008020461,14231,20082009,1,60,4,2,2,0,0,0,29,31,-2,42,35,7,58,55,3,5,5,0,0
"23930","WSH","PHI",2008020475,14233,20082009,0,60,1,7,-6,0,0,0,48,28,20,65,32,33,80,47,33,7,7,0,0
"23931","WSH","NYR",2008020496,14236,20082009,0,60.9833333333333,5,4,1,0,0,0,36,28,8,51,47,4,63,58,5,5,3,0,0
"23932","WSH","BUF",2008020509,14239,20082009,1,60,3,2,1,0,0,0,34,24,10,44,31,13,61,48,13,4,3,0,0
"23933","WSH","TOR",2008020530,14241,20082009,1,60,4,1,3,0,0,0,29,24,5,42,35,7,66,57,9,4,5,0,0
"23934","WSH","BUF",2008020539,14243,20082009,0,60,4,2,2,0,0,0,31,33,-2,42,46,-4,50,59,-9,4,5,0,0
"23935","WSH","T.B",2008020557,14245,20082009,1,60,7,4,3,0,0,0,35,27,8,44,40,4,66,58,8,3,2,0,0
"23936","WSH","NYR",2008020569,14247,20082009,1,60,2,1,1,0,0,0,31,22,9,44,28,16,61,41,20,5,4,0,0
"23937","WSH","PHI",2008020587,14250,20082009,1,65,1,1,0,0,0,0,34,34,0,53,39,14,77,57,20,4,4,0,0
"23938","WSH","CBJ",2008020609,14253,20082009,1,60,0,3,-3,0,0,0,45,23,22,59,32,27,75,43,32,6,7,0,0
"23939","WSH","MTL",2008020616,14254,20082009,0,60,4,5,-1,0,0,0,35,35,0,47,47,0,79,64,15,5,7,0,0
"23940","WSH","EDM",2008020634,14257,20082009,1,60,2,5,-3,0,0,0,36,23,13,55,34,21,73,48,25,5,5,0,0
"23941","WSH","PIT",2008020642,14258,20082009,0,60,6,3,3,0,0,0,42,29,13,60,43,17,81,57,24,6,5,0,0
"23942","WSH","BOS",2008020666,14261,20082009,1,60,2,1,1,0,0,0,30,24,6,42,37,5,63,46,17,5,4,0,0
"23943","WSH","NYI",2008020678,14263,20082009,0,61.7666666666667,2,1,1,0,0,0,38,28,10,47,45,2,66,61,5,4,5,0,0
"23944","WSH","OTT",2008020686,14264,20082009,0,60,2,3,-1,0,0,0,31,34,-3,45,49,-4,67,53,14,5,6,0,0
"23945","WSH","BOS",2008020701,14271,20082009,0,61.9166666666667,2,3,-1,0,0,0,36,28,8,48,39,9,61,50,11,6,5,0,0
"23946","WSH","DET",2008020730,14275,20082009,1,60,4,2,2,0,0,0,27,29,-2,35,48,-13,42,73,-31,3,7,0,0
"23947","WSH","OTT",2008020742,14276,20082009,1,60,7,4,3,0,0,0,30,38,-8,48,46,2,62,66,-4,5,6,0,0
"23948","WSH","N.J",2008020748,14278,20082009,0,60,5,2,3,0,0,0,26,34,-8,38,46,-8,48,59,-11,4,4,0,0
"23949","WSH","L.A",2008020764,14280,20082009,1,60,4,5,-1,0,0,0,45,35,10,47,44,3,65,60,5,6,8,0,0
"23950","WSH","FLA",2008020783,14282,20082009,1,60,3,1,2,0,0,0,39,21,18,49,25,24,64,44,20,3,4,0,0
"23951","WSH","NYR",2008020803,14286,20082009,0,65,4,4,0,0,0,0,30,32,-2,35,56,-21,45,72,-27,2,5,0,0
"23952","WSH","T.B",2008020829,14289,20082009,0,60,5,1,4,0,0,0,32,32,0,53,42,11,66,54,12,4,3,0,0
"23953","WSH","FLA",2008020836,14290,20082009,0,60,4,2,2,0,0,0,33,31,2,40,50,-10,53,64,-11,3,8,0,0
"23954","WSH","MTL",2008020856,14293,20082009,1,65,3,3,0,0,0,0,35,33,2,49,43,6,72,60,12,3,4,0,0
"23955","WSH","COL",2008020871,14295,20082009,1,60,1,4,-3,0,0,0,29,25,4,43,33,10,61,47,14,3,5,0,0
"23956","WSH","PIT",2008020887,14297,20082009,1,60,5,2,3,0,0,0,34,33,1,52,47,5,64,64,0,4,9,0,0
"23957","WSH","PHI",2008020895,14299,20082009,1,60,2,4,-2,0,0,0,35,37,-2,57,51,6,69,66,3,8,9,0,0
"23958","WSH","ATL",2008020912,14301,20082009,1,60,4,3,1,0,0,0,40,24,16,53,29,24,69,45,24,8,5,0,0
"23959","WSH","BOS",2008020923,14303,20082009,0,60.3666666666667,4,3,1,0,0,0,32,37,-5,44,45,-1,57,61,-4,5,4,0,0
"23960","WSH","FLA",2008020935,14304,20082009,1,60,2,6,-4,0,0,0,34,33,1,52,45,7,79,60,19,2,6,0,0
"23961","WSH","CAR",2008020942,14306,20082009,1,60,2,5,-3,0,0,0,41,30,11,54,38,16,73,46,27,5,5,0,0
"23962","WSH","TOR",2008020958,14308,20082009,1,60,1,2,-1,0,0,0,38,29,9,47,38,9,71,49,22,4,4,0,0
"23963","WSH","PIT",2008020981,14311,20082009,1,65,3,3,0,0,0,0,32,22,10,42,32,10,63,41,22,8,8,0,0
"23964","WSH","PHI",2008021006,14315,20082009,0,60,2,1,1,0,0,0,30,36,-6,46,53,-7,59,68,-9,2,4,0,0
"23965","WSH","FLA",2008021045,14320,20082009,0,60,3,0,3,0,0,0,27,19,8,43,32,11,54,52,2,1,4,0,0
"23966","WSH","T.B",2008021057,14322,20082009,0,60,5,2,3,0,0,0,30,28,2,43,41,2,49,51,-2,5,5,0,0
"23967","WSH","TOR",2008021088,14327,20082009,0,65,2,2,0,0,0,0,45,29,16,57,43,14,76,67,9,2,3,0,0
"23968","WSH","T.B",2008021110,14330,20082009,1,60,5,3,2,0,0,0,39,36,3,50,42,8,68,49,19,10,5,0,0
"23969","WSH","NYI",2008021144,14335,20082009,1,60,5,3,2,0,0,0,43,27,16,62,38,24,87,58,29,4,4,0,0
"23970","WSH","T.B",2008021205,14343,20082009,0,60,4,2,2,0,0,0,33,24,9,44,32,12,63,44,19,5,5,0,0
"23971","WSH","FLA",2008021223,14345,20082009,0,60,4,7,-3,0,0,0,41,42,-1,54,56,-2,69,66,3,3,1,0,0
"23972","WSH","NYR",2008030121,14349,20082009,1,60,3,4,-1,0,0,0,35,21,14,51,38,13,72,48,24,7,4,0,0
"23973","WSH","NYR",2008030122,14352,20082009,1,60,0,1,-1,0,0,0,35,24,11,59,35,24,88,48,40,3,5,0,0
"23974","WSH","NYR",2008030123,14354,20082009,0,60,4,0,4,0,0,0,40,33,7,55,51,4,68,64,4,8,7,0,0
"23975","WSH","NYR",2008030124,14356,20082009,0,60,1,2,-1,0,0,0,39,21,18,54,32,22,70,39,31,6,3,0,0
"23976","WSH","NYR",2008030125,14358,20082009,1,60,4,0,4,0,0,0,21,20,1,32,26,6,43,47,-4,9,7,0,0
"23977","WSH","NYR",2008030126,14360,20082009,0,60,5,3,2,0,0,0,22,32,-10,35,40,-5,46,52,-6,5,11,0,0
"23978","WSH","NYR",2008030127,14362,20082009,1,60,2,1,1,0,0,0,24,15,9,34,34,0,50,45,5,2,1,0,0
"23979","WSH","PIT",2008030221,14366,20082009,1,60,3,2,1,0,0,0,26,36,-10,39,50,-11,59,67,-8,2,5,0,0
"23980","WSH","PIT",2008030222,14368,20082009,1,60,4,3,1,0,0,0,33,36,-3,43,53,-10,60,76,-16,7,7,0,0
"23981","WSH","PIT",2008030223,14370,20082009,0,71.3833333333333,2,3,-1,0,0,0,23,42,-19,32,61,-29,43,76,-33,2,7,0,0
"23982","WSH","PIT",2008030224,14372,20082009,0,60,3,5,-2,0,0,0,22,28,-6,34,40,-6,51,49,2,4,6,0,0
"23983","WSH","PIT",2008030225,14373,20082009,1,63.4666666666667,3,4,-1,0,0,0,31,42,-11,45,54,-9,69,71,-2,4,4,0,0
"23984","WSH","PIT",2008030226,14375,20082009,0,66.3666666666667,5,4,1,0,0,0,24,42,-18,35,52,-17,54,59,-5,4,5,0,0
"23985","WSH","PIT",2008030227,14377,20082009,1,60,2,6,-4,0,0,0,21,30,-9,32,41,-9,51,54,-3,0,4,0,0
"23986","WSH","PHI",2009020027,14523,20092010,0,63.8666666666667,5,6,-1,0,0,0,36,41,-5,46,60,-14,58,74,-16,6,9,0,0
"23987","WSH","NYR",2009020039,14525,20092010,1,60,3,4,-1,0,0,0,28,29,-1,46,40,6,68,48,20,9,5,0,0
"23988","WSH","N.J",2009020067,14529,20092010,1,65,2,2,0,0,0,0,33,29,4,39,42,-3,57,50,7,5,5,0,0
"23989","WSH","NYI",2009020132,14541,20092010,0,61,3,2,1,0,0,0,24,30,-6,43,38,5,68,49,19,4,2,0,0
"23990","WSH","PHI",2009020152,14544,20092010,1,60,4,2,2,0,0,0,36,43,-7,45,62,-17,58,82,-24,4,5,0,0
"23991","WSH","NYI",2009020172,14547,20092010,1,60.8833333333333,3,4,-1,0,0,0,40,30,10,51,43,8,68,57,11,5,3,0,0
"23992","WSH","N.J",2009020204,14552,20092010,0,60,2,3,-1,0,0,0,28,32,-4,33,35,-2,39,40,-1,1,5,0,0
"23993","WSH","FLA",2009020222,14554,20092010,0,60,4,1,3,0,0,0,25,29,-4,37,38,-1,52,53,-1,2,1,0,0
"23994","WSH","FLA",2009020232,14555,20092010,1,60,7,4,3,0,0,0,32,28,4,44,37,7,67,50,17,5,3,0,0
"23995","WSH","NYI",2009020249,14559,20092010,1,65,4,4,0,0,0,0,41,31,10,50,39,11,77,56,21,3,3,0,0
"23996","WSH","MIN",2009020262,14561,20092010,1,60,3,1,2,0,0,0,41,30,11,55,38,17,69,51,18,3,3,0,0
"23997","WSH","N.J",2009020270,14562,20092010,0,60,2,5,-3,0,0,0,29,23,6,35,28,7,47,35,12,1,3,0,0
"23998","WSH","NYR",2009020289,14565,20092010,0,60,4,2,2,0,0,0,26,20,6,40,35,5,53,49,4,5,5,0,0
"23999","WSH","MTL",2009020307,14568,20092010,1,60,2,3,-1,0,0,0,34,22,12,53,30,23,79,43,36,4,3,0,0
"24000","WSH","TOR",2009020314,14569,20092010,0,65,1,1,0,0,0,0,32,39,-7,44,62,-18,57,86,-29,4,2,0,0
"24001","WSH","OTT",2009020331,14571,20092010,0,61.2333333333333,3,4,-1,0,0,0,28,37,-9,42,46,-4,58,63,-5,3,3,0,0
"24002","WSH","MTL",2009020370,14576,20092010,0,65,3,3,0,0,0,0,23,24,-1,34,41,-7,57,55,2,3,4,0,0
"24003","WSH","FLA",2009020400,14581,20092010,1,60,6,2,4,0,0,0,44,28,16,63,38,25,84,50,34,9,6,0,0
"24004","WSH","PHI",2009020419,14583,20092010,0,60,8,2,6,0,0,0,30,36,-6,42,46,-4,58,65,-7,4,2,0,0
"24005","WSH","T.B",2009020433,14585,20092010,0,60,3,0,3,0,0,0,34,26,8,45,36,9,51,51,0,8,6,0,0
"24006","WSH","TOR",2009020466,14590,20092010,0,60,3,6,-3,0,0,0,37,36,1,51,50,1,69,64,5,3,4,0,0
"24007","WSH","COL",2009020492,14593,20092010,0,60,6,1,5,0,0,0,25,28,-3,34,36,-2,41,47,-6,1,6,0,0
"24008","WSH","EDM",2009020528,14597,20092010,0,60,4,2,2,0,0,0,42,28,14,62,41,21,85,49,36,4,2,0,0
"24009","WSH","N.J",2009020560,14604,20092010,1,60,4,1,3,0,0,0,40,30,10,51,40,11,61,55,6,2,4,0,0
"24010","WSH","MTL",2009020631,14614,20092010,1,60,4,2,2,0,0,0,43,26,17,62,40,22,80,52,28,5,4,0,0
"24011","WSH","OTT",2009020646,14616,20092010,1,60,5,2,3,0,0,0,38,28,10,44,35,9,55,53,2,4,4,0,0
"24012","WSH","T.B",2009020685,14621,20092010,0,60,4,7,-3,0,0,0,36,36,0,51,52,-1,65,61,4,6,10,0,0
"24013","WSH","FLA",2009020690,14622,20092010,0,65,4,4,0,0,0,0,37,30,7,60,46,14,78,54,24,1,3,0,0
"24014","WSH","TOR",2009020705,14624,20092010,1,60,6,1,5,0,0,0,24,29,-5,36,41,-5,61,55,6,7,9,0,0
"24015","WSH","PHI",2009020719,14626,20092010,1,60,5,3,2,0,0,0,22,33,-11,29,53,-24,46,71,-25,2,6,0,0
"24016","WSH","PIT",2009020750,14630,20092010,0,60,6,3,3,0,0,0,34,38,-4,44,52,-8,55,68,-13,2,4,0,0
"24017","WSH","NYI",2009020779,14635,20092010,0,60,7,2,5,0,0,0,33,31,2,38,40,-2,57,58,-1,2,5,0,0
"24018","WSH","ANA",2009020788,14636,20092010,1,60,5,1,4,0,0,0,49,31,18,69,42,27,81,59,22,10,7,0,0
"24019","WSH","FLA",2009020802,14638,20092010,1,60,4,1,3,0,0,0,40,36,4,51,54,-3,73,66,7,4,6,0,0
"24020","WSH","T.B",2009020818,14640,20092010,1,60,3,2,1,0,0,0,31,27,4,42,36,6,66,41,25,3,2,0,0
"24021","WSH","NYR",2009020842,14644,20092010,0,60,6,5,1,0,0,0,32,38,-6,51,53,-2,69,68,1,9,6,0,0
"24022","WSH","PIT",2009020870,14647,20092010,1,62.8166666666667,5,4,1,0,0,0,34,35,-1,53,55,-2,75,77,-2,5,7,0,0
"24023","WSH","MTL",2009020886,14650,20092010,0,64.8666666666667,5,6,-1,0,0,0,38,39,-1,54,53,1,80,68,12,7,5,0,0
"24024","WSH","OTT",2009020891,14651,20092010,0,60,5,6,-1,0,0,0,24,28,-4,35,35,0,64,40,24,2,2,0,0
"24025","WSH","STL",2009020911,14653,20092010,0,65,3,3,0,0,0,0,34,36,-2,46,46,0,62,61,1,5,8,0,0
"24026","WSH","T.B",2009020943,14672,20092010,1,60,5,4,1,0,0,0,34,29,5,44,43,1,67,65,2,4,6,0,0
"24027","WSH","NYR",2009020958,14674,20092010,1,60,2,0,2,0,0,0,28,30,-2,37,43,-6,50,61,-11,4,2,0,0
"24028","WSH","DAL",2009020974,14676,20092010,1,65,3,3,0,0,0,0,52,26,26,69,40,29,96,63,33,3,2,0,0
"24029","WSH","T.B",2009021001,14680,20092010,1,60,2,3,-1,0,0,0,30,27,3,50,38,12,70,48,22,4,1,0,0
"24030","WSH","FLA",2009021033,14684,20092010,0,60,7,3,4,0,0,0,39,37,2,54,49,5,64,67,-3,5,4,0,0
"24031","WSH","T.B",2009021063,14688,20092010,0,60,3,1,2,0,0,0,28,34,-6,39,47,-8,47,58,-11,5,6,0,0
"24032","WSH","PIT",2009021091,14692,20092010,1,65,3,3,0,0,0,0,32,42,-10,47,52,-5,65,70,-5,1,5,0,0
"24033","WSH","OTT",2009021136,14698,20092010,1,64.6833333333333,4,5,-1,0,0,0,21,31,-10,36,42,-6,64,50,14,5,4,0,0
"24034","WSH","PIT",2009021186,14705,20092010,0,60,6,3,3,0,0,0,28,29,-1,35,44,-9,43,62,-19,1,4,0,0
"24035","WSH","MTL",2009030111,14714,20092010,1,73.3166666666667,2,3,-1,0,0,0,47,38,9,67,58,9,94,88,6,4,4,0,0
"24036","WSH","MTL",2009030112,14716,20092010,1,60.5166666666667,6,5,1,0,0,0,37,24,13,55,31,24,85,42,43,3,3,0,0
"24037","WSH","MTL",2009030113,14718,20092010,0,60,5,1,4,0,0,0,36,27,9,48,34,14,68,50,18,7,5,0,0
"24038","WSH","MTL",2009030114,14720,20092010,0,60,6,3,3,0,0,0,38,39,-1,51,44,7,73,58,15,5,4,0,0
"24039","WSH","MTL",2009030115,14722,20092010,1,60,1,2,-1,0,0,0,38,28,10,49,43,6,68,58,10,5,6,0,0
"24040","WSH","MTL",2009030116,14725,20092010,0,60,1,4,-3,0,0,0,54,22,32,71,35,36,94,47,47,7,6,0,0
"24041","WSH","MTL",2009030117,14727,20092010,1,60,1,2,-1,0,0,0,42,16,26,53,27,26,94,38,56,4,4,0,0
"24042","WSH","N.J",2010020017,14891,20102011,1,60,7,2,5,6.20818623295054,3.74308588304189,2.46510034990865,29,33,-4,42,43,-1,55,56,-1,5,5,0,0
"24043","WSH","OTT",2010020032,14893,20102011,1,64.4666666666667,3,2,1,4.57674896792859,5.40884853095486,-0.83209956302627,26,31,-5,39,44,-5,50,59,-9,6,6,0,0
"24044","WSH","NYI",2010020037,14895,20102011,1,60,2,1,1,2.65727610571776,4.25447444933525,-1.59719834361749,26,24,2,35,39,-4,48,61,-13,4,3,0,0
"24045","WSH","MIN",2010020134,14910,20102011,0,60,1,2,-1,3.67827172031139,3.30206027650274,0.376211443808643,22,17,5,40,27,13,53,42,11,2,5,0,0
"24046","WSH","TOR",2010020165,14916,20102011,1,65,4,4,0,4.44481447961914,5.22030144271639,-0.775486963097248,30,28,2,44,39,5,64,56,8,4,4,0,0
"24047","WSH","PHI",2010020199,14920,20102011,1,60.4833333333333,3,2,1,5.04981272012009,2.2951802026364,2.75463251748369,39,25,14,51,35,16,74,49,25,5,2,0,0
"24048","WSH","NYR",2010020204,14922,20102011,0,60,5,3,2,4.16883618530119,2.94553896778962,1.22329721751157,24,28,-4,31,39,-8,51,46,5,6,6,0,0
"24049","WSH","T.B",2010020219,14924,20102011,1,60,6,3,3,3.77229318627795,3.14234808087349,0.629945105404458,26,41,-15,34,53,-19,47,70,-23,1,4,0,0
"24050","WSH","PHI",2010020287,14933,20102011,1,65,4,4,0,4.24035006549093,4.76284070569091,-0.522490640199976,37,35,2,55,44,11,76,59,17,7,9,0,0
"24051","WSH","N.J",2010020299,14935,20102011,0,60,0,5,-5,4.07346297253389,1.0344323154095,3.03903065712439,30,23,7,36,25,11,42,28,14,4,4,0,0
"24052","WSH","T.B",2010020327,14939,20102011,1,60,6,0,6,3.84001364175732,1.8869991938991,1.95301444785822,29,17,12,40,30,10,58,49,9,4,5,0,0
"24053","WSH","STL",2010020361,14944,20102011,0,60,4,1,3,5.71419231212349,3.8437831359995,1.87040917612399,26,38,-12,35,50,-15,43,65,-22,2,4,0,0
"24054","WSH","DAL",2010020371,14945,20102011,0,60,1,2,-1,3.85569079711195,2.10912845554371,1.74656234156824,38,21,17,60,32,28,82,48,34,3,6,0,0
"24055","WSH","TOR",2010020397,14949,20102011,1,65,4,4,0,5.26604412816232,3.80021620479874,1.46582792336358,36,28,8,47,37,10,60,52,8,3,4,0,0
"24056","WSH","FLA",2010020414,14952,20102011,1,60,0,3,-3,4.31404387961315,5.77118055980407,-1.45713668019092,36,32,4,52,41,11,68,54,14,8,6,0,0
"24057","WSH","COL",2010020430,14954,20102011,1,60,2,3,-1,4.8737921272384,4.59782964552869,0.275962481709712,42,26,16,57,34,23,84,43,41,3,1,0,0
"24058","WSH","NYR",2010020438,14955,20102011,0,60,0,7,-7,4.98168979364618,4.36924527365818,0.612444519988003,31,20,11,50,34,16,67,40,27,6,5,0,0
"24059","WSH","ANA",2010020452,14958,20102011,1,64.05,1,2,-1,3.13672023902473,4.96243245078949,-1.82571221176477,32,24,8,45,40,5,65,55,10,2,2,0,0
"24060","WSH","OTT",2010020484,14962,20102011,0,60,3,2,1,4.67610786012665,4.33760332097881,0.338504539147834,34,26,8,47,33,14,61,47,14,7,6,0,0
"24061","WSH","N.J",2010020496,14964,20102011,1,60,5,1,4,3.67341256729361,4.65881128988821,-0.985398722594594,28,36,-8,43,44,-1,59,59,0,5,4,0,0
"24062","WSH","PIT",2010020510,14966,20102011,1,65,2,2,0,4.72447041352279,5.87792221253039,-1.1534517990076,34,27,7,46,35,11,69,56,13,7,7,0,0
"24063","WSH","MTL",2010020538,14971,20102011,1,60,3,0,3,4.53263600554783,3.64101689805411,0.891619107493719,30,25,5,45,40,5,64,58,6,8,6,0,0
"24064","WSH","PIT",2010020566,14975,20102011,0,60,3,1,2,4.39374583136444,3.3394505442968,1.05429528706764,32,33,-1,41,50,-9,50,66,-16,2,4,0,0
"24065","WSH","T.B",2010020587,14978,20102011,1,62.9,0,1,-1,5.07055372995092,4.984237227319,0.0863165026319166,34,38,-4,48,49,-1,65,59,6,3,3,0,0
"24066","WSH","FLA",2010020617,14982,20102011,1,60,3,2,1,2.73013099596596,3.93592274404386,-1.20579174807791,27,27,0,35,39,-4,52,57,-5,3,4,0,0
"24067","WSH","FLA",2010020638,14985,20102011,0,62.85,3,4,-1,6.09859387791948,6.26176310342271,-0.163169225503225,33,41,-8,46,46,0,49,68,-19,6,6,0,0
"24068","WSH","T.B",2010020643,14986,20102011,0,60,0,3,-3,4.53045945306076,4.36245300175506,0.1680064513057,23,38,-15,32,57,-25,47,68,-21,4,8,0,0
"24069","WSH","OTT",2010020672,14990,20102011,1,60,3,1,2,4.38194441760425,2.69701578599052,1.68492863161373,26,23,3,39,38,1,60,53,7,2,2,0,0
"24070","WSH","PHI",2010020684,14992,20102011,0,61.1166666666667,2,3,-1,7.86398230746272,5.65711891837418,2.20686338908854,25,30,-5,38,43,-5,52,52,0,0,1,0,0
"24071","WSH","NYI",2010020699,14994,20102011,0,60,2,1,1,3.68912525457563,4.20105617772788,-0.511930923152249,24,25,-1,36,36,0,44,56,-12,2,6,0,0
"24072","WSH","TOR",2010020715,14996,20102011,0,60,4,1,3,5.02488334287897,4.81752982273925,0.207353520139716,31,36,-5,41,49,-8,51,76,-25,2,3,0,0
"24073","WSH","NYR",2010020728,14998,20102011,1,65,1,1,0,2.83475378715229,3.43749826743442,-0.602744480282126,23,29,-6,30,35,-5,48,45,3,3,3,0,0
"24074","WSH","MTL",2010020754,15006,20102011,1,65,2,2,0,2.71766060256186,6.44592779886443,-3.72826719630257,29,38,-9,36,56,-20,56,69,-13,3,6,0,0
"24075","WSH","T.B",2010020779,15009,20102011,0,60,5,2,3,4.26213364401656,2.93080479477067,1.33132884924589,36,25,11,50,37,13,64,50,14,5,5,0,0
"24076","WSH","PIT",2010020793,15011,20102011,1,60,3,0,3,3.85006093662993,5.7922403403245,-1.94217940369456,24,22,2,33,33,0,48,51,-3,4,2,0,0
"24077","WSH","ANA",2010020862,15021,20102011,0,60,7,6,1,5.96108093171428,2.57246627868153,3.38861465303275,31,21,10,41,30,11,57,42,15,4,4,0,0
"24078","WSH","PIT",2010020893,15026,20102011,0,60,1,0,1,3.40766287519364,5.13233822268268,-1.72467534748904,24,39,-15,33,48,-15,51,68,-17,4,4,0,0
"24079","WSH","NYR",2010020915,15030,20102011,1,60,0,6,-6,4.78088449611096,2.92984956435976,1.8510349317512,35,28,7,54,37,17,72,46,26,5,3,0,0
"24080","WSH","NYI",2010020930,15031,20102011,0,60,3,2,1,3.74341936805286,4.13088746315392,-0.387468095101063,22,31,-9,36,40,-4,57,58,-1,2,4,0,0
"24081","WSH","NYI",2010020943,15034,20102011,1,61.9166666666667,2,1,1,4.33664501377474,5.6478850179119,-1.31124000413716,42,29,13,52,44,8,71,62,9,2,4,0,0
"24082","WSH","STL",2010020960,15036,20102011,1,60,3,2,1,2.00923138982164,3.82411647109984,-1.8148850812782,30,27,3,41,42,-1,58,64,-6,1,3,0,0
"24083","WSH","FLA",2010020985,15039,20102011,0,60.8,3,2,1,4.56716028959522,3.53740692396241,1.02975336563281,25,34,-9,38,45,-7,51,61,-10,1,6,0,0
"24084","WSH","T.B",2010020989,15040,20102011,0,65,1,1,0,6.21509256062564,4.4911855548271,1.72390700579854,30,28,2,44,39,5,69,53,16,4,5,0,0
"24085","WSH","EDM",2010021001,15042,20102011,1,60,5,0,5,3.80286196268546,3.66415041949421,0.138711543191251,36,22,14,46,31,15,58,45,13,5,4,0,0
"24086","WSH","MTL",2010021045,15048,20102011,0,60,4,2,2,3.75765813414976,2.48988847640903,1.26776965774074,41,26,15,52,35,17,63,45,18,6,4,0,0
"24087","WSH","N.J",2010021066,15051,20102011,0,60,3,0,3,1.83135913979589,5.56333371024812,-3.73197457045222,12,33,-21,15,42,-27,21,50,-29,0,3,0,0
"24088","WSH","PHI",2010021090,15055,20102011,0,65,4,4,0,3.43604737887654,4.35811280385678,-0.922065424980246,23,33,-10,37,49,-12,51,70,-19,2,2,0,0
"24089","WSH","OTT",2010021113,15058,20102011,0,60,0,2,-2,4.13620598536136,5.08065024318691,-0.944444257825552,31,23,8,44,33,11,61,46,15,4,4,0,0
"24090","WSH","MTL",2010021119,15059,20102011,0,60,2,0,2,4.5359568031854,3.06534879458933,1.47060800859607,33,18,15,48,33,15,63,48,15,4,3,0,0
"24091","WSH","TOR",2010021185,15069,20102011,0,65,2,2,0,6.65149287435634,2.48494021380611,4.16655266055022,41,21,20,60,30,30,78,48,30,3,2,0,0
"24092","WSH","FLA",2010021195,15070,20102011,1,60,5,2,3,3.48053616665595,4.00231396366477,-0.52177779700882,25,33,-8,37,44,-7,43,68,-25,5,5,0,0
"24093","WSH","FLA",2010021220,15073,20102011,0,60,0,1,-1,4.96549001305035,4.86640117783099,0.0990888352193586,28,23,5,41,34,7,54,52,2,1,2,0,0
"24094","WSH","NYR",2010030111,15077,20102011,1,78.4,2,1,1,8.88915217306203,5.90251132990852,2.98664084315351,33,25,8,52,33,19,80,65,15,2,2,0,0
"24095","WSH","NYR",2010030112,15079,20102011,1,60,2,0,2,3.35003867388605,1.89368413762077,1.45635453626528,18,22,-4,31,27,4,46,48,-2,4,2,0,0
"24096","WSH","NYR",2010030113,15081,20102011,0,60,2,3,-1,3.55698200693587,4.18994379159955,-0.632961784663678,25,35,-10,40,49,-9,52,60,-8,4,8,0,0
"24097","WSH","NYR",2010030114,15084,20102011,0,80,3,3,0,4.51874372182779,4.15294570277348,0.36579801905431,48,35,13,64,44,20,90,63,27,4,6,0,0
"24098","WSH","NYR",2010030115,15087,20102011,1,60,3,1,2,5.16062872818293,3.86839971492009,1.29222901326284,27,27,0,43,35,8,63,54,9,7,5,0,0
"24099","WSH","T.B",2010030211,15093,20102011,1,60,2,4,-2,0,0,0,28,24,4,38,34,4,61,49,12,5,4,0,0
"24100","WSH","T.B",2010030212,15095,20102011,1,66.3166666666667,2,3,-1,5.18581953039393,2.25331618481351,2.93250334558042,37,23,14,52,35,17,76,56,20,6,5,0,0
"24101","WSH","T.B",2010030213,15097,20102011,0,60,3,4,-1,2.42230846912093,8.33350171762089,-5.91119324849996,32,30,2,39,42,-3,58,50,8,5,4,0,0
"24102","WSH","T.B",2010030214,15098,20102011,0,60,3,5,-2,5.20723234033721,4.98963764507789,0.217594695259322,36,37,-1,56,43,13,78,54,24,3,5,0,0
"24103","WSH","T.B",2011020029,15257,20112012,1,65,5,5,0,4.62628715080875,4.37022280487508,0.256064345933664,43,28,15,62,41,21,85,54,31,7,5,0,0
"24104","WSH","PIT",2011020039,15260,20112012,0,62.8,3,2,1,2.78010388917755,6.46068640246813,-3.68058251329057,19,41,-22,29,56,-27,40,79,-39,1,5,0,0
"24105","WSH","OTT",2011020054,15262,20112012,1,60,2,1,1,4.83962728222832,2.49315058792454,2.34647669430378,26,34,-8,38,46,-8,55,56,-1,3,1,0,0
"24106","WSH","FLA",2011020070,15265,20112012,1,60,3,0,3,4.15015532658435,3.57633107792208,0.573824248662277,32,20,12,47,32,15,56,44,12,2,3,0,0
"24107","WSH","PHI",2011020081,15267,20112012,0,60,5,2,3,3.77303880261024,4.43146202069573,-0.658423218085485,28,42,-14,41,49,-8,64,61,3,6,4,0,0
"24108","WSH","EDM",2011020134,15274,20112012,0,60,1,2,-1,3.93852010657866,4.4080988781061,-0.469578771527438,35,19,16,58,26,32,76,38,38,6,9,0,0
"24109","WSH","ANA",2011020161,15279,20112012,1,62.3,5,4,1,7.1510538820803,1.4138926205769,5.7371612615034,40,15,25,53,22,31,70,37,33,3,1,0,0
"24110","WSH","NYI",2011020187,15283,20112012,0,60,3,5,-2,5.11983642715495,5.75431329935964,-0.634476872204687,28,35,-7,40,41,-1,59,55,4,1,4,0,0
"24111","WSH","DAL",2011020205,15286,20112012,1,60,2,5,-3,3.68517585654627,4.11649574995031,-0.431319893404044,32,36,-4,40,45,-5,55,54,1,5,6,0,0
"24112","WSH","N.J",2011020222,15289,20112012,0,60,3,1,2,3.00378884840757,3.59023273524767,-0.586443886840108,20,33,-13,25,37,-12,30,48,-18,4,5,0,0
"24113","WSH","N.J",2011020231,15290,20112012,1,65,2,2,0,2.86477464972995,3.27941736605165,-0.414642716321699,17,19,-2,28,36,-8,50,50,0,5,5,0,0
"24114","WSH","WPG",2011020267,15295,20112012,0,60,1,4,-3,6.36575574651511,3.60240345539913,2.76335229111598,32,31,1,56,43,13,67,48,19,5,5,0,0
"24115","WSH","TOR",2011020277,15297,20112012,0,60,1,7,-6,5.99022611797959,5.97362213928477,0.0166039786948211,41,29,12,55,47,8,68,57,11,7,7,0,0
"24116","WSH","WPG",2011020304,15301,20112012,1,61.8666666666667,4,3,1,7.05948713319958,5.45462604665423,1.60486108654536,37,25,12,51,37,14,68,51,17,4,3,0,0
"24117","WSH","NYR",2011020317,15303,20112012,1,60,3,6,-3,2.96377572333381,5.50780847625356,-2.54403275291975,21,33,-12,33,45,-12,46,57,-11,4,5,0,0
"24118","WSH","STL",2011020347,15307,20112012,1,60,1,2,-1,1.09720694071558,3.2289394170657,-2.13173247635012,19,30,-11,24,41,-17,30,61,-31,2,4,0,0
"24119","WSH","OTT",2011020374,15311,20112012,1,60.2,3,2,1,4.13285347132478,4.82149667524391,-0.688643203919128,35,34,1,47,44,3,61,57,4,4,1,0,0
"24120","WSH","FLA",2011020390,15313,20112012,0,60,4,5,-1,7.05463475114084,3.42509071336895,3.62954403777189,32,30,2,44,41,3,54,45,9,2,6,0,0
"24121","WSH","OTT",2011020402,15315,20112012,0,60,5,3,2,8.20661200607312,5.70392565212876,2.50268635394436,44,34,10,51,47,4,58,66,-8,5,7,0,0
"24122","WSH","TOR",2011020417,15317,20112012,1,60,4,2,2,3.25460550020216,5.06088359974092,-1.80627809953876,25,28,-3,32,39,-7,42,55,-13,8,4,0,0
"24123","WSH","PHI",2011020441,15321,20112012,1,60,1,5,-4,4.44833863075473,5.25732646077711,-0.808987830022375,32,33,-1,48,43,5,67,56,11,3,1,0,0
"24124","WSH","WPG",2011020458,15323,20112012,0,60,1,0,1,4.93456161458744,4.64497573021799,0.289585884369444,28,26,2,46,44,2,65,58,7,2,4,0,0
"24125","WSH","COL",2011020476,15325,20112012,0,60,1,2,-1,6.75964815128827,4.0726824238759,2.68696572741237,26,28,-2,39,38,1,47,51,-4,4,2,0,0
"24126","WSH","N.J",2011020509,15331,20112012,0,65,3,3,0,6.00302867707796,1.39486155255634,4.60816712452163,25,28,-3,38,35,3,50,45,5,3,4,0,0
"24127","WSH","NYR",2011020537,15336,20112012,1,60,4,1,3,3.39512164263715,4.84408353765829,-1.44896189502114,23,32,-9,31,48,-17,49,68,-19,2,5,0,0
"24128","WSH","T.B",2011020642,15352,20112012,1,60,4,3,1,5.00416669226252,6.92046027625324,-1.91629358399072,20,31,-11,28,49,-21,38,64,-26,5,6,0,0
"24129","WSH","NYI",2011020675,15356,20112012,1,60,0,3,-3,1.93054819243162,3.95446954285035,-2.02392135041873,17,28,-11,30,39,-9,48,52,-4,3,6,0,0
"24130","WSH","MTL",2011020681,15357,20112012,0,60,3,0,3,1.91495834744637,5.90776953806494,-3.99281119061857,16,31,-15,21,47,-26,36,72,-36,4,6,0,0
"24131","WSH","T.B",2011020742,15370,20112012,0,62.75,3,4,-1,3.55125257413602,6.59950850206224,-3.04825592792622,30,31,-1,38,39,-1,52,54,-2,2,1,0,0
"24132","WSH","FLA",2011020751,15371,20112012,0,60,2,4,-2,3.03546327343065,5.38549563587719,-2.35003236244654,28,38,-10,40,54,-14,51,70,-19,2,4,0,0
"24133","WSH","MTL",2011020769,15374,20112012,0,60,3,0,3,2.05486440047389,5.94695288091275,-3.89208848043886,23,30,-7,29,41,-12,45,68,-23,5,1,0,0
"24134","WSH","FLA",2011020788,15377,20112012,1,60,4,0,4,2.40492578521052,4.24292740915553,-1.83800162394501,24,42,-18,33,57,-24,39,74,-35,1,4,0,0
"24135","WSH","WPG",2011020805,15379,20112012,1,65,2,2,0,2.94085608558089,4.96267717689801,-2.02182109131712,34,27,7,46,46,0,64,68,-4,5,3,0,0
"24136","WSH","NYR",2011020828,15382,20112012,0,60,2,3,-1,5.65713358977501,4.35274211087402,1.304391478901,26,28,-2,38,41,-3,63,54,9,2,2,0,0
"24137","WSH","FLA",2011020861,15387,20112012,0,60,2,1,1,5.8929263951577,2.98200888044084,2.91091751471686,41,23,18,59,33,26,75,50,25,6,3,0,0
"24138","WSH","T.B",2011020869,15388,20112012,0,60,1,2,-1,5.34481408155989,2.84108412054775,2.50372996101214,24,23,1,34,34,0,57,46,11,2,5,0,0
"24139","WSH","OTT",2011020896,15392,20112012,0,60,2,5,-3,4.15337796217864,3.02920537549873,1.12417258667991,35,26,9,48,30,18,63,46,17,5,3,0,0
"24140","WSH","MTL",2011020910,15394,20112012,1,60,4,1,3,4.24272263195598,4.0173043206305,0.225418311325484,24,31,-7,30,40,-10,53,50,3,6,4,0,0
"24141","WSH","TOR",2011020918,15395,20112012,0,60,4,2,2,4.65868418052014,4.25308871220477,0.405595468315369,36,30,6,44,45,-1,54,70,-16,2,5,0,0
"24142","WSH","NYI",2011020939,15398,20112012,1,61.5833333333333,3,2,1,3.13704147193494,2.36277201891062,0.774269453024317,34,24,10,53,33,20,72,46,26,4,3,0,0
"24143","WSH","N.J",2011020959,15401,20112012,1,60,0,5,-5,2.60494557043421,2.16741629449803,0.437529275936186,23,20,3,28,31,-3,45,38,7,2,2,0,0
"24144","WSH","PHI",2011020979,15403,20112012,1,60,0,1,-1,4.21353715532314,3.0285430261938,1.18499412912934,34,23,11,45,33,12,60,41,19,0,1,0,0
"24145","WSH","T.B",2011021001,15407,20112012,1,64.15,3,2,1,0,0,0,32,26,6,49,31,18,68,45,23,2,3,0,0
"24146","WSH","TOR",2011021025,15410,20112012,1,60,2,0,2,3.56270280649187,2.14332470257068,1.41937810392119,23,23,0,31,31,0,45,52,-7,1,1,0,0
"24147","WSH","NYI",2011021037,15412,20112012,0,65,4,4,0,0,0,0,28,30,-2,43,40,3,56,57,-1,0,5,0,0
"24148","WSH","WPG",2011021061,15415,20112012,0,60,2,3,-1,1.88543553585987,4.62252978939796,-2.73709425353809,22,28,-6,32,39,-7,47,57,-10,4,6,0,0
"24149","WSH","PHI",2011021102,15421,20112012,0,65,1,1,0,4.00380932614235,6.88110872270227,-2.87729939655992,31,28,3,40,44,-4,50,60,-10,3,1,0,0
"24150","WSH","WPG",2011021112,15422,20112012,1,62.6166666666667,3,4,-1,4.05363068138831,5.33862832007769,-1.28499763868938,23,42,-19,38,56,-18,51,76,-25,2,2,0,0
"24151","WSH","MIN",2011021128,15424,20112012,1,60,3,0,3,3.24267811063328,3.02766757685458,0.215010533778695,23,28,-5,35,39,-4,49,57,-8,3,2,0,0
"24152","WSH","MTL",2011021172,15430,20112012,1,65,2,2,0,6.3158679476453,5.16558756084123,1.15028038680407,33,41,-8,48,52,-4,68,68,0,5,4,0,0
"24153","WSH","T.B",2011021187,15432,20112012,0,60,2,4,-2,5.15771133314158,6.54722573360459,-1.38951440046301,33,27,6,49,39,10,61,55,6,2,4,0,0
"24154","WSH","FLA",2011021205,15435,20112012,1,60,4,2,2,2.62955251074163,3.87919625298309,-1.24964374224146,24,27,-3,28,45,-17,39,70,-31,2,1,0,0
"24155","WSH","NYR",2011021218,15437,20112012,0,60,4,1,3,2.45058149329907,3.36309269879246,-0.912511205493388,17,36,-19,22,46,-24,32,55,-23,4,4,0,0
"24156","WSH","NYR",2011030211,15458,20112012,0,60,1,3,-2,5.69914891402004,2.95591542576585,2.74323348825419,18,14,4,34,32,2,49,47,2,4,4,0,0
"24157","WSH","NYR",2011030212,15460,20112012,0,60,3,2,1,2.76108680150355,3.26255501434207,-0.501468212838518,25,28,-3,32,41,-9,46,65,-19,4,4,0,0
"24158","WSH","NYR",2011030213,15462,20112012,1,80,1,1,0,5.30037044706205,3.72409733174339,1.57627311531866,37,37,0,56,46,10,86,71,15,3,3,0,0
"24159","WSH","NYR",2011030214,15465,20112012,1,60,3,2,1,3.03691986668855,3.04989167128224,-0.0129718045936897,26,20,6,33,26,7,40,52,-12,2,2,0,0
"24160","WSH","NYR",2011030215,15467,20112012,0,61.5833333333333,2,3,-1,3.46693991706707,5.6830607088632,-2.21612079179613,18,38,-20,25,53,-28,35,78,-43,4,4,0,0
"24161","WSH","NYR",2011030216,15469,20112012,1,60,2,1,1,4.67109898069668,5.73751082554372,-1.06641184484704,23,31,-8,36,44,-8,42,68,-26,3,5,0,0
"24162","WSH","NYR",2011030217,15472,20112012,0,60,1,2,-1,2.12448621589851,5.3044282476767,-3.17994203177818,23,31,-8,36,42,-6,55,57,-2,1,2,0,0
"24163","WSH","T.B",2012020007,15724,20122013,0,60,3,6,-3,5.32460193784488,3.97882713462604,1.34577480321884,30,34,-4,42,41,1,50,51,-1,5,8,0,0
"24164","WSH","WPG",2012020027,15727,20122013,1,60,2,4,-2,4.14373159987736,6.93821849002302,-2.79448689014566,34,39,-5,39,46,-7,57,56,1,4,5,0,0
"24165","WSH","MTL",2012020042,15729,20122013,1,60,1,4,-3,2.9690929529589,3.63403856474906,-0.664945611790159,31,22,9,47,30,17,66,40,26,4,6,0,0
"24166","WSH","N.J",2012020052,15730,20122013,0,64.65,2,3,-1,3.24020708267926,4.71261828321713,-1.47241120053786,28,35,-7,34,44,-10,43,60,-17,8,6,0,0
"24167","WSH","OTT",2012020082,15734,20122013,0,60,2,3,-1,4.3522039426025,5.82502478103561,-1.47282083843311,33,27,6,39,40,-1,48,52,-4,4,6,0,0
"24168","WSH","TOR",2012020093,15736,20122013,0,60,2,3,-1,0,0,0,22,40,-18,34,62,-28,46,84,-38,3,8,0,0
"24169","WSH","PHI",2012020101,15737,20122013,1,60,3,2,1,1.89213918260066,4.01550046377815,-2.12336128117749,26,31,-5,33,43,-10,44,66,-22,5,3,0,0
"24170","WSH","TOR",2012020130,15741,20122013,1,60,2,3,-1,4.1591728773783,3.39148443023441,0.767688447143883,26,21,5,42,33,9,64,42,22,3,3,0,0
"24171","WSH","FLA",2012020162,15745,20122013,1,60,5,0,5,4.43131087050795,1.65174817268462,2.77956269782333,25,27,-2,35,31,4,53,50,3,3,3,0,0
"24172","WSH","FLA",2012020182,15748,20122013,0,60.5333333333333,6,5,1,3.60145493731751,3.92098399360289,-0.319529056285385,29,32,-3,43,40,3,57,49,8,4,6,0,0
"24173","WSH","T.B",2012020193,15750,20122013,0,60,4,3,1,5.62553738273982,5.79137576479116,-0.165838382051334,39,30,9,53,40,13,71,49,22,2,3,0,0
"24174","WSH","NYR",2012020217,15753,20122013,0,60,1,2,-1,2.44371304969536,2.23190240323493,0.211810646460435,28,40,-12,39,51,-12,51,69,-18,4,5,0,0
"24175","WSH","N.J",2012020239,15757,20122013,1,60,2,3,-1,2.92022853808885,5.84982054459397,-2.92959200650512,19,37,-18,30,48,-18,41,66,-25,5,7,0,0
"24176","WSH","N.J",2012020250,15759,20122013,1,60,5,1,4,4.09207728074398,1.86993296720902,2.22214431353495,26,22,4,36,33,3,44,46,-2,3,4,0,0
"24177","WSH","PHI",2012020285,15763,20122013,0,60,1,4,-3,2.81959351635315,5.3531058212393,-2.53351230488614,24,32,-8,31,46,-15,52,67,-15,3,4,0,0
"24178","WSH","WPG",2012020305,15766,20122013,0,60,3,0,3,3.24033653019461,3.95846152026843,-0.71812499007382,21,35,-14,35,49,-14,44,66,-22,4,4,0,0
"24179","WSH","FLA",2012020343,15771,20122013,1,60,7,1,6,2.85075425272225,5.06858590436643,-2.21783165164417,26,30,-4,37,44,-7,48,66,-18,1,2,0,0
"24180","WSH","NYI",2012020356,15773,20122013,0,60,2,5,-3,2.39593103772495,6.30239283619449,-3.90646179846954,24,45,-21,31,56,-25,49,72,-23,3,5,0,0
"24181","WSH","NYR",2012020365,15774,20122013,1,60,1,4,-3,4.48987643755888,6.07419994025258,-1.58432350269371,29,30,-1,44,39,5,64,54,10,4,3,0,0
"24182","WSH","WPG",2012020448,15785,20122013,0,60,4,0,4,2.63699856271341,2.98090056369256,-0.343902000979145,25,20,5,30,32,-2,45,50,-5,3,3,0,0
"24183","WSH","WPG",2012020454,15786,20122013,0,60,6,1,5,3.60692352856778,5.22167779636499,-1.6147542677972,24,31,-7,34,44,-10,40,61,-21,5,6,0,0
"24184","WSH","NYR",2012020467,15788,20122013,0,65,2,2,0,4.72111679909358,4.76826453988906,-0.0471477407954808,24,32,-8,42,44,-2,65,55,10,4,3,0,0
"24185","WSH","NYI",2012020481,15790,20122013,1,60,2,3,-1,3.96594764517304,3.83819446829193,0.127753176881103,22,31,-9,40,40,0,66,51,15,3,2,0,0
"24186","WSH","PHI",2012020521,15795,20122013,0,61.5666666666667,4,5,-1,4.86537952486497,5.04381267519511,-0.178433150330143,29,34,-5,49,50,-1,67,71,-4,8,5,0,0
"24187","WSH","NYI",2012020545,15799,20122013,1,65,1,1,0,4.85715280100703,6.09757446389267,-1.24042166288564,22,36,-14,34,44,-10,50,59,-9,3,3,0,0
"24188","WSH","FLA",2012020566,15801,20122013,0,60,4,3,1,4.2604566195223,3.55295073668822,0.707505882834084,31,30,1,43,33,10,58,45,13,3,2,0,0
"24189","WSH","T.B",2012020573,15802,20122013,1,60,4,2,2,5.88647979160305,5.26502224151045,0.6214575500926,38,30,8,48,38,10,60,56,4,3,3,0,0
"24190","WSH","MTL",2012020585,15804,20122013,0,60,3,2,1,7.52996233326849,5.49783681867484,2.03212551459364,27,29,-2,36,42,-6,46,76,-30,1,1,0,0
"24191","WSH","T.B",2012020614,15808,20122013,1,62.9833333333333,6,5,1,5.22659335384378,4.80632890065635,0.420264453187428,38,40,-2,46,48,-2,57,67,-10,5,2,0,0
"24192","WSH","TOR",2012020633,15811,20122013,1,60,5,1,4,6.37006401006265,4.3544452568612,2.01561875320145,37,30,7,50,38,12,65,47,18,6,3,0,0
"24193","WSH","OTT",2012020647,15813,20122013,0,60,1,3,-2,3.73019696539268,9.22558861538278,-5.4953916499901,19,38,-19,30,52,-22,40,68,-28,3,3,0,0
"24194","WSH","MTL",2012020662,15815,20122013,0,60,5,1,4,4.8622978622152,5.89777571900294,-1.03547785678774,25,36,-11,32,50,-18,50,72,-22,4,6,0,0
"24195","WSH","WPG",2012020682,15818,20122013,1,60,5,3,2,7.03204605434928,3.72113521094025,3.31091084340903,41,27,14,56,31,25,72,48,24,1,3,0,0
"24196","WSH","OTT",2012020695,15820,20122013,1,60.7833333333333,1,2,-1,5.20812002867901,9.5107226433247,-4.30260261464569,20,41,-21,32,52,-20,43,68,-25,2,6,0,0
"24197","WSH","NYR",2012030131,15827,20122013,1,60,3,1,2,3.305036782439,4.05401482094567,-0.748978038506664,30,36,-6,38,54,-16,53,79,-26,6,5,0,0
"24198","WSH","NYR",2012030132,15829,20122013,1,68,1,0,1,8.64906709711067,4.80517358670477,3.84389351040591,38,24,14,54,44,10,75,57,18,4,5,0,0
"24199","WSH","NYR",2012030133,15831,20122013,0,60,3,4,-1,2.69508490656153,4.83306395648321,-2.13797904992168,31,30,1,45,44,1,64,58,6,3,6,0,0
"24200","WSH","NYR",2012030134,15833,20122013,0,60,3,4,-1,4.81350469470172,3.44077550282054,1.37272919188118,30,34,-4,49,42,7,82,62,20,2,4,0,0
"24201","WSH","NYR",2012030135,15835,20122013,1,69.4,2,1,1,6.45183529699898,2.81023198214825,3.64160331485073,35,25,10,52,37,15,81,67,14,2,4,0,0
"24202","WSH","NYR",2012030136,15837,20122013,0,60,0,1,-1,3.4097350372798,5.32707412718446,-1.91733908990466,27,29,-2,42,47,-5,59,66,-7,2,7,0,0
"24203","WSH","NYR",2012030137,15838,20122013,1,60,0,5,-5,5.15066326142551,3.01357533788541,2.13708792354009,35,27,8,52,38,14,79,47,32,2,2,0,0
"24204","WSH","DAL",2013020028,15983,20132014,0,60,1,2,-1,3.84677885492306,4.00511996838031,-0.158341113457254,26,21,5,35,41,-6,49,51,-2,3,2,0,0
"24205","WSH","COL",2013020067,15990,20132014,1,60,1,5,-4,2.31217513373485,4.89748719375653,-2.58531206002168,41,28,13,48,35,13,67,44,23,2,3,0,0
"24206","WSH","EDM",2013020080,15992,20132014,1,60,4,2,2,2.44849498872645,4.66016842157842,-2.21167343285197,20,30,-10,32,42,-10,48,55,-7,6,6,0,0
"24207","WSH","NYR",2013020094,15994,20132014,1,60,0,2,-2,3.62751728022704,4.25574528161087,-0.628228001383832,22,36,-14,35,48,-13,57,61,-4,5,4,0,0
"24208","WSH","WPG",2013020135,16000,20132014,0,65,4,4,0,4.65423833020031,5.32208063948103,-0.66784230928072,32,47,-15,44,69,-25,53,82,-29,6,4,0,0
"24209","WSH","EDM",2013020147,16002,20132014,0,60,4,1,3,0,0,0,26,31,-5,36,44,-8,45,57,-12,3,4,0,0
"24210","WSH","PHI",2013020191,16010,20132014,0,60,7,0,7,5.95414505535695,4.15778645641353,1.79635859894343,32,30,2,44,44,0,55,59,-4,7,5,0,0
"24211","WSH","FLA",2013020206,16011,20132014,1,65,2,2,0,3.81449884347967,4.94285712314286,-1.12835827966319,23,33,-10,39,43,-4,50,66,-16,5,8,0,0
"24212","WSH","NYI",2013020218,16014,20132014,1,60,6,2,4,4.95367420991528,4.39360510862797,0.560069101287311,39,36,3,51,50,1,66,66,0,7,6,0,0
"24213","WSH","MIN",2013020233,16016,20132014,1,65,2,2,0,4.33219290315174,2.6014276125934,1.73076529055834,27,35,-8,42,41,1,57,51,6,3,3,0,0
"24214","WSH","ARI",2013020253,16018,20132014,0,65,3,3,0,3.97846980467875,6.09749093612712,-2.11902113144836,32,35,-3,41,44,-3,55,60,-5,8,7,0,0
"24215","WSH","COL",2013020260,16019,20132014,0,60,1,4,-3,4.21941628707755,5.0256612919884,-0.806245004910853,34,37,-3,44,47,-3,61,64,-3,4,3,0,0
"24216","WSH","STL",2013020304,16026,20132014,1,60,4,1,3,3.68931897855509,5.48905987893507,-1.79974090037997,20,47,-27,37,63,-26,49,85,-36,4,5,0,0
"24217","WSH","MTL",2013020337,16031,20132014,1,60,2,3,-1,3.26404186649233,2.61901930955355,0.645022556938784,27,31,-4,49,42,7,66,57,9,2,5,0,0
"24218","WSH","TOR",2013020343,16032,20132014,0,65,1,1,0,8.5914062877273,5.43798368552234,3.15342260220496,50,28,22,73,41,32,101,54,47,3,1,0,0
"24219","WSH","OTT",2013020368,16036,20132014,1,60,4,6,-2,3.66834328841651,6.23841256619198,-2.57006927777547,33,41,-8,41,58,-17,51,67,-16,7,9,0,0
"24220","WSH","MTL",2013020386,16038,20132014,1,65,2,2,0,3.43140806357405,5.58361088348277,-2.15220281990872,26,37,-11,38,48,-10,54,61,-7,5,3,0,0
"24221","WSH","NYI",2013020397,16039,20132014,0,62.1166666666667,3,2,1,3.65129632976641,4.41788602800807,-0.76658969824166,30,39,-9,42,47,-5,58,65,-7,1,2,0,0
"24222","WSH","NYR",2013020451,16047,20132014,0,60,4,1,3,4.89672405317106,3.25679536571261,1.63992868745845,36,31,5,47,41,6,56,58,-2,4,3,0,0
"24223","WSH","T.B",2013020459,16049,20132014,1,65,5,5,0,4.53255996211566,8.91215326565725,-4.3795933035416,31,42,-11,43,57,-14,51,77,-26,2,5,0,0
"24224","WSH","FLA",2013020485,16052,20132014,0,65,2,2,0,2.84686168784538,4.2594621978642,-1.41260051001882,25,41,-16,34,56,-22,45,67,-22,1,2,0,0
"24225","WSH","PHI",2013020499,16054,20132014,1,65,4,4,0,0,0,0,33,28,5,40,39,1,50,55,-5,5,4,0,0
"24226","WSH","PHI",2013020515,16056,20132014,0,60,2,5,-3,3.03435588581488,4.67228930233368,-1.63793341651881,26,35,-9,32,45,-13,51,65,-14,4,5,0,0
"24227","WSH","N.J",2013020546,16060,20132014,1,60.7166666666667,4,5,-1,5.67504624393769,4.88068027087138,0.794365973066306,22,37,-15,29,51,-22,37,72,-35,1,2,0,0
"24228","WSH","ANA",2013020555,16062,20132014,1,60,2,3,-1,1.88999419368338,2.36045872998511,-0.470464536301733,19,29,-10,32,43,-11,53,56,-3,5,4,0,0
"24229","WSH","NYR",2013020570,16066,20132014,1,60,3,2,1,4.29299115275228,6.03977801196015,-1.74678685920787,34,40,-6,40,52,-12,55,71,-16,6,5,0,0
"24230","WSH","OTT",2013020595,16069,20132014,0,60,1,3,-2,3.99373802472257,7.57856569950809,-3.58482767478552,35,38,-3,50,49,1,65,60,5,2,4,0,0
"24231","WSH","MIN",2013020635,16074,20132014,0,60,3,5,-2,4.72822422225806,3.6364681229461,1.09175609931197,30,11,19,44,17,27,63,25,38,3,6,0,0
"24232","WSH","T.B",2013020663,16079,20132014,0,60,4,3,1,4.3153226384311,5.43425753249176,-1.11893489406066,20,36,-16,39,46,-7,57,58,-1,3,1,0,0
"24233","WSH","TOR",2013020670,16080,20132014,1,60,3,2,1,3.0536036295902,5.74862649489432,-2.69502286530413,35,34,1,48,50,-2,68,66,2,5,4,0,0
"24234","WSH","NYR",2013020738,16089,20132014,0,60,1,4,-3,5.27345525219937,3.89489546567141,1.37855978652795,25,26,-1,41,36,5,64,50,14,5,6,0,0
"24235","WSH","OTT",2013020750,16091,20132014,1,60,0,2,-2,2.15419623896186,3.94523031799418,-1.79103407903232,34,26,8,43,42,1,53,54,-1,5,5,0,0
"24236","WSH","N.J",2013020769,16094,20132014,0,60,1,2,-1,2.9726076642437,4.6169579430134,-1.64435027876971,31,30,1,40,38,2,47,42,5,3,5,0,0
"24237","WSH","MTL",2013020777,16095,20132014,0,60,5,0,5,4.59855306497775,4.54862035509996,0.049932709877794,34,21,13,44,32,12,60,52,8,7,4,0,0
"24238","WSH","NYI",2013020849,16105,20132014,1,60,0,1,-1,5.19383660668973,4.61553612391943,0.578300482770299,22,28,-6,34,40,-6,49,61,-12,7,7,0,0
"24239","WSH","WPG",2013020859,16107,20132014,1,60,4,2,2,3.24381971685216,4.78211609475859,-1.53829637790643,30,36,-6,45,45,0,61,57,4,4,1,0,0
"24240","WSH","N.J",2013020879,16109,20132014,1,60,3,0,3,5.10208261013031,4.4182048813125,0.683877728817805,26,25,1,37,42,-5,53,63,-10,4,4,0,0
"24241","WSH","FLA",2013020892,16128,20132014,0,60,5,4,1,4.9115723160121,4.19359148514195,0.717980830870147,32,34,-2,37,49,-12,43,63,-20,2,6,0,0
"24242","WSH","PHI",2013020912,16131,20132014,1,62.75,4,5,-1,3.01451237726724,3.56484146258381,-0.550329085316577,29,36,-7,40,54,-14,52,76,-24,8,5,0,0
"24243","WSH","PHI",2013020935,16134,20132014,0,60,4,6,-2,4.29691483383067,5.87695424505195,-1.58003941122128,25,30,-5,35,41,-6,51,60,-9,6,4,0,0
"24244","WSH","ARI",2013020958,16137,20132014,1,60,3,2,1,8.72044557081244,5.0722961940337,3.64814937677875,33,33,0,42,46,-4,53,54,-1,2,3,0,0
"24245","WSH","TOR",2013021014,16145,20132014,1,60,4,2,2,4.57109059405047,4.83012809512729,-0.259037501076818,33,29,4,44,35,9,58,50,8,4,3,0,0
"24246","WSH","ANA",2013021036,16147,20132014,0,60,3,2,1,3.37466673874591,5.06623652428971,-1.6915697855438,30,45,-15,41,66,-25,54,79,-25,4,6,0,0
"24247","WSH","DAL",2013021133,16161,20132014,1,60,0,5,-5,4.68296687287511,6.10330545803299,-1.42033858515788,35,36,-1,48,48,0,68,59,9,5,4,0,0
"24248","WSH","N.J",2013021157,16164,20132014,0,60,1,2,-1,4.68107053604035,6.46570636052638,-1.78463582448603,25,31,-6,36,39,-3,46,54,-8,4,5,0,0
"24249","WSH","NYI",2013021162,16165,20132014,0,65,3,3,0,2.77044312338694,5.02438421718398,-2.25394109379704,29,38,-9,40,51,-11,63,67,-4,6,4,0,0
"24250","WSH","STL",2013021186,16168,20132014,0,60,4,1,3,3.05734590460045,4.47392418807542,-1.41657828347496,22,29,-7,26,54,-28,32,80,-48,5,4,0,0
"24251","WSH","T.B",2013021223,16173,20132014,1,65,0,0,0,3.24470511093386,3.55033011240084,-0.305625001466979,18,32,-14,32,48,-16,45,65,-20,1,1,0,0
"24252","WSH","MTL",2014020008,16352,20142015,1,65,1,1,0,4.38111282704159,3.11243566925884,1.26867715778275,30,24,6,45,30,15,65,46,19,7,7,0,0
"24253","WSH","N.J",2014020052,16359,20142015,1,60,6,2,4,3.86694866257858,3.66716714706854,0.19978151551004,33,28,5,43,38,5,56,56,0,5,3,0,0
"24254","WSH","FLA",2014020069,16361,20142015,1,65,1,1,0,3.77594948977712,4.77361534550437,-0.99766585572725,28,21,7,40,36,4,57,50,7,2,5,0,0
"24255","WSH","EDM",2014020091,16365,20142015,0,60,2,3,-1,4.30274623304285,3.93199598789215,0.370750245150703,34,20,14,48,27,21,66,36,30,2,2,0,0
"24256","WSH","T.B",2014020155,16375,20142015,0,60,3,4,-1,2.84213964656132,4.02724387294438,-1.18510422638307,38,28,10,48,36,12,57,46,11,3,3,0,0
"24257","WSH","ARI",2014020167,16376,20142015,1,60,5,6,-1,4.48724083460876,5.16210468049394,-0.674863845885184,37,30,7,49,47,2,62,68,-6,5,8,0,0
"24258","WSH","N.J",2014020243,16388,20142015,1,60,0,1,-1,3.55795260082834,1.97605118104324,1.5819014197851,30,28,2,43,37,6,62,51,11,5,4,0,0
"24259","WSH","STL",2014020258,16389,20142015,0,60,1,4,-3,4.57671146493522,3.55055661895312,1.02615484598209,25,34,-9,36,46,-10,48,57,-9,1,3,0,0
"24260","WSH","ARI",2014020276,16392,20142015,0,63.2666666666667,2,1,1,3.84966644644555,3.98568356024043,-0.136017113794878,24,24,0,33,36,-3,50,50,0,3,4,0,0
"24261","WSH","COL",2014020286,16394,20142015,0,60,3,2,1,4.48584199062316,5.07958630658686,-0.593744315963704,23,29,-6,34,38,-4,51,50,1,2,1,0,0
"24262","WSH","NYI",2014020324,16400,20142015,0,64.6,2,3,-1,3.43832599454356,6.58108723336773,-3.14276123882416,27,35,-8,37,52,-15,44,71,-27,3,4,0,0
"24263","WSH","NYI",2014020335,16402,20142015,1,60,5,2,3,6.55386228922642,5.87926685724708,0.674595431979336,27,28,-1,43,44,-1,70,60,10,2,2,0,0
"24264","WSH","TOR",2014020344,16403,20142015,0,60,2,6,-4,5.35347280319547,5.14152325128089,0.211949551914586,37,23,14,56,38,18,70,52,18,3,4,0,0
"24265","WSH","N.J",2014020396,16410,20142015,0,60,4,1,3,3.25088561908342,3.95067695042962,-0.699791331346205,29,34,-5,39,49,-10,42,66,-24,4,4,0,0
"24266","WSH","T.B",2014020414,16413,20142015,0,60,5,3,2,5.01019858219524,5.60951388347894,-0.599315301283696,35,36,-1,46,49,-3,57,60,-3,3,4,0,0
"24267","WSH","T.B",2014020440,16417,20142015,1,60,4,2,2,3.38697526429314,7.69651716641216,-4.30954190211902,28,28,0,34,46,-12,49,64,-15,5,5,0,0
"24268","WSH","FLA",2014020457,16420,20142015,0,65,1,1,0,5.12790294986917,6.26535890297964,-1.13745595311048,24,29,-5,34,42,-8,49,51,-2,2,2,0,0
"24269","WSH","N.J",2014020483,16424,20142015,0,60,4,0,4,4.96814352711658,1.88453132550772,3.08361220160887,21,21,0,29,32,-3,37,36,1,4,3,0,0
"24270","WSH","OTT",2014020497,16426,20142015,1,60,2,1,1,4.51970446284903,3.53943656401248,0.980267898836559,23,39,-16,40,49,-9,59,67,-8,4,3,0,0
"24271","WSH","NYR",2014020506,16427,20142015,0,60,2,4,-2,3.71049448005357,6.04699312632965,-2.33649864627608,32,27,5,44,36,8,60,48,12,5,6,0,0
"24272","WSH","NYI",2014020531,16433,20142015,0,62.8833333333333,3,4,-1,2.05674134768196,6.429403555052,-4.37266220737004,26,39,-13,34,63,-29,49,77,-28,4,6,0,0
"24273","WSH","FLA",2014020577,16439,20142015,1,60,4,3,1,4.86495329909121,3.7491193228343,1.11583397625691,26,32,-6,44,44,0,63,60,3,3,6,0,0
"24274","WSH","TOR",2014020594,16442,20142015,0,60,6,2,4,7.33378519440443,3.5490493105608,3.78473588384363,26,33,-7,44,46,-2,53,59,-6,3,3,0,0
"24275","WSH","PHI",2014020599,16443,20142015,0,61.4666666666667,2,3,-1,3.38211740021147,7.00891763421123,-3.62680023399976,28,33,-5,37,49,-12,57,71,-14,3,4,0,0
"24276","WSH","COL",2014020628,16447,20142015,1,60,2,1,1,5.64444076835258,5.89235985280863,-0.247919084456052,38,32,6,59,44,15,79,56,23,4,3,0,0
"24277","WSH","PHI",2014020641,16449,20142015,1,60,1,0,1,4.35585290595009,4.31449933780823,0.041353568141858,26,21,5,40,32,8,54,55,-1,2,3,0,0
"24278","WSH","DAL",2014020668,16452,20142015,0,60,4,5,-1,6.46721437938993,3.47489128825488,2.99232309113505,32,26,6,42,40,2,68,51,17,3,5,0,0
"24279","WSH","EDM",2014020685,16455,20142015,1,65,4,4,0,2.00882935160689,4.2234023705039,-2.21457301889701,24,31,-7,40,40,0,61,60,1,2,6,0,0
"24280","WSH","MTL",2014020727,16466,20142015,0,63.1333333333333,0,1,-1,4.62723274005111,3.96832518544441,0.658907554606699,36,30,6,49,42,7,69,62,7,7,5,0,0
"24281","WSH","OTT",2014020761,16471,20142015,0,60,2,1,1,3.57914049733404,3.38205967690078,0.197080820433257,29,26,3,41,37,4,59,50,9,3,6,0,0
"24282","WSH","ANA",2014020769,16472,20142015,1,65,2,2,0,7.25446869543521,4.99059349015442,2.26387520528078,34,25,9,49,33,16,64,51,13,1,2,0,0
"24283","WSH","PHI",2014020786,16474,20142015,1,60,1,3,-2,4.94605272205081,3.8205991819365,1.12545354011431,14,25,-11,35,35,0,51,49,2,7,2,0,0
"24284","WSH","ANA",2014020836,16481,20142015,0,60,5,3,2,5.03030061884783,5.99901817913595,-0.968717560288121,28,33,-5,44,51,-7,55,69,-14,5,4,0,0
"24285","WSH","WPG",2014020863,16485,20142015,1,60,5,1,4,3.68159999827346,3.0202708874519,0.661329110821558,33,20,13,40,31,9,49,52,-3,6,3,0,0
"24286","WSH","NYI",2014020873,16487,20142015,1,65,2,2,0,5.47924964712001,8.90666077734204,-3.42741113022203,27,32,-5,40,51,-11,67,75,-8,1,1,0,0
"24287","WSH","PHI",2014020884,16488,20142015,0,60,2,3,-1,5.26482931871324,1.89104912172507,3.37378019698818,23,28,-5,35,39,-4,54,54,0,5,4,0,0
"24288","WSH","TOR",2014020936,16495,20142015,1,60,4,0,4,4.69850635950024,3.26275571501026,1.43575064448999,32,32,0,45,45,0,60,63,-3,4,6,0,0
"24289","WSH","MIN",2014020958,16499,20142015,1,60,1,2,-1,3.26265455393961,4.94546681178326,-1.68281225784365,25,30,-5,36,40,-4,46,55,-9,1,2,0,0
"24290","WSH","NYR",2014021000,16505,20142015,1,60,1,3,-2,6.16494457255062,4.72171351438247,1.44323105816815,29,31,-2,48,38,10,68,53,15,4,4,0,0
"24291","WSH","DAL",2014021014,16507,20142015,1,60,2,4,-2,0,0,0,20,31,-11,35,41,-6,48,57,-9,4,7,0,0
"24292","WSH","MIN",2014021057,16513,20142015,0,60,3,2,1,3.11057449321379,4.60262570963113,-1.49205121641734,27,30,-3,42,40,2,58,54,4,6,5,0,0
"24293","WSH","WPG",2014021074,16515,20142015,0,60,0,3,-3,2.54182890174105,4.35186222132324,-1.81003331958219,28,24,4,46,36,10,72,54,18,4,4,0,0
"24294","WSH","N.J",2014021104,16520,20142015,1,61.2166666666667,3,2,1,2.93119212580132,5.38450157914657,-2.45330945334525,24,31,-7,34,44,-10,47,50,-3,4,4,0,0
"24295","WSH","NYR",2014021128,16523,20142015,0,60,5,2,3,4.90015506141935,3.87950552121436,1.020649540205,31,25,6,38,39,-1,50,50,0,4,5,0,0
"24296","WSH","MTL",2014021154,16527,20142015,0,65,4,4,0,3.01515486765311,4.23745613984647,-1.22230127219336,19,27,-8,28,35,-7,49,65,-16,4,4,0,0
"24297","WSH","OTT",2014021171,16529,20142015,0,63.2333333333333,3,4,-1,9.85926393751288,5.03939020048347,4.81987373702941,32,28,4,52,40,12,65,54,11,2,4,0,0
"24298","WSH","NYR",2014021217,16536,20142015,1,60,2,4,-2,3.50163054049995,4.90861247199791,-1.40698193149797,24,34,-10,38,41,-3,55,53,2,2,5,0,0
"24299","WSH","NYI",2014030141,16540,20142015,1,60,1,4,-3,3.79234260355588,6.62225979172217,-2.82991718816629,25,27,-2,36,48,-12,55,65,-10,2,3,0,0
"24300","WSH","NYI",2014030142,16542,20142015,1,60,4,3,1,8.24184619476728,2.49904811230954,5.74279808245774,35,21,14,55,40,15,82,51,31,1,1,0,0
"24301","WSH","NYI",2014030143,16544,20142015,0,60.25,1,2,-1,3.51482757541817,4.48534821269982,-0.970520637281652,25,42,-17,33,52,-19,57,76,-19,3,3,0,0
"24302","WSH","NYI",2014030144,16546,20142015,0,71.15,2,1,1,4.62229159261119,4.61107910291685,0.0112124896943433,30,37,-7,42,57,-15,66,78,-12,1,4,0,0
"24303","WSH","NYI",2014030145,16548,20142015,1,60,5,1,4,4.76547477226995,3.41096649145311,1.35450828081684,41,23,18,51,42,9,67,60,7,3,2,0,0
"24304","WSH","NYI",2014030146,16550,20142015,0,60,1,3,-2,5.71619800792541,6.61074063921296,-0.89454263128755,39,38,1,51,48,3,65,66,-1,9,7,0,0
"24305","WSH","NYI",2014030147,16552,20142015,1,60,2,1,1,3.02035410958342,5.25466081981722,-2.2343067102338,26,11,15,40,29,11,60,49,11,0,1,0,0
"24306","WSH","NYR",2014030221,16555,20142015,0,60,2,1,1,4.50486542269937,4.11199868842959,0.392866734269774,29,32,-3,45,46,-1,60,65,-5,3,3,0,0
"24307","WSH","NYR",2014030222,16557,20142015,0,60,2,3,-1,3.09983884683606,4.08253128052456,-0.982692433688499,32,35,-3,48,48,0,60,63,-3,1,4,0,0
"24308","WSH","NYR",2014030223,16559,20142015,1,60,1,0,1,5.34084531744884,3.65481068007648,1.68603463737236,22,30,-8,37,42,-5,49,69,-20,2,2,0,0
"24309","WSH","NYR",2014030224,16561,20142015,1,60,2,1,1,5.75805223226052,3.30799018205289,2.45006205020763,30,29,1,42,41,1,49,66,-17,4,5,0,0
"24310","WSH","NYR",2014030225,16563,20142015,0,69.6166666666667,1,2,-1,4.34089799864159,4.03128053546243,0.309617463179165,29,43,-14,35,53,-18,56,66,-10,2,2,0,0
"24311","WSH","NYR",2014030226,16565,20142015,1,60,3,4,-1,7.83523828529814,5.46673949537217,2.36849878992598,45,28,17,62,40,22,96,55,41,4,3,0,0
"24312","WSH","NYR",2014030227,16568,20142015,0,71.4,1,2,-1,3.63312828875496,5.97561668067304,-2.34248839191808,36,39,-3,49,53,-4,68,74,-6,3,4,0,0
"24313","WSH","N.J",2015020022,16718,20152016,1,60,5,3,2,3.37850045737287,3.442017953245,-0.0635174958721336,27,25,2,37,35,2,54,51,3,6,4,0,0
"24314","WSH","EDM",2015020104,16731,20152016,0,60,7,4,3,4.80674261904308,3.55279984894514,1.25394277009794,26,23,3,37,39,-2,49,55,-6,4,6,0,0
"24315","WSH","NYR",2015020174,16742,20152016,0,60,2,5,-3,4.57181929715443,2.57470051616838,1.99711878098606,34,22,12,47,32,15,67,38,29,2,1,0,0
"24316","WSH","TOR",2015020203,16746,20152016,1,65,2,2,0,5.22392941309954,4.67394679867209,0.549982614427449,31,25,6,45,36,9,61,44,17,8,5,0,0
"24317","WSH","PHI",2015020232,16751,20152016,0,60,5,2,3,3.36425185730521,3.10859069452868,0.25566116277653,32,20,12,40,34,6,55,49,6,3,4,0,0
"24318","WSH","DAL",2015020281,16758,20152016,1,60,2,3,-1,4.82069197353081,3.55773824911739,1.26295372441342,35,31,4,49,43,6,68,60,8,0,2,0,0
"24319","WSH","COL",2015020298,16760,20152016,1,60,7,3,4,2.7970872517908,3.21819636455835,-0.421109112767553,32,27,5,46,39,7,62,46,16,5,2,0,0
"24320","WSH","EDM",2015020311,16762,20152016,1,60,1,0,1,2.43050761531049,3.72141224608509,-1.2909046307746,30,33,-3,43,49,-6,54,68,-14,3,3,0,0
"24321","WSH","WPG",2015020322,16764,20152016,1,60,5,3,2,3.30920948313724,2.36341721906501,0.945792264072224,34,26,8,48,39,9,62,57,5,3,3,0,0
"24322","WSH","T.B",2015020334,16766,20152016,1,60,4,2,2,5.09376973009785,6.33765675974428,-1.24388702964643,37,34,3,50,40,10,62,56,6,5,3,0,0
"24323","WSH","TOR",2015020343,16767,20152016,0,60,4,2,2,5.38744296482764,2.99255493416422,2.39488803066342,23,34,-11,44,48,-4,52,57,-5,3,2,0,0
"24324","WSH","MTL",2015020375,16772,20152016,0,60,3,2,1,3.59176530155673,3.52112443313308,0.0706408684236521,19,35,-16,30,47,-17,43,73,-30,3,3,0,0
"24325","WSH","WPG",2015020388,16774,20152016,0,64.6666666666667,1,2,-1,7.10566973162349,7.64874081144808,-0.543071079824585,38,36,2,50,50,0,69,57,12,5,6,0,0
"24326","WSH","T.B",2015020438,16781,20152016,0,60,2,1,1,1.89697856173468,4.20811477169627,-2.31113620996159,20,36,-16,39,54,-15,49,77,-28,2,4,0,0
"24327","WSH","PIT",2015020449,16783,20152016,0,60,4,1,3,5.30902401404455,3.20312610166849,2.10589791237607,34,45,-11,39,55,-16,52,79,-27,4,2,0,0
"24328","WSH","OTT",2015020464,16785,20152016,1,60,2,1,1,2.86154328979319,3.01518105974537,-0.153637769952184,25,27,-2,40,39,1,49,54,-5,3,2,0,0
"24329","WSH","T.B",2015020478,16787,20152016,1,60,5,3,2,6.04440540339196,3.21737911878154,2.82702628461042,23,19,4,38,35,3,52,56,-4,5,4,0,0
"24330","WSH","NYR",2015020497,16789,20152016,0,60,7,3,4,4.24838838562209,6.30822421091216,-2.05983582529007,30,36,-6,42,52,-10,52,66,-14,5,7,0,0
"24331","WSH","MTL",2015020519,16795,20152016,1,60,3,1,2,4.29545110620525,7.78393447007966,-3.48848336387441,33,30,3,39,42,-3,52,61,-9,3,3,0,0
"24332","WSH","NYI",2015020601,16807,20152016,0,60,4,1,3,5.16241877194261,4.88335473423291,0.279064037709702,38,35,3,46,54,-8,60,73,-13,3,3,0,0
"24333","WSH","NYR",2015020614,16809,20152016,0,61.4166666666667,4,3,1,5.27057340530155,3.76589607044466,1.50467733485689,31,26,5,40,44,-4,52,62,-10,3,3,0,0
"24334","WSH","OTT",2015020625,16810,20152016,1,60,7,1,6,5.36356565272183,5.31756823539035,0.0459974173314777,36,33,3,48,43,5,60,54,6,4,5,0,0
"24335","WSH","NYR",2015020673,16817,20152016,1,60,5,2,3,3.59862386549321,4.41486911773291,-0.816245252239696,24,33,-9,35,44,-9,57,61,-4,4,4,0,0
"24336","WSH","ANA",2015020704,16901,20152016,1,60,0,2,-2,4.19829239005958,3.3293538877333,0.868938502326273,24,21,3,42,35,7,56,45,11,4,4,0,0
"24337","WSH","PIT",2015020720,16861,20152016,1,60,3,2,1,3.72418232542259,5.18973494485722,-1.46555261943463,37,30,7,44,40,4,58,64,-6,5,4,0,0
"24338","WSH","PHI",2015020741,16827,20152016,1,60.6333333333333,3,4,-1,4.42450337700115,6.10319715496157,-1.67869377796042,30,32,-2,41,44,-3,62,66,-4,3,6,0,0
"24339","WSH","NYI",2015020761,16835,20152016,1,60,3,2,1,1.8346002131002,5.91625460342038,-4.08165439032018,23,26,-3,26,38,-12,41,71,-30,2,2,0,0
"24340","WSH","N.J",2015020775,16837,20152016,0,65,2,2,0,4.62844482436776,2.30909381633637,2.31935100803139,29,24,5,39,29,10,53,39,14,3,2,0,0
"24341","WSH","PHI",2015020787,16838,20152016,1,60,3,2,1,3.52301176969128,6.34312241841243,-2.82011064872115,30,35,-5,39,53,-14,57,68,-11,2,5,0,0
"24342","WSH","MIN",2015020813,16842,20152016,0,60,4,3,1,5.83455855826378,5.10507608680597,0.729482471457807,33,36,-3,44,55,-11,56,72,-16,5,5,0,0
"24343","WSH","DAL",2015020831,16844,20152016,0,60,3,4,-1,4.86087393481284,5.25619234115584,-0.395318406342994,23,35,-12,39,48,-9,53,65,-12,3,4,0,0
"24344","WSH","NYI",2015020858,16849,20152016,0,64.2666666666667,3,2,1,4.89431887233513,2.52799229012453,2.3663265822106,35,22,13,42,33,9,60,49,11,7,4,0,0
"24345","WSH","N.J",2015020878,16851,20152016,1,60,4,3,1,4.15453029383207,4.35161238027126,-0.197082086439195,32,24,8,41,33,8,64,48,16,3,1,0,0
"24346","WSH","ARI",2015020890,16853,20152016,1,60,3,2,1,3.83390707025501,3.62858535692794,0.205321713327066,34,27,7,53,35,18,65,52,13,4,6,0,0
"24347","WSH","MTL",2015020902,16855,20152016,1,60,3,4,-1,3.75160730443167,5.466139899263,-1.71453259483133,36,34,2,53,47,6,68,60,8,4,5,0,0
"24348","WSH","MIN",2015020917,16857,20152016,1,60,3,2,1,5.1264250583481,4.90426165382451,0.222163404523599,27,32,-5,36,45,-9,52,64,-12,1,3,0,0
"24349","WSH","TOR",2015020951,16862,20152016,1,60,3,2,1,1.45049298046069,3.06022171064978,-1.60972873018909,23,29,-6,32,37,-5,46,58,-12,5,5,0,0
"24350","WSH","NYR",2015020966,16864,20152016,1,60,2,3,-1,5.85930939228274,7.61139334735486,-1.75208395507212,34,23,11,50,35,15,77,48,29,3,3,0,0
"24351","WSH","ANA",2015020991,16867,20152016,0,65,1,1,0,5.69604897632962,5.20540112328399,0.49064785304563,32,28,4,40,44,-4,52,62,-10,4,4,0,0
"24352","WSH","PIT",2015021080,16880,20152016,0,60,2,6,-4,3.06420273298863,4.19070199441887,-1.12649926143024,18,31,-13,25,41,-16,40,51,-11,6,8,0,0
"24353","WSH","OTT",2015021092,16882,20152016,0,60,4,2,2,5.08365441695787,5.10221946676802,-0.0185650498101495,22,30,-8,32,44,-12,43,62,-19,2,4,0,0
"24354","WSH","N.J",2015021112,16885,20152016,0,62.2833333333333,1,0,1,4.69484576949617,3.0056028659892,1.68924290350697,26,22,4,36,30,6,48,38,10,3,4,0,0
"24355","WSH","PHI",2015021150,16890,20152016,0,65,1,1,0,7.98857261350713,4.17786892929917,3.81070368420797,30,34,-4,45,44,1,68,69,-1,6,6,0,0
"24356","WSH","COL",2015021165,16892,20152016,0,60,4,2,2,8.16688498779692,2.97690840950236,5.18997657829456,47,19,28,63,29,34,83,37,46,3,3,0,0
"24357","WSH","ARI",2015021177,16893,20152016,0,60,0,3,-3,4.35624834345072,3.14742161654578,1.20882672690493,31,27,4,47,36,11,68,51,17,2,1,0,0
"24358","WSH","NYI",2015021191,16896,20152016,1,62.2166666666667,3,4,-1,0,0,0,32,27,5,42,39,3,57,62,-5,3,4,0,0
"24359","WSH","PIT",2015021206,16898,20152016,1,64,3,4,-1,5.28476594889172,6.43788884420152,-1.1531228953098,30,35,-5,40,46,-6,52,56,-4,5,4,0,0
"24360","WSH","PHI",2015030131,16905,20152016,1,60,2,0,2,3.46391123266039,1.17690229026357,2.28700894239682,31,19,12,48,26,22,69,49,20,10,8,0,0
"24361","WSH","PHI",2015030132,16907,20152016,1,60,4,1,3,3.62430431519169,6.57479329244961,-2.95048897725792,23,42,-19,39,55,-16,48,81,-33,4,6,0,0
"24362","WSH","PHI",2015030133,16909,20152016,0,60,6,1,5,5.93715804081876,6.36820163148423,-0.431043590665467,27,32,-5,42,50,-8,68,63,5,9,7,0,0
"24363","WSH","PHI",2015030134,16911,20152016,0,60,1,2,-1,5.19259591103764,4.45998268826224,0.732613222775399,32,25,7,47,35,12,76,47,29,2,2,0,0
"24364","WSH","PHI",2015030135,16913,20152016,1,60,0,2,-2,3.34497211360401,3.19312879338395,0.151843320220057,44,11,33,63,21,42,82,27,55,4,7,0,0
"24365","WSH","PHI",2015030136,16915,20152016,0,60,1,0,1,3.76717119215755,4.24967040574503,-0.482499213587484,29,26,3,44,37,7,65,53,12,5,2,0,0
"24366","WSH","PIT",2015030221,16919,20152016,1,69.55,4,3,1,8.5102003091888,8.35585813898888,0.154342170199925,35,45,-10,49,61,-12,76,77,-1,5,3,0,0
"24367","WSH","PIT",2015030222,16921,20152016,1,60,1,2,-1,1.72419934253163,4.78485050603922,-3.06065116350759,24,35,-11,30,57,-27,54,79,-25,3,6,0,0
"24368","WSH","PIT",2015030223,16923,20152016,0,60,2,3,-1,5.83716253569582,2.67434143208419,3.16282110361164,49,23,26,66,30,36,85,36,49,4,3,0,0
"24369","WSH","PIT",2015030224,16925,20152016,0,62.5666666666667,2,3,-1,6.99762091230969,6.34168619977231,0.655934712537373,36,33,3,55,47,8,69,61,8,4,5,0,0
"24370","WSH","PIT",2015030225,16928,20152016,1,60,3,1,2,4.55237395671429,5.37022504733795,-0.817851090623662,19,31,-12,42,51,-9,58,70,-12,6,3,0,0
"24371","WSH","PIT",2015030226,16931,20152016,0,66.5333333333333,3,4,-1,8.03939433063351,8.69657622705563,-0.657181896422117,39,42,-3,52,55,-3,65,76,-11,6,2,0,0
"24372","WSH","PIT",2016020007,17087,20162017,0,65,2,2,0,6.72430556229665,2.82705242116936,3.89725314112729,41,30,11,53,33,20,68,48,20,3,2,0,0
"24373","WSH","NYI",2016020022,17089,20162017,1,60,2,1,1,2.84166805224959,4.9559189112079,-2.11425085895832,28,22,6,38,37,1,58,51,7,5,2,0,0
"24374","WSH","COL",2016020039,17092,20162017,1,60,3,0,3,6.201613094946,4.23863514285767,1.96297795208832,40,18,22,48,27,21,61,36,25,6,4,0,0
"24375","WSH","NYR",2016020071,17096,20162017,1,60,2,4,-2,2.58376208374827,3.61636460066438,-1.03260251691611,28,26,2,37,35,2,52,48,4,2,3,0,0
"24376","WSH","EDM",2016020096,17100,20162017,0,60,1,4,-3,3.56871227182637,4.27441243529029,-0.705700163463916,35,29,6,51,41,10,64,57,7,4,5,0,0
"24377","WSH","WPG",2016020138,17106,20162017,0,60,3,2,1,4.47112162140547,5.6962532007019,-1.22513157929643,27,45,-18,35,56,-21,48,61,-13,4,4,0,0
"24378","WSH","WPG",2016020149,17108,20162017,1,63.35,4,3,1,3.32736549177207,3.60226320727088,-0.27489771549881,32,27,5,46,42,4,65,53,12,6,3,0,0
"24379","WSH","PIT",2016020243,17121,20162017,1,60,7,1,6,5.96514243097794,4.25053865129303,1.71460377968491,39,26,13,50,35,15,68,46,22,9,6,0,0
"24380","WSH","TOR",2016020313,17131,20162017,0,60,2,4,-2,5.80109524234608,4.2745082065787,1.52658703576738,35,37,-2,53,53,0,70,62,8,4,5,0,0
"24381","WSH","NYI",2016020348,17136,20162017,1,60,0,3,-3,3.47860629132631,3.24403947024062,0.234566821085696,38,28,10,66,38,28,87,47,40,6,2,0,0
"24382","WSH","T.B",2016020364,17138,20162017,0,65,1,1,0,6.32961897832408,4.71037839169147,1.61924058663261,35,33,2,48,40,8,63,45,18,6,3,0,0
"24383","WSH","NYI",2016020432,17148,20162017,0,60,4,2,2,6.02357358289737,2.18663249199017,3.8369410909072,38,28,10,48,35,13,67,52,15,3,2,0,0
"24384","WSH","MTL",2016020465,17152,20162017,1,60,1,2,-1,4.50745773266044,3.45156925525398,1.05588847740646,21,25,-4,37,40,-3,58,44,14,5,3,0,0
"24385","WSH","PHI",2016020493,17156,20162017,0,65,2,2,0,6.88672914934341,6.03938215239032,0.847346996953092,38,38,0,47,50,-3,67,64,3,2,3,0,0
"24386","WSH","T.B",2016020508,17158,20162017,1,60,4,0,4,4.59895454560779,3.53421088348841,1.06474366211938,27,23,4,43,34,9,52,53,-1,2,3,0,0
"24387","WSH","NYI",2016020518,17162,20162017,0,60,3,4,-1,4.36400738952216,1.48252803782816,2.881479351694,34,31,3,47,42,5,61,54,7,4,4,0,0
"24388","WSH","N.J",2016020533,17164,20162017,1,65,1,1,0,6.05075037757388,3.18085654717402,2.86989383039986,44,27,17,62,37,25,78,50,28,4,4,0,0
"24389","WSH","N.J",2016020549,17166,20162017,0,60,6,2,4,2.22093032699487,3.32435174140846,-1.10342141441359,26,23,3,31,36,-5,41,49,-8,5,10,0,0
"24390","WSH","TOR",2016020566,17169,20162017,1,60.3666666666667,6,5,1,3.00922602478112,4.67589564737864,-1.66666962259752,29,25,4,40,37,3,56,50,6,3,7,0,0
"24391","WSH","MTL",2016020610,17175,20162017,0,60,4,1,3,6.06197651157709,5.25085772277089,0.811118788806198,39,23,16,50,38,12,68,62,6,2,4,0,0
"24392","WSH","PIT",2016020622,17177,20162017,1,60,5,2,3,5.48013690279913,3.22449420191263,2.2556427008865,30,32,-2,41,45,-4,51,64,-13,6,7,0,0
"24393","WSH","PHI",2016020652,17181,20162017,1,60,5,0,5,3.59141275093022,4.69989271845486,-1.10847996752464,22,24,-2,30,40,-10,48,56,-8,2,5,0,0
"24394","WSH","PIT",2016020661,17182,20162017,0,60.5666666666667,7,8,-1,4.19035050036382,3.9740130031808,0.216337497183019,28,37,-9,36,51,-15,52,67,-15,5,2,0,0
"24395","WSH","DAL",2016020697,17187,20162017,0,60.3166666666667,4,3,1,3.33207589465019,3.22481894741213,0.107256947238056,22,35,-13,36,45,-9,50,61,-11,3,7,0,0
"24396","WSH","N.J",2016020729,17192,20162017,0,60,5,2,3,6.2828826615781,5.78032999957213,0.502552662005964,36,29,7,47,43,4,54,48,6,5,4,0,0
"24397","WSH","NYI",2016020741,17197,20162017,0,60,2,3,-1,4.55796323164031,6.01617004908621,-1.4582068174459,30,29,1,44,45,-1,60,54,6,1,2,0,0
"24398","WSH","MTL",2016020771,17201,20162017,0,60,3,2,1,3.45014786940584,2.92242763245807,0.527720236947765,30,22,8,36,31,5,51,49,2,4,3,0,0
"24399","WSH","ANA",2016020824,17208,20162017,1,60,6,4,2,4.3811002788416,3.50748754439337,0.87361273444823,39,22,17,49,31,18,61,45,16,5,4,0,0
"24400","WSH","NYR",2016020869,17216,20162017,0,60,1,2,-1,4.42578912303052,5.40276227192953,-0.976973148899008,32,30,2,45,39,6,60,53,7,3,3,0,0
"24401","WSH","PHI",2016020892,17219,20162017,0,60,4,1,3,3.40394389629364,6.55336963085574,-3.1494257345621,29,34,-5,38,46,-8,50,69,-19,5,5,0,0
"24402","WSH","EDM",2016020900,17221,20162017,1,60,2,1,1,3.40365868330991,6.98177060734815,-3.57811192403824,25,31,-6,36,50,-14,54,61,-7,2,0,0,0
"24403","WSH","NYR",2016020924,17225,20162017,0,60,4,1,3,4.29586559523113,4.24332035413109,0.0525452411000398,38,30,8,47,43,4,65,54,11,2,4,0,0
"24404","WSH","N.J",2016020939,17227,20162017,1,60,1,0,1,4.18893322756319,1.32562786334862,2.86330536421457,24,15,9,40,26,14,59,50,9,5,4,0,0
"24405","WSH","PHI",2016020957,17229,20162017,1,63.4166666666667,2,1,1,3.33934110494122,2.89858202953474,0.440759075406486,24,31,-7,32,41,-9,52,58,-6,5,7,0,0
"24406","WSH","DAL",2016020969,17231,20162017,1,60,2,4,-2,5.89566885615932,4.46685859678526,1.42881025937406,44,22,22,60,29,31,82,48,34,4,2,0,0
"24407","WSH","ANA",2016021014,17237,20162017,0,60,2,5,-3,5.86123787862842,5.58881885599112,0.272419022637303,27,32,-5,51,46,5,71,58,13,5,6,0,0
"24408","WSH","MIN",2016021025,17239,20162017,1,60,4,2,2,5.54011350568906,1.82947029387727,3.71064321181179,40,32,8,52,39,13,67,54,13,5,7,0,0
"24409","WSH","T.B",2016021057,17243,20162017,0,60,5,3,2,5.85244212869293,5.56228132965043,0.290160799042496,35,29,6,47,41,6,65,52,13,4,3,0,0
"24410","WSH","ARI",2016021112,17250,20162017,1,60,4,1,3,6.36387178234872,6.02139824782898,0.34247353451974,33,29,4,54,37,17,69,46,23,5,5,0,0
"24411","WSH","MIN",2016021133,17253,20162017,0,61.8666666666667,5,4,1,3.61133477221805,5.18905659332009,-1.57772182110203,20,30,-10,30,44,-14,35,61,-26,4,4,0,0
"24412","WSH","COL",2016021139,17254,20162017,0,60,5,3,2,4.89062723508568,5.63262188690715,-0.741994651821467,35,35,0,42,46,-4,57,63,-6,3,3,0,0
"24413","WSH","ARI",2016021156,17256,20162017,0,60,3,6,-3,6.25181840151831,2.78011039714329,3.47170800437502,48,25,23,59,32,27,80,41,39,1,2,0,0
"24414","WSH","TOR",2016021182,17260,20162017,0,60,4,1,3,4.17353824906056,3.73511556067388,0.43842268838668,38,28,10,50,42,8,58,55,3,4,5,0,0
"24415","WSH","NYR",2016021193,17261,20162017,1,60,2,0,2,4.17593039579879,5.92135782862535,-1.74542743282656,25,24,1,38,36,2,52,45,7,4,2,0,0
"24416","WSH","TOR",2016030131,17269,20162017,1,65.25,3,2,1,7.9739436165255,8.30195521493442,-0.328011598408921,44,37,7,57,51,6,74,62,12,3,1,0,0
"24417","WSH","TOR",2016030132,17271,20162017,1,80,3,3,0,10.6532481809987,8.80800730411788,1.84524087688085,44,44,0,68,57,11,97,81,16,6,6,0,0
"24418","WSH","TOR",2016030133,17273,20162017,0,61.6166666666667,3,4,-1,4.1807958310431,4.65822624359033,-0.477430412547225,26,28,-2,41,47,-6,52,71,-19,6,6,0,0
"24419","WSH","TOR",2016030134,17275,20162017,0,60,5,4,1,4.61982842805446,3.36049640527926,1.2593320227752,27,34,-7,39,45,-6,56,67,-11,1,4,0,0
"24420","WSH","TOR",2016030135,17277,20162017,1,61.0666666666667,2,1,1,3.75645087647717,5.78070059389574,-2.02424971741857,28,25,3,42,41,1,58,63,-5,5,6,0,0
"24421","WSH","TOR",2016030136,17279,20162017,0,66.5166666666667,2,1,1,5.62663374773911,7.17887943834008,-1.55224569060097,36,38,-2,50,45,5,70,67,3,3,2,0,0
"24422","WSH","PIT",2016030221,17283,20162017,1,60,2,3,-1,6.17270162618661,2.75942589017723,3.41327573600938,35,21,14,54,33,21,83,41,42,1,3,0,0
"24423","WSH","PIT",2016030222,17285,20162017,1,60,2,6,-4,4.63201662217034,8.55754640212399,-3.92552977995365,36,24,12,55,35,20,88,45,43,5,3,0,0
"24424","WSH","PIT",2016030223,17287,20162017,0,63.2166666666667,3,2,1,5.26149239731785,4.39283116441129,0.868661232906566,33,30,3,45,41,4,63,55,8,7,4,0,0
"24425","WSH","PIT",2016030224,17289,20162017,0,60,2,3,-1,5.00095442647993,5.51468147229025,-0.513727045810319,38,19,19,48,28,20,72,39,33,5,7,0,0
"24426","WSH","PIT",2016030225,17292,20162017,1,60,4,2,2,0,0,0,32,22,10,46,35,11,66,52,14,3,2,0,0
"24427","WSH","PIT",2016030226,17294,20162017,0,60,5,2,3,2.70431814156311,3.39620378613955,-0.691885644576448,26,18,8,38,26,12,51,38,13,5,4,0,0
"24428","WSH","PIT",2016030227,17296,20162017,1,60,0,2,-2,6.56662144954752,5.45302126595925,1.11360018358827,29,28,1,42,39,3,61,48,13,2,2,0,0
"24429","WSH","MTL",2017020022,17446,20172018,1,60,6,1,5,3.96687802109409,6.44240249100747,-2.47552446991338,23,39,-16,29,55,-26,37,70,-33,4,4,0,0
"24430","WSH","T.B",2017020036,17448,20172018,0,63.1333333333333,3,4,-1,2.19014687341897,6.13337704397691,-3.94323017055794,26,40,-14,35,66,-31,48,83,-35,6,7,0,0
"24431","WSH","PIT",2017020047,17450,20172018,1,60,2,3,-1,2.85366872264422,4.05782996693986,-1.20416124429565,22,36,-14,37,41,-4,54,57,-3,4,6,0,0
"24432","WSH","N.J",2017020058,17452,20172018,0,60,5,2,3,3.84029945981456,5.14818535721861,-1.30788589740405,28,23,5,43,37,6,52,46,6,5,5,0,0
"24433","WSH","PHI",2017020066,17453,20172018,0,60,2,8,-6,3.90733364626067,5.31965058804097,-1.4123169417803,23,37,-14,36,47,-11,52,57,-5,2,2,0,0
"24434","WSH","TOR",2017020084,17456,20172018,1,60,0,2,-2,3.82699359580147,6.37733407423366,-2.55034047843219,30,30,0,39,48,-9,56,57,-1,3,2,0,0
"24435","WSH","EDM",2017020166,17467,20172018,0,60,5,2,3,5.08535432728968,3.38175477230106,1.70359955498861,31,40,-9,45,52,-7,57,76,-19,1,5,0,0
"24436","WSH","NYI",2017020187,17472,20172018,1,60,4,3,1,3.98806882696226,7.01774557970657,-3.02967675274431,19,38,-19,28,53,-25,48,72,-24,4,4,0,0
"24437","WSH","ARI",2017020220,17476,20172018,1,64.2333333333333,3,2,1,6.50982522207924,5.97315146783889,0.53667375424035,40,26,14,60,38,22,75,49,26,6,3,0,0
"24438","WSH","PIT",2017020244,17480,20172018,1,60,4,1,3,4.20098069839878,4.08722232146306,0.113758376935721,31,28,3,41,44,-3,56,59,-3,6,4,0,0
"24439","WSH","EDM",2017020261,17482,20172018,1,65,1,1,0,2.21029480476864,5.41116425289874,-3.20086944813011,19,30,-11,25,45,-20,35,64,-29,4,1,0,0
"24440","WSH","COL",2017020285,17486,20172018,0,60,2,6,-4,2.23755214349512,3.4149265836495,-1.17737444015438,30,28,2,35,36,-1,54,54,0,9,11,0,0
"24441","WSH","MIN",2017020301,17488,20172018,1,60,3,1,2,4.03399387630634,4.64769188768696,-0.61369801138062,43,31,12,47,42,5,60,52,8,6,4,0,0
"24442","WSH","T.B",2017020338,17494,20172018,1,60,3,1,2,5.90103445126442,2.97851052637239,2.92252392489203,38,26,12,50,43,7,64,68,-4,3,3,0,0
"24443","WSH","TOR",2017020348,17495,20172018,0,60,4,2,2,3.55503796990734,4.95818940072786,-1.40315143082052,21,29,-8,31,44,-13,43,56,-13,3,1,0,0
"24444","WSH","NYR",2017020440,17508,20172018,1,60,4,2,2,3.4113981203908,2.33846921502258,1.07292890536822,40,29,11,51,40,11,67,55,12,4,3,0,0
"24445","WSH","NYI",2017020460,17511,20172018,0,60,1,3,-2,3.59853246675216,3.06153591824113,0.536996548511027,32,29,3,40,46,-6,57,54,3,2,3,0,0
"24446","WSH","COL",2017020469,17512,20172018,1,60,5,2,3,3.60428050147215,2.14966078188156,1.45461971959059,27,24,3,42,34,8,55,56,-1,1,4,0,0
"24447","WSH","ANA",2017020502,17516,20172018,1,61.9666666666667,3,2,1,5.78570140151714,4.2391541058314,1.54654729568574,27,30,-3,45,45,0,68,61,7,0,1,0,0
"24448","WSH","DAL",2017020522,17519,20172018,0,61.85,4,3,1,3.66163677471286,5.13864271136117,-1.47700593664831,28,36,-8,41,49,-8,56,70,-14,6,7,0,0
"24449","WSH","ARI",2017020542,17522,20172018,0,64.55,2,3,-1,2.65502990582536,4.26730228231281,-1.61227237648745,17,27,-10,39,39,0,58,52,6,2,2,0,0
"24450","WSH","VGK",2017020555,17523,20172018,0,60,0,3,-3,4.75085811328609,2.19896690211447,2.55189121117161,26,28,-2,38,39,-1,63,49,14,4,2,0,0
"24451","WSH","NYR",2017020561,17527,20172018,0,65,0,0,0,2.11173712947332,5.12304613571719,-3.01130900624387,30,37,-7,35,52,-17,54,64,-10,2,3,0,0
"24452","WSH","N.J",2017020589,17530,20172018,1,60,5,2,3,4.88758820343074,5.53929665840406,-0.651708454973317,35,27,8,45,41,4,67,60,7,2,2,0,0
"24453","WSH","N.J",2017020695,17549,20172018,0,60.5666666666667,3,4,-1,1.91066187848816,4.49459292201573,-2.58393104352757,19,32,-13,32,49,-17,44,56,-12,5,3,0,0
"24454","WSH","MTL",2017020706,17550,20172018,1,60,2,3,-1,3.05268363113811,4.04894444507346,-0.996260813935347,26,26,0,43,48,-5,61,67,-6,4,5,0,0
"24455","WSH","PHI",2017020721,17552,20172018,1,60.45,1,2,-1,5.73567055616877,2.00210613106174,3.73356442510703,28,23,5,46,38,8,65,42,23,4,4,0,0
"24456","WSH","PHI",2017020775,17562,20172018,1,60,5,3,2,3.68489464684797,4.50323146293522,-0.818336816087253,25,30,-5,37,40,-3,52,49,3,3,1,0,0
"24457","WSH","PIT",2017020788,17564,20172018,0,60,4,7,-3,5.41841186846432,5.87816012790518,-0.459748259440858,33,39,-6,40,53,-13,54,64,-10,4,5,0,0
"24458","WSH","VGK",2017020805,17566,20172018,1,60,3,4,-1,2.92294074816164,8.37053767150285,-5.44759692334121,23,31,-8,31,49,-18,43,66,-23,2,1,0,0
"24459","WSH","WPG",2017020873,17575,20172018,0,62.5833333333333,3,4,-1,3.19794904282162,5.82223761299974,-2.62428857017812,27,44,-17,40,58,-18,48,78,-30,2,3,0,0
"24460","WSH","MIN",2017020885,17577,20172018,0,60,5,2,3,4.25546237031284,3.29093679018069,0.964525580132147,27,34,-7,38,43,-5,49,55,-6,2,5,0,0
"24461","WSH","T.B",2017020921,17582,20172018,1,60,2,4,-2,4.07284873904428,1.53422169625992,2.53862704278436,37,19,18,50,33,17,69,46,23,2,2,0,0
"24462","WSH","TOR",2017021005,17593,20172018,1,60,5,2,3,4.68907708546612,5.95227678053197,-1.26319969506585,34,29,5,41,45,-4,52,69,-17,2,2,0,0
"24463","WSH","ANA",2017021028,17596,20172018,0,60,0,4,-4,5.783259860822,5.81517459530005,-0.0319147344780504,36,18,18,56,37,19,79,50,29,4,2,0,0
"24464","WSH","WPG",2017021065,17602,20172018,1,64.1833333333333,3,2,1,7.17953459406272,3.75434814674372,3.42518644731899,43,28,15,52,40,12,73,62,11,4,3,0,0
"24465","WSH","NYI",2017021084,17605,20172018,0,60,7,3,4,3.34916981153947,4.26292449008385,-0.913754678544379,22,38,-16,26,51,-25,35,68,-33,1,3,0,0
"24466","WSH","NYI",2017021092,17606,20172018,1,60,6,3,3,5.43950806672729,5.64426706633628,-0.204758999608991,31,25,6,48,38,10,60,57,3,8,5,0,0
"24467","WSH","PHI",2017021112,17608,20172018,0,60,3,6,-3,4.36605181972845,5.39102146411005,-1.0249696443816,28,35,-7,42,51,-9,53,66,-13,4,4,0,0
"24468","WSH","DAL",2017021123,17610,20172018,1,60,4,3,1,5.61973843634277,4.35925149382092,1.26048694252185,32,27,5,40,38,2,51,59,-8,4,5,0,0
"24469","WSH","MTL",2017021154,17614,20172018,0,60,6,4,2,2.51904377649316,3.02258528353741,-0.503541507044247,30,21,9,40,33,7,53,47,6,3,3,0,0
"24470","WSH","NYR",2017021170,17616,20172018,0,60,4,2,2,3.86212897232582,3.87591842433903,-0.0137894520132136,33,30,3,38,47,-9,47,62,-15,3,4,0,0
"24471","WSH","NYR",2017021187,17618,20172018,1,60.6333333333333,3,2,1,2.44314276018822,5.40860257554414,-2.96545981535591,33,37,-4,47,51,-4,62,63,-1,5,6,0,0
"24472","WSH","PIT",2017021221,17622,20172018,0,60,3,1,2,5.69082147667476,4.39356544569572,1.29725603097904,34,37,-3,45,44,1,57,59,-2,8,7,0,0
"24473","WSH","N.J",2017021262,17628,20172018,1,60,5,3,2,8.14067317650188,2.86629477715729,5.27437839934459,26,26,0,46,35,11,57,48,9,4,3,0,0
"24474","WSH","PIT",2017030221,17647,20172018,1,60,2,3,-1,5.03198217806889,3.90941237569496,1.12256980237393,34,25,9,50,34,16,72,50,22,1,2,0,0
"24475","WSH","PIT",2017030222,17650,20172018,1,60,4,1,3,4.0928039057714,5.87017349014059,-1.77736958436918,32,33,-1,45,44,1,69,75,-6,5,5,0,0
"24476","WSH","PIT",2017030223,17652,20172018,0,60,4,3,1,5.58117630803099,4.38007455982649,1.2011017482045,22,22,0,36,36,0,48,48,0,6,6,0,0
"24477","WSH","PIT",2017030224,17654,20172018,0,60,1,3,-2,2.48451993897001,4.40045845158193,-1.91593851261192,21,24,-3,35,39,-4,48,52,-4,3,4,0,0
"24478","WSH","PIT",2017030225,17656,20172018,1,60,6,3,3,5.55938558698648,10.7137630819561,-5.15437749496965,32,39,-7,42,63,-21,59,75,-16,3,5,0,0
"24479","WSH","PIT",2017030226,17658,20172018,0,65.45,2,1,1,5.8892412338646,5.96052600242742,-0.0712847685628262,30,22,8,41,38,3,62,52,10,1,1,0,0
"24480","WSH","T.B",2017030311,17662,20172018,0,60,4,2,2,4.90139025676581,3.63684230818612,1.26454794857969,32,21,11,48,33,15,58,52,6,4,3,0,0
"24481","WSH","T.B",2017030312,17664,20172018,0,60,6,2,4,3.77637183146726,3.55319289085674,0.223178940610524,37,35,2,48,44,4,58,60,-2,6,7,0,0
"24482","WSH","T.B",2017030313,17666,20172018,1,60,2,4,-2,6.35660718032159,4.72757037951442,1.62903680080717,38,23,15,51,40,11,69,47,22,4,6,0,0
"24483","WSH","T.B",2017030314,17668,20172018,1,60,2,4,-2,8.26849572021456,4.43107880407479,3.83741691613977,38,20,18,49,27,22,65,45,20,4,2,0,0
"24484","WSH","T.B",2017030315,17670,20172018,0,60,2,3,-1,3.8656666544266,1.43907246626623,2.42659418816038,30,22,8,40,37,3,59,48,11,0,1,0,0
"24485","WSH","T.B",2017030316,17672,20172018,1,60,3,0,3,4.35973703330819,3.62748238891793,0.73225464439026,34,24,10,48,39,9,61,59,2,1,2,0,0
"24486","WSH","T.B",2017030317,17674,20172018,0,60,4,0,4,4.11842444317881,3.68410461100575,0.43431983217306,23,29,-6,32,45,-13,38,60,-22,3,2,0,0
"24487","WSH","VGK",2017030411,17679,20172018,0,60,4,6,-2,7.85315020955022,5.91179841401754,1.94135179553268,28,34,-6,51,49,2,68,67,1,2,2,0,0
"24488","WSH","VGK",2017030412,17681,20172018,0,60,3,2,1,4.74362176517025,5.73870313446969,-0.995081369299442,26,39,-13,36,51,-15,44,69,-25,4,7,0,0
"24489","WSH","VGK",2017030413,17684,20172018,1,60,3,1,2,4.53916516144454,3.64433936870102,0.894825792743524,26,22,4,49,36,13,58,62,-4,4,2,0,0
"24490","WSH","VGK",2017030414,17686,20172018,1,60,6,2,4,4.85515129251871,3.63391792942741,1.22123336309131,23,30,-7,33,47,-14,41,71,-30,6,5,0,0
"24491","WSH","VGK",2017030415,17689,20172018,0,60,4,3,1,3.31678769353684,6.46367479409173,-3.14688710055489,33,31,2,44,41,3,55,54,1,6,4,0,0
"24492","WSH","PIT",2018020007,17808,20182019,0,61.3333333333333,6,7,-1,4.26746386983785,3.85063649074711,0.416827379090748,36,41,-5,44,57,-13,56,75,-19,2,6,0,0
"24493","WSH","VGK",2018020043,17814,20182019,1,60,5,2,3,8.35961739700713,4.47596802774251,3.88364936926462,29,31,-2,43,48,-5,51,68,-17,4,3,0,0
"24494","WSH","N.J",2018020048,17815,20182019,0,60,0,6,-6,2.31129408247944,5.35756818480968,-3.04627410233024,21,36,-15,33,54,-21,53,62,-9,5,5,0,0
"24495","WSH","TOR",2018020065,17817,20182019,1,60,2,4,-2,4.67844818726007,4.52647659763182,0.151971589628256,27,28,-1,40,39,1,59,57,2,3,3,0,0
"24496","WSH","NYR",2018020087,17821,20182019,1,62.3,4,3,1,3.29722662889311,5.75858757996684,-2.46136095107374,38,32,6,48,44,4,65,54,11,4,4,0,0
"24497","WSH","EDM",2018020142,17829,20182019,0,60,1,4,-3,4.93816491574319,6.48775436329015,-1.54958944754696,32,32,0,43,42,1,68,54,14,1,4,0,0
"24498","WSH","MTL",2018020182,17836,20182019,0,60,4,3,1,1.62602027218909,3.78110186383128,-2.15508159164219,28,35,-7,35,43,-8,49,62,-13,1,3,0,0
"24499","WSH","DAL",2018020200,17838,20182019,1,63.2833333333333,3,4,-1,2.97026402740524,3.90621622603887,-0.935952198633631,32,37,-5,49,44,5,69,49,20,3,3,0,0
"24500","WSH","EDM",2018020213,17840,20182019,1,60,4,2,2,3.83619337565482,4.07826827313693,-0.242074897482105,23,33,-10,38,50,-12,48,73,-25,2,4,0,0
"24501","WSH","PIT",2018020224,17842,20182019,1,60,2,1,1,2.67385716902209,5.98206330740823,-3.30820613838614,22,42,-20,29,57,-28,46,78,-32,5,3,0,0
"24502","WSH","ARI",2018020255,17846,20182019,1,60,1,4,-3,5.19043736336095,3.79697077786113,1.39346658549981,39,22,17,53,38,15,64,52,12,2,6,0,0
"24503","WSH","MIN",2018020269,17848,20182019,0,60,5,2,3,5.95746705903189,5.49488590664987,0.46258115238202,33,28,5,40,42,-2,49,62,-13,3,7,0,0
"24504","WSH","WPG",2018020274,17849,20182019,0,60,1,3,-2,3.85094726366515,5.5058093254047,-1.65486206173955,28,24,4,36,39,-3,50,56,-6,3,3,0,0
"24505","WSH","COL",2018020289,17851,20182019,0,60.3666666666667,3,2,1,4.07507178990636,4.37399108924581,-0.298919299339445,29,26,3,39,31,8,56,49,7,3,2,0,0
"24506","WSH","MTL",2018020311,17854,20182019,0,63.5666666666667,5,4,1,5.37956635720911,6.59111948728969,-1.21155313008057,34,44,-10,45,53,-8,60,71,-11,3,4,0,0
"24507","WSH","NYR",2018020347,17859,20182019,0,60,5,3,2,4.47408708523809,5.31707420968138,-0.84298712444329,28,30,-2,46,36,10,54,47,7,2,2,0,0
"24508","WSH","NYI",2018020364,17861,20182019,0,60,4,1,3,2.68879707352608,4.71498580300249,-2.02618872947642,24,33,-9,35,45,-10,47,62,-15,2,4,0,0
"24509","WSH","N.J",2018020391,17865,20182019,1,60,6,3,3,6.77965078560192,6.22534692939507,0.554303856206843,31,36,-5,39,48,-9,50,62,-12,3,4,0,0
"24510","WSH","ANA",2018020407,17867,20182019,1,60,5,6,-1,6.55437352441368,3.66930108178713,2.88507244262655,32,25,7,41,37,4,55,49,6,5,3,0,0
"24511","WSH","VGK",2018020424,17869,20182019,0,60,3,5,-2,3.47988744006581,5.42850379747874,-1.94861635741293,26,28,-2,37,37,0,51,54,-3,3,5,0,0
"24512","WSH","ARI",2018020436,17871,20182019,0,60,4,2,2,6.98199881741311,4.64246643120833,2.33953238620478,29,29,0,44,45,-1,59,63,-4,2,3,0,0
"24513","WSH","PIT",2018020528,17884,20182019,1,60,1,2,-1,3.66821491846349,3.50808235130885,0.160132567154646,32,30,2,54,39,15,76,57,19,6,5,0,0
"24514","WSH","DAL",2018020632,17900,20182019,0,63.6166666666667,1,2,-1,6.61721449596098,3.41127037802607,3.20594411793491,37,29,8,52,38,14,63,57,6,4,4,0,0
"24515","WSH","PHI",2018020661,17904,20182019,1,60,5,3,2,6.1276385391393,5.3864736764667,0.741164862672601,25,40,-15,39,46,-7,53,65,-12,4,5,0,0
"24516","WSH","NYI",2018020735,17914,20182019,1,60,0,2,-2,2.93054573986956,4.98732976963583,-2.05678402976628,19,25,-6,34,37,-3,50,52,-2,2,2,0,0
"24517","WSH","TOR",2018020765,17919,20182019,0,60,3,6,-3,5.31298403069377,6.34281440085761,-1.02983037016384,44,37,7,59,56,3,68,78,-10,1,1,0,0
"24518","WSH","COL",2018020827,17934,20182019,1,64.2,4,3,1,4.88431005288281,5.57520410916044,-0.690894056277632,42,37,5,59,50,9,76,75,1,5,3,0,0
"24519","WSH","ANA",2018020909,17944,20182019,0,60,2,5,-3,3.89396699670383,7.35473679951974,-3.46076980281592,25,39,-14,35,61,-26,55,78,-23,3,4,0,0
"24520","WSH","TOR",2018020929,17948,20182019,0,60,3,2,1,4.03171379767082,5.21851937298925,-1.18680557531843,28,42,-14,53,68,-15,65,89,-24,4,3,0,0
"24521","WSH","NYR",2018020956,17951,20182019,1,64.3333333333333,6,5,1,7.54503331377398,5.39452402456509,2.15050928920889,35,31,4,55,40,15,71,53,18,7,8,0,0
"24522","WSH","NYI",2018020993,17956,20182019,0,60,3,1,2,4.68203792977147,1.71507087097552,2.96696705879594,29,21,8,44,29,15,69,40,29,3,3,0,0
"24523","WSH","NYR",2018021009,17958,20182019,0,65,2,2,0,4.82822737949948,3.06189687659472,1.76633050290476,39,24,15,48,33,15,60,42,18,4,2,0,0
"24524","WSH","PHI",2018021029,17961,20182019,0,60,5,3,2,4.79442958545405,4.21341585169564,0.581013733758414,35,30,5,49,44,5,64,54,10,4,2,0,0
"24525","WSH","N.J",2018021045,17963,20182019,1,60,3,0,3,6.69871501982237,3.71727196810672,2.98144305171564,36,25,11,53,35,18,69,55,14,5,6,0,0
"24526","WSH","WPG",2018021061,17965,20182019,1,60,3,1,2,4.71382121311035,4.61992077068935,0.0939004424209955,18,34,-16,31,48,-17,39,58,-19,2,5,0,0
"24527","WSH","PIT",2018021073,17967,20182019,0,60,3,5,-2,7.54506263248921,6.20046639849897,1.34459623399023,41,30,11,53,40,13,74,46,28,3,5,0,0
"24528","WSH","PHI",2018021085,17969,20182019,0,60,5,2,3,5.46551022867698,4.24483285151655,1.22067737716043,32,24,8,43,34,9,53,55,-2,3,4,0,0
"24529","WSH","T.B",2018021105,17971,20182019,0,60,3,6,-3,3.76634532679545,5.36259641204106,-1.5962510852456,34,35,-1,51,42,9,63,50,13,4,4,0,0
"24530","WSH","N.J",2018021122,17974,20182019,0,60,4,1,3,2.29255507141352,3.49285565217724,-1.20030058076372,22,21,1,32,29,3,38,37,1,1,2,0,0
"24531","WSH","T.B",2018021133,17975,20182019,1,63.0166666666667,4,5,-1,6.12672731436987,2.6166856639533,3.51004165041657,58,28,30,72,36,36,86,51,35,8,5,0,0
"24532","WSH","MIN",2018021148,17977,20182019,1,60,1,2,-1,4.19719242254087,6.65646155194952,-2.45926912940865,22,27,-5,42,44,-2,64,57,7,4,2,0,0
"24533","WSH","PHI",2018021164,17979,20182019,1,60,3,1,2,3.1915391411848,4.82420899059031,-1.63266984940551,30,36,-6,39,56,-17,47,74,-27,2,4,0,0
"24534","WSH","T.B",2018021206,17985,20182019,0,60,6,3,3,3.70802165173518,4.19995011633728,-0.491928464602097,35,28,7,45,36,9,55,49,6,5,3,0,0
"24535","WSH","MTL",2018021246,17990,20182019,1,60,2,1,1,5.80799787814249,4.26353700320396,1.54446087493852,31,34,-3,36,53,-17,44,72,-28,1,1,0,0
"24536","WSH","NYI",2018021265,17992,20182019,1,60,0,3,-3,3.84217982373775,5.9581091273285,-2.11592930359075,29,24,5,44,29,15,58,40,18,2,1,0,0
